"state_from","county_from","state_to","county_to","in","out","change"
1,1,1,3,66,0,66
1,1,1,21,201,231,-30
1,1,1,47,265,178,87
1,1,1,51,1077,974,103
1,1,1,69,36,53,-17
1,1,1,73,80,178,-98
1,1,1,81,63,57,6
1,1,1,85,48,0,48
1,1,1,89,29,0,29
1,1,1,97,60,89,-29
1,1,1,101,1620,1117,503
1,1,1,109,44,0,44
1,1,1,117,88,96,-8
1,1,1,125,56,35,21
1,1,1,127,0,28,-28
1,1,8,41,0,73,-73
1,1,12,33,0,33,-33
1,1,12,91,44,0,44
1,1,13,215,38,0,38
1,1,15,3,0,42,-42
1,1,17,163,47,0,47
1,1,45,79,0,47,-47
1,1,48,29,54,47,7
1,1,51,59,0,141,-141
1,1,51,153,0,56,-56
1,3,1,1,0,66,-66
1,3,1,15,67,82,-15
1,3,1,21,53,0,53
1,3,1,25,52,60,-8
1,3,1,31,37,49,-12
1,3,1,35,0,25,-25
1,3,1,39,0,30,-30
1,3,1,43,39,41,-2
1,3,1,47,51,36,15
1,3,1,51,81,46,35
1,3,1,53,220,258,-38
1,3,1,55,28,41,-13
1,3,1,69,66,60,6
1,3,1,73,362,358,4
1,3,1,77,48,36,12
1,3,1,81,140,131,9
1,3,1,89,109,110,-1
1,3,1,95,32,56,-24
1,3,1,97,2665,1846,819
1,3,1,99,74,79,-5
1,3,1,101,209,119,90
1,3,1,103,60,55,5
1,3,1,109,42,30,12
1,3,1,115,51,0,51
1,3,1,117,192,199,-7
1,3,1,121,34,0,34
1,3,1,123,0,33,-33
1,3,1,125,193,136,57
1,3,1,127,43,50,-7
1,3,1,129,53,71,-18
1,3,4,13,47,57,-10
1,3,6,37,42,35,7
1,3,6,73,51,0,51
1,3,12,5,62,76,-14
1,3,12,11,63,29,34
1,3,12,31,61,40,21
1,3,12,33,1016,653,363
1,3,12,57,63,52,11
1,3,12,71,35,0,35
1,3,12,81,39,0,39
1,3,12,86,44,0,44
1,3,12,91,70,82,-12
1,3,12,95,57,25,32
1,3,12,99,40,29,11
1,3,12,101,30,0,30
1,3,12,103,65,0,65
1,3,12,105,35,0,35
1,3,12,113,170,140,30
1,3,13,57,41,0,41
1,3,13,67,89,55,34
1,3,13,77,25,0,25
1,3,13,89,53,47,6
1,3,13,121,45,75,-30
1,3,13,135,54,44,10
1,3,13,139,28,0,28
1,3,13,151,39,0,39
1,3,15,3,38,0,38
1,3,17,31,40,23,17
1,3,22,33,53,50,3
1,3,22,51,61,55,6
1,3,22,71,32,40,-8
1,3,22,103,77,75,2
1,3,22,105,32,0,32
1,3,26,125,32,0,32
1,3,28,35,0,28,-28
1,3,28,47,86,80,6
1,3,28,49,24,0,24
1,3,28,59,94,65,29
1,3,28,87,30,0,30
1,3,28,121,38,0,38
1,3,32,3,48,0,48
1,3,37,119,0,30,-30
1,3,37,133,0,26,-26
1,3,40,143,36,0,36
1,3,47,37,66,59,7
1,3,47,93,36,0,36
1,3,47,125,33,0,33
1,3,47,149,0,36,-36
1,3,47,157,105,52,53
1,3,48,29,37,0,37
1,3,48,85,45,0,45
1,3,48,113,35,35,0
1,3,48,201,104,121,-17
1,3,48,439,52,36,16
1,3,53,33,0,32,-32
1,5,1,11,58,47,11
1,5,1,31,0,33,-33
1,5,1,45,111,190,-79
1,5,1,67,96,131,-35
1,5,1,69,118,148,-30
1,5,1,73,0,39,-39
1,5,1,81,42,77,-35
1,5,1,87,0,43,-43
1,5,1,101,72,123,-51
1,5,1,109,72,59,13
1,5,1,113,35,58,-23
1,5,12,57,40,0,40
1,5,13,215,35,62,-27
1,5,13,239,80,72,8
1,7,1,21,82,93,-11
1,7,1,73,373,390,-17
1,7,1,101,25,0,25
1,7,1,105,54,38,16
1,7,1,117,235,224,11
1,7,1,125,363,402,-39
1,9,1,15,27,0,27
1,9,1,43,290,353,-63
1,9,1,55,163,173,-10
1,9,1,73,2136,1196,940
1,9,1,89,50,75,-25
1,9,1,95,241,284,-43
1,9,1,101,34,0,34
1,9,1,103,0,36,-36
1,9,1,115,174,213,-39
1,9,1,117,83,102,-19
1,9,1,121,0,41,-41
1,9,1,125,28,52,-24
1,9,1,127,93,46,47
1,11,1,5,47,58,-11
1,11,1,87,54,76,-22
1,11,1,101,160,186,-26
1,11,1,109,55,49,6
1,13,1,35,64,35,29
1,13,1,39,50,90,-40
1,13,1,41,108,108,0
1,13,1,51,0,39,-39
1,13,1,85,119,86,33
1,13,1,101,144,220,-76
1,13,1,109,0,38,-38
1,15,1,3,82,67,15
1,15,1,9,0,27,-27
1,15,1,19,141,120,21
1,15,1,27,125,129,-4
1,15,1,29,299,296,3
1,15,1,43,0,31,-31
1,15,1,49,58,41,17
1,15,1,51,34,29,5
1,15,1,55,582,584,-2
1,15,1,73,313,387,-74
1,15,1,81,86,62,24
1,15,1,89,107,185,-78
1,15,1,95,70,58,12
1,15,1,97,0,51,-51
1,15,1,101,72,89,-17
1,15,1,103,0,29,-29
1,15,1,111,104,104,0
1,15,1,115,213,193,20
1,15,1,117,105,123,-18
1,15,1,121,1022,983,39
1,15,1,125,45,87,-42
1,15,1,127,29,0,29
1,15,4,13,28,0,28
1,15,12,5,28,33,-5
1,15,12,31,41,0,41
1,15,12,33,35,0,35
1,15,13,45,91,60,31
1,15,13,67,65,69,-4
1,15,13,89,37,45,-8
1,15,13,97,38,45,-7
1,15,13,115,30,0,30
1,15,13,121,46,53,-7
1,15,13,135,69,48,21
1,15,13,223,0,36,-36
1,15,13,233,29,33,-4
1,15,47,37,0,31,-31
1,15,47,65,0,31,-31
1,15,48,27,0,35,-35
1,15,48,201,0,24,-24
1,17,1,73,0,32,-32
1,17,1,81,813,928,-115
1,17,1,87,41,0,41
1,17,1,101,35,77,-42
1,17,1,111,64,110,-46
1,17,1,113,41,45,-4
1,17,1,123,61,85,-24
1,17,13,121,0,36,-36
1,17,13,145,41,36,5
1,17,13,215,45,56,-11
1,17,13,285,388,456,-68
1,19,1,15,120,141,-21
1,19,1,49,192,203,-11
1,19,1,55,192,184,8
1,19,1,73,0,23,-23
1,19,13,15,31,0,31
1,19,13,55,83,90,-7
1,19,13,67,26,0,26
1,19,13,115,113,172,-59
1,19,13,233,0,33,-33
1,21,1,1,231,201,30
1,21,1,3,0,53,-53
1,21,1,7,93,82,11
1,21,1,37,0,29,-29
1,21,1,47,66,40,26
1,21,1,51,117,72,45
1,21,1,73,276,310,-34
1,21,1,81,0,22,-22
1,21,1,97,0,31,-31
1,21,1,101,146,109,37
1,21,1,115,0,48,-48
1,21,1,117,656,686,-30
1,21,1,121,46,36,10
1,21,1,125,29,68,-39
1,23,1,25,42,0,42
1,23,1,97,36,42,-6
1,23,1,119,30,56,-26
1,23,1,125,0,50,-50
1,23,1,129,30,47,-17
1,23,28,75,50,60,-10
1,25,1,3,60,52,8
1,25,1,23,0,42,-42
1,25,1,73,0,37,-37
1,25,1,91,74,80,-6
1,25,1,97,171,218,-47
1,25,1,99,41,55,-14
1,25,1,101,45,79,-34
1,25,1,125,24,66,-42
1,25,1,129,161,137,24
1,25,1,131,106,111,-5
1,25,12,33,0,34,-34
1,27,1,15,129,125,4
1,27,1,29,35,0,35
1,27,1,37,28,0,28
1,27,1,73,68,39,29
1,27,1,111,56,107,-51
1,27,1,121,223,210,13
1,27,1,123,60,91,-31
1,29,1,15,296,299,-3
1,29,1,27,0,35,-35
1,29,1,111,70,59,11
1,29,1,121,37,38,-1
1,29,13,45,132,133,-1
1,29,13,143,112,71,41
1,31,1,3,49,37,12
1,31,1,5,33,0,33
1,31,1,39,218,239,-21
1,31,1,41,41,41,0
1,31,1,45,909,681,228
1,31,1,61,301,192,109
1,31,1,69,238,267,-29
1,31,1,73,39,65,-26
1,31,1,81,44,71,-27
1,31,1,89,28,105,-77
1,31,1,97,0,36,-36
1,31,1,101,82,49,33
1,31,1,109,253,233,20
1,31,2,90,58,92,-34
1,31,12,5,63,55,8
1,31,12,57,34,0,34
1,31,12,91,38,37,1
1,31,12,95,31,0,31
1,31,12,113,40,0,40
1,31,13,215,38,0,38
1,31,15,3,109,109,0
1,31,22,115,34,0,34
1,31,36,45,69,96,-27
1,31,36,71,116,0,116
1,31,37,51,83,82,1
1,31,47,125,186,104,82
1,31,48,27,89,156,-67
1,31,48,201,39,0,39
1,31,53,53,36,0,36
1,33,1,59,382,333,49
1,33,1,73,59,108,-49
1,33,1,77,1328,1297,31
1,33,1,79,163,110,53
1,33,1,83,44,52,-8
1,33,1,89,92,158,-66
1,33,1,93,66,56,10
1,33,1,101,39,0,39
1,33,1,103,95,109,-14
1,33,1,125,32,44,-12
1,33,28,141,64,51,13
1,33,47,37,33,0,33
1,33,47,99,27,0,27
1,33,47,157,40,0,40
1,35,1,3,25,0,25
1,35,1,13,35,64,-29
1,35,1,39,97,75,22
1,35,1,53,126,102,24
1,35,1,73,0,28,-28
1,35,1,97,37,71,-34
1,35,1,99,197,171,26
1,35,1,101,46,48,-2
1,35,12,33,0,49,-49
1,37,1,21,29,0,29
1,37,1,27,0,28,-28
1,37,1,51,71,66,5
1,37,1,73,37,0,37
1,37,1,101,36,33,3
1,37,1,121,274,320,-46
1,37,1,123,325,300,25
1,39,1,3,30,0,30
1,39,1,13,90,50,40
1,39,1,31,239,218,21
1,39,1,35,75,97,-22
1,39,1,41,93,79,14
1,39,1,45,31,60,-29
1,39,1,53,44,43,1
1,39,1,61,50,55,-5
1,39,1,69,45,51,-6
1,39,1,73,0,55,-55
1,39,1,81,0,30,-30
1,39,1,97,0,36,-36
1,39,1,101,63,58,5
1,39,1,109,0,46,-46
1,39,12,5,0,32,-32
1,39,12,33,52,51,1
1,39,12,91,171,167,4
1,39,12,113,29,50,-21
1,39,12,131,91,130,-39
1,41,1,13,108,108,0
1,41,1,31,41,41,0
1,41,1,39,79,93,-14
1,41,1,51,36,46,-10
1,41,1,101,192,187,5
1,41,1,109,154,151,3
1,43,1,3,41,39,2
1,43,1,9,353,290,63
1,43,1,15,31,0,31
1,43,1,55,34,40,-6
1,43,1,73,564,395,169
1,43,1,77,37,0,37
1,43,1,79,0,43,-43
1,43,1,81,29,0,29
1,43,1,83,52,70,-18
1,43,1,89,103,188,-85
1,43,1,95,278,231,47
1,43,1,101,50,0,50
1,43,1,103,568,537,31
1,43,1,115,69,49,20
1,43,1,117,90,57,33
1,43,1,125,49,36,13
1,43,1,127,140,118,22
1,43,1,133,141,136,5
1,45,1,5,190,111,79
1,45,1,31,681,909,-228
1,45,1,39,60,31,29
1,45,1,61,159,183,-24
1,45,1,67,104,96,8
1,45,1,69,950,1072,-122
1,45,1,73,57,47,10
1,45,1,81,32,27,5
1,45,1,89,0,52,-52
1,45,1,97,0,58,-58
1,45,1,101,68,72,-4
1,45,1,109,98,84,14
1,45,2,90,41,129,-88
1,45,8,41,53,44,9
1,45,12,5,48,44,4
1,45,12,11,31,0,31
1,45,12,31,32,0,32
1,45,12,33,37,0,37
1,45,12,63,0,34,-34
1,45,12,86,35,0,35
1,45,12,91,32,0,32
1,45,12,105,31,0,31
1,45,13,51,0,57,-57
1,45,13,215,0,37,-37
1,45,15,3,88,115,-27
1,45,20,61,35,0,35
1,45,21,47,61,0,61
1,45,22,115,36,0,36
1,45,28,47,0,34,-34
1,45,36,45,105,185,-80
1,45,36,71,35,0,35
1,45,37,51,111,105,6
1,45,47,125,222,322,-100
1,45,48,27,178,218,-40
1,45,48,29,43,45,-2
1,45,48,99,0,50,-50
1,45,48,141,42,64,-22
1,45,51,59,0,38,-38
1,45,53,53,57,52,5
1,47,1,1,178,265,-87
1,47,1,3,36,51,-15
1,47,1,21,40,66,-26
1,47,1,51,33,54,-21
1,47,1,73,139,110,29
1,47,1,85,75,59,16
1,47,1,89,0,35,-35
1,47,1,97,27,47,-20
1,47,1,101,275,444,-169
1,47,1,105,124,96,28
1,47,1,117,0,55,-55
1,47,1,125,25,113,-88
1,47,1,131,74,62,12
1,47,8,35,37,0,37
1,47,13,67,0,33,-33
1,49,1,15,41,58,-17
1,49,1,19,203,192,11
1,49,1,55,226,274,-48
1,49,1,71,519,566,-47
1,49,1,73,64,90,-26
1,49,1,81,0,32,-32
1,49,1,89,57,108,-51
1,49,1,95,591,727,-136
1,49,1,97,38,0,38
1,49,1,101,43,0,43
1,49,1,125,0,26,-26
1,49,12,99,36,0,36
1,49,13,55,48,0,48
1,49,13,83,93,50,43
1,49,13,115,0,43,-43
1,49,13,295,43,31,12
1,49,47,65,80,90,-10
1,51,1,1,974,1077,-103
1,51,1,3,46,81,-35
1,51,1,13,39,0,39
1,51,1,15,29,34,-5
1,51,1,21,72,117,-45
1,51,1,37,66,71,-5
1,51,1,41,46,36,10
1,51,1,47,54,33,21
1,51,1,53,35,0,35
1,51,1,55,0,38,-38
1,51,1,69,43,59,-16
1,51,1,73,140,268,-128
1,51,1,81,124,119,5
1,51,1,85,41,0,41
1,51,1,87,111,88,23
1,51,1,89,46,53,-7
1,51,1,97,62,79,-17
1,51,1,101,3100,2100,1000
1,51,1,109,61,0,61
1,51,1,115,40,0,40
1,51,1,117,69,172,-103
1,51,1,121,44,41,3
1,51,1,123,174,223,-49
1,51,1,125,0,96,-96
1,51,12,33,37,28,9
1,51,12,57,47,0,47
1,51,12,91,42,0,42
1,51,12,113,0,32,-32
1,51,13,135,49,0,49
1,51,13,215,0,33,-33
1,51,45,63,0,37,-37
1,51,45,79,0,83,-83
1,53,1,3,258,220,38
1,53,1,35,102,126,-24
1,53,1,39,43,44,-1
1,53,1,51,0,35,-35
1,53,1,73,0,31,-31
1,53,1,81,0,36,-36
1,53,1,97,71,100,-29
1,53,1,99,84,103,-19
1,53,1,101,58,45,13
1,53,1,125,0,32,-32
1,53,12,33,464,388,76
1,53,12,91,0,29,-29
1,53,12,113,126,127,-1
1,55,1,3,41,28,13
1,55,1,9,173,163,10
1,55,1,15,584,582,2
1,55,1,19,184,192,-8
1,55,1,43,40,34,6
1,55,1,49,274,226,48
1,55,1,51,38,0,38
1,55,1,71,0,32,-32
1,55,1,73,429,412,17
1,55,1,81,32,23,9
1,55,1,89,95,154,-59
1,55,1,95,849,885,-36
1,55,1,97,33,36,-3
1,55,1,101,56,47,9
1,55,1,103,31,0,31
1,55,1,115,339,294,45
1,55,1,117,65,119,-54
1,55,1,121,77,93,-16
1,55,1,125,57,50,7
1,55,13,89,40,31,9
1,55,13,115,53,0,53
1,55,13,121,0,28,-28
1,55,47,37,0,25,-25
1,57,1,73,28,40,-12
1,57,1,75,116,65,51
1,57,1,93,130,178,-48
1,57,1,107,35,0,35
1,57,1,125,221,268,-47
1,57,1,127,62,79,-17
1,59,1,33,333,382,-49
1,59,1,73,61,42,19
1,59,1,77,141,158,-17
1,59,1,79,48,74,-26
1,59,1,83,0,30,-30
1,59,1,89,0,31,-31
1,59,1,93,158,145,13
1,59,1,101,28,0,28
1,59,1,103,33,48,-15
1,59,1,133,122,60,62
1,59,28,57,96,69,27
1,59,28,141,84,98,-14
1,61,1,31,192,301,-109
1,61,1,39,55,50,5
1,61,1,45,183,159,24
1,61,1,69,499,494,5
1,61,12,5,46,0,46
1,61,12,59,171,67,104
1,61,12,63,34,0,34
1,61,12,131,71,38,33
1,63,1,65,0,41,-41
1,63,1,73,38,53,-15
1,63,1,91,64,76,-12
1,63,1,125,176,281,-105
1,65,1,63,41,0,41
1,65,1,91,87,91,-4
1,65,1,105,94,51,43
1,65,1,125,654,623,31
1,67,1,5,131,96,35
1,67,1,45,96,104,-8
1,67,1,69,537,528,9
1,67,1,109,0,29,-29
1,69,1,1,53,36,17
1,69,1,3,60,66,-6
1,69,1,5,148,118,30
1,69,1,31,267,238,29
1,69,1,39,51,45,6
1,69,1,45,1072,950,122
1,69,1,51,59,43,16
1,69,1,61,494,499,-5
1,69,1,67,528,537,-9
1,69,1,73,126,175,-49
1,69,1,81,70,73,-3
1,69,1,89,31,70,-39
1,69,1,97,90,76,14
1,69,1,101,164,145,19
1,69,1,109,105,96,9
1,69,1,117,34,56,-22
1,69,1,125,30,48,-18
1,69,12,5,219,205,14
1,69,12,11,71,0,71
1,69,12,31,66,45,21
1,69,12,33,45,68,-23
1,69,12,57,62,52,10
1,69,12,59,68,53,15
1,69,12,63,168,144,24
1,69,12,71,44,0,44
1,69,12,73,57,0,57
1,69,12,86,84,0,84
1,69,12,91,58,37,21
1,69,12,95,47,0,47
1,69,12,103,42,0,42
1,69,12,105,75,0,75
1,69,12,131,42,32,10
1,69,12,133,72,0,72
1,69,13,67,35,40,-5
1,69,13,99,74,57,17
1,69,13,121,47,30,17
1,69,13,135,33,33,0
1,69,13,215,36,34,2
1,69,13,253,33,35,-2
1,69,15,3,43,0,43
1,69,47,37,0,23,-23
1,71,1,49,566,519,47
1,71,1,55,32,0,32
1,71,1,73,42,49,-7
1,71,1,89,300,395,-95
1,71,1,95,212,153,59
1,71,1,103,38,36,2
1,71,13,83,102,120,-18
1,71,13,295,65,36,29
1,71,47,51,38,28,10
1,71,47,65,136,106,30
1,71,47,115,186,151,35
1,73,1,1,178,80,98
1,73,1,3,358,362,-4
1,73,1,5,39,0,39
1,73,1,7,390,373,17
1,73,1,9,1196,2136,-940
1,73,1,15,387,313,74
1,73,1,17,32,0,32
1,73,1,19,23,0,23
1,73,1,21,310,276,34
1,73,1,25,37,0,37
1,73,1,27,39,68,-29
1,73,1,31,65,39,26
1,73,1,33,108,59,49
1,73,1,35,28,0,28
1,73,1,37,0,37,-37
1,73,1,39,55,0,55
1,73,1,43,395,564,-169
1,73,1,45,47,57,-10
1,73,1,47,110,139,-29
1,73,1,49,90,64,26
1,73,1,51,268,140,128
1,73,1,53,31,0,31
1,73,1,55,412,429,-17
1,73,1,57,40,28,12
1,73,1,59,42,61,-19
1,73,1,63,53,38,15
1,73,1,69,175,126,49
1,73,1,71,49,42,7
1,73,1,77,119,106,13
1,73,1,79,0,28,-28
1,73,1,81,431,337,94
1,73,1,83,54,53,1
1,73,1,87,37,0,37
1,73,1,89,706,739,-33
1,73,1,91,106,53,53
1,73,1,93,80,49,31
1,73,1,95,155,153,2
1,73,1,97,637,527,110
1,73,1,99,40,0,40
1,73,1,101,1176,694,482
1,73,1,103,234,234,0
1,73,1,105,45,38,7
1,73,1,107,0,41,-41
1,73,1,109,107,44,63
1,73,1,113,46,0,46
1,73,1,115,1711,3325,-1614
1,73,1,117,5935,8111,-2176
1,73,1,119,49,55,-6
1,73,1,121,433,358,75
1,73,1,123,111,206,-95
1,73,1,125,1482,1498,-16
1,73,1,127,891,941,-50
1,73,1,131,84,30,54
1,73,1,133,64,64,0
1,73,4,13,120,114,6
1,73,4,19,37,0,37
1,73,5,119,39,85,-46
1,73,6,1,0,67,-67
1,73,6,37,166,167,-1
1,73,6,59,59,29,30
1,73,6,65,36,34,2
1,73,6,67,0,35,-35
1,73,6,71,58,46,12
1,73,6,73,150,92,58
1,73,6,75,25,32,-7
1,73,6,85,0,68,-68
1,73,8,5,0,32,-32
1,73,8,31,26,38,-12
1,73,8,41,36,48,-12
1,73,11,1,57,65,-8
1,73,12,1,74,51,23
1,73,12,5,145,119,26
1,73,12,9,0,38,-38
1,73,12,11,119,72,47
1,73,12,19,43,37,6
1,73,12,31,107,126,-19
1,73,12,33,207,149,58
1,73,12,57,98,143,-45
1,73,12,71,65,28,37
1,73,12,73,88,57,31
1,73,12,83,34,31,3
1,73,12,86,140,87,53
1,73,12,91,108,74,34
1,73,12,95,102,106,-4
1,73,12,97,28,0,28
1,73,12,99,100,65,35
1,73,12,103,79,82,-3
1,73,12,105,35,56,-21
1,73,12,113,69,86,-17
1,73,12,117,80,44,36
1,73,12,127,51,31,20
1,73,12,131,0,54,-54
1,73,13,21,33,0,33
1,73,13,45,51,52,-1
1,73,13,51,51,44,7
1,73,13,57,45,33,12
1,73,13,59,47,30,17
1,73,13,63,113,115,-2
1,73,13,67,282,357,-75
1,73,13,77,31,41,-10
1,73,13,89,233,354,-121
1,73,13,97,70,112,-42
1,73,13,113,45,42,3
1,73,13,115,33,0,33
1,73,13,117,31,0,31
1,73,13,121,483,571,-88
1,73,13,135,320,248,72
1,73,13,139,0,33,-33
1,73,13,151,48,64,-16
1,73,13,153,33,0,33
1,73,13,215,51,107,-56
1,73,13,223,38,0,38
1,73,13,245,56,58,-2
1,73,15,3,23,36,-13
1,73,17,19,26,0,26
1,73,17,31,209,188,21
1,73,17,43,37,0,37
1,73,17,197,27,0,27
1,73,18,97,62,43,19
1,73,20,91,0,35,-35
1,73,21,67,48,49,-1
1,73,21,111,64,50,14
1,73,22,33,57,60,-3
1,73,22,51,76,65,11
1,73,22,71,49,187,-138
1,73,22,73,40,0,40
1,73,22,103,33,35,-2
1,73,24,31,44,35,9
1,73,24,33,0,31,-31
1,73,25,17,37,60,-23
1,73,25,25,41,24,17
1,73,26,99,47,0,47
1,73,26,125,71,0,71
1,73,26,163,156,66,90
1,73,27,53,37,0,37
1,73,28,33,25,34,-9
1,73,28,35,0,30,-30
1,73,28,47,64,66,-2
1,73,28,49,107,81,26
1,73,28,59,49,44,5
1,73,28,71,41,0,41
1,73,28,75,68,61,7
1,73,28,81,47,0,47
1,73,28,87,68,0,68
1,73,28,89,79,40,39
1,73,28,105,46,0,46
1,73,28,121,74,35,39
1,73,29,189,89,71,18
1,73,29,510,31,0,31
1,73,32,3,68,67,1
1,73,34,23,0,28,-28
1,73,36,29,43,0,43
1,73,36,47,67,53,14
1,73,36,55,0,39,-39
1,73,36,61,88,92,-4
1,73,36,81,42,35,7
1,73,37,21,0,34,-34
1,73,37,51,50,56,-6
1,73,37,63,38,54,-16
1,73,37,67,0,42,-42
1,73,37,119,134,174,-40
1,73,37,133,47,30,17
1,73,37,135,33,0,33
1,73,37,183,55,68,-13
1,73,39,17,35,0,35
1,73,39,35,104,86,18
1,73,39,49,74,55,19
1,73,39,61,60,54,6
1,73,39,113,0,26,-26
1,73,40,143,43,24,19
1,73,42,3,78,45,33
1,73,42,101,49,57,-8
1,73,45,13,36,0,36
1,73,45,19,31,79,-48
1,73,45,45,63,70,-7
1,73,45,63,41,39,2
1,73,45,79,83,52,31
1,73,47,37,251,349,-98
1,73,47,65,108,116,-8
1,73,47,93,100,63,37
1,73,47,113,30,0,30
1,73,47,125,42,36,6
1,73,47,149,61,67,-6
1,73,47,157,231,173,58
1,73,47,165,46,0,46
1,73,47,187,72,82,-10
1,73,48,27,58,81,-23
1,73,48,29,39,64,-25
1,73,48,85,0,73,-73
1,73,48,113,124,151,-27
1,73,48,121,55,30,25
1,73,48,141,46,39,7
1,73,48,157,32,37,-5
1,73,48,201,174,204,-30
1,73,48,439,127,80,47
1,73,48,453,30,82,-52
1,73,48,491,0,36,-36
1,73,51,13,28,32,-4
1,73,51,59,59,56,3
1,73,51,87,31,0,31
1,73,51,153,0,41,-41
1,73,51,650,34,0,34
1,73,51,700,37,26,11
1,73,51,760,0,22,-22
1,73,51,810,46,32,14
1,73,53,33,54,43,11
1,73,53,53,0,57,-57
1,73,55,79,41,0,41
1,75,1,57,65,116,-51
1,75,1,93,129,145,-16
1,75,1,125,51,65,-14
1,75,28,87,135,108,27
1,75,28,95,63,84,-21
1,77,1,3,36,48,-12
1,77,1,33,1297,1328,-31
1,77,1,43,0,37,-37
1,77,1,59,158,141,17
1,77,1,73,106,119,-13
1,77,1,79,119,85,34
1,77,1,81,0,37,-37
1,77,1,83,213,245,-32
1,77,1,89,269,287,-18
1,77,1,93,58,0,58
1,77,1,101,45,49,-4
1,77,1,103,126,156,-30
1,77,1,117,23,63,-40
1,77,1,125,34,58,-24
1,77,1,127,30,0,30
1,77,1,133,32,0,32
1,77,12,11,28,0,28
1,77,28,141,38,0,38
1,77,47,37,65,86,-21
1,77,47,71,39,0,39
1,77,47,99,129,129,0
1,77,47,119,33,0,33
1,77,47,149,0,28,-28
1,77,47,157,43,0,43
1,77,47,181,84,73,11
1,79,1,33,110,163,-53
1,79,1,43,43,0,43
1,79,1,59,74,48,26
1,79,1,73,28,0,28
1,79,1,77,85,119,-34
1,79,1,83,64,83,-19
1,79,1,89,72,74,-2
1,79,1,103,870,889,-19
1,81,1,1,57,63,-6
1,81,1,3,131,140,-9
1,81,1,5,77,42,35
1,81,1,15,62,86,-24
1,81,1,17,928,813,115
1,81,1,21,22,0,22
1,81,1,31,71,44,27
1,81,1,39,30,0,30
1,81,1,43,0,29,-29
1,81,1,45,27,32,-5
1,81,1,49,32,0,32
1,81,1,51,119,124,-5
1,81,1,53,36,0,36
1,81,1,55,23,32,-9
1,81,1,69,73,70,3
1,81,1,73,337,431,-94
1,81,1,77,37,0,37
1,81,1,87,388,374,14
1,81,1,89,106,162,-56
1,81,1,95,58,39,19
1,81,1,97,111,138,-27
1,81,1,101,455,365,90
1,81,1,103,44,26,18
1,81,1,109,58,51,7
1,81,1,111,55,47,8
1,81,1,113,1605,1322,283
1,81,1,115,0,30,-30
1,81,1,117,175,158,17
1,81,1,121,61,31,30
1,81,1,123,301,267,34
1,81,1,125,72,48,24
1,81,4,13,0,41,-41
1,81,6,37,36,58,-22
1,81,6,73,25,0,25
1,81,12,5,28,33,-5
1,81,12,11,32,0,32
1,81,12,31,34,32,2
1,81,12,33,25,57,-32
1,81,12,57,40,0,40
1,81,12,73,0,29,-29
1,81,12,91,36,36,0
1,81,12,95,30,29,1
1,81,12,99,26,0,26
1,81,12,131,0,22,-22
1,81,13,51,0,32,-32
1,81,13,53,157,0,157
1,81,13,63,41,40,1
1,81,13,67,109,136,-27
1,81,13,73,0,31,-31
1,81,13,77,49,51,-2
1,81,13,89,48,109,-61
1,81,13,113,26,29,-3
1,81,13,121,87,187,-100
1,81,13,135,46,80,-34
1,81,13,145,92,95,-3
1,81,13,151,46,0,46
1,81,13,197,0,34,-34
1,81,13,215,1276,840,436
1,81,13,285,132,110,22
1,81,15,3,0,31,-31
1,81,17,31,0,33,-33
1,81,21,67,0,29,-29
1,81,26,163,41,0,41
1,81,32,3,0,42,-42
1,81,36,61,0,39,-39
1,81,37,51,0,45,-45
1,81,37,119,0,32,-32
1,81,37,133,30,0,30
1,81,37,183,0,28,-28
1,81,45,45,0,38,-38
1,81,45,79,0,44,-44
1,81,47,37,34,41,-7
1,81,47,125,44,0,44
1,81,48,27,0,48,-48
1,81,48,29,0,41,-41
1,81,48,113,0,34,-34
1,81,48,201,27,37,-10
1,83,1,33,52,44,8
1,83,1,43,70,52,18
1,83,1,59,30,0,30
1,83,1,73,53,54,-1
1,83,1,77,245,213,32
1,83,1,79,83,64,19
1,83,1,89,2636,1481,1155
1,83,1,95,57,30,27
1,83,1,103,575,548,27
1,83,1,117,53,42,11
1,83,12,9,36,0,36
1,83,47,37,40,55,-15
1,83,47,55,243,245,-2
1,83,47,65,35,0,35
1,83,47,103,73,77,-4
1,83,51,59,51,0,51
1,85,1,1,0,48,-48
1,85,1,13,86,119,-33
1,85,1,47,59,75,-16
1,85,1,51,0,41,-41
1,85,1,101,521,617,-96
1,87,1,5,43,0,43
1,87,1,11,76,54,22
1,87,1,17,0,41,-41
1,87,1,51,88,111,-23
1,87,1,73,0,37,-37
1,87,1,81,374,388,-14
1,87,1,101,274,341,-67
1,87,1,113,46,0,46
1,87,1,121,42,0,42
1,87,1,123,64,39,25
1,87,13,215,30,49,-19
1,89,1,1,0,29,-29
1,89,1,3,110,109,1
1,89,1,9,75,50,25
1,89,1,15,185,107,78
1,89,1,31,105,28,77
1,89,1,33,158,92,66
1,89,1,43,188,103,85
1,89,1,45,52,0,52
1,89,1,47,35,0,35
1,89,1,49,108,57,51
1,89,1,51,53,46,7
1,89,1,55,154,95,59
1,89,1,59,31,0,31
1,89,1,69,70,31,39
1,89,1,71,395,300,95
1,89,1,73,739,706,33
1,89,1,77,287,269,18
1,89,1,79,74,72,2
1,89,1,81,162,106,56
1,89,1,83,1481,2636,-1155
1,89,1,91,30,0,30
1,89,1,93,49,0,49
1,89,1,95,700,535,165
1,89,1,97,213,200,13
1,89,1,101,223,209,14
1,89,1,103,1147,1123,24
1,89,1,115,63,42,21
1,89,1,117,177,159,18
1,89,1,119,30,0,30
1,89,1,121,62,45,17
1,89,1,125,199,177,22
1,89,1,127,38,0,38
1,89,2,90,34,0,34
1,89,4,3,34,0,34
1,89,4,13,168,77,91
1,89,4,19,81,78,3
1,89,5,119,33,40,-7
1,89,6,1,39,0,39
1,89,6,37,199,84,115
1,89,6,59,84,0,84
1,89,6,65,64,0,64
1,89,6,67,31,0,31
1,89,6,71,59,45,14
1,89,6,73,120,71,49
1,89,6,83,42,0,42
1,89,6,85,52,25,27
1,89,6,111,42,0,42
1,89,8,35,0,56,-56
1,89,8,41,131,66,65
1,89,9,9,48,0,48
1,89,12,1,31,0,31
1,89,12,5,61,0,61
1,89,12,9,220,74,146
1,89,12,11,122,30,92
1,89,12,31,46,58,-12
1,89,12,33,44,53,-9
1,89,12,57,67,52,15
1,89,12,71,67,0,67
1,89,12,73,46,26,20
1,89,12,81,29,0,29
1,89,12,86,90,24,66
1,89,12,91,196,65,131
1,89,12,95,138,74,64
1,89,12,99,124,48,76
1,89,12,101,36,0,36
1,89,12,103,111,53,58
1,89,12,105,50,0,50
1,89,12,113,54,36,18
1,89,12,117,47,30,17
1,89,12,127,42,0,42
1,89,13,21,0,30,-30
1,89,13,51,45,39,6
1,89,13,57,38,0,38
1,89,13,63,51,54,-3
1,89,13,67,110,100,10
1,89,13,89,104,145,-41
1,89,13,97,0,27,-27
1,89,13,121,131,141,-10
1,89,13,135,141,110,31
1,89,13,151,32,25,7
1,89,13,153,34,0,34
1,89,13,179,50,0,50
1,89,13,215,89,31,58
1,89,15,3,81,36,45
1,89,17,31,139,124,15
1,89,17,89,33,0,33
1,89,18,89,0,32,-32
1,89,18,97,63,0,63
1,89,20,61,0,33,-33
1,89,20,173,35,0,35
1,89,21,47,80,0,80
1,89,21,67,30,0,30
1,89,21,111,61,0,61
1,89,22,33,47,33,14
1,89,22,51,34,40,-6
1,89,22,71,0,48,-48
1,89,22,103,35,44,-9
1,89,24,3,66,0,66
1,89,24,5,40,0,40
1,89,24,17,32,0,32
1,89,24,27,44,0,44
1,89,24,31,69,27,42
1,89,24,33,68,31,37
1,89,25,17,50,0,50
1,89,26,49,34,0,34
1,89,26,81,47,0,47
1,89,26,99,56,0,56
1,89,26,125,114,48,66
1,89,26,163,152,46,106
1,89,28,33,0,49,-49
1,89,28,47,47,0,47
1,89,28,49,53,0,53
1,89,28,75,32,0,32
1,89,28,89,44,0,44
1,89,28,105,52,0,52
1,89,29,183,63,28,35
1,89,29,189,152,73,79
1,89,32,3,53,47,6
1,89,34,25,42,0,42
1,89,35,1,37,0,37
1,89,36,47,0,23,-23
1,89,36,55,56,0,56
1,89,36,61,43,26,17
1,89,36,81,39,0,39
1,89,36,103,29,0,29
1,89,37,51,79,70,9
1,89,37,119,36,56,-20
1,89,37,129,21,0,21
1,89,37,133,52,0,52
1,89,37,183,40,47,-7
1,89,39,35,62,44,18
1,89,39,49,103,37,66
1,89,39,57,38,0,38
1,89,39,61,0,42,-42
1,89,39,113,33,0,33
1,89,40,31,0,37,-37
1,89,45,19,22,0,22
1,89,45,45,43,26,17
1,89,45,79,39,44,-5
1,89,47,3,27,0,27
1,89,47,31,73,0,73
1,89,47,37,271,255,16
1,89,47,51,90,33,57
1,89,47,55,155,136,19
1,89,47,65,149,87,62
1,89,47,93,72,59,13
1,89,47,103,386,515,-129
1,89,47,119,51,56,-5
1,89,47,125,189,82,107
1,89,47,149,59,96,-37
1,89,47,157,109,104,5
1,89,47,165,29,0,29
1,89,47,187,53,59,-6
1,89,48,27,150,74,76
1,89,48,29,88,55,33
1,89,48,85,55,42,13
1,89,48,113,70,43,27
1,89,48,121,34,32,2
1,89,48,141,106,53,53
1,89,48,167,55,0,55
1,89,48,201,195,96,99
1,89,48,439,86,92,-6
1,89,48,453,51,36,15
1,89,49,35,0,31,-31
1,89,51,13,55,36,19
1,89,51,41,28,0,28
1,89,51,59,263,131,132
1,89,51,107,59,0,59
1,89,51,153,182,58,124
1,89,51,177,63,0,63
1,89,51,179,54,0,54
1,89,51,510,37,0,37
1,89,51,700,30,0,30
1,89,51,810,73,25,48
1,89,53,33,93,51,42
1,89,53,53,54,26,28
1,89,53,61,62,0,62
1,89,53,67,0,41,-41
1,89,55,79,27,0,27
1,91,1,25,80,74,6
1,91,1,63,76,64,12
1,91,1,65,91,87,4
1,91,1,73,53,106,-53
1,91,1,89,0,30,-30
1,91,1,97,0,61,-61
1,91,1,101,51,75,-24
1,91,1,105,0,46,-46
1,91,1,119,67,52,15
1,91,1,125,62,164,-102
1,91,1,131,40,0,40
1,93,1,33,56,66,-10
1,93,1,57,178,130,48
1,93,1,59,145,158,-13
1,93,1,73,49,80,-31
1,93,1,75,145,129,16
1,93,1,77,0,58,-58
1,93,1,89,0,49,-49
1,93,1,125,39,76,-37
1,93,1,127,91,99,-8
1,93,1,133,174,166,8
1,93,28,81,36,34,2
1,95,1,3,56,32,24
1,95,1,9,284,241,43
1,95,1,15,58,70,-12
1,95,1,43,231,278,-47
1,95,1,49,727,591,136
1,95,1,55,885,849,36
1,95,1,71,153,212,-59
1,95,1,73,153,155,-2
1,95,1,81,39,58,-19
1,95,1,83,30,57,-27
1,95,1,89,535,700,-165
1,95,1,97,36,0,36
1,95,1,103,324,225,99
1,95,1,115,26,0,26
1,95,1,117,40,65,-25
1,95,1,125,38,48,-10
1,95,1,127,0,35,-35
1,95,12,57,29,0,29
1,95,12,71,49,0,49
1,95,12,91,38,0,38
1,95,12,105,32,0,32
1,97,1,1,89,60,29
1,97,1,3,1846,2665,-819
1,97,1,15,51,0,51
1,97,1,21,31,0,31
1,97,1,23,42,36,6
1,97,1,25,218,171,47
1,97,1,31,36,0,36
1,97,1,35,71,37,34
1,97,1,39,36,0,36
1,97,1,45,58,0,58
1,97,1,47,47,27,20
1,97,1,49,0,38,-38
1,97,1,51,79,62,17
1,97,1,53,100,71,29
1,97,1,55,36,33,3
1,97,1,69,76,90,-14
1,97,1,73,527,637,-110
1,97,1,81,138,111,27
1,97,1,89,200,213,-13
1,97,1,91,61,0,61
1,97,1,95,0,36,-36
1,97,1,99,91,60,31
1,97,1,101,561,389,172
1,97,1,103,56,41,15
1,97,1,109,0,44,-44
1,97,1,115,34,38,-4
1,97,1,117,156,198,-42
1,97,1,121,35,0,35
1,97,1,123,0,29,-29
1,97,1,125,193,145,48
1,97,1,129,444,425,19
1,97,1,131,40,0,40
1,97,4,13,72,57,15
1,97,4,19,0,28,-28
1,97,6,37,133,59,74
1,97,6,59,37,0,37
1,97,6,65,25,0,25
1,97,6,73,91,96,-5
1,97,8,41,52,27,25
1,97,9,3,0,25,-25
1,97,11,1,0,26,-26
1,97,12,5,99,96,3
1,97,12,9,48,38,10
1,97,12,11,74,39,35
1,97,12,19,0,31,-31
1,97,12,31,113,126,-13
1,97,12,33,315,381,-66
1,97,12,57,124,103,21
1,97,12,69,41,0,41
1,97,12,71,39,0,39
1,97,12,73,75,57,18
1,97,12,86,127,45,82
1,97,12,91,180,115,65
1,97,12,95,57,68,-11
1,97,12,99,61,0,61
1,97,12,101,0,28,-28
1,97,12,103,56,47,9
1,97,12,105,33,40,-7
1,97,12,113,103,121,-18
1,97,12,117,29,35,-6
1,97,13,51,36,0,36
1,97,13,63,71,64,7
1,97,13,67,96,116,-20
1,97,13,89,135,126,9
1,97,13,121,116,174,-58
1,97,13,135,118,83,35
1,97,15,3,76,39,37
1,97,17,31,80,62,18
1,97,21,111,0,32,-32
1,97,22,19,26,39,-13
1,97,22,33,100,78,22
1,97,22,51,166,116,50
1,97,22,63,0,33,-33
1,97,22,71,106,130,-24
1,97,22,75,0,43,-43
1,97,22,103,91,95,-4
1,97,24,31,0,32,-32
1,97,26,99,24,0,24
1,97,26,125,48,0,48
1,97,26,163,89,38,51
1,97,28,35,75,75,0
1,97,28,39,202,183,19
1,97,28,41,61,74,-13
1,97,28,47,320,286,34
1,97,28,49,60,51,9
1,97,28,59,983,703,280
1,97,28,67,0,27,-27
1,97,28,73,35,57,-22
1,97,28,75,35,0,35
1,97,28,87,28,0,28
1,97,28,89,0,44,-44
1,97,28,109,31,0,31
1,97,28,121,49,36,13
1,97,28,153,0,34,-34
1,97,32,3,38,51,-13
1,97,36,47,0,29,-29
1,97,36,61,0,44,-44
1,97,36,103,27,0,27
1,97,37,51,44,36,8
1,97,37,119,50,37,13
1,97,37,133,43,46,-3
1,97,37,139,35,0,35
1,97,37,183,0,32,-32
1,97,39,35,46,0,46
1,97,39,49,28,0,28
1,97,40,109,37,0,37
1,97,40,143,0,49,-49
1,97,47,37,80,112,-32
1,97,47,65,0,40,-40
1,97,47,93,31,29,2
1,97,47,157,113,84,29
1,97,48,27,49,59,-10
1,97,48,29,45,53,-8
1,97,48,113,85,84,1
1,97,48,157,0,59,-59
1,97,48,167,44,27,17
1,97,48,201,205,305,-100
1,97,48,245,0,44,-44
1,97,48,339,30,35,-5
1,97,48,355,42,0,42
1,97,48,439,67,61,6
1,97,48,453,29,34,-5
1,97,51,59,0,47,-47
1,97,51,550,30,0,30
1,97,51,650,0,29,-29
1,97,51,810,60,0,60
1,97,53,33,25,0,25
1,97,53,53,0,32,-32
1,97,55,79,34,0,34
1,99,1,3,79,74,5
1,99,1,25,55,41,14
1,99,1,35,171,197,-26
1,99,1,53,103,84,19
1,99,1,73,0,40,-40
1,99,1,97,60,91,-31
1,99,1,101,49,78,-29
1,99,1,131,28,34,-6
1,99,12,33,46,47,-1
1,99,28,59,0,31,-31
1,101,1,1,1117,1620,-503
1,101,1,3,119,209,-90
1,101,1,5,123,72,51
1,101,1,7,0,25,-25
1,101,1,9,0,34,-34
1,101,1,11,186,160,26
1,101,1,13,220,144,76
1,101,1,15,89,72,17
1,101,1,17,77,35,42
1,101,1,21,109,146,-37
1,101,1,25,79,45,34
1,101,1,31,49,82,-33
1,101,1,33,0,39,-39
1,101,1,35,48,46,2
1,101,1,37,33,36,-3
1,101,1,39,58,63,-5
1,101,1,41,187,192,-5
1,101,1,43,0,50,-50
1,101,1,45,72,68,4
1,101,1,47,444,275,169
1,101,1,49,0,43,-43
1,101,1,51,2100,3100,-1000
1,101,1,53,45,58,-13
1,101,1,55,47,56,-9
1,101,1,59,0,28,-28
1,101,1,69,145,164,-19
1,101,1,73,694,1176,-482
1,101,1,77,49,45,4
1,101,1,81,365,455,-90
1,101,1,85,617,521,96
1,101,1,87,341,274,67
1,101,1,89,209,223,-14
1,101,1,91,75,51,24
1,101,1,97,389,561,-172
1,101,1,99,78,49,29
1,101,1,103,30,54,-24
1,101,1,105,48,0,48
1,101,1,109,255,233,22
1,101,1,113,82,70,12
1,101,1,115,40,34,6
1,101,1,117,178,421,-243
1,101,1,121,128,74,54
1,101,1,123,197,172,25
1,101,1,125,177,219,-42
1,101,1,127,0,32,-32
1,101,1,131,77,38,39
1,101,2,20,53,48,5
1,101,2,90,0,33,-33
1,101,4,13,50,34,16
1,101,4,19,0,37,-37
1,101,6,37,118,88,30
1,101,6,59,0,29,-29
1,101,6,73,49,75,-26
1,101,6,95,0,54,-54
1,101,8,41,98,65,33
1,101,11,1,36,34,2
1,101,12,5,64,62,2
1,101,12,9,0,48,-48
1,101,12,11,37,44,-7
1,101,12,31,77,108,-31
1,101,12,33,84,88,-4
1,101,12,57,77,125,-48
1,101,12,73,29,33,-4
1,101,12,86,63,42,21
1,101,12,91,95,158,-63
1,101,12,95,33,41,-8
1,101,12,99,48,0,48
1,101,12,103,0,27,-27
1,101,12,105,27,0,27
1,101,12,113,59,54,5
1,101,13,21,0,30,-30
1,101,13,51,45,30,15
1,101,13,63,85,102,-17
1,101,13,67,154,137,17
1,101,13,89,150,166,-16
1,101,13,97,0,28,-28
1,101,13,121,134,312,-178
1,101,13,135,107,132,-25
1,101,13,151,33,36,-3
1,101,13,153,53,53,0
1,101,13,215,99,112,-13
1,101,15,3,68,89,-21
1,101,17,31,63,85,-22
1,101,17,163,0,49,-49
1,101,18,97,30,0,30
1,101,21,111,0,35,-35
1,101,22,15,61,0,61
1,101,22,51,0,25,-25
1,101,22,71,45,94,-49
1,101,24,33,0,32,-32
1,101,25,17,38,0,38
1,101,25,25,0,27,-27
1,101,26,125,61,41,20
1,101,26,163,152,82,70
1,101,28,47,63,71,-8
1,101,28,49,0,26,-26
1,101,28,59,31,33,-2
1,101,32,3,93,100,-7
1,101,36,47,31,0,31
1,101,36,61,0,40,-40
1,101,37,51,57,66,-9
1,101,37,119,0,55,-55
1,101,37,133,31,0,31
1,101,37,183,0,34,-34
1,101,39,35,40,29,11
1,101,39,57,54,0,54
1,101,39,61,0,25,-25
1,101,39,113,42,34,8
1,101,40,109,44,0,44
1,101,45,19,28,27,1
1,101,45,63,0,38,-38
1,101,45,79,0,129,-129
1,101,45,85,0,50,-50
1,101,47,37,82,85,-3
1,101,47,65,0,47,-47
1,101,47,93,30,0,30
1,101,47,125,0,39,-39
1,101,47,149,36,0,36
1,101,47,157,58,59,-1
1,101,48,27,0,67,-67
1,101,48,29,121,115,6
1,101,48,85,0,31,-31
1,101,48,113,49,50,-1
1,101,48,121,0,32,-32
1,101,48,201,56,96,-40
1,101,48,439,0,58,-58
1,101,48,453,38,34,4
1,101,51,59,71,217,-146
1,101,51,153,44,88,-44
1,101,51,199,58,0,58
1,101,51,510,0,46,-46
1,101,51,810,37,34,3
1,103,1,3,55,60,-5
1,103,1,9,36,0,36
1,103,1,15,29,0,29
1,103,1,33,109,95,14
1,103,1,43,537,568,-31
1,103,1,55,0,31,-31
1,103,1,59,48,33,15
1,103,1,71,36,38,-2
1,103,1,73,234,234,0
1,103,1,77,156,126,30
1,103,1,79,889,870,19
1,103,1,81,26,44,-18
1,103,1,83,548,575,-27
1,103,1,89,1123,1147,-24
1,103,1,95,225,324,-99
1,103,1,97,41,56,-15
1,103,1,101,54,30,24
1,103,1,117,80,56,24
1,103,1,125,52,97,-45
1,103,1,133,54,53,1
1,103,12,9,29,0,29
1,103,12,33,30,0,30
1,103,12,57,32,0,32
1,103,12,91,32,0,32
1,103,13,67,30,0,30
1,103,13,121,0,38,-38
1,103,17,31,51,0,51
1,103,26,163,30,0,30
1,103,47,37,39,45,-6
1,103,47,125,37,0,37
1,103,48,201,30,0,30
1,105,1,7,38,54,-16
1,105,1,47,96,124,-28
1,105,1,65,51,94,-43
1,105,1,73,38,45,-7
1,105,1,91,46,0,46
1,105,1,101,0,48,-48
1,105,1,125,29,127,-98
1,107,1,57,0,35,-35
1,107,1,73,41,0,41
1,107,1,125,366,494,-128
1,107,28,87,125,66,59
1,109,1,1,0,44,-44
1,109,1,3,30,42,-12
1,109,1,5,59,72,-13
1,109,1,11,49,55,-6
1,109,1,13,38,0,38
1,109,1,31,233,253,-20
1,109,1,39,46,0,46
1,109,1,41,151,154,-3
1,109,1,45,84,98,-14
1,109,1,51,0,61,-61
1,109,1,67,29,0,29
1,109,1,69,96,105,-9
1,109,1,73,44,107,-63
1,109,1,81,51,58,-7
1,109,1,97,44,0,44
1,109,1,101,233,255,-22
1,111,1,15,104,104,0
1,111,1,17,110,64,46
1,111,1,27,107,56,51
1,111,1,29,59,70,-11
1,111,1,81,47,55,-8
1,111,1,121,0,35,-35
1,111,1,123,0,49,-49
1,111,13,45,93,97,-4
1,111,13,77,35,0,35
1,111,13,97,65,0,65
1,111,13,121,34,0,34
1,111,13,149,47,0,47
1,111,13,285,87,74,13
1,113,1,5,58,35,23
1,113,1,17,45,41,4
1,113,1,73,0,46,-46
1,113,1,81,1322,1605,-283
1,113,1,87,0,46,-46
1,113,1,101,70,82,-12
1,113,8,41,0,40,-40
1,113,12,5,0,30,-30
1,113,13,53,252,91,161
1,113,13,89,0,40,-40
1,113,13,121,0,70,-70
1,113,13,145,76,157,-81
1,113,13,215,2371,1988,383
1,113,37,51,0,43,-43
1,113,47,125,32,0,32
1,113,48,27,0,38,-38
1,113,53,53,50,0,50
1,115,1,3,0,51,-51
1,115,1,9,213,174,39
1,115,1,15,193,213,-20
1,115,1,21,48,0,48
1,115,1,43,49,69,-20
1,115,1,51,0,40,-40
1,115,1,55,294,339,-45
1,115,1,73,3325,1711,1614
1,115,1,81,30,0,30
1,115,1,89,42,63,-21
1,115,1,95,0,26,-26
1,115,1,97,38,34,4
1,115,1,101,34,40,-6
1,115,1,117,518,434,84
1,115,1,121,450,460,-10
1,115,1,125,90,47,43
1,115,1,127,33,60,-27
1,117,1,1,96,88,8
1,117,1,3,199,192,7
1,117,1,7,224,235,-11
1,117,1,9,102,83,19
1,117,1,15,123,105,18
1,117,1,21,686,656,30
1,117,1,43,57,90,-33
1,117,1,47,55,0,55
1,117,1,51,172,69,103
1,117,1,55,119,65,54
1,117,1,69,56,34,22
1,117,1,73,8111,5935,2176
1,117,1,77,63,23,40
1,117,1,81,158,175,-17
1,117,1,83,42,53,-11
1,117,1,89,159,177,-18
1,117,1,95,65,40,25
1,117,1,97,198,156,42
1,117,1,101,421,178,243
1,117,1,103,56,80,-24
1,117,1,115,434,518,-84
1,117,1,121,419,337,82
1,117,1,123,92,111,-19
1,117,1,125,386,333,53
1,117,1,127,134,79,55
1,117,1,133,0,29,-29
1,117,4,13,44,35,9
1,117,6,37,60,46,14
1,117,6,73,48,28,20
1,117,12,5,60,46,14
1,117,12,9,38,0,38
1,117,12,11,61,0,61
1,117,12,31,50,67,-17
1,117,12,33,81,32,49
1,117,12,57,76,0,76
1,117,12,86,71,36,35
1,117,12,91,86,0,86
1,117,12,95,72,60,12
1,117,12,99,54,0,54
1,117,12,103,66,26,40
1,117,12,105,50,0,50
1,117,12,109,0,35,-35
1,117,12,113,62,50,12
1,117,12,117,0,34,-34
1,117,12,127,31,0,31
1,117,12,131,37,0,37
1,117,13,51,36,0,36
1,117,13,57,0,37,-37
1,117,13,67,103,92,11
1,117,13,89,55,52,3
1,117,13,117,38,39,-1
1,117,13,121,116,106,10
1,117,13,135,152,80,72
1,117,13,215,31,41,-10
1,117,17,31,65,30,35
1,117,22,51,40,46,-6
1,117,22,71,0,48,-48
1,117,28,33,0,34,-34
1,117,28,47,39,0,39
1,117,28,87,43,0,43
1,117,28,89,47,35,12
1,117,28,121,42,0,42
1,117,37,119,45,50,-5
1,117,37,183,41,36,5
1,117,45,19,34,0,34
1,117,45,45,0,51,-51
1,117,47,37,72,123,-51
1,117,47,65,43,49,-6
1,117,47,93,33,56,-23
1,117,47,149,0,40,-40
1,117,47,157,137,72,65
1,117,47,187,0,77,-77
1,117,48,85,0,42,-42
1,117,48,113,42,42,0
1,117,48,121,0,48,-48
1,117,48,201,83,73,10
1,117,48,439,35,50,-15
1,117,51,59,0,35,-35
1,119,1,23,56,30,26
1,119,1,73,55,49,6
1,119,1,89,0,30,-30
1,119,1,91,52,67,-15
1,119,1,125,66,176,-110
1,119,28,75,65,74,-9
1,121,1,3,0,34,-34
1,121,1,9,41,0,41
1,121,1,15,983,1022,-39
1,121,1,21,36,46,-10
1,121,1,27,210,223,-13
1,121,1,29,38,37,1
1,121,1,37,320,274,46
1,121,1,51,41,44,-3
1,121,1,55,93,77,16
1,121,1,73,358,433,-75
1,121,1,81,31,61,-30
1,121,1,87,0,42,-42
1,121,1,89,45,62,-17
1,121,1,97,0,35,-35
1,121,1,101,74,128,-54
1,121,1,111,35,0,35
1,121,1,115,460,450,10
1,121,1,117,337,419,-82
1,121,1,123,142,97,45
1,121,1,125,36,66,-30
1,123,1,3,33,0,33
1,123,1,17,85,61,24
1,123,1,27,91,60,31
1,123,1,37,300,325,-25
1,123,1,51,223,174,49
1,123,1,73,206,111,95
1,123,1,81,267,301,-34
1,123,1,87,39,64,-25
1,123,1,97,29,0,29
1,123,1,101,172,197,-25
1,123,1,111,49,0,49
1,123,1,117,111,92,19
1,123,1,121,97,142,-45
1,125,1,1,35,56,-21
1,125,1,3,136,193,-57
1,125,1,7,402,363,39
1,125,1,9,52,28,24
1,125,1,15,87,45,42
1,125,1,21,68,29,39
1,125,1,23,50,0,50
1,125,1,25,66,24,42
1,125,1,33,44,32,12
1,125,1,43,36,49,-13
1,125,1,47,113,25,88
1,125,1,49,26,0,26
1,125,1,51,96,0,96
1,125,1,53,32,0,32
1,125,1,55,50,57,-7
1,125,1,57,268,221,47
1,125,1,63,281,176,105
1,125,1,65,623,654,-31
1,125,1,69,48,30,18
1,125,1,73,1498,1482,16
1,125,1,75,65,51,14
1,125,1,77,58,34,24
1,125,1,81,48,72,-24
1,125,1,89,177,199,-22
1,125,1,91,164,62,102
1,125,1,93,76,39,37
1,125,1,95,48,38,10
1,125,1,97,145,193,-48
1,125,1,101,219,177,42
1,125,1,103,97,52,45
1,125,1,105,127,29,98
1,125,1,107,494,366,128
1,125,1,115,47,90,-43
1,125,1,117,333,386,-53
1,125,1,119,176,66,110
1,125,1,121,66,36,30
1,125,1,127,138,117,21
1,125,1,131,25,0,25
1,125,1,133,38,0,38
1,125,4,13,0,42,-42
1,125,5,119,0,28,-28
1,125,6,37,32,28,4
1,125,6,73,32,0,32
1,125,12,5,46,27,19
1,125,12,31,57,61,-4
1,125,12,33,43,0,43
1,125,12,86,45,33,12
1,125,12,91,0,29,-29
1,125,13,67,56,63,-7
1,125,13,89,52,70,-18
1,125,13,97,28,0,28
1,125,13,121,51,92,-41
1,125,13,135,47,33,14
1,125,17,31,76,43,33
1,125,21,111,0,40,-40
1,125,22,51,0,50,-50
1,125,22,71,0,69,-69
1,125,22,87,0,26,-26
1,125,26,163,64,28,36
1,125,28,75,38,0,38
1,125,28,87,99,89,10
1,125,28,105,38,37,1
1,125,37,119,21,36,-15
1,125,37,133,0,25,-25
1,125,45,45,0,27,-27
1,125,47,37,51,72,-21
1,125,47,65,0,25,-25
1,125,47,93,0,25,-25
1,125,47,157,45,63,-18
1,125,48,113,30,0,30
1,125,48,201,30,49,-19
1,125,48,439,25,34,-9
1,125,48,453,0,26,-26
1,127,1,1,28,0,28
1,127,1,3,50,43,7
1,127,1,9,46,93,-47
1,127,1,15,0,29,-29
1,127,1,43,118,140,-22
1,127,1,57,79,62,17
1,127,1,73,941,891,50
1,127,1,77,0,30,-30
1,127,1,89,0,38,-38
1,127,1,93,99,91,8
1,127,1,95,35,0,35
1,127,1,101,32,0,32
1,127,1,115,60,33,27
1,127,1,117,79,134,-55
1,127,1,125,117,138,-21
1,127,1,133,369,237,132
1,129,1,3,71,53,18
1,129,1,23,47,30,17
1,129,1,25,137,161,-24
1,129,1,97,425,444,-19
1,129,28,41,0,36,-36
1,129,28,153,0,55,-55
1,131,1,25,111,106,5
1,131,1,47,62,74,-12
1,131,1,73,30,84,-54
1,131,1,91,0,40,-40
1,131,1,97,0,40,-40
1,131,1,99,34,28,6
1,131,1,101,38,77,-39
1,131,1,125,0,25,-25
1,133,1,43,136,141,-5
1,133,1,59,60,122,-62
1,133,1,73,64,64,0
1,133,1,77,0,32,-32
1,133,1,93,166,174,-8
1,133,1,103,53,54,-1
1,133,1,117,29,0,29
1,133,1,125,0,38,-38
1,133,1,127,237,369,-132
2,13,2,20,0,51,-51
2,13,6,73,27,0,27
2,13,53,33,25,39,-14
2,16,2,20,57,170,-113
2,16,6,29,0,38,-38
2,16,6,73,0,32,-32
2,16,15,3,26,0,26
2,16,53,33,35,134,-99
2,20,1,101,48,53,-5
2,20,2,13,51,0,51
2,20,2,16,170,57,113
2,20,2,50,372,202,170
2,20,2,68,53,42,11
2,20,2,70,143,75,68
2,20,2,90,848,645,203
2,20,2,100,30,0,30
2,20,2,110,252,169,83
2,20,2,122,845,1007,-162
2,20,2,130,82,44,38
2,20,2,150,260,124,136
2,20,2,164,75,50,25
2,20,2,170,1850,3415,-1565
2,20,2,180,230,133,97
2,20,2,185,196,118,78
2,20,2,188,181,138,43
2,20,2,201,40,0,40
2,20,2,220,65,75,-10
2,20,2,240,115,52,63
2,20,2,261,280,180,100
2,20,2,270,143,86,57
2,20,2,280,31,0,31
2,20,2,290,135,50,85
2,20,4,3,85,82,3
2,20,4,5,44,26,18
2,20,4,13,360,493,-133
2,20,4,19,97,256,-159
2,20,4,21,0,49,-49
2,20,4,25,22,46,-24
2,20,4,27,0,25,-25
2,20,5,85,0,85,-85
2,20,5,119,65,93,-28
2,20,6,1,65,39,26
2,20,6,7,0,32,-32
2,20,6,13,43,40,3
2,20,6,17,22,0,22
2,20,6,19,60,0,60
2,20,6,29,83,41,42
2,20,6,37,291,242,49
2,20,6,47,55,0,55
2,20,6,53,0,65,-65
2,20,6,59,84,65,19
2,20,6,61,0,35,-35
2,20,6,65,52,82,-30
2,20,6,67,130,120,10
2,20,6,71,141,123,18
2,20,6,73,195,175,20
2,20,6,75,29,34,-5
2,20,6,77,47,0,47
2,20,6,81,31,0,31
2,20,6,83,36,46,-10
2,20,6,85,39,52,-13
2,20,6,89,27,0,27
2,20,6,95,84,113,-29
2,20,6,97,41,0,41
2,20,6,111,27,36,-9
2,20,6,115,44,38,6
2,20,8,1,77,0,77
2,20,8,5,34,73,-39
2,20,8,13,0,38,-38
2,20,8,31,54,77,-23
2,20,8,35,0,36,-36
2,20,8,41,158,251,-93
2,20,8,59,42,65,-23
2,20,8,69,36,94,-58
2,20,8,77,0,48,-48
2,20,8,123,0,24,-24
2,20,10,1,45,63,-18
2,20,11,1,38,34,4
2,20,12,5,106,150,-44
2,20,12,11,37,49,-12
2,20,12,31,49,0,49
2,20,12,33,42,53,-11
2,20,12,57,35,78,-43
2,20,12,86,67,43,24
2,20,12,91,148,161,-13
2,20,12,95,48,92,-44
2,20,12,99,37,0,37
2,20,12,101,31,0,31
2,20,12,103,57,50,7
2,20,12,113,0,94,-94
2,20,12,117,40,0,40
2,20,13,51,40,0,40
2,20,13,67,0,32,-32
2,20,13,121,0,27,-27
2,20,13,153,50,82,-32
2,20,13,185,37,139,-102
2,20,13,215,42,62,-20
2,20,13,245,0,49,-49
2,20,15,1,71,85,-14
2,20,15,3,406,251,155
2,20,15,9,0,56,-56
2,20,16,1,68,146,-78
2,20,16,27,37,38,-1
2,20,16,39,65,193,-128
2,20,16,55,0,51,-51
2,20,16,57,0,37,-37
2,20,17,31,79,61,18
2,20,17,89,38,0,38
2,20,17,97,28,0,28
2,20,17,163,0,77,-77
2,20,18,89,37,0,37
2,20,18,97,40,29,11
2,20,20,61,0,36,-36
2,20,20,173,40,55,-15
2,20,21,47,45,39,6
2,20,21,111,53,34,19
2,20,22,15,0,42,-42
2,20,22,115,43,62,-19
2,20,24,3,40,109,-69
2,20,24,27,0,30,-30
2,20,24,31,42,35,7
2,20,24,33,26,53,-27
2,20,25,17,50,41,9
2,20,25,25,0,26,-26
2,20,26,81,44,0,44
2,20,26,125,44,0,44
2,20,26,161,28,0,28
2,20,27,37,34,0,34
2,20,27,53,50,71,-21
2,20,27,123,60,47,13
2,20,28,47,0,55,-55
2,20,28,87,32,0,32
2,20,29,95,0,29,-29
2,20,29,101,0,45,-45
2,20,29,169,51,40,11
2,20,30,13,57,35,22
2,20,30,29,39,41,-2
2,20,30,31,47,35,12
2,20,30,63,45,50,-5
2,20,30,111,42,52,-10
2,20,31,55,48,23,25
2,20,31,153,0,75,-75
2,20,32,3,308,493,-185
2,20,32,31,68,91,-23
2,20,33,11,35,0,35
2,20,34,5,60,64,-4
2,20,35,1,95,118,-23
2,20,35,9,0,41,-41
2,20,35,35,39,71,-32
2,20,35,45,0,46,-46
2,20,35,49,0,29,-29
2,20,36,45,65,0,65
2,20,36,47,39,0,39
2,20,36,61,0,39,-39
2,20,36,81,33,0,33
2,20,37,51,142,142,0
2,20,37,119,46,0,46
2,20,37,183,0,45,-45
2,20,37,191,47,80,-33
2,20,38,35,36,0,36
2,20,38,101,66,45,21
2,20,39,35,37,39,-2
2,20,39,49,35,34,1
2,20,39,57,28,47,-19
2,20,39,113,49,42,7
2,20,40,27,75,57,18
2,20,40,31,101,0,101
2,20,40,109,128,84,44
2,20,40,143,49,53,-4
2,20,40,147,0,49,-49
2,20,41,5,38,67,-29
2,20,41,17,41,75,-34
2,20,41,19,0,36,-36
2,20,41,29,65,66,-1
2,20,41,39,72,88,-16
2,20,41,47,55,75,-20
2,20,41,51,153,227,-74
2,20,41,67,75,166,-91
2,20,41,71,26,0,26
2,20,42,3,47,25,22
2,20,45,15,43,0,43
2,20,45,19,69,35,34
2,20,45,79,56,33,23
2,20,45,85,50,47,3
2,20,46,103,37,46,-9
2,20,47,125,80,74,6
2,20,47,157,48,48,0
2,20,48,27,131,86,45
2,20,48,29,266,340,-74
2,20,48,85,37,56,-19
2,20,48,99,48,0,48
2,20,48,113,80,48,32
2,20,48,121,47,0,47
2,20,48,141,99,79,20
2,20,48,157,62,94,-32
2,20,48,187,0,38,-38
2,20,48,201,315,246,69
2,20,48,339,43,55,-12
2,20,48,355,0,31,-31
2,20,48,439,64,121,-57
2,20,48,441,51,42,9
2,20,48,451,38,0,38
2,20,48,453,41,58,-17
2,20,48,465,50,0,50
2,20,48,485,59,38,21
2,20,48,491,0,46,-46
2,20,49,11,83,93,-10
2,20,49,35,130,127,3
2,20,49,49,54,79,-25
2,20,51,59,67,140,-73
2,20,51,153,42,0,42
2,20,51,199,96,0,96
2,20,51,650,56,33,23
2,20,51,700,64,54,10
2,20,51,810,34,25,9
2,20,53,5,51,59,-8
2,20,53,7,0,26,-26
2,20,53,9,0,32,-32
2,20,53,11,91,144,-53
2,20,53,29,0,32,-32
2,20,53,33,401,655,-254
2,20,53,35,25,58,-33
2,20,53,53,273,312,-39
2,20,53,61,115,171,-56
2,20,53,63,144,247,-103
2,20,53,67,55,141,-86
2,20,53,73,46,89,-43
2,20,53,77,0,43,-43
2,20,55,25,36,0,36
2,20,55,79,0,24,-24
2,20,56,21,46,67,-21
2,50,2,20,202,372,-170
2,50,2,90,0,62,-62
2,50,2,122,0,50,-50
2,50,2,170,44,81,-37
2,50,2,270,90,85,5
2,68,2,20,42,53,-11
2,68,2,90,41,53,-12
2,70,2,20,75,143,-68
2,90,1,31,92,58,34
2,90,1,45,129,41,88
2,90,1,89,0,34,-34
2,90,1,101,33,0,33
2,90,2,20,645,848,-203
2,90,2,50,62,0,62
2,90,2,68,53,41,12
2,90,2,110,45,52,-7
2,90,2,122,106,141,-35
2,90,2,150,58,0,58
2,90,2,170,179,260,-81
2,90,2,180,44,32,12
2,90,2,185,73,39,34
2,90,2,188,38,0,38
2,90,2,240,161,122,39
2,90,2,261,66,36,30
2,90,2,270,0,24,-24
2,90,2,290,251,159,92
2,90,4,3,88,101,-13
2,90,4,13,133,218,-85
2,90,4,19,58,120,-62
2,90,6,1,0,25,-25
2,90,6,29,0,35,-35
2,90,6,37,86,58,28
2,90,6,53,38,0,38
2,90,6,59,39,30,9
2,90,6,65,41,40,1
2,90,6,71,92,127,-35
2,90,6,73,74,88,-14
2,90,6,85,30,26,4
2,90,6,95,0,46,-46
2,90,6,115,0,62,-62
2,90,8,5,0,36,-36
2,90,8,13,0,31,-31
2,90,8,31,0,23,-23
2,90,8,41,88,94,-6
2,90,12,5,0,41,-41
2,90,12,57,0,47,-47
2,90,12,91,61,85,-24
2,90,13,51,0,61,-61
2,90,13,53,0,41,-41
2,90,13,179,38,105,-67
2,90,13,185,0,190,-190
2,90,13,215,54,93,-39
2,90,15,3,61,147,-86
2,90,16,1,37,50,-13
2,90,16,39,0,126,-126
2,90,16,55,0,28,-28
2,90,17,31,38,0,38
2,90,17,163,0,38,-38
2,90,20,61,0,80,-80
2,90,20,103,0,52,-52
2,90,20,161,0,58,-58
2,90,20,173,30,33,-3
2,90,21,47,114,43,71
2,90,21,93,64,85,-21
2,90,21,163,0,43,-43
2,90,22,115,0,119,-119
2,90,24,3,0,56,-56
2,90,24,31,0,30,-30
2,90,26,163,27,0,27
2,90,29,169,67,59,8
2,90,29,189,25,0,25
2,90,30,13,34,66,-32
2,90,30,63,36,0,36
2,90,31,153,0,48,-48
2,90,32,3,99,186,-87
2,90,32,31,23,53,-30
2,90,35,1,30,49,-19
2,90,36,45,71,44,27
2,90,37,51,144,122,22
2,90,37,191,0,38,-38
2,90,38,101,0,43,-43
2,90,39,49,0,27,-27
2,90,40,31,139,121,18
2,90,40,109,27,51,-24
2,90,41,39,40,33,7
2,90,41,51,0,44,-44
2,90,45,79,37,73,-36
2,90,45,85,0,54,-54
2,90,46,103,0,49,-49
2,90,47,125,122,120,2
2,90,48,27,157,161,-4
2,90,48,29,153,144,9
2,90,48,99,65,83,-18
2,90,48,141,73,182,-109
2,90,48,201,49,67,-18
2,90,48,439,39,34,5
2,90,48,441,0,86,-86
2,90,48,453,0,22,-22
2,90,48,485,0,43,-43
2,90,49,11,38,62,-24
2,90,49,35,0,52,-52
2,90,51,59,32,57,-25
2,90,51,700,48,57,-9
2,90,53,11,22,0,22
2,90,53,33,72,108,-36
2,90,53,53,97,292,-195
2,90,53,61,31,39,-8
2,90,53,63,52,117,-65
2,90,53,67,40,103,-63
2,90,55,25,0,23,-23
2,90,56,21,0,52,-52
2,100,2,20,0,30,-30
2,100,2,110,0,20,-20
2,105,2,110,36,60,-24
2,110,2,20,169,252,-83
2,110,2,90,52,45,7
2,110,2,100,20,0,20
2,110,2,105,60,36,24
2,110,2,122,30,37,-7
2,110,2,130,119,40,79
2,110,2,170,52,56,-4
2,110,2,220,56,33,23
2,110,2,280,49,24,25
2,110,4,13,34,24,10
2,110,6,73,43,0,43
2,110,15,3,41,0,41
2,110,32,3,43,0,43
2,110,41,39,0,35,-35
2,110,41,51,31,50,-19
2,110,53,33,67,77,-10
2,110,53,35,35,0,35
2,110,53,53,27,40,-13
2,110,53,61,0,40,-40
2,110,53,73,23,32,-9
2,122,2,20,1007,845,162
2,122,2,50,50,0,50
2,122,2,90,141,106,35
2,122,2,110,37,30,7
2,122,2,130,24,0,24
2,122,2,150,49,34,15
2,122,2,170,193,249,-56
2,122,2,180,34,0,34
2,122,2,261,52,0,52
2,122,4,13,56,29,27
2,122,4,19,0,26,-26
2,122,6,37,0,21,-21
2,122,6,73,43,0,43
2,122,8,41,36,0,36
2,122,15,1,0,44,-44
2,122,32,3,0,27,-27
2,122,41,17,0,27,-27
2,122,41,39,27,47,-20
2,122,41,51,35,31,4
2,122,53,33,53,76,-23
2,122,53,53,0,22,-22
2,122,53,63,0,28,-28
2,130,2,20,44,82,-38
2,130,2,110,40,119,-79
2,130,2,122,0,24,-24
2,130,2,201,82,98,-16
2,130,41,51,30,23,7
2,130,53,33,57,67,-10
2,130,53,61,27,0,27
2,150,2,20,124,260,-136
2,150,2,90,0,58,-58
2,150,2,122,34,49,-15
2,150,2,170,0,64,-64
2,150,6,1,47,0,47
2,150,6,73,54,29,25
2,150,6,97,35,0,35
2,150,12,103,0,40,-40
2,150,15,3,0,65,-65
2,150,53,33,35,0,35
2,164,2,20,50,75,-25
2,170,2,20,3415,1850,1565
2,170,2,50,81,44,37
2,170,2,68,49,0,49
2,170,2,90,260,179,81
2,170,2,110,56,52,4
2,170,2,122,249,193,56
2,170,2,150,64,0,64
2,170,2,180,48,0,48
2,170,2,185,39,0,39
2,170,2,188,44,0,44
2,170,2,240,44,44,0
2,170,2,261,116,39,77
2,170,4,13,89,70,19
2,170,6,67,0,25,-25
2,170,6,73,50,30,20
2,170,8,1,33,0,33
2,170,8,41,53,0,53
2,170,15,1,0,49,-49
2,170,16,55,0,34,-34
2,170,32,3,53,32,21
2,170,41,5,0,31,-31
2,170,41,67,32,36,-4
2,170,53,11,0,60,-60
2,170,53,33,64,87,-23
2,170,53,53,61,42,19
2,170,53,61,37,60,-23
2,170,53,63,45,68,-23
2,180,2,20,133,230,-97
2,180,2,90,32,44,-12
2,180,2,122,0,34,-34
2,180,2,170,0,48,-48
2,185,2,20,118,196,-78
2,185,2,90,39,73,-34
2,185,2,170,0,39,-39
2,188,2,20,138,181,-43
2,188,2,90,0,38,-38
2,188,2,170,0,44,-44
2,201,2,20,0,40,-40
2,201,2,130,98,82,16
2,220,2,20,75,65,10
2,220,2,110,33,56,-23
2,240,2,20,52,115,-63
2,240,2,90,122,161,-39
2,240,2,170,44,44,0
2,240,2,261,33,0,33
2,261,2,20,180,280,-100
2,261,2,90,36,66,-30
2,261,2,122,0,52,-52
2,261,2,170,39,116,-77
2,261,2,240,0,33,-33
2,270,2,20,86,143,-57
2,270,2,50,85,90,-5
2,270,2,90,24,0,24
2,280,2,20,0,31,-31
2,280,2,110,24,49,-25
2,280,53,33,0,23,-23
2,290,2,20,50,135,-85
2,290,2,90,159,251,-92
4,1,4,5,442,613,-171
4,1,4,7,27,42,-15
4,1,4,13,1495,1097,398
4,1,4,15,0,43,-43
4,1,4,17,1056,1061,-5
4,1,4,19,154,133,21
4,1,4,21,72,47,25
4,1,4,25,46,53,-7
4,1,6,73,63,42,21
4,1,8,83,58,39,19
4,1,32,3,70,60,10
4,1,35,1,119,180,-61
4,1,35,31,1496,1356,140
4,1,35,45,780,739,41
4,1,49,35,57,58,-1
4,1,49,37,98,0,98
4,3,1,89,0,34,-34
4,3,2,20,82,85,-3
4,3,2,90,101,88,13
4,3,4,5,59,76,-17
4,3,4,7,0,32,-32
4,3,4,9,103,179,-76
4,3,4,11,0,46,-46
4,3,4,13,1031,905,126
4,3,4,15,48,36,12
4,3,4,17,49,0,49
4,3,4,19,1753,2042,-289
4,3,4,21,107,214,-107
4,3,4,23,106,96,10
4,3,4,25,83,79,4
4,3,4,27,59,118,-59
4,3,6,1,31,0,31
4,3,6,37,161,112,49
4,3,6,53,66,44,22
4,3,6,59,51,41,10
4,3,6,65,92,44,48
4,3,6,67,0,29,-29
4,3,6,71,178,106,72
4,3,6,73,203,134,69
4,3,6,111,33,0,33
4,3,8,5,39,0,39
4,3,8,41,133,126,7
4,3,12,11,43,0,43
4,3,12,31,25,0,25
4,3,12,57,34,54,-20
4,3,12,86,0,34,-34
4,3,12,95,25,0,25
4,3,12,127,32,0,32
4,3,13,51,53,33,20
4,3,13,53,30,0,30
4,3,13,73,37,65,-28
4,3,13,179,41,0,41
4,3,13,215,0,42,-42
4,3,13,245,81,73,8
4,3,15,3,237,239,-2
4,3,17,31,44,42,2
4,3,17,43,25,0,25
4,3,20,61,0,90,-90
4,3,20,103,0,39,-39
4,3,20,161,0,85,-85
4,3,21,47,106,42,64
4,3,22,115,69,62,7
4,3,24,3,40,61,-21
4,3,24,31,35,0,35
4,3,25,17,0,21,-21
4,3,26,125,33,0,33
4,3,26,163,43,29,14
4,3,29,169,0,39,-39
4,3,32,3,102,103,-1
4,3,35,1,33,59,-26
4,3,35,13,58,42,16
4,3,35,17,0,60,-60
4,3,36,45,82,106,-24
4,3,37,51,169,242,-73
4,3,40,31,69,54,15
4,3,41,51,27,0,27
4,3,45,79,0,55,-55
4,3,47,125,177,123,54
4,3,48,27,262,352,-90
4,3,48,29,175,91,84
4,3,48,99,60,123,-63
4,3,48,113,0,54,-54
4,3,48,121,37,0,37
4,3,48,141,111,165,-54
4,3,48,201,44,53,-9
4,3,48,439,0,43,-43
4,3,48,451,0,42,-42
4,3,49,35,34,49,-15
4,3,49,49,40,35,5
4,3,51,59,66,132,-66
4,3,51,153,31,39,-8
4,3,51,179,0,42,-42
4,3,51,810,34,0,34
4,3,53,33,30,48,-18
4,3,53,53,165,160,5
4,3,53,61,39,0,39
4,3,53,67,43,59,-16
4,5,2,20,26,44,-18
4,5,4,1,613,442,171
4,5,4,3,76,59,17
4,5,4,7,54,91,-37
4,5,4,9,0,72,-72
4,5,4,13,2846,2960,-114
4,5,4,15,347,278,69
4,5,4,17,734,753,-19
4,5,4,19,487,539,-52
4,5,4,21,98,194,-96
4,5,4,25,815,1057,-242
4,5,4,27,70,77,-7
4,5,6,1,0,27,-27
4,5,6,37,179,107,72
4,5,6,59,75,74,1
4,5,6,65,92,52,40
4,5,6,71,115,53,62
4,5,6,73,163,161,2
4,5,6,83,37,0,37
4,5,6,111,44,0,44
4,5,8,5,0,23,-23
4,5,8,13,0,34,-34
4,5,8,31,37,65,-28
4,5,8,41,0,101,-101
4,5,8,59,0,66,-66
4,5,8,67,0,37,-37
4,5,8,69,23,70,-47
4,5,12,99,23,0,23
4,5,15,1,0,22,-22
4,5,15,3,44,0,44
4,5,15,9,26,0,26
4,5,16,1,27,30,-3
4,5,17,31,31,39,-8
4,5,26,125,23,0,23
4,5,27,53,0,24,-24
4,5,27,137,32,0,32
4,5,30,31,0,39,-39
4,5,32,3,294,307,-13
4,5,32,31,0,35,-35
4,5,35,1,98,115,-17
4,5,35,31,135,142,-7
4,5,35,45,125,152,-27
4,5,35,49,0,36,-36
4,5,41,17,0,36,-36
4,5,41,39,29,29,0
4,5,41,51,33,104,-71
4,5,41,67,30,0,30
4,5,48,141,0,30,-30
4,5,48,201,35,0,35
4,5,48,439,0,30,-30
4,5,48,453,0,64,-64
4,5,48,491,0,35,-35
4,5,49,11,0,49,-49
4,5,49,21,37,28,9
4,5,49,25,87,77,10
4,5,49,35,92,142,-50
4,5,49,49,86,77,9
4,5,49,53,114,92,22
4,5,53,33,60,107,-47
4,5,53,53,0,50,-50
4,5,53,61,0,32,-32
4,7,4,1,42,27,15
4,7,4,3,32,0,32
4,7,4,5,91,54,37
4,7,4,9,102,93,9
4,7,4,13,1614,1468,146
4,7,4,15,33,0,33
4,7,4,17,147,165,-18
4,7,4,19,171,185,-14
4,7,4,21,238,296,-58
4,7,4,25,117,175,-58
4,7,6,37,48,0,48
4,7,6,59,41,0,41
4,7,6,65,24,0,24
4,7,6,71,32,0,32
4,7,6,73,64,35,29
4,7,32,3,30,0,30
4,7,35,1,0,30,-30
4,9,4,3,179,103,76
4,9,4,5,72,40,32
4,9,4,7,93,102,-9
4,9,4,11,340,147,193
4,9,4,13,527,389,138
4,9,4,17,91,37,54
4,9,4,19,321,235,86
4,9,4,21,84,77,7
4,9,4,25,106,67,39
4,9,6,73,38,0,38
4,9,32,3,27,0,27
4,9,35,13,32,0,32
4,9,35,17,68,0,68
4,11,4,3,46,0,46
4,11,4,9,147,340,-193
4,11,4,13,142,61,81
4,11,4,19,118,102,16
4,11,4,21,57,0,57
4,11,4,25,40,0,40
4,11,35,17,47,0,47
4,12,4,13,253,280,-27
4,12,4,15,124,154,-30
4,12,4,19,47,31,16
4,12,4,25,36,44,-8
4,12,4,27,0,79,-79
4,12,6,37,32,0,32
4,12,6,59,38,0,38
4,12,6,65,186,98,88
4,12,6,71,89,49,40
4,12,32,3,41,48,-7
4,13,1,3,57,47,10
4,13,1,15,0,28,-28
4,13,1,73,114,120,-6
4,13,1,81,41,0,41
4,13,1,89,77,168,-91
4,13,1,97,57,72,-15
4,13,1,101,34,50,-16
4,13,1,117,35,44,-9
4,13,1,125,42,0,42
4,13,2,20,493,360,133
4,13,2,90,218,133,85
4,13,2,110,24,34,-10
4,13,2,122,29,56,-27
4,13,2,170,70,89,-19
4,13,4,1,1097,1495,-398
4,13,4,3,905,1031,-126
4,13,4,5,2960,2846,114
4,13,4,7,1468,1614,-146
4,13,4,9,389,527,-138
4,13,4,12,280,253,27
4,13,4,15,1378,822,556
4,13,4,17,2050,2555,-505
4,13,4,19,7044,5765,1279
4,13,4,21,12229,23962,-11733
4,13,4,23,327,414,-87
4,13,4,25,3719,4697,-978
4,13,4,27,1556,1490,66
4,13,5,5,0,40,-40
4,13,5,7,120,201,-81
4,13,5,31,0,35,-35
4,13,5,45,36,0,36
4,13,5,51,51,76,-25
4,13,5,85,30,0,30
4,13,5,115,31,0,31
4,13,5,119,128,110,18
4,13,5,125,0,40,-40
4,13,5,131,31,29,2
4,13,5,143,69,119,-50
4,13,6,1,1088,772,316
4,13,6,7,103,133,-30
4,13,6,13,677,603,74
4,13,6,17,148,129,19
4,13,6,19,568,485,83
4,13,6,23,100,65,35
4,13,6,25,314,344,-30
4,13,6,27,0,34,-34
4,13,6,29,522,634,-112
4,13,6,31,130,56,74
4,13,6,33,49,52,-3
4,13,6,35,24,0,24
4,13,6,37,10856,5796,5060
4,13,6,39,91,33,58
4,13,6,41,100,111,-11
4,13,6,45,55,42,13
4,13,6,47,153,134,19
4,13,6,53,364,322,42
4,13,6,55,54,86,-32
4,13,6,57,53,49,4
4,13,6,59,4340,2743,1597
4,13,6,61,225,315,-90
4,13,6,63,35,0,35
4,13,6,65,2907,1903,1004
4,13,6,67,873,834,39
4,13,6,69,88,30,58
4,13,6,71,3052,1462,1590
4,13,6,73,4998,3967,1031
4,13,6,75,494,515,-21
4,13,6,77,476,314,162
4,13,6,79,232,209,23
4,13,6,81,428,376,52
4,13,6,83,424,307,117
4,13,6,85,1403,1261,142
4,13,6,87,177,108,69
4,13,6,89,140,82,58
4,13,6,93,28,0,28
4,13,6,95,315,251,64
4,13,6,97,282,312,-30
4,13,6,99,343,246,97
4,13,6,101,71,39,32
4,13,6,103,39,43,-4
4,13,6,107,250,224,26
4,13,6,111,1167,716,451
4,13,6,113,142,90,52
4,13,6,115,75,60,15
4,13,8,1,563,576,-13
4,13,8,3,34,0,34
4,13,8,5,788,931,-143
4,13,8,7,40,63,-23
4,13,8,13,263,337,-74
4,13,8,14,138,227,-89
4,13,8,15,0,38,-38
4,13,8,29,34,28,6
4,13,8,31,721,795,-74
4,13,8,35,522,762,-240
4,13,8,37,71,94,-23
4,13,8,41,1296,1246,50
4,13,8,43,26,39,-13
4,13,8,45,66,140,-74
4,13,8,49,32,0,32
4,13,8,59,477,577,-100
4,13,8,67,117,188,-71
4,13,8,69,391,586,-195
4,13,8,77,189,323,-134
4,13,8,83,97,56,41
4,13,8,85,54,89,-35
4,13,8,97,0,32,-32
4,13,8,101,170,159,11
4,13,8,107,31,33,-2
4,13,8,113,0,27,-27
4,13,8,117,71,44,27
4,13,8,119,60,0,60
4,13,8,123,256,334,-78
4,13,9,1,366,155,211
4,13,9,3,303,212,91
4,13,9,5,73,0,73
4,13,9,7,68,0,68
4,13,9,9,274,137,137
4,13,9,11,78,82,-4
4,13,9,13,57,49,8
4,13,9,15,31,0,31
4,13,10,1,34,0,34
4,13,10,3,200,82,118
4,13,10,5,38,49,-11
4,13,11,1,216,204,12
4,13,12,1,104,59,45
4,13,12,5,118,82,36
4,13,12,9,246,155,91
4,13,12,11,647,440,207
4,13,12,15,74,38,36
4,13,12,17,0,29,-29
4,13,12,19,65,44,21
4,13,12,21,100,105,-5
4,13,12,31,343,233,110
4,13,12,33,127,109,18
4,13,12,35,38,33,5
4,13,12,53,52,0,52
4,13,12,57,381,321,60
4,13,12,61,40,29,11
4,13,12,69,81,38,43
4,13,12,71,234,183,51
4,13,12,73,66,35,31
4,13,12,81,96,89,7
4,13,12,83,66,88,-22
4,13,12,85,46,46,0
4,13,12,86,423,331,92
4,13,12,87,31,0,31
4,13,12,91,161,132,29
4,13,12,95,416,337,79
4,13,12,97,97,71,26
4,13,12,99,438,216,222
4,13,12,101,158,121,37
4,13,12,103,364,244,120
4,13,12,105,137,111,26
4,13,12,109,53,53,0
4,13,12,111,89,63,26
4,13,12,113,39,62,-23
4,13,12,115,102,118,-16
4,13,12,117,163,155,8
4,13,12,119,0,28,-28
4,13,12,127,162,134,28
4,13,13,15,39,0,39
4,13,13,51,102,89,13
4,13,13,53,24,0,24
4,13,13,57,87,83,4
4,13,13,63,60,49,11
4,13,13,67,283,248,35
4,13,13,73,0,58,-58
4,13,13,77,32,44,-12
4,13,13,89,260,195,65
4,13,13,97,32,37,-5
4,13,13,113,31,0,31
4,13,13,117,56,54,2
4,13,13,121,383,343,40
4,13,13,135,250,261,-11
4,13,13,139,37,28,9
4,13,13,151,53,48,5
4,13,13,153,50,51,-1
4,13,13,179,89,0,89
4,13,13,215,53,27,26
4,13,13,217,0,32,-32
4,13,13,223,53,47,6
4,13,13,245,60,38,22
4,13,15,1,149,171,-22
4,13,15,3,995,706,289
4,13,15,7,66,91,-25
4,13,15,9,199,181,18
4,13,16,1,432,758,-326
4,13,16,5,61,120,-59
4,13,16,11,34,53,-19
4,13,16,13,40,0,40
4,13,16,17,54,32,22
4,13,16,19,106,141,-35
4,13,16,27,150,268,-118
4,13,16,39,94,40,54
4,13,16,55,104,218,-114
4,13,16,57,25,0,25
4,13,16,65,120,76,44
4,13,16,67,0,42,-42
4,13,16,69,0,32,-32
4,13,16,81,0,36,-36
4,13,16,83,63,122,-59
4,13,17,1,44,0,44
4,13,17,7,29,36,-7
4,13,17,19,109,118,-9
4,13,17,31,3280,2158,1122
4,13,17,37,83,38,45
4,13,17,43,935,363,572
4,13,17,63,33,0,33
4,13,17,73,0,32,-32
4,13,17,77,46,0,46
4,13,17,89,425,253,172
4,13,17,91,107,31,76
4,13,17,93,90,73,17
4,13,17,95,43,0,43
4,13,17,97,723,356,367
4,13,17,99,71,29,42
4,13,17,111,319,185,134
4,13,17,113,144,84,60
4,13,17,115,41,26,15
4,13,17,119,80,70,10
4,13,17,141,44,31,13
4,13,17,143,118,66,52
4,13,17,161,114,66,48
4,13,17,163,145,126,19
4,13,17,167,166,81,85
4,13,17,177,51,0,51
4,13,17,179,62,54,8
4,13,17,195,48,34,14
4,13,17,197,517,220,297
4,13,17,199,27,0,27
4,13,17,201,298,150,148
4,13,18,1,25,0,25
4,13,18,3,258,133,125
4,13,18,19,34,0,34
4,13,18,35,41,0,41
4,13,18,39,99,53,46
4,13,18,53,36,0,36
4,13,18,57,184,235,-51
4,13,18,63,69,59,10
4,13,18,81,59,72,-13
4,13,18,85,34,0,34
4,13,18,89,361,192,169
4,13,18,91,58,30,28
4,13,18,95,53,49,4
4,13,18,97,430,252,178
4,13,18,105,65,59,6
4,13,18,109,0,30,-30
4,13,18,127,170,80,90
4,13,18,141,169,129,40
4,13,18,157,100,81,19
4,13,18,163,65,38,27
4,13,18,167,39,0,39
4,13,18,177,35,0,35
4,13,18,181,23,0,23
4,13,19,13,78,72,6
4,13,19,33,34,27,7
4,13,19,49,58,57,1
4,13,19,61,75,61,14
4,13,19,103,152,144,8
4,13,19,113,131,175,-44
4,13,19,153,374,331,43
4,13,19,155,38,40,-2
4,13,19,163,87,258,-171
4,13,19,169,116,85,31
4,13,19,187,31,40,-9
4,13,19,193,73,81,-8
4,13,20,15,31,42,-11
4,13,20,35,0,36,-36
4,13,20,45,85,75,10
4,13,20,55,39,36,3
4,13,20,61,49,61,-12
4,13,20,91,517,467,50
4,13,20,103,36,0,36
4,13,20,111,41,0,41
4,13,20,113,30,0,30
4,13,20,155,40,0,40
4,13,20,161,69,77,-8
4,13,20,169,34,29,5
4,13,20,173,296,279,17
4,13,20,177,123,64,59
4,13,20,209,100,54,46
4,13,21,15,38,42,-4
4,13,21,47,85,63,22
4,13,21,67,92,71,21
4,13,21,93,46,40,6
4,13,21,111,211,159,52
4,13,21,117,56,32,24
4,13,22,15,40,32,8
4,13,22,17,49,60,-11
4,13,22,19,28,40,-12
4,13,22,33,112,83,29
4,13,22,51,122,89,33
4,13,22,55,30,65,-35
4,13,22,71,78,107,-29
4,13,22,73,42,0,42
4,13,22,103,93,39,54
4,13,22,115,62,42,20
4,13,23,1,49,0,49
4,13,23,5,140,115,25
4,13,23,11,44,28,16
4,13,23,19,50,65,-15
4,13,23,31,57,63,-6
4,13,24,3,188,134,54
4,13,24,5,220,119,101
4,13,24,13,39,0,39
4,13,24,15,42,0,42
4,13,24,17,48,0,48
4,13,24,21,82,69,13
4,13,24,25,82,43,39
4,13,24,27,171,142,29
4,13,24,31,367,272,95
4,13,24,33,190,104,86
4,13,24,37,29,0,29
4,13,24,510,174,87,87
4,13,25,1,90,45,45
4,13,25,3,56,0,56
4,13,25,5,91,83,8
4,13,25,9,195,130,65
4,13,25,13,128,56,72
4,13,25,15,28,0,28
4,13,25,17,522,377,145
4,13,25,21,230,121,109
4,13,25,23,118,58,60
4,13,25,25,204,189,15
4,13,25,27,269,167,102
4,13,26,5,43,46,-3
4,13,26,7,32,0,32
4,13,26,15,53,0,53
4,13,26,17,74,43,31
4,13,26,21,112,47,65
4,13,26,25,74,42,32
4,13,26,33,29,0,29
4,13,26,37,71,0,71
4,13,26,45,85,27,58
4,13,26,49,455,129,326
4,13,26,55,46,43,3
4,13,26,61,24,0,24
4,13,26,65,294,125,169
4,13,26,73,44,0,44
4,13,26,75,121,45,76
4,13,26,77,245,58,187
4,13,26,81,520,200,320
4,13,26,87,61,0,61
4,13,26,91,101,48,53
4,13,26,93,184,43,141
4,13,26,99,925,196,729
4,13,26,103,59,0,59
4,13,26,111,56,0,56
4,13,26,115,85,35,50
4,13,26,121,102,36,66
4,13,26,125,1583,422,1161
4,13,26,139,143,62,81
4,13,26,145,112,55,57
4,13,26,147,125,57,68
4,13,26,149,36,0,36
4,13,26,151,35,0,35
4,13,26,155,43,0,43
4,13,26,157,22,0,22
4,13,26,159,49,0,49
4,13,26,161,367,155,212
4,13,26,163,1775,378,1397
4,13,26,165,29,0,29
4,13,27,3,253,139,114
4,13,27,5,25,25,0
4,13,27,7,38,0,38
4,13,27,13,64,0,64
4,13,27,19,107,69,38
4,13,27,25,34,0,34
4,13,27,27,0,28,-28
4,13,27,35,54,35,19
4,13,27,37,384,200,184
4,13,27,41,25,0,25
4,13,27,49,40,0,40
4,13,27,53,1157,799,358
4,13,27,61,28,0,28
4,13,27,67,0,30,-30
4,13,27,109,196,115,81
4,13,27,111,51,0,51
4,13,27,123,316,173,143
4,13,27,131,36,0,36
4,13,27,137,117,48,69
4,13,27,139,96,71,25
4,13,27,141,74,45,29
4,13,27,145,93,40,53
4,13,27,163,223,154,69
4,13,27,169,33,0,33
4,13,27,171,69,56,13
4,13,28,33,62,48,14
4,13,28,47,73,72,1
4,13,28,49,50,37,13
4,13,28,59,46,0,46
4,13,28,87,82,29,53
4,13,28,121,33,0,33
4,13,29,1,42,0,42
4,13,29,19,103,72,31
4,13,29,21,46,34,12
4,13,29,29,38,39,-1
4,13,29,31,0,28,-28
4,13,29,37,40,32,8
4,13,29,43,30,60,-30
4,13,29,47,172,94,78
4,13,29,71,0,57,-57
4,13,29,77,156,119,37
4,13,29,95,460,315,145
4,13,29,97,58,65,-7
4,13,29,99,54,38,16
4,13,29,101,41,0,41
4,13,29,165,88,39,49
4,13,29,169,31,0,31
4,13,29,183,216,190,26
4,13,29,187,0,37,-37
4,13,29,189,563,325,238
4,13,29,209,0,29,-29
4,13,29,213,39,69,-30
4,13,29,510,180,85,95
4,13,30,13,103,57,46
4,13,30,29,112,112,0
4,13,30,31,114,97,17
4,13,30,47,22,0,22
4,13,30,49,33,50,-17
4,13,30,53,0,31,-31
4,13,30,63,81,163,-82
4,13,30,81,29,53,-24
4,13,30,111,129,196,-67
4,13,31,1,37,0,37
4,13,31,19,35,0,35
4,13,31,53,25,30,-5
4,13,31,55,625,464,161
4,13,31,109,332,239,93
4,13,31,153,163,133,30
4,13,31,157,42,48,-6
4,13,32,3,3983,4031,-48
4,13,32,5,108,36,72
4,13,32,7,77,47,30
4,13,32,13,0,32,-32
4,13,32,19,66,79,-13
4,13,32,23,84,70,14
4,13,32,31,623,468,155
4,13,32,510,69,72,-3
4,13,33,1,33,0,33
4,13,33,3,37,0,37
4,13,33,5,0,27,-27
4,13,33,9,36,23,13
4,13,33,11,264,129,135
4,13,33,13,76,64,12
4,13,33,15,153,84,69
4,13,33,17,38,42,-4
4,13,34,1,77,37,40
4,13,34,3,321,129,192
4,13,34,5,165,81,84
4,13,34,7,119,53,66
4,13,34,9,33,0,33
4,13,34,11,22,0,22
4,13,34,13,201,122,79
4,13,34,15,58,39,19
4,13,34,17,200,126,74
4,13,34,21,93,57,36
4,13,34,23,346,192,154
4,13,34,25,187,65,122
4,13,34,27,241,153,88
4,13,34,29,180,60,120
4,13,34,31,144,49,95
4,13,34,35,116,73,43
4,13,34,37,46,0,46
4,13,34,39,108,65,43
4,13,34,41,31,0,31
4,13,35,1,1567,1674,-107
4,13,35,3,0,24,-24
4,13,35,5,101,153,-52
4,13,35,6,42,46,-4
4,13,35,9,296,51,245
4,13,35,13,556,465,91
4,13,35,15,53,80,-27
4,13,35,17,117,100,17
4,13,35,23,0,28,-28
4,13,35,25,52,134,-82
4,13,35,27,28,53,-25
4,13,35,28,34,0,34
4,13,35,29,153,122,31
4,13,35,31,393,375,18
4,13,35,35,166,147,19
4,13,35,39,46,43,3
4,13,35,41,49,0,49
4,13,35,43,375,425,-50
4,13,35,45,411,442,-31
4,13,35,47,0,27,-27
4,13,35,49,217,279,-62
4,13,35,51,0,46,-46
4,13,35,55,44,49,-5
4,13,35,61,79,119,-40
4,13,36,1,142,60,82
4,13,36,5,214,119,95
4,13,36,7,63,33,30
4,13,36,9,30,0,30
4,13,36,11,35,0,35
4,13,36,13,60,43,17
4,13,36,15,30,0,30
4,13,36,27,73,59,14
4,13,36,29,512,212,300
4,13,36,39,36,0,36
4,13,36,43,26,0,26
4,13,36,45,76,69,7
4,13,36,47,380,310,70
4,13,36,55,330,151,179
4,13,36,57,25,0,25
4,13,36,59,432,140,292
4,13,36,61,469,468,1
4,13,36,63,71,105,-34
4,13,36,65,64,86,-22
4,13,36,67,185,103,82
4,13,36,69,35,0,35
4,13,36,71,116,68,48
4,13,36,75,39,0,39
4,13,36,81,479,257,222
4,13,36,83,41,0,41
4,13,36,85,115,50,65
4,13,36,87,93,48,45
4,13,36,91,98,54,44
4,13,36,93,57,0,57
4,13,36,101,32,0,32
4,13,36,103,594,229,365
4,13,36,105,25,0,25
4,13,36,109,38,34,4
4,13,36,111,54,36,18
4,13,36,113,31,0,31
4,13,36,117,30,0,30
4,13,36,119,253,97,156
4,13,37,19,0,36,-36
4,13,37,21,55,68,-13
4,13,37,25,45,32,13
4,13,37,27,0,35,-35
4,13,37,35,51,41,10
4,13,37,49,61,36,25
4,13,37,51,202,232,-30
4,13,37,63,97,89,8
4,13,37,67,80,113,-33
4,13,37,71,0,40,-40
4,13,37,81,89,143,-54
4,13,37,89,0,37,-37
4,13,37,97,41,52,-11
4,13,37,101,0,47,-47
4,13,37,119,330,481,-151
4,13,37,129,48,73,-25
4,13,37,133,140,110,30
4,13,37,135,38,94,-56
4,13,37,147,29,0,29
4,13,37,179,71,99,-28
4,13,37,183,311,460,-149
4,13,37,191,49,0,49
4,13,38,15,58,70,-12
4,13,38,17,208,79,129
4,13,38,35,105,44,61
4,13,38,101,92,38,54
4,13,39,7,50,25,25
4,13,39,17,139,93,46
4,13,39,23,36,31,5
4,13,39,25,91,64,27
4,13,39,29,42,34,8
4,13,39,35,809,350,459
4,13,39,41,113,106,7
4,13,39,43,45,0,45
4,13,39,45,54,50,4
4,13,39,49,871,493,378
4,13,39,51,34,0,34
4,13,39,55,48,0,48
4,13,39,57,74,85,-11
4,13,39,61,249,163,86
4,13,39,63,41,0,41
4,13,39,81,30,0,30
4,13,39,85,130,49,81
4,13,39,89,37,53,-16
4,13,39,93,187,89,98
4,13,39,95,257,68,189
4,13,39,99,122,43,79
4,13,39,103,139,40,99
4,13,39,109,27,0,27
4,13,39,113,236,100,136
4,13,39,119,27,0,27
4,13,39,133,105,29,76
4,13,39,139,60,26,34
4,13,39,151,168,88,80
4,13,39,153,262,162,100
4,13,39,155,104,48,56
4,13,39,157,24,0,24
4,13,39,165,82,66,16
4,13,39,169,38,0,38
4,13,39,173,76,33,43
4,13,40,17,42,34,8
4,13,40,27,159,120,39
4,13,40,31,114,78,36
4,13,40,37,0,35,-35
4,13,40,47,81,35,46
4,13,40,51,0,25,-25
4,13,40,109,324,406,-82
4,13,40,119,36,35,1
4,13,40,125,26,0,26
4,13,40,131,0,35,-35
4,13,40,143,384,349,35
4,13,40,145,0,44,-44
4,13,40,147,0,45,-45
4,13,41,3,82,90,-8
4,13,41,5,383,377,6
4,13,41,9,25,0,25
4,13,41,11,39,36,3
4,13,41,15,28,0,28
4,13,41,17,202,256,-54
4,13,41,19,76,56,20
4,13,41,29,195,202,-7
4,13,41,33,44,70,-26
4,13,41,35,41,50,-9
4,13,41,39,258,317,-59
4,13,41,41,37,65,-28
4,13,41,43,65,125,-60
4,13,41,47,292,302,-10
4,13,41,51,580,720,-140
4,13,41,53,79,34,45
4,13,41,57,0,29,-29
4,13,41,59,61,67,-6
4,13,41,67,930,932,-2
4,13,41,71,92,80,12
4,13,42,3,539,357,182
4,13,42,7,89,67,22
4,13,42,11,106,52,54
4,13,42,13,34,0,34
4,13,42,17,232,122,110
4,13,42,19,32,55,-23
4,13,42,21,35,0,35
4,13,42,27,66,52,14
4,13,42,29,208,120,88
4,13,42,39,27,0,27
4,13,42,41,54,60,-6
4,13,42,43,80,82,-2
4,13,42,45,166,83,83
4,13,42,49,167,63,104
4,13,42,55,39,0,39
4,13,42,69,67,30,37
4,13,42,71,128,107,21
4,13,42,73,22,0,22
4,13,42,75,27,0,27
4,13,42,77,132,81,51
4,13,42,79,94,45,49
4,13,42,81,0,30,-30
4,13,42,85,29,0,29
4,13,42,89,42,37,5
4,13,42,91,243,200,43
4,13,42,95,132,53,79
4,13,42,101,275,207,68
4,13,42,125,75,59,16
4,13,42,129,101,73,28
4,13,42,133,110,65,45
4,13,44,3,67,36,31
4,13,44,5,25,0,25
4,13,44,7,164,89,75
4,13,44,9,0,32,-32
4,13,45,7,0,46,-46
4,13,45,13,77,72,5
4,13,45,15,66,49,17
4,13,45,19,90,110,-20
4,13,45,45,122,131,-9
4,13,45,51,98,60,38
4,13,45,63,63,40,23
4,13,45,79,125,94,31
4,13,45,83,0,56,-56
4,13,45,85,68,87,-19
4,13,45,91,44,98,-54
4,13,46,81,0,42,-42
4,13,46,83,0,33,-33
4,13,46,93,0,37,-37
4,13,46,99,199,164,35
4,13,46,103,143,152,-9
4,13,46,135,28,0,28
4,13,47,3,40,0,40
4,13,47,9,30,0,30
4,13,47,37,289,273,16
4,13,47,65,53,62,-9
4,13,47,93,117,145,-28
4,13,47,125,140,111,29
4,13,47,141,0,30,-30
4,13,47,149,69,96,-27
4,13,47,157,359,193,166
4,13,47,163,0,40,-40
4,13,47,165,37,69,-32
4,13,47,179,21,0,21
4,13,47,187,103,124,-21
4,13,47,189,30,42,-12
4,13,48,21,33,46,-13
4,13,48,27,288,262,26
4,13,48,29,772,1324,-552
4,13,48,37,0,39,-39
4,13,48,39,56,102,-46
4,13,48,41,57,85,-28
4,13,48,53,0,41,-41
4,13,48,61,83,65,18
4,13,48,85,527,679,-152
4,13,48,91,44,95,-51
4,13,48,99,65,59,6
4,13,48,113,791,1014,-223
4,13,48,121,388,565,-177
4,13,48,135,74,106,-32
4,13,48,139,55,0,55
4,13,48,141,1585,1418,167
4,13,48,147,0,27,-27
4,13,48,157,170,240,-70
4,13,48,167,85,115,-30
4,13,48,181,42,38,4
4,13,48,183,37,45,-8
4,13,48,187,58,128,-70
4,13,48,201,1019,1400,-381
4,13,48,209,52,120,-68
4,13,48,215,118,142,-24
4,13,48,221,0,46,-46
4,13,48,245,50,49,1
4,13,48,251,0,75,-75
4,13,48,257,30,42,-12
4,13,48,303,164,136,28
4,13,48,309,47,101,-54
4,13,48,329,49,112,-63
4,13,48,339,155,261,-106
4,13,48,341,0,35,-35
4,13,48,355,107,134,-27
4,13,48,367,85,84,1
4,13,48,373,135,65,70
4,13,48,375,70,84,-14
4,13,48,381,64,52,12
4,13,48,397,0,33,-33
4,13,48,423,61,70,-9
4,13,48,439,738,1180,-442
4,13,48,441,93,65,28
4,13,48,451,55,76,-21
4,13,48,453,540,856,-316
4,13,48,465,87,32,55
4,13,48,479,0,49,-49
4,13,48,485,200,85,115
4,13,48,491,274,533,-259
4,13,48,497,0,37,-37
4,13,49,3,38,44,-6
4,13,49,5,158,182,-24
4,13,49,11,512,627,-115
4,13,49,13,0,39,-39
4,13,49,21,57,80,-23
4,13,49,35,1498,1960,-462
4,13,49,37,47,35,12
4,13,49,39,0,36,-36
4,13,49,43,26,56,-30
4,13,49,45,47,74,-27
4,13,49,47,0,32,-32
4,13,49,49,1214,1283,-69
4,13,49,51,35,62,-27
4,13,49,53,237,294,-57
4,13,49,57,205,399,-194
4,13,50,7,100,34,66
4,13,50,23,0,25,-25
4,13,51,3,0,55,-55
4,13,51,13,129,157,-28
4,13,51,41,87,58,29
4,13,51,59,493,431,62
4,13,51,61,43,0,43
4,13,51,87,70,126,-56
4,13,51,95,0,34,-34
4,13,51,107,154,213,-59
4,13,51,121,28,30,-2
4,13,51,153,134,85,49
4,13,51,177,34,37,-3
4,13,51,179,52,32,20
4,13,51,199,46,34,12
4,13,51,510,67,84,-17
4,13,51,550,104,46,58
4,13,51,650,70,33,37
4,13,51,700,94,64,30
4,13,51,710,133,71,62
4,13,51,740,0,29,-29
4,13,51,760,45,61,-16
4,13,51,810,225,173,52
4,13,53,5,170,191,-21
4,13,53,7,48,103,-55
4,13,53,9,61,73,-12
4,13,53,11,491,504,-13
4,13,53,15,65,73,-8
4,13,53,17,0,48,-48
4,13,53,21,52,51,1
4,13,53,25,71,72,-1
4,13,53,27,48,49,-1
4,13,53,29,144,98,46
4,13,53,33,2324,2222,102
4,13,53,35,262,252,10
4,13,53,37,35,0,35
4,13,53,41,59,26,33
4,13,53,45,52,54,-2
4,13,53,53,1004,740,264
4,13,53,57,86,89,-3
4,13,53,61,906,843,63
4,13,53,63,503,478,25
4,13,53,65,36,0,36
4,13,53,67,279,284,-5
4,13,53,71,0,37,-37
4,13,53,73,171,163,8
4,13,53,75,50,0,50
4,13,53,77,162,128,34
4,13,55,9,138,108,30
4,13,55,21,42,0,42
4,13,55,25,289,266,23
4,13,55,27,36,35,1
4,13,55,35,62,38,24
4,13,55,39,40,29,11
4,13,55,55,42,0,42
4,13,55,59,135,80,55
4,13,55,63,49,53,-4
4,13,55,71,30,20,10
4,13,55,73,45,55,-10
4,13,55,79,753,406,347
4,13,55,85,38,0,38
4,13,55,87,71,58,13
4,13,55,89,67,31,36
4,13,55,93,29,0,29
4,13,55,97,34,30,4
4,13,55,101,149,65,84
4,13,55,105,80,40,40
4,13,55,109,35,57,-22
4,13,55,111,21,26,-5
4,13,55,117,58,26,32
4,13,55,127,72,65,7
4,13,55,131,99,47,52
4,13,55,133,357,192,165
4,13,55,139,81,42,39
4,13,55,141,41,0,41
4,13,56,1,67,0,67
4,13,56,5,42,60,-18
4,13,56,21,148,121,27
4,13,56,23,0,34,-34
4,13,56,25,86,106,-20
4,13,56,29,0,39,-39
4,13,56,33,29,0,29
4,13,56,37,39,75,-36
4,13,56,39,40,52,-12
4,15,4,3,36,48,-12
4,15,4,5,278,347,-69
4,15,4,7,0,33,-33
4,15,4,12,154,124,30
4,15,4,13,822,1378,-556
4,15,4,17,93,117,-24
4,15,4,19,174,285,-111
4,15,4,21,84,158,-74
4,15,4,25,258,360,-102
4,15,4,27,90,197,-107
4,15,6,19,41,45,-4
4,15,6,25,51,53,-2
4,15,6,29,131,92,39
4,15,6,37,999,482,517
4,15,6,59,568,315,253
4,15,6,65,699,507,192
4,15,6,67,68,62,6
4,15,6,71,1302,723,579
4,15,6,73,454,372,82
4,15,6,77,34,0,34
4,15,6,79,32,71,-39
4,15,6,83,31,22,9
4,15,6,85,41,0,41
4,15,6,107,0,59,-59
4,15,6,111,199,92,107
4,15,8,1,27,0,27
4,15,8,5,34,0,34
4,15,8,31,25,38,-13
4,15,8,35,38,0,38
4,15,8,41,59,94,-35
4,15,8,59,46,25,21
4,15,8,69,0,33,-33
4,15,8,77,0,40,-40
4,15,8,83,35,34,1
4,15,8,101,0,55,-55
4,15,8,123,0,30,-30
4,15,15,3,0,42,-42
4,15,16,1,35,40,-5
4,15,16,27,0,34,-34
4,15,16,55,0,32,-32
4,15,16,83,0,35,-35
4,15,17,31,38,0,38
4,15,26,49,48,0,48
4,15,26,99,28,58,-30
4,15,26,125,47,0,47
4,15,26,163,43,0,43
4,15,32,3,1998,1909,89
4,15,32,7,0,34,-34
4,15,32,23,51,0,51
4,15,32,31,45,75,-30
4,15,35,1,0,45,-45
4,15,35,13,0,30,-30
4,15,35,45,35,38,-3
4,15,40,143,33,0,33
4,15,41,17,0,45,-45
4,15,41,19,0,34,-34
4,15,41,29,31,0,31
4,15,41,39,32,54,-22
4,15,41,41,31,0,31
4,15,41,51,45,28,17
4,15,41,67,0,45,-45
4,15,48,27,0,43,-43
4,15,48,29,29,33,-4
4,15,48,113,0,30,-30
4,15,48,201,46,44,2
4,15,48,439,0,41,-41
4,15,49,5,0,47,-47
4,15,49,11,0,48,-48
4,15,49,21,0,31,-31
4,15,49,35,128,115,13
4,15,49,49,0,39,-39
4,15,49,53,304,246,58
4,15,49,57,0,40,-40
4,15,53,11,33,41,-8
4,15,53,33,74,70,4
4,15,53,35,0,35,-35
4,15,53,53,38,46,-8
4,15,53,61,49,64,-15
4,15,53,63,31,88,-57
4,15,53,67,31,39,-8
4,17,4,1,1061,1056,5
4,17,4,3,0,49,-49
4,17,4,5,753,734,19
4,17,4,7,165,147,18
4,17,4,9,37,91,-54
4,17,4,13,2555,2050,505
4,17,4,15,117,93,24
4,17,4,19,465,388,77
4,17,4,21,259,207,52
4,17,4,25,172,189,-17
4,17,4,27,61,0,61
4,17,6,37,57,33,24
4,17,6,59,25,0,25
4,17,6,65,53,48,5
4,17,6,71,72,0,72
4,17,6,73,123,73,50
4,17,8,41,34,0,34
4,17,32,3,94,81,13
4,17,35,1,88,72,16
4,17,35,31,283,240,43
4,17,35,45,181,295,-114
4,17,49,35,33,53,-20
4,17,49,37,36,59,-23
4,17,49,49,36,73,-37
4,17,49,53,54,35,19
4,17,53,63,0,33,-33
4,19,1,73,0,37,-37
4,19,1,89,78,81,-3
4,19,1,97,28,0,28
4,19,1,101,37,0,37
4,19,2,20,256,97,159
4,19,2,90,120,58,62
4,19,2,122,26,0,26
4,19,4,1,133,154,-21
4,19,4,3,2042,1753,289
4,19,4,5,539,487,52
4,19,4,7,185,171,14
4,19,4,9,235,321,-86
4,19,4,11,102,118,-16
4,19,4,13,5765,7044,-1279
4,19,4,15,285,174,111
4,19,4,17,388,465,-77
4,19,4,21,1197,2432,-1235
4,19,4,23,1327,1022,305
4,19,4,25,457,429,28
4,19,4,27,460,395,65
4,19,5,7,40,0,40
4,19,5,119,37,58,-21
4,19,5,143,0,36,-36
4,19,6,1,175,137,38
4,19,6,13,123,148,-25
4,19,6,17,24,42,-18
4,19,6,19,88,107,-19
4,19,6,23,40,0,40
4,19,6,25,57,69,-12
4,19,6,29,167,128,39
4,19,6,37,1588,1096,492
4,19,6,41,50,44,6
4,19,6,53,149,152,-3
4,19,6,57,0,25,-25
4,19,6,59,617,484,133
4,19,6,61,33,64,-31
4,19,6,65,474,348,126
4,19,6,67,215,155,60
4,19,6,71,500,207,293
4,19,6,73,1178,1062,116
4,19,6,75,81,159,-78
4,19,6,77,68,62,6
4,19,6,79,71,50,21
4,19,6,81,106,69,37
4,19,6,83,111,91,20
4,19,6,85,205,329,-124
4,19,6,87,40,30,10
4,19,6,89,0,26,-26
4,19,6,95,69,52,17
4,19,6,97,99,56,43
4,19,6,99,70,77,-7
4,19,6,107,59,60,-1
4,19,6,111,169,115,54
4,19,6,113,56,28,28
4,19,8,1,95,101,-6
4,19,8,5,151,230,-79
4,19,8,13,97,151,-54
4,19,8,14,33,34,-1
4,19,8,31,129,173,-44
4,19,8,35,116,105,11
4,19,8,41,359,336,23
4,19,8,45,0,41,-41
4,19,8,59,139,105,34
4,19,8,67,41,57,-16
4,19,8,69,76,122,-46
4,19,8,77,32,43,-11
4,19,8,101,39,45,-6
4,19,8,123,71,43,28
4,19,9,1,91,33,58
4,19,9,3,83,27,56
4,19,9,5,22,0,22
4,19,9,9,61,50,11
4,19,9,11,22,0,22
4,19,10,3,38,34,4
4,19,11,1,82,104,-22
4,19,12,1,44,36,8
4,19,12,5,34,0,34
4,19,12,9,62,63,-1
4,19,12,11,148,93,55
4,19,12,21,36,30,6
4,19,12,31,58,70,-12
4,19,12,33,86,56,30
4,19,12,57,167,122,45
4,19,12,71,89,47,42
4,19,12,73,25,0,25
4,19,12,81,28,35,-7
4,19,12,86,108,85,23
4,19,12,91,103,72,31
4,19,12,95,99,56,43
4,19,12,97,27,0,27
4,19,12,99,110,101,9
4,19,12,101,27,0,27
4,19,12,103,97,96,1
4,19,12,113,0,47,-47
4,19,12,115,66,0,66
4,19,12,117,42,0,42
4,19,12,127,31,36,-5
4,19,13,51,0,26,-26
4,19,13,63,30,0,30
4,19,13,67,72,36,36
4,19,13,89,59,30,29
4,19,13,121,46,47,-1
4,19,13,135,46,52,-6
4,19,13,153,0,64,-64
4,19,13,179,24,0,24
4,19,13,185,0,62,-62
4,19,15,1,76,54,22
4,19,15,3,249,257,-8
4,19,15,9,39,41,-2
4,19,16,1,61,133,-72
4,19,16,5,43,0,43
4,19,16,55,65,50,15
4,19,17,19,47,44,3
4,19,17,31,501,292,209
4,19,17,43,162,63,99
4,19,17,89,50,46,4
4,19,17,97,124,53,71
4,19,17,111,58,26,32
4,19,17,143,40,33,7
4,19,17,163,0,50,-50
4,19,17,167,26,0,26
4,19,17,197,62,51,11
4,19,17,201,63,49,14
4,19,18,3,66,0,66
4,19,18,57,42,49,-7
4,19,18,89,34,32,2
4,19,18,97,109,74,35
4,19,18,105,25,28,-3
4,19,18,127,31,0,31
4,19,18,141,49,0,49
4,19,18,157,46,0,46
4,19,19,113,29,38,-9
4,19,19,153,42,50,-8
4,19,19,169,26,0,26
4,19,20,45,34,0,34
4,19,20,91,76,82,-6
4,19,20,173,75,68,7
4,19,21,47,36,0,36
4,19,21,111,56,86,-30
4,19,22,33,34,29,5
4,19,22,71,0,33,-33
4,19,22,115,48,0,48
4,19,23,5,44,0,44
4,19,23,31,31,0,31
4,19,24,3,55,80,-25
4,19,24,5,80,46,34
4,19,24,21,33,0,33
4,19,24,25,36,0,36
4,19,24,27,30,0,30
4,19,24,31,102,102,0
4,19,24,33,40,58,-18
4,19,24,510,55,30,25
4,19,25,1,41,25,16
4,19,25,9,37,31,6
4,19,25,13,0,26,-26
4,19,25,15,0,27,-27
4,19,25,17,156,156,0
4,19,25,21,44,52,-8
4,19,25,25,81,44,37
4,19,25,27,100,27,73
4,19,26,21,0,37,-37
4,19,26,49,85,0,85
4,19,26,65,55,39,16
4,19,26,77,30,0,30
4,19,26,81,79,38,41
4,19,26,99,146,32,114
4,19,26,103,23,0,23
4,19,26,125,219,68,151
4,19,26,139,48,0,48
4,19,26,161,103,40,63
4,19,26,163,231,49,182
4,19,27,37,62,29,33
4,19,27,53,177,105,72
4,19,27,109,29,28,1
4,19,27,123,60,55,5
4,19,27,139,34,0,34
4,19,27,163,40,48,-8
4,19,28,47,67,27,40
4,19,29,19,34,45,-11
4,19,29,47,39,0,39
4,19,29,77,49,35,14
4,19,29,95,65,83,-18
4,19,29,183,44,34,10
4,19,29,189,129,76,53
4,19,29,510,0,32,-32
4,19,30,29,34,24,10
4,19,30,31,0,28,-28
4,19,30,49,23,0,23
4,19,30,63,24,35,-11
4,19,30,111,0,33,-33
4,19,31,55,108,82,26
4,19,31,109,67,40,27
4,19,31,153,55,65,-10
4,19,32,3,916,1006,-90
4,19,32,7,54,26,28
4,19,32,31,184,137,47
4,19,33,11,44,37,7
4,19,33,13,35,0,35
4,19,33,15,37,30,7
4,19,34,3,49,0,49
4,19,34,5,40,0,40
4,19,34,17,52,0,52
4,19,34,23,57,0,57
4,19,34,25,47,0,47
4,19,34,27,52,0,52
4,19,34,31,40,0,40
4,19,35,1,494,372,122
4,19,35,5,28,0,28
4,19,35,9,93,0,93
4,19,35,13,204,143,61
4,19,35,15,35,37,-2
4,19,35,17,134,114,20
4,19,35,29,33,40,-7
4,19,35,31,32,0,32
4,19,35,35,59,55,4
4,19,35,43,81,72,9
4,19,35,45,37,93,-56
4,19,35,49,67,101,-34
4,19,35,51,0,31,-31
4,19,35,61,36,0,36
4,19,36,1,24,0,24
4,19,36,5,27,0,27
4,19,36,29,100,88,12
4,19,36,45,36,50,-14
4,19,36,47,106,108,-2
4,19,36,55,60,57,3
4,19,36,59,54,27,27
4,19,36,61,119,93,26
4,19,36,67,60,36,24
4,19,36,71,41,0,41
4,19,36,81,68,49,19
4,19,36,103,94,32,62
4,19,36,119,51,45,6
4,19,37,51,142,140,2
4,19,37,63,0,39,-39
4,19,37,67,0,32,-32
4,19,37,81,0,32,-32
4,19,37,119,46,75,-29
4,19,37,133,40,31,9
4,19,37,183,67,116,-49
4,19,37,191,0,51,-51
4,19,38,35,0,55,-55
4,19,38,101,53,0,53
4,19,39,35,156,62,94
4,19,39,49,149,81,68
4,19,39,57,46,0,46
4,19,39,61,94,39,55
4,19,39,93,37,34,3
4,19,39,95,77,0,77
4,19,39,103,21,0,21
4,19,39,113,73,61,12
4,19,39,153,44,28,16
4,19,40,27,62,0,62
4,19,40,31,26,0,26
4,19,40,47,35,0,35
4,19,40,109,69,97,-28
4,19,40,143,78,73,5
4,19,41,3,0,48,-48
4,19,41,5,53,94,-41
4,19,41,17,43,63,-20
4,19,41,19,0,26,-26
4,19,41,29,35,60,-25
4,19,41,39,118,69,49
4,19,41,47,46,27,19
4,19,41,51,191,254,-63
4,19,41,53,30,0,30
4,19,41,67,138,126,12
4,19,41,71,0,35,-35
4,19,42,3,96,71,25
4,19,42,11,30,0,30
4,19,42,17,57,0,57
4,19,42,19,41,0,41
4,19,42,27,0,30,-30
4,19,42,29,42,32,10
4,19,42,49,45,32,13
4,19,42,71,38,43,-5
4,19,42,77,27,0,27
4,19,42,91,50,45,5
4,19,42,101,73,54,19
4,19,42,133,31,37,-6
4,19,44,7,38,32,6
4,19,45,13,0,46,-46
4,19,45,15,0,24,-24
4,19,45,19,0,31,-31
4,19,45,45,0,31,-31
4,19,45,51,32,0,32
4,19,45,63,0,35,-35
4,19,46,99,56,41,15
4,19,46,103,34,33,1
4,19,47,37,74,38,36
4,19,47,93,40,38,2
4,19,47,125,73,0,73
4,19,47,149,35,0,35
4,19,47,157,102,46,56
4,19,47,187,0,45,-45
4,19,48,27,127,125,2
4,19,48,29,319,354,-35
4,19,48,41,0,30,-30
4,19,48,61,54,48,6
4,19,48,85,123,210,-87
4,19,48,113,223,205,18
4,19,48,121,107,126,-19
4,19,48,135,0,37,-37
4,19,48,141,449,371,78
4,19,48,157,32,40,-8
4,19,48,167,24,0,24
4,19,48,187,0,41,-41
4,19,48,201,243,271,-28
4,19,48,215,37,40,-3
4,19,48,265,0,45,-45
4,19,48,303,46,44,2
4,19,48,309,0,43,-43
4,19,48,339,34,61,-27
4,19,48,355,51,76,-25
4,19,48,373,53,29,24
4,19,48,375,38,0,38
4,19,48,439,220,213,7
4,19,48,441,56,0,56
4,19,48,451,60,0,60
4,19,48,453,156,185,-29
4,19,48,465,43,35,8
4,19,48,485,95,43,52
4,19,48,491,0,108,-108
4,19,49,5,35,0,35
4,19,49,11,115,79,36
4,19,49,35,237,262,-25
4,19,49,49,167,193,-26
4,19,49,53,38,61,-23
4,19,49,57,76,60,16
4,19,50,7,0,33,-33
4,19,51,13,62,54,8
4,19,51,59,161,115,46
4,19,51,107,43,38,5
4,19,51,153,37,64,-27
4,19,51,179,37,43,-6
4,19,51,650,58,0,58
4,19,51,700,0,59,-59
4,19,51,810,60,60,0
4,19,53,7,28,0,28
4,19,53,9,32,0,32
4,19,53,11,89,65,24
4,19,53,27,0,28,-28
4,19,53,29,57,0,57
4,19,53,33,583,563,20
4,19,53,35,62,52,10
4,19,53,45,29,0,29
4,19,53,53,255,219,36
4,19,53,57,49,24,25
4,19,53,61,227,139,88
4,19,53,63,148,135,13
4,19,53,67,43,62,-19
4,19,53,73,73,111,-38
4,19,53,75,31,0,31
4,19,55,25,100,102,-2
4,19,55,79,141,51,90
4,19,55,87,37,0,37
4,19,55,101,27,0,27
4,19,55,131,32,0,32
4,19,55,133,48,38,10
4,19,55,139,28,33,-5
4,19,56,21,63,0,63
4,21,2,20,49,0,49
4,21,4,1,47,72,-25
4,21,4,3,214,107,107
4,21,4,5,194,98,96
4,21,4,7,296,238,58
4,21,4,9,77,84,-7
4,21,4,11,0,57,-57
4,21,4,13,23962,12229,11733
4,21,4,15,158,84,74
4,21,4,17,207,259,-52
4,21,4,19,2432,1197,1235
4,21,4,25,256,212,44
4,21,4,27,179,48,131
4,21,6,1,74,22,52
4,21,6,13,87,45,42
4,21,6,19,38,0,38
4,21,6,29,81,50,31
4,21,6,37,1106,251,855
4,21,6,53,30,0,30
4,21,6,59,359,75,284
4,21,6,61,29,0,29
4,21,6,65,486,185,301
4,21,6,67,72,77,-5
4,21,6,71,396,99,297
4,21,6,73,517,224,293
4,21,6,77,54,44,10
4,21,6,79,36,0,36
4,21,6,85,142,36,106
4,21,6,95,46,0,46
4,21,6,97,41,0,41
4,21,6,99,62,0,62
4,21,6,107,42,0,42
4,21,6,111,117,29,88
4,21,8,5,73,29,44
4,21,8,31,41,0,41
4,21,8,35,54,0,54
4,21,8,41,216,38,178
4,21,8,59,44,0,44
4,21,8,69,32,76,-44
4,21,8,123,41,24,17
4,21,12,9,34,0,34
4,21,12,57,66,0,66
4,21,12,95,62,0,62
4,21,12,99,42,0,42
4,21,12,103,39,0,39
4,21,12,105,37,0,37
4,21,15,3,105,37,68
4,21,16,1,37,34,3
4,21,17,31,241,64,177
4,21,17,43,62,0,62
4,21,17,89,31,0,31
4,21,17,97,70,0,70
4,21,17,111,32,0,32
4,21,17,197,65,0,65
4,21,17,201,30,0,30
4,21,18,89,43,0,43
4,21,20,91,30,0,30
4,21,24,5,40,0,40
4,21,25,17,34,0,34
4,21,26,49,78,0,78
4,21,26,81,39,0,39
4,21,26,99,103,0,103
4,21,26,125,133,0,133
4,21,26,147,61,0,61
4,21,26,163,149,27,122
4,21,27,3,48,0,48
4,21,27,53,60,0,60
4,21,29,95,47,0,47
4,21,29,189,30,0,30
4,21,32,3,384,184,200
4,21,32,7,54,0,54
4,21,32,31,77,28,49
4,21,34,23,29,0,29
4,21,35,1,146,58,88
4,21,35,13,57,0,57
4,21,35,17,37,0,37
4,21,35,43,48,0,48
4,21,35,45,28,0,28
4,21,35,61,39,0,39
4,21,36,29,37,0,37
4,21,36,47,34,0,34
4,21,36,55,28,0,28
4,21,36,59,39,0,39
4,21,36,103,69,0,69
4,21,37,51,32,0,32
4,21,37,119,0,41,-41
4,21,39,35,42,0,42
4,21,39,49,43,0,43
4,21,39,85,30,0,30
4,21,39,153,34,0,34
4,21,40,143,33,0,33
4,21,41,5,30,0,30
4,21,41,17,0,37,-37
4,21,41,39,46,0,46
4,21,41,47,42,0,42
4,21,41,51,53,44,9
4,21,41,67,141,29,112
4,21,46,99,47,31,16
4,21,47,157,27,0,27
4,21,48,27,43,0,43
4,21,48,29,43,59,-16
4,21,48,113,36,0,36
4,21,48,121,0,28,-28
4,21,48,141,150,77,73
4,21,48,201,62,39,23
4,21,48,373,75,0,75
4,21,48,439,88,77,11
4,21,48,453,0,25,-25
4,21,48,491,29,41,-12
4,21,49,35,136,92,44
4,21,49,49,138,59,79
4,21,49,53,33,0,33
4,21,53,5,36,0,36
4,21,53,11,77,0,77
4,21,53,33,177,72,105
4,21,53,41,40,0,40
4,21,53,53,93,62,31
4,21,53,57,27,0,27
4,21,53,61,117,88,29
4,21,53,63,52,52,0
4,21,53,67,46,0,46
4,21,55,79,48,0,48
4,21,55,133,31,0,31
4,23,4,3,96,106,-10
4,23,4,13,414,327,87
4,23,4,19,1022,1327,-305
4,23,6,37,75,58,17
4,23,6,73,58,62,-4
4,23,32,3,0,35,-35
4,25,2,20,46,22,24
4,25,4,1,0,46,-46
4,25,4,3,79,83,-4
4,25,4,5,1057,815,242
4,25,4,7,175,117,58
4,25,4,9,67,106,-39
4,25,4,12,44,36,8
4,25,4,13,4697,3719,978
4,25,4,15,360,258,102
4,25,4,17,189,172,17
4,25,4,19,429,457,-28
4,25,4,21,212,256,-44
4,25,4,27,110,116,-6
4,25,6,1,53,29,24
4,25,6,13,54,56,-2
4,25,6,17,29,0,29
4,25,6,19,38,30,8
4,25,6,29,46,41,5
4,25,6,37,569,230,339
4,25,6,53,40,0,40
4,25,6,59,417,157,260
4,25,6,61,31,31,0
4,25,6,65,331,178,153
4,25,6,67,52,47,5
4,25,6,71,233,99,134
4,25,6,73,417,374,43
4,25,6,79,52,42,10
4,25,6,83,81,28,53
4,25,6,85,54,0,54
4,25,6,97,31,53,-22
4,25,6,111,137,67,70
4,25,8,5,22,39,-17
4,25,8,13,31,48,-17
4,25,8,31,31,33,-2
4,25,8,35,0,30,-30
4,25,8,41,58,111,-53
4,25,8,59,30,33,-3
4,25,8,67,0,60,-60
4,25,8,69,33,55,-22
4,25,8,77,44,30,14
4,25,8,85,0,29,-29
4,25,9,3,31,0,31
4,25,12,11,40,0,40
4,25,12,33,0,29,-29
4,25,12,86,23,0,23
4,25,12,99,37,0,37
4,25,15,3,33,52,-19
4,25,16,1,29,78,-49
4,25,17,31,65,59,6
4,25,17,43,37,0,37
4,25,17,97,36,0,36
4,25,24,31,24,0,24
4,25,25,27,23,0,23
4,25,26,65,24,0,24
4,25,26,125,60,0,60
4,25,26,163,38,0,38
4,25,27,53,35,0,35
4,25,29,77,0,27,-27
4,25,30,63,27,0,27
4,25,30,111,0,34,-34
4,25,32,3,355,215,140
4,25,32,31,35,38,-3
4,25,35,1,43,51,-8
4,25,35,13,34,0,34
4,25,35,43,0,32,-32
4,25,35,45,0,35,-35
4,25,35,49,31,52,-21
4,25,36,47,32,0,32
4,25,36,103,39,0,39
4,25,40,143,0,46,-46
4,25,41,5,0,30,-30
4,25,41,17,0,31,-31
4,25,41,29,0,53,-53
4,25,41,39,0,56,-56
4,25,41,51,30,93,-63
4,25,41,67,46,59,-13
4,25,42,17,30,0,30
4,25,48,29,45,37,8
4,25,48,113,33,0,33
4,25,48,201,47,29,18
4,25,48,209,0,26,-26
4,25,48,373,33,0,33
4,25,48,439,0,36,-36
4,25,48,453,41,27,14
4,25,49,21,38,0,38
4,25,49,35,48,58,-10
4,25,49,49,0,53,-53
4,25,49,53,32,0,32
4,25,53,11,28,0,28
4,25,53,33,108,89,19
4,25,53,53,54,44,10
4,25,53,57,35,0,35
4,25,53,61,60,46,14
4,25,53,63,48,33,15
4,25,53,67,37,0,37
4,25,53,73,0,46,-46
4,25,55,25,0,28,-28
4,25,55,79,24,23,1
4,27,2,20,25,0,25
4,27,4,3,118,59,59
4,27,4,5,77,70,7
4,27,4,12,79,0,79
4,27,4,13,1490,1556,-66
4,27,4,15,197,90,107
4,27,4,17,42,61,-19
4,27,4,19,395,460,-65
4,27,4,21,48,179,-131
4,27,4,25,116,110,6
4,27,6,1,42,0,42
4,27,6,19,102,84,18
4,27,6,25,836,475,361
4,27,6,29,67,85,-18
4,27,6,37,558,251,307
4,27,6,47,0,29,-29
4,27,6,53,542,382,160
4,27,6,59,196,84,112
4,27,6,65,406,283,123
4,27,6,67,36,55,-19
4,27,6,71,344,123,221
4,27,6,73,816,750,66
4,27,6,77,79,33,46
4,27,6,83,35,40,-5
4,27,6,85,50,32,18
4,27,6,97,28,0,28
4,27,6,99,41,0,41
4,27,6,107,51,41,10
4,27,6,111,69,48,21
4,27,8,5,40,0,40
4,27,8,41,54,0,54
4,27,12,11,29,0,29
4,27,12,33,101,64,37
4,27,15,3,70,42,28
4,27,16,1,0,49,-49
4,27,17,31,83,33,50
4,27,26,125,25,0,25
4,27,26,163,24,0,24
4,27,32,3,261,192,69
4,27,32,31,44,27,17
4,27,35,1,29,39,-10
4,27,37,49,163,112,51
4,27,37,133,154,117,37
4,27,41,5,24,0,24
4,27,41,17,0,31,-31
4,27,41,39,41,0,41
4,27,41,51,28,0,28
4,27,45,13,41,38,3
4,27,48,27,52,0,52
4,27,48,29,63,89,-26
4,27,48,113,49,0,49
4,27,48,141,49,108,-59
4,27,48,201,66,64,2
4,27,48,373,44,0,44
4,27,48,439,50,66,-16
4,27,49,35,45,71,-26
4,27,51,59,0,43,-43
4,27,51,153,37,78,-41
4,27,51,179,47,0,47
4,27,53,11,31,0,31
4,27,53,33,108,64,44
4,27,53,35,26,40,-14
4,27,53,53,120,81,39
4,27,53,61,71,30,41
4,27,53,63,79,45,34
4,27,53,67,28,44,-16
4,27,53,77,36,30,6
5,1,5,31,0,34,-34
5,1,5,41,0,39,-39
5,1,5,43,30,0,30
5,1,5,45,0,48,-48
5,1,5,69,108,130,-22
5,1,5,85,92,82,10
5,1,5,95,92,45,47
5,1,5,117,55,83,-28
5,1,5,119,71,193,-122
5,1,5,125,0,37,-37
5,1,5,145,0,40,-40
5,3,5,11,34,0,34
5,3,5,17,65,48,17
5,3,5,43,102,90,12
5,3,5,45,0,36,-36
5,3,5,119,58,108,-50
5,3,5,139,68,57,11
5,3,22,67,98,84,14
5,3,22,73,50,63,-13
5,5,4,13,40,0,40
5,5,5,7,32,64,-32
5,5,5,9,44,66,-22
5,5,5,31,65,56,9
5,5,5,45,31,29,2
5,5,5,49,83,89,-6
5,5,5,63,38,0,38
5,5,5,65,80,96,-16
5,5,5,85,34,0,34
5,5,5,89,340,312,28
5,5,5,119,30,55,-25
5,5,5,129,0,39,-39
5,5,5,135,32,0,32
5,5,5,143,69,85,-16
5,5,6,37,27,0,27
5,5,17,31,65,0,65
5,5,29,43,0,42,-42
5,5,29,77,60,73,-13
5,5,29,91,54,35,19
5,5,29,153,71,74,-3
5,5,48,439,43,0,43
5,7,4,13,201,120,81
5,7,4,19,0,40,-40
5,7,5,5,64,32,32
5,7,5,9,83,65,18
5,7,5,15,191,155,36
5,7,5,19,32,0,32
5,7,5,31,61,43,18
5,7,5,33,159,98,61
5,7,5,35,34,0,34
5,7,5,45,115,80,35
5,7,5,47,33,0,33
5,7,5,51,68,32,36
5,7,5,57,28,0,28
5,7,5,63,40,0,40
5,7,5,69,51,39,12
5,7,5,71,32,35,-3
5,7,5,83,31,0,31
5,7,5,85,68,47,21
5,7,5,87,166,164,2
5,7,5,113,0,27,-27
5,7,5,115,135,98,37
5,7,5,119,323,171,152
5,7,5,125,70,46,24
5,7,5,131,315,206,109
5,7,5,143,5506,3654,1852
5,7,5,145,59,41,18
5,7,6,29,44,0,44
5,7,6,37,413,134,279
5,7,6,53,63,0,63
5,7,6,59,124,41,83
5,7,6,65,99,0,99
5,7,6,71,106,28,78
5,7,6,73,84,64,20
5,7,6,85,40,0,40
5,7,6,107,45,0,45
5,7,6,111,46,0,46
5,7,8,31,25,0,25
5,7,8,41,48,29,19
5,7,8,59,0,26,-26
5,7,12,11,48,0,48
5,7,12,31,0,26,-26
5,7,12,57,0,35,-35
5,7,12,71,38,0,38
5,7,12,86,54,0,54
5,7,12,95,31,0,31
5,7,12,99,47,0,47
5,7,12,103,41,0,41
5,7,12,105,27,0,27
5,7,12,117,32,0,32
5,7,13,67,44,34,10
5,7,13,135,34,0,34
5,7,17,31,131,81,50
5,7,17,43,42,0,42
5,7,17,197,65,0,65
5,7,20,37,27,0,27
5,7,20,91,115,100,15
5,7,20,173,83,65,18
5,7,20,177,26,0,26
5,7,23,19,53,0,53
5,7,27,53,86,46,40
5,7,29,9,261,224,37
5,7,29,43,36,35,1
5,7,29,47,26,0,26
5,7,29,77,176,114,62
5,7,29,95,99,45,54
5,7,29,97,219,134,85
5,7,29,109,30,38,-8
5,7,29,119,478,368,110
5,7,29,145,144,107,37
5,7,29,183,40,41,-1
5,7,29,189,89,66,23
5,7,29,213,45,66,-21
5,7,31,55,43,53,-10
5,7,32,3,104,58,46
5,7,32,31,33,0,33
5,7,34,23,41,0,41
5,7,34,27,41,0,41
5,7,37,119,36,27,9
5,7,37,183,49,0,49
5,7,39,49,60,0,60
5,7,40,1,243,198,45
5,7,40,21,58,53,5
5,7,40,27,30,33,-3
5,7,40,41,412,520,-108
5,7,40,47,0,29,-29
5,7,40,79,39,0,39
5,7,40,97,30,61,-31
5,7,40,101,0,31,-31
5,7,40,109,112,99,13
5,7,40,115,35,59,-24
5,7,40,131,36,53,-17
5,7,40,135,52,0,52
5,7,40,143,305,361,-56
5,7,40,145,0,39,-39
5,7,40,147,0,38,-38
5,7,47,37,39,29,10
5,7,47,149,36,0,36
5,7,47,157,124,56,68
5,7,48,27,45,0,45
5,7,48,29,73,44,29
5,7,48,37,30,0,30
5,7,48,85,100,94,6
5,7,48,113,136,171,-35
5,7,48,121,129,67,62
5,7,48,141,41,36,5
5,7,48,201,135,167,-32
5,7,48,215,45,75,-30
5,7,48,439,173,147,26
5,7,48,453,45,60,-15
5,7,48,491,36,50,-14
5,7,49,35,53,0,53
5,7,49,49,49,0,49
5,7,51,59,34,0,34
5,7,53,33,0,44,-44
5,9,5,5,66,44,22
5,9,5,7,65,83,-18
5,9,5,15,147,241,-94
5,9,5,45,0,35,-35
5,9,5,51,0,37,-37
5,9,5,89,146,171,-25
5,9,5,101,258,206,52
5,9,5,119,30,30,0
5,9,5,129,108,56,52
5,9,5,143,118,157,-39
5,9,29,43,60,39,21
5,9,29,77,57,61,-4
5,9,29,209,0,38,-38
5,9,29,213,151,199,-48
5,11,5,3,0,34,-34
5,11,5,13,0,45,-45
5,11,5,25,35,57,-22
5,11,5,43,114,99,15
5,11,5,103,0,34,-34
5,11,5,119,45,69,-24
5,11,5,139,0,59,-59
5,13,5,11,45,0,45
5,13,5,39,0,38,-38
5,13,5,103,58,77,-19
5,13,5,139,32,40,-8
5,15,5,7,155,191,-36
5,15,5,9,241,147,94
5,15,5,87,61,77,-16
5,15,5,115,0,37,-37
5,15,5,119,0,35,-35
5,15,5,143,120,204,-84
5,15,6,37,39,0,39
5,15,29,9,82,60,22
5,15,29,77,52,35,17
5,15,29,209,66,81,-15
5,15,29,213,23,0,23
5,17,5,3,48,65,-17
5,17,5,41,87,107,-20
5,17,5,43,42,83,-41
5,17,5,45,0,35,-35
5,17,5,69,0,41,-41
5,17,5,119,56,117,-61
5,17,28,151,64,81,-17
5,19,5,7,0,32,-32
5,19,5,39,34,56,-22
5,19,5,45,31,0,31
5,19,5,51,155,205,-50
5,19,5,57,41,33,8
5,19,5,59,153,168,-15
5,19,5,69,30,0,30
5,19,5,99,72,44,28
5,19,5,103,40,0,40
5,19,5,109,109,63,46
5,19,5,119,99,166,-67
5,19,5,125,68,108,-40
5,19,48,37,0,42,-42
5,21,5,31,57,126,-69
5,21,5,55,239,283,-44
5,21,5,121,51,58,-7
5,21,29,23,62,47,15
5,21,29,69,153,102,51
5,23,5,31,0,29,-29
5,23,5,45,186,172,14
5,23,5,63,77,98,-21
5,23,5,69,34,0,34
5,23,5,85,50,46,4
5,23,5,119,120,84,36
5,23,5,125,28,30,-2
5,23,5,137,38,46,-8
5,23,5,141,75,61,14
5,23,5,143,0,43,-43
5,23,5,145,258,247,11
5,23,47,157,80,0,80
5,25,5,11,57,35,22
5,25,5,39,37,54,-17
5,25,5,43,0,35,-35
5,25,5,53,0,34,-34
5,25,5,69,318,322,-4
5,25,5,79,55,55,0
5,25,5,119,29,67,-38
5,27,5,57,31,0,31
5,27,5,73,89,54,35
5,27,5,91,0,68,-68
5,27,5,103,108,81,27
5,27,5,119,42,114,-72
5,27,5,139,83,134,-51
5,27,22,17,0,27,-27
5,27,22,27,46,0,46
5,27,22,119,88,95,-7
5,27,48,37,32,49,-17
5,27,48,113,0,112,-112
5,27,48,201,0,41,-41
5,29,5,45,350,431,-81
5,29,5,105,134,116,18
5,29,5,115,150,212,-62
5,29,5,119,73,139,-66
5,29,5,141,63,47,16
5,29,5,143,0,35,-35
5,29,5,149,0,40,-40
5,31,4,13,35,0,35
5,31,5,1,34,0,34
5,31,5,5,56,65,-9
5,31,5,7,43,61,-18
5,31,5,21,126,57,69
5,31,5,23,29,0,29
5,31,5,35,208,151,57
5,31,5,37,201,124,77
5,31,5,45,55,99,-44
5,31,5,49,0,36,-36
5,31,5,51,0,41,-41
5,31,5,55,591,551,40
5,31,5,63,121,107,14
5,31,5,65,28,0,28
5,31,5,67,158,97,61
5,31,5,69,40,0,40
5,31,5,75,297,200,97
5,31,5,77,45,39,6
5,31,5,85,30,46,-16
5,31,5,93,544,284,260
5,31,5,95,39,0,39
5,31,5,107,119,0,119
5,31,5,111,859,665,194
5,31,5,119,247,235,12
5,31,5,121,130,76,54
5,31,5,123,195,78,117
5,31,5,125,63,82,-19
5,31,5,135,69,80,-11
5,31,5,143,62,82,-20
5,31,5,145,93,62,31
5,31,5,147,35,0,35
5,31,6,73,0,29,-29
5,31,17,31,33,0,33
5,31,28,33,44,42,2
5,31,29,23,50,24,26
5,31,29,69,109,48,61
5,31,47,37,0,53,-53
5,31,47,157,207,202,5
5,31,48,29,0,36,-36
5,31,48,113,36,44,-8
5,31,48,439,0,48,-48
5,33,5,7,98,159,-61
5,33,5,45,40,51,-11
5,33,5,47,196,157,39
5,33,5,71,51,0,51
5,33,5,83,69,57,12
5,33,5,115,61,55,6
5,33,5,119,63,28,35
5,33,5,127,43,0,43
5,33,5,131,2139,2078,61
5,33,5,143,247,237,10
5,33,6,37,59,0,59
5,33,40,79,135,103,32
5,33,40,109,0,36,-36
5,33,40,135,228,209,19
5,33,40,143,0,60,-60
5,33,48,201,0,48,-48
5,33,48,439,0,26,-26
5,35,5,7,0,34,-34
5,35,5,31,151,208,-57
5,35,5,37,128,132,-4
5,35,5,45,0,61,-61
5,35,5,77,0,27,-27
5,35,5,93,133,163,-30
5,35,5,107,47,0,47
5,35,5,111,83,98,-15
5,35,5,119,84,85,-1
5,35,5,123,300,198,102
5,35,5,143,37,32,5
5,35,5,145,0,40,-40
5,35,17,31,35,0,35
5,35,28,33,110,152,-42
5,35,47,37,0,28,-28
5,35,47,157,1169,927,242
5,37,5,31,124,201,-77
5,37,5,35,132,128,4
5,37,5,45,32,31,1
5,37,5,111,72,45,27
5,37,5,119,57,52,5
5,37,5,123,302,182,120
5,37,5,145,0,41,-41
5,37,47,157,55,42,13
5,39,5,13,38,0,38
5,39,5,19,56,34,22
5,39,5,25,54,37,17
5,39,5,51,0,35,-35
5,39,5,103,74,56,18
5,39,5,119,32,53,-21
5,41,5,1,39,0,39
5,41,5,17,107,87,20
5,41,5,43,110,117,-7
5,41,5,45,0,48,-48
5,41,5,69,73,135,-62
5,41,5,79,78,62,16
5,41,5,119,85,129,-44
5,43,5,1,0,30,-30
5,43,5,3,90,102,-12
5,43,5,11,99,114,-15
5,43,5,17,83,42,41
5,43,5,25,35,0,35
5,43,5,41,117,110,7
5,43,5,45,36,0,36
5,43,5,69,63,64,-1
5,43,5,79,51,48,3
5,43,5,119,81,93,-12
5,45,4,13,0,36,-36
5,45,5,1,48,0,48
5,45,5,3,36,0,36
5,45,5,5,29,31,-2
5,45,5,7,80,115,-35
5,45,5,9,35,0,35
5,45,5,17,35,0,35
5,45,5,19,0,31,-31
5,45,5,23,172,186,-14
5,45,5,29,431,350,81
5,45,5,31,99,55,44
5,45,5,33,51,40,11
5,45,5,35,61,0,61
5,45,5,37,31,32,-1
5,45,5,41,48,0,48
5,45,5,43,0,36,-36
5,45,5,51,94,100,-6
5,45,5,53,42,35,7
5,45,5,57,28,0,28
5,45,5,59,33,37,-4
5,45,5,63,73,38,35
5,45,5,69,139,65,74
5,45,5,71,52,35,17
5,45,5,83,37,0,37
5,45,5,85,276,286,-10
5,45,5,91,43,37,6
5,45,5,93,44,0,44
5,45,5,103,54,27,27
5,45,5,105,197,166,31
5,45,5,107,63,37,26
5,45,5,115,271,179,92
5,45,5,117,37,0,37
5,45,5,119,2292,2134,158
5,45,5,123,31,0,31
5,45,5,125,318,225,93
5,45,5,131,183,80,103
5,45,5,133,29,0,29
5,45,5,139,58,0,58
5,45,5,141,293,226,67
5,45,5,143,166,151,15
5,45,5,145,351,252,99
5,45,5,149,43,36,7
5,45,6,37,46,0,46
5,45,17,31,29,0,29
5,45,29,77,0,37,-37
5,45,32,3,29,0,29
5,45,40,109,38,0,38
5,45,40,143,41,74,-33
5,45,47,157,60,56,4
5,45,48,27,0,33,-33
5,45,48,29,0,38,-38
5,45,48,37,0,31,-31
5,45,48,113,51,97,-46
5,45,48,121,0,37,-37
5,45,48,201,71,52,19
5,45,48,439,47,66,-19
5,47,5,7,0,33,-33
5,47,5,33,157,196,-39
5,47,5,71,125,175,-50
5,47,5,83,149,111,38
5,47,5,115,37,0,37
5,47,5,131,218,272,-54
5,47,5,143,49,32,17
5,49,5,5,89,83,6
5,49,5,31,36,0,36
5,49,5,65,52,48,4
5,49,5,135,140,143,-3
5,49,29,91,42,48,-6
5,49,29,149,86,40,46
5,51,4,13,76,51,25
5,51,5,7,32,68,-36
5,51,5,9,37,0,37
5,51,5,19,205,155,50
5,51,5,31,41,0,41
5,51,5,39,35,0,35
5,51,5,45,100,94,6
5,51,5,53,48,41,7
5,51,5,57,35,0,35
5,51,5,59,586,619,-33
5,51,5,61,28,0,28
5,51,5,69,112,33,79
5,51,5,85,42,49,-7
5,51,5,91,28,0,28
5,51,5,93,32,0,32
5,51,5,97,183,166,17
5,51,5,103,57,26,31
5,51,5,105,29,0,29
5,51,5,109,88,65,23
5,51,5,113,74,44,30
5,51,5,115,69,69,0
5,51,5,119,481,420,61
5,51,5,125,323,434,-111
5,51,5,131,39,56,-17
5,51,5,139,81,26,55
5,51,5,143,86,102,-16
5,51,5,145,73,50,23
5,51,6,37,74,0,74
5,51,6,73,48,0,48
5,51,17,31,48,40,8
5,51,22,15,30,0,30
5,51,29,77,25,0,25
5,51,32,3,41,0,41
5,51,40,143,24,37,-13
5,51,47,157,60,50,10
5,51,48,37,43,89,-46
5,51,48,85,27,47,-20
5,51,48,113,71,68,3
5,51,48,121,41,42,-1
5,51,48,201,122,55,67
5,51,48,439,68,93,-25
5,53,5,25,34,0,34
5,53,5,45,35,42,-7
5,53,5,51,41,48,-7
5,53,5,59,98,104,-6
5,53,5,69,422,318,104
5,53,5,85,48,0,48
5,53,5,119,242,203,39
5,53,5,125,331,297,34
5,55,5,21,283,239,44
5,55,5,31,551,591,-40
5,55,5,75,74,119,-45
5,55,5,93,111,88,23
5,55,5,111,46,62,-16
5,55,5,119,44,66,-22
5,55,5,121,67,89,-22
5,55,29,23,0,29,-29
5,55,29,69,174,98,76
5,55,47,157,32,0,32
5,57,5,7,0,28,-28
5,57,5,19,33,41,-8
5,57,5,27,0,31,-31
5,57,5,45,0,28,-28
5,57,5,51,0,35,-35
5,57,5,61,128,118,10
5,57,5,73,49,69,-20
5,57,5,91,68,132,-64
5,57,5,99,233,195,38
5,57,5,109,30,56,-26
5,57,5,119,53,62,-9
5,57,5,125,0,41,-41
5,57,5,143,0,43,-43
5,57,48,37,74,113,-39
5,59,5,19,168,153,15
5,59,5,45,37,33,4
5,59,5,51,619,586,33
5,59,5,53,104,98,6
5,59,5,69,28,0,28
5,59,5,119,138,156,-18
5,59,5,125,331,377,-46
5,61,5,51,0,28,-28
5,61,5,57,118,128,-10
5,61,5,81,51,44,7
5,61,5,91,47,75,-28
5,61,5,109,123,99,24
5,61,5,119,0,46,-46
5,61,5,133,67,71,-4
5,61,48,37,32,0,32
5,63,5,5,0,38,-38
5,63,5,7,0,40,-40
5,63,5,23,98,77,21
5,63,5,31,107,121,-14
5,63,5,45,38,73,-35
5,63,5,65,82,82,0
5,63,5,67,183,129,54
5,63,5,75,32,0,32
5,63,5,85,0,46,-46
5,63,5,119,62,134,-72
5,63,5,125,0,34,-34
5,63,5,135,298,231,67
5,63,5,137,66,93,-27
5,63,5,143,0,38,-38
5,63,5,145,185,232,-47
5,63,47,157,28,0,28
5,65,5,5,96,80,16
5,65,5,31,0,28,-28
5,65,5,49,48,52,-4
5,65,5,63,82,82,0
5,65,5,135,94,79,15
5,65,5,137,0,40,-40
5,67,5,31,97,158,-61
5,67,5,63,129,183,-54
5,67,5,111,32,32,0
5,67,5,119,61,57,4
5,67,5,143,27,29,-2
5,67,5,145,83,157,-74
5,67,5,147,58,34,24
5,69,5,1,130,108,22
5,69,5,7,39,51,-12
5,69,5,17,41,0,41
5,69,5,19,0,30,-30
5,69,5,23,0,34,-34
5,69,5,25,322,318,4
5,69,5,31,0,40,-40
5,69,5,41,135,73,62
5,69,5,43,64,63,1
5,69,5,45,65,139,-74
5,69,5,51,33,112,-79
5,69,5,53,318,422,-104
5,69,5,59,0,28,-28
5,69,5,79,261,173,88
5,69,5,85,101,96,5
5,69,5,115,0,35,-35
5,69,5,119,693,1012,-319
5,69,5,123,33,0,33
5,69,5,125,94,189,-95
5,69,5,139,35,0,35
5,69,5,143,44,67,-23
5,69,5,145,0,71,-71
5,69,6,37,0,25,-25
5,69,17,31,50,0,50
5,69,26,163,28,0,28
5,69,47,157,51,77,-26
5,69,48,85,0,31,-31
5,69,48,113,61,112,-51
5,69,48,201,45,59,-14
5,69,48,439,40,77,-37
5,71,5,7,35,32,3
5,71,5,33,0,51,-51
5,71,5,45,35,52,-17
5,71,5,47,175,125,50
5,71,5,83,109,106,3
5,71,5,115,236,227,9
5,71,5,119,34,29,5
5,71,5,131,72,59,13
5,71,5,143,30,65,-35
5,71,40,143,0,30,-30
5,73,5,27,54,89,-35
5,73,5,57,69,49,20
5,73,22,119,64,0,64
5,73,48,37,0,39,-39
5,75,5,31,200,297,-97
5,75,5,55,119,74,45
5,75,5,63,0,32,-32
5,75,5,121,207,218,-11
5,75,5,135,42,59,-17
5,77,5,31,39,45,-6
5,77,5,35,27,0,27
5,77,5,107,48,52,-4
5,77,5,119,28,63,-35
5,77,5,123,99,118,-19
5,77,5,143,0,30,-30
5,77,47,157,38,43,-5
5,79,5,25,55,55,0
5,79,5,41,62,78,-16
5,79,5,43,48,51,-3
5,79,5,69,173,261,-88
5,79,5,119,0,51,-51
5,81,5,61,44,51,-7
5,81,5,91,136,212,-76
5,81,5,133,67,67,0
5,81,48,37,131,137,-6
5,83,5,7,0,31,-31
5,83,5,33,57,69,-12
5,83,5,45,0,37,-37
5,83,5,47,111,149,-38
5,83,5,71,106,109,-3
5,83,5,115,109,130,-21
5,83,5,127,59,43,16
5,83,5,131,198,318,-120
5,83,5,143,58,30,28
5,83,5,149,116,80,36
5,85,2,20,85,0,85
5,85,4,13,0,30,-30
5,85,5,1,82,92,-10
5,85,5,5,0,34,-34
5,85,5,7,47,68,-21
5,85,5,23,46,50,-4
5,85,5,31,46,30,16
5,85,5,45,286,276,10
5,85,5,51,49,42,7
5,85,5,53,0,48,-48
5,85,5,63,46,0,46
5,85,5,69,96,101,-5
5,85,5,95,33,0,33
5,85,5,107,39,0,39
5,85,5,115,49,55,-6
5,85,5,117,143,69,74
5,85,5,119,3024,2002,1022
5,85,5,125,208,177,31
5,85,5,131,53,0,53
5,85,5,143,81,105,-24
5,85,5,145,619,662,-43
5,85,37,51,79,0,79
5,85,48,29,35,39,-4
5,85,48,439,0,36,-36
5,87,5,7,164,166,-2
5,87,5,15,77,61,16
5,87,5,143,601,441,160
5,89,5,5,312,340,-28
5,89,5,9,171,146,25
5,89,5,143,34,0,34
5,91,5,27,68,0,68
5,91,5,45,37,43,-6
5,91,5,51,0,28,-28
5,91,5,57,132,68,64
5,91,5,61,75,47,28
5,91,5,81,212,136,76
5,91,5,99,32,0,32
5,91,5,119,53,78,-25
5,91,5,125,43,0,43
5,91,5,133,52,27,25
5,91,22,17,42,0,42
5,91,48,37,1923,1973,-50
5,91,48,67,132,148,-16
5,91,48,85,0,41,-41
5,91,48,113,62,95,-33
5,91,48,201,27,0,27
5,91,48,439,31,59,-28
5,93,5,31,284,544,-260
5,93,5,35,163,133,30
5,93,5,45,0,44,-44
5,93,5,51,0,32,-32
5,93,5,55,88,111,-23
5,93,5,111,76,148,-72
5,93,5,119,54,48,6
5,93,5,135,0,30,-30
5,93,5,145,33,37,-4
5,93,17,31,47,0,47
5,93,28,33,0,34,-34
5,93,29,69,84,129,-45
5,93,29,155,207,147,60
5,93,47,157,122,83,39
5,95,5,1,45,92,-47
5,95,5,31,0,39,-39
5,95,5,85,0,33,-33
5,95,5,107,36,0,36
5,95,5,117,0,37,-37
5,95,5,119,38,99,-61
5,95,5,123,40,44,-4
5,95,5,145,0,62,-62
5,97,5,51,166,183,-17
5,97,5,109,0,45,-45
5,97,5,113,0,32,-32
5,99,5,19,44,72,-28
5,99,5,57,195,233,-38
5,99,5,91,0,32,-32
5,99,5,103,30,42,-12
5,99,48,37,0,34,-34
5,101,5,9,206,258,-52
5,103,5,11,34,0,34
5,103,5,13,77,58,19
5,103,5,19,0,40,-40
5,103,5,27,81,108,-27
5,103,5,39,56,74,-18
5,103,5,45,27,54,-27
5,103,5,51,26,57,-31
5,103,5,99,42,30,12
5,103,5,119,85,135,-50
5,103,5,125,0,44,-44
5,103,5,139,215,208,7
5,105,5,29,116,134,-18
5,105,5,45,166,197,-31
5,105,5,51,0,29,-29
5,105,5,115,42,55,-13
5,105,5,119,135,132,3
5,105,5,125,39,64,-25
5,105,5,149,40,88,-48
5,107,5,31,0,119,-119
5,107,5,35,0,47,-47
5,107,5,45,37,63,-26
5,107,5,77,52,48,4
5,107,5,85,0,39,-39
5,107,5,95,0,36,-36
5,107,5,119,126,228,-102
5,107,17,31,36,0,36
5,107,28,27,62,0,62
5,107,28,33,0,53,-53
5,107,28,143,34,62,-28
5,107,47,157,67,94,-27
5,109,5,19,63,109,-46
5,109,5,51,65,88,-23
5,109,5,57,56,30,26
5,109,5,61,99,123,-24
5,109,5,97,45,0,45
5,111,5,31,665,859,-194
5,111,5,35,98,83,15
5,111,5,37,45,72,-27
5,111,5,55,62,46,16
5,111,5,67,32,32,0
5,111,5,93,148,76,72
5,111,5,119,0,39,-39
5,111,47,157,53,41,12
5,113,5,7,27,0,27
5,113,5,51,44,74,-30
5,113,5,97,32,0,32
5,113,5,115,0,34,-34
5,113,5,119,0,35,-35
5,113,5,127,46,0,46
5,113,5,131,0,97,-97
5,113,5,133,80,60,20
5,113,5,143,40,32,8
5,113,40,89,50,0,50
5,113,48,113,31,0,31
5,115,4,13,0,31,-31
5,115,5,7,98,135,-37
5,115,5,15,37,0,37
5,115,5,29,212,150,62
5,115,5,33,55,61,-6
5,115,5,45,179,271,-92
5,115,5,47,0,37,-37
5,115,5,51,69,69,0
5,115,5,69,35,0,35
5,115,5,71,227,236,-9
5,115,5,83,130,109,21
5,115,5,85,55,49,6
5,115,5,105,55,42,13
5,115,5,113,34,0,34
5,115,5,119,154,212,-58
5,115,5,125,53,65,-12
5,115,5,129,35,0,35
5,115,5,131,97,107,-10
5,115,5,141,36,0,36
5,115,5,143,101,141,-40
5,115,5,145,42,48,-6
5,115,5,149,781,602,179
5,115,6,37,82,0,82
5,115,29,77,28,0,28
5,115,40,143,49,0,49
5,115,48,113,31,33,-2
5,117,5,1,83,55,28
5,117,5,45,0,37,-37
5,117,5,85,69,143,-74
5,117,5,95,37,0,37
5,117,5,119,56,74,-18
5,117,5,145,49,68,-19
5,119,1,73,85,39,46
5,119,1,89,40,33,7
5,119,1,125,28,0,28
5,119,2,20,93,65,28
5,119,4,13,110,128,-18
5,119,4,19,58,37,21
5,119,5,1,193,71,122
5,119,5,3,108,58,50
5,119,5,5,55,30,25
5,119,5,7,171,323,-152
5,119,5,9,30,30,0
5,119,5,11,69,45,24
5,119,5,15,35,0,35
5,119,5,17,117,56,61
5,119,5,19,166,99,67
5,119,5,23,84,120,-36
5,119,5,25,67,29,38
5,119,5,27,114,42,72
5,119,5,29,139,73,66
5,119,5,31,235,247,-12
5,119,5,33,28,63,-35
5,119,5,35,85,84,1
5,119,5,37,52,57,-5
5,119,5,39,53,32,21
5,119,5,41,129,85,44
5,119,5,43,93,81,12
5,119,5,45,2134,2292,-158
5,119,5,51,420,481,-61
5,119,5,53,203,242,-39
5,119,5,55,66,44,22
5,119,5,57,62,53,9
5,119,5,59,156,138,18
5,119,5,61,46,0,46
5,119,5,63,134,62,72
5,119,5,67,57,61,-4
5,119,5,69,1012,693,319
5,119,5,71,29,34,-5
5,119,5,77,63,28,35
5,119,5,79,51,0,51
5,119,5,85,2002,3024,-1022
5,119,5,91,78,53,25
5,119,5,93,48,54,-6
5,119,5,95,99,38,61
5,119,5,103,135,85,50
5,119,5,105,132,135,-3
5,119,5,107,228,126,102
5,119,5,111,39,0,39
5,119,5,113,35,0,35
5,119,5,115,212,154,58
5,119,5,117,74,56,18
5,119,5,123,91,56,35
5,119,5,125,2556,3993,-1437
5,119,5,131,244,121,123
5,119,5,133,0,30,-30
5,119,5,137,0,28,-28
5,119,5,139,202,118,84
5,119,5,141,71,102,-31
5,119,5,143,622,549,73
5,119,5,145,574,589,-15
5,119,5,147,50,27,23
5,119,6,1,29,38,-9
5,119,6,37,235,155,80
5,119,6,59,63,48,15
5,119,6,65,78,34,44
5,119,6,67,31,47,-16
5,119,6,71,49,0,49
5,119,6,73,95,97,-2
5,119,6,85,31,0,31
5,119,8,5,0,39,-39
5,119,8,31,38,52,-14
5,119,8,41,61,59,2
5,119,8,69,0,42,-42
5,119,11,1,23,57,-34
5,119,12,9,28,0,28
5,119,12,11,47,23,24
5,119,12,31,75,67,8
5,119,12,33,0,30,-30
5,119,12,57,54,73,-19
5,119,12,73,30,0,30
5,119,12,86,42,28,14
5,119,12,91,78,52,26
5,119,12,95,0,44,-44
5,119,12,99,26,21,5
5,119,12,103,39,54,-15
5,119,12,117,0,29,-29
5,119,13,51,29,0,29
5,119,13,67,58,64,-6
5,119,13,89,57,52,5
5,119,13,121,47,62,-15
5,119,13,135,42,58,-16
5,119,15,3,91,94,-3
5,119,17,31,192,159,33
5,119,17,43,53,33,20
5,119,17,163,39,79,-40
5,119,18,97,34,54,-20
5,119,20,91,37,70,-33
5,119,20,173,76,53,23
5,119,21,111,34,50,-16
5,119,22,15,33,34,-1
5,119,22,17,52,51,1
5,119,22,33,30,66,-36
5,119,22,51,92,70,22
5,119,22,55,35,0,35
5,119,22,71,48,135,-87
5,119,22,73,74,0,74
5,119,22,79,36,0,36
5,119,22,103,44,34,10
5,119,24,3,0,38,-38
5,119,24,33,30,0,30
5,119,25,25,29,0,29
5,119,26,125,53,0,53
5,119,26,163,65,0,65
5,119,27,53,50,35,15
5,119,28,33,76,67,9
5,119,28,49,47,39,8
5,119,28,87,30,0,30
5,119,28,121,31,0,31
5,119,28,151,28,0,28
5,119,29,19,0,27,-27
5,119,29,77,69,48,21
5,119,29,95,76,79,-3
5,119,29,183,37,0,37
5,119,29,189,117,86,31
5,119,29,213,0,29,-29
5,119,29,510,51,22,29
5,119,30,13,27,0,27
5,119,31,55,43,41,2
5,119,32,3,108,133,-25
5,119,35,1,34,62,-28
5,119,36,47,62,31,31
5,119,36,61,0,44,-44
5,119,37,51,146,36,110
5,119,37,85,39,0,39
5,119,37,119,0,79,-79
5,119,37,183,0,49,-49
5,119,39,35,41,0,41
5,119,39,49,32,47,-15
5,119,39,61,42,34,8
5,119,40,31,0,26,-26
5,119,40,109,97,108,-11
5,119,40,143,443,169,274
5,119,41,51,0,24,-24
5,119,45,79,29,0,29
5,119,47,37,83,101,-18
5,119,47,65,0,52,-52
5,119,47,93,42,0,42
5,119,47,157,406,414,-8
5,119,48,27,76,54,22
5,119,48,29,124,197,-73
5,119,48,37,123,66,57
5,119,48,41,0,27,-27
5,119,48,85,123,209,-86
5,119,48,113,385,524,-139
5,119,48,121,92,172,-80
5,119,48,141,47,47,0
5,119,48,157,0,42,-42
5,119,48,201,225,361,-136
5,119,48,309,0,33,-33
5,119,48,355,112,0,112
5,119,48,423,0,51,-51
5,119,48,439,275,294,-19
5,119,48,441,0,79,-79
5,119,48,453,56,127,-71
5,119,48,465,36,0,36
5,119,48,485,53,0,53
5,119,48,491,0,33,-33
5,119,51,59,56,74,-18
5,119,51,710,23,0,23
5,119,53,33,43,59,-16
5,119,53,53,53,60,-7
5,119,53,63,37,0,37
5,119,55,79,80,0,80
5,121,5,21,58,51,7
5,121,5,31,76,130,-54
5,121,5,55,89,67,22
5,121,5,75,218,207,11
5,121,5,135,33,0,33
5,123,5,31,78,195,-117
5,123,5,35,198,300,-102
5,123,5,37,182,302,-120
5,123,5,45,0,31,-31
5,123,5,69,0,33,-33
5,123,5,77,118,99,19
5,123,5,95,44,40,4
5,123,5,119,56,91,-35
5,123,5,143,30,54,-24
5,123,5,145,0,40,-40
5,123,47,157,95,115,-20
5,125,4,13,40,0,40
5,125,5,1,37,0,37
5,125,5,7,46,70,-24
5,125,5,19,108,68,40
5,125,5,23,30,28,2
5,125,5,31,82,63,19
5,125,5,45,225,318,-93
5,125,5,51,434,323,111
5,125,5,53,297,331,-34
5,125,5,57,41,0,41
5,125,5,59,377,331,46
5,125,5,63,34,0,34
5,125,5,69,189,94,95
5,125,5,85,177,208,-31
5,125,5,91,0,43,-43
5,125,5,103,44,0,44
5,125,5,105,64,39,25
5,125,5,115,65,53,12
5,125,5,119,3993,2556,1437
5,125,5,131,43,0,43
5,125,5,139,38,0,38
5,125,5,143,128,78,50
5,125,5,145,94,106,-12
5,125,6,37,55,0,55
5,125,17,31,26,0,26
5,125,29,77,0,29,-29
5,125,40,143,53,0,53
5,125,47,157,42,40,2
5,125,48,37,30,0,30
5,125,48,85,0,38,-38
5,125,48,113,55,28,27
5,125,48,201,87,59,28
5,125,48,439,39,53,-14
5,127,5,33,0,43,-43
5,127,5,83,43,59,-16
5,127,5,113,0,46,-46
5,127,5,131,217,290,-73
5,127,40,79,51,45,6
5,129,5,5,39,0,39
5,129,5,9,56,108,-52
5,129,5,115,0,35,-35
5,129,5,141,40,45,-5
5,131,4,13,29,31,-2
5,131,5,7,206,315,-109
5,131,5,33,2078,2139,-61
5,131,5,45,80,183,-103
5,131,5,47,272,218,54
5,131,5,51,56,39,17
5,131,5,71,59,72,-13
5,131,5,83,318,198,120
5,131,5,85,0,53,-53
5,131,5,113,97,0,97
5,131,5,115,107,97,10
5,131,5,119,121,244,-123
5,131,5,125,0,43,-43
5,131,5,127,290,217,73
5,131,5,143,299,550,-251
5,131,5,145,0,41,-41
5,131,5,149,0,34,-34
5,131,6,37,111,83,28
5,131,6,71,0,28,-28
5,131,6,73,43,33,10
5,131,20,173,0,29,-29
5,131,22,71,0,50,-50
5,131,29,77,40,40,0
5,131,29,95,31,0,31
5,131,29,97,36,0,36
5,131,32,3,0,28,-28
5,131,40,21,0,36,-36
5,131,40,27,0,27,-27
5,131,40,31,0,49,-49
5,131,40,61,43,30,13
5,131,40,79,716,734,-18
5,131,40,101,34,43,-9
5,131,40,109,63,113,-50
5,131,40,121,29,0,29
5,131,40,135,627,560,67
5,131,40,143,137,212,-75
5,131,48,27,0,44,-44
5,131,48,85,0,62,-62
5,131,48,113,80,85,-5
5,131,48,121,25,44,-19
5,131,48,201,0,88,-88
5,131,48,439,74,77,-3
5,131,48,453,0,45,-45
5,133,5,45,0,29,-29
5,133,5,61,71,67,4
5,133,5,81,67,67,0
5,133,5,91,27,52,-25
5,133,5,113,60,80,-20
5,133,5,119,30,0,30
5,133,5,143,0,30,-30
5,133,40,89,82,55,27
5,133,48,37,0,46,-46
5,135,5,5,0,32,-32
5,135,5,31,80,69,11
5,135,5,49,143,140,3
5,135,5,63,231,298,-67
5,135,5,65,79,94,-15
5,135,5,75,59,42,17
5,135,5,93,30,0,30
5,135,5,121,0,33,-33
5,137,5,23,46,38,8
5,137,5,63,93,66,27
5,137,5,65,40,0,40
5,137,5,119,28,0,28
5,139,5,3,57,68,-11
5,139,5,11,59,0,59
5,139,5,13,40,32,8
5,139,5,27,134,83,51
5,139,5,45,0,58,-58
5,139,5,51,26,81,-55
5,139,5,69,0,35,-35
5,139,5,103,208,215,-7
5,139,5,119,118,202,-84
5,139,5,125,0,38,-38
5,139,5,143,31,44,-13
5,139,22,27,44,0,44
5,139,22,73,48,53,-5
5,139,22,111,103,125,-22
5,139,22,119,0,32,-32
5,139,48,37,0,35,-35
5,139,48,113,36,31,5
5,139,48,201,0,36,-36
5,139,48,439,0,50,-50
5,141,5,23,61,75,-14
5,141,5,29,47,63,-16
5,141,5,45,226,293,-67
5,141,5,115,0,36,-36
5,141,5,119,102,71,31
5,141,5,129,45,40,5
5,141,5,145,0,51,-51
5,143,4,13,119,69,50
5,143,4,19,36,0,36
5,143,5,5,85,69,16
5,143,5,7,3654,5506,-1852
5,143,5,9,157,118,39
5,143,5,15,204,120,84
5,143,5,23,43,0,43
5,143,5,29,35,0,35
5,143,5,31,82,62,20
5,143,5,33,237,247,-10
5,143,5,35,32,37,-5
5,143,5,45,151,166,-15
5,143,5,47,32,49,-17
5,143,5,51,102,86,16
5,143,5,57,43,0,43
5,143,5,63,38,0,38
5,143,5,67,29,27,2
5,143,5,69,67,44,23
5,143,5,71,65,30,35
5,143,5,77,30,0,30
5,143,5,83,30,58,-28
5,143,5,85,105,81,24
5,143,5,87,441,601,-160
5,143,5,89,0,34,-34
5,143,5,113,32,40,-8
5,143,5,115,141,101,40
5,143,5,119,549,622,-73
5,143,5,123,54,30,24
5,143,5,125,78,128,-50
5,143,5,131,550,299,251
5,143,5,133,30,0,30
5,143,5,139,44,31,13
5,143,5,145,98,38,60
5,143,5,149,28,0,28
5,143,6,37,260,95,165
5,143,6,59,101,0,101
5,143,6,71,46,0,46
5,143,6,73,58,65,-7
5,143,6,111,49,0,49
5,143,8,41,0,38,-38
5,143,12,11,32,0,32
5,143,12,57,39,26,13
5,143,12,95,0,32,-32
5,143,13,135,0,29,-29
5,143,15,3,31,50,-19
5,143,17,31,81,81,0
5,143,20,91,45,65,-20
5,143,20,173,48,71,-23
5,143,22,33,0,25,-25
5,143,22,51,0,29,-29
5,143,27,53,41,51,-10
5,143,29,9,42,59,-17
5,143,29,19,28,24,4
5,143,29,43,35,0,35
5,143,29,47,0,23,-23
5,143,29,77,93,104,-11
5,143,29,95,37,63,-26
5,143,29,97,67,100,-33
5,143,29,119,68,77,-9
5,143,29,145,51,46,5
5,143,29,189,38,0,38
5,143,29,209,0,37,-37
5,143,29,213,27,32,-5
5,143,32,3,74,33,41
5,143,35,1,0,32,-32
5,143,36,61,0,38,-38
5,143,37,183,0,40,-40
5,143,39,61,55,45,10
5,143,40,1,98,169,-71
5,143,40,21,47,0,47
5,143,40,27,0,47,-47
5,143,40,41,58,81,-23
5,143,40,47,0,37,-37
5,143,40,79,49,0,49
5,143,40,97,0,37,-37
5,143,40,101,0,30,-30
5,143,40,109,64,105,-41
5,143,40,119,25,0,25
5,143,40,135,40,0,40
5,143,40,143,207,238,-31
5,143,40,145,0,44,-44
5,143,40,147,0,29,-29
5,143,47,37,30,51,-21
5,143,47,93,0,30,-30
5,143,47,157,83,49,34
5,143,48,29,56,52,4
5,143,48,37,46,45,1
5,143,48,85,53,93,-40
5,143,48,113,137,189,-52
5,143,48,121,51,42,9
5,143,48,201,78,163,-85
5,143,48,215,0,41,-41
5,143,48,439,69,100,-31
5,143,48,453,47,74,-27
5,143,53,33,0,39,-39
5,145,5,1,40,0,40
5,145,5,7,41,59,-18
5,145,5,23,247,258,-11
5,145,5,31,62,93,-31
5,145,5,35,40,0,40
5,145,5,37,41,0,41
5,145,5,45,252,351,-99
5,145,5,51,50,73,-23
5,145,5,63,232,185,47
5,145,5,67,157,83,74
5,145,5,69,71,0,71
5,145,5,85,662,619,43
5,145,5,93,37,33,4
5,145,5,95,62,0,62
5,145,5,115,48,42,6
5,145,5,117,68,49,19
5,145,5,119,589,574,15
5,145,5,123,40,0,40
5,145,5,125,106,94,12
5,145,5,131,41,0,41
5,145,5,141,51,0,51
5,145,5,143,38,98,-60
5,145,5,147,160,98,62
5,145,47,37,0,37,-37
5,145,47,157,41,41,0
5,145,48,113,0,31,-31
5,147,5,31,0,35,-35
5,147,5,67,34,58,-24
5,147,5,119,27,50,-23
5,147,5,145,98,160,-62
5,149,5,29,40,0,40
5,149,5,45,36,43,-7
5,149,5,83,80,116,-36
5,149,5,105,88,40,48
5,149,5,115,602,781,-179
5,149,5,131,34,0,34
5,149,5,143,0,28,-28
5,149,40,143,82,46,36
6,1,1,73,67,0,67
6,1,1,89,0,39,-39
6,1,2,20,39,65,-26
6,1,2,90,25,0,25
6,1,2,150,0,47,-47
6,1,4,3,0,31,-31
6,1,4,5,27,0,27
6,1,4,13,772,1088,-316
6,1,4,19,137,175,-38
6,1,4,21,22,74,-52
6,1,4,25,29,53,-24
6,1,4,27,0,42,-42
6,1,5,119,38,29,9
6,1,6,5,29,102,-73
6,1,6,7,301,369,-68
6,1,6,9,93,211,-118
6,1,6,13,13471,18755,-5284
6,1,6,17,202,341,-139
6,1,6,19,629,618,11
6,1,6,23,145,193,-48
6,1,6,25,37,49,-12
6,1,6,29,299,166,133
6,1,6,31,95,82,13
6,1,6,33,118,127,-9
6,1,6,37,4141,3563,578
6,1,6,39,125,151,-26
6,1,6,41,907,1027,-120
6,1,6,43,29,48,-19
6,1,6,45,113,91,22
6,1,6,47,350,377,-27
6,1,6,53,385,395,-10
6,1,6,55,284,278,6
6,1,6,57,98,177,-79
6,1,6,59,1365,1288,77
6,1,6,61,390,685,-295
6,1,6,63,0,30,-30
6,1,6,65,582,573,9
6,1,6,67,2921,3189,-268
6,1,6,69,56,52,4
6,1,6,71,585,443,142
6,1,6,73,1852,1705,147
6,1,6,75,10526,7215,3311
6,1,6,77,6058,6525,-467
6,1,6,79,295,260,35
6,1,6,81,6594,5109,1485
6,1,6,83,357,251,106
6,1,6,85,11839,10157,1682
6,1,6,87,605,444,161
6,1,6,89,126,197,-71
6,1,6,93,0,59,-59
6,1,6,95,2033,2247,-214
6,1,6,97,935,888,47
6,1,6,99,2087,2170,-83
6,1,6,101,77,101,-24
6,1,6,103,26,89,-63
6,1,6,107,140,181,-41
6,1,6,109,101,188,-87
6,1,6,111,351,271,80
6,1,6,113,555,553,2
6,1,6,115,60,89,-29
6,1,8,1,35,79,-44
6,1,8,5,86,114,-28
6,1,8,13,144,186,-42
6,1,8,31,160,121,39
6,1,8,35,54,76,-22
6,1,8,41,130,145,-15
6,1,8,59,52,48,4
6,1,8,69,51,73,-22
6,1,8,77,0,26,-26
6,1,9,1,96,92,4
6,1,9,3,77,60,17
6,1,9,9,124,72,52
6,1,9,11,30,0,30
6,1,10,3,59,28,31
6,1,11,1,278,231,47
6,1,12,1,57,0,57
6,1,12,9,43,38,5
6,1,12,11,126,102,24
6,1,12,31,86,34,52
6,1,12,33,0,29,-29
6,1,12,57,74,91,-17
6,1,12,71,30,0,30
6,1,12,73,34,0,34
6,1,12,86,160,104,56
6,1,12,95,83,67,16
6,1,12,99,97,95,2
6,1,12,101,23,0,23
6,1,12,103,60,67,-7
6,1,12,115,29,0,29
6,1,12,117,41,32,9
6,1,12,127,0,39,-39
6,1,13,51,27,0,27
6,1,13,59,20,0,20
6,1,13,67,89,92,-3
6,1,13,89,123,131,-8
6,1,13,121,191,225,-34
6,1,13,135,86,128,-42
6,1,13,151,0,32,-32
6,1,15,1,85,83,2
6,1,15,3,449,420,29
6,1,15,7,0,36,-36
6,1,15,9,55,63,-8
6,1,16,1,105,126,-21
6,1,16,27,0,32,-32
6,1,16,55,0,34,-34
6,1,16,57,30,0,30
6,1,17,19,91,51,40
6,1,17,31,803,565,238
6,1,17,43,160,82,78
6,1,17,89,31,0,31
6,1,17,97,50,54,-4
6,1,17,197,51,0,51
6,1,18,57,0,32,-32
6,1,18,97,91,53,38
6,1,18,105,65,23,42
6,1,18,141,21,0,21
6,1,18,157,25,25,0
6,1,19,103,40,0,40
6,1,19,153,33,0,33
6,1,19,163,0,51,-51
6,1,19,169,36,0,36
6,1,20,91,79,64,15
6,1,20,173,38,0,38
6,1,21,67,31,24,7
6,1,21,111,55,0,55
6,1,22,33,39,36,3
6,1,22,51,36,50,-14
6,1,22,71,57,86,-29
6,1,22,103,42,0,42
6,1,23,5,39,50,-11
6,1,24,3,53,29,24
6,1,24,5,65,38,27
6,1,24,27,27,53,-26
6,1,24,31,209,179,30
6,1,24,33,132,58,74
6,1,24,510,70,60,10
6,1,25,3,22,0,22
6,1,25,9,61,58,3
6,1,25,15,53,40,13
6,1,25,17,572,392,180
6,1,25,21,120,116,4
6,1,25,23,27,0,27
6,1,25,25,220,123,97
6,1,25,27,96,39,57
6,1,26,65,48,33,15
6,1,26,77,30,0,30
6,1,26,81,33,0,33
6,1,26,99,51,0,51
6,1,26,125,202,94,108
6,1,26,161,158,89,69
6,1,26,163,147,69,78
6,1,27,37,29,42,-13
6,1,27,53,271,127,144
6,1,27,123,70,50,20
6,1,29,95,51,56,-5
6,1,29,189,118,94,24
6,1,29,510,25,32,-7
6,1,30,63,34,29,5
6,1,31,55,54,60,-6
6,1,31,109,37,0,37
6,1,32,3,822,1057,-235
6,1,32,5,36,68,-32
6,1,32,19,0,72,-72
6,1,32,31,398,527,-129
6,1,32,510,43,39,4
6,1,33,11,65,0,65
6,1,33,15,27,0,27
6,1,34,3,73,79,-6
6,1,34,5,32,0,32
6,1,34,7,45,0,45
6,1,34,13,65,39,26
6,1,34,17,115,127,-12
6,1,34,21,68,55,13
6,1,34,23,181,119,62
6,1,34,25,36,0,36
6,1,34,27,87,0,87
6,1,34,31,25,0,25
6,1,34,35,44,49,-5
6,1,35,1,102,141,-39
6,1,35,28,26,0,26
6,1,35,43,32,0,32
6,1,35,49,59,38,21
6,1,36,1,26,26,0
6,1,36,5,51,42,9
6,1,36,29,46,36,10
6,1,36,47,388,355,33
6,1,36,55,80,40,40
6,1,36,59,61,32,29
6,1,36,61,542,522,20
6,1,36,67,53,28,25
6,1,36,81,203,182,21
6,1,36,83,27,0,27
6,1,36,85,0,35,-35
6,1,36,91,36,0,36
6,1,36,103,107,57,50
6,1,36,109,44,39,5
6,1,36,119,109,77,32
6,1,37,21,22,29,-7
6,1,37,51,21,33,-12
6,1,37,63,59,71,-12
6,1,37,67,30,0,30
6,1,37,81,41,33,8
6,1,37,119,104,107,-3
6,1,37,133,29,23,6
6,1,37,135,55,29,26
6,1,37,183,134,223,-89
6,1,39,35,83,74,9
6,1,39,49,162,84,78
6,1,39,61,84,56,28
6,1,39,113,53,0,53
6,1,39,153,38,0,38
6,1,40,109,48,37,11
6,1,40,143,27,45,-18
6,1,41,3,35,56,-21
6,1,41,5,55,133,-78
6,1,41,17,30,84,-54
6,1,41,19,0,48,-48
6,1,41,29,62,127,-65
6,1,41,33,0,58,-58
6,1,41,35,0,34,-34
6,1,41,39,121,162,-41
6,1,41,47,37,73,-36
6,1,41,51,298,460,-162
6,1,41,67,182,223,-41
6,1,42,3,159,59,100
6,1,42,17,72,0,72
6,1,42,27,20,0,20
6,1,42,29,45,66,-21
6,1,42,45,29,31,-2
6,1,42,91,105,45,60
6,1,42,101,158,117,41
6,1,44,7,63,0,63
6,1,45,19,24,0,24
6,1,45,45,27,0,27
6,1,45,79,53,0,53
6,1,47,37,61,65,-4
6,1,47,93,34,0,34
6,1,47,157,91,74,17
6,1,48,27,40,49,-9
6,1,48,29,156,205,-49
6,1,48,39,0,38,-38
6,1,48,41,29,0,29
6,1,48,85,199,263,-64
6,1,48,113,254,274,-20
6,1,48,121,71,149,-78
6,1,48,141,97,62,35
6,1,48,157,39,160,-121
6,1,48,167,33,0,33
6,1,48,201,341,495,-154
6,1,48,215,28,0,28
6,1,48,339,0,35,-35
6,1,48,439,164,174,-10
6,1,48,453,197,290,-93
6,1,48,491,34,146,-112
6,1,49,5,0,31,-31
6,1,49,11,37,47,-10
6,1,49,35,196,209,-13
6,1,49,49,148,169,-21
6,1,49,57,0,31,-31
6,1,50,7,35,0,35
6,1,51,13,75,72,3
6,1,51,59,211,175,36
6,1,51,87,55,0,55
6,1,51,107,49,53,-4
6,1,51,121,28,0,28
6,1,51,153,0,46,-46
6,1,51,510,61,33,28
6,1,51,540,0,25,-25
6,1,51,710,0,29,-29
6,1,51,760,0,25,-25
6,1,51,810,49,36,13
6,1,53,5,0,34,-34
6,1,53,11,50,193,-143
6,1,53,29,0,29,-29
6,1,53,33,839,966,-127
6,1,53,35,64,58,6
6,1,53,53,144,218,-74
6,1,53,61,119,170,-51
6,1,53,63,72,71,1
6,1,53,67,46,60,-14
6,1,53,73,38,41,-3
6,1,55,25,113,90,23
6,1,55,79,77,88,-11
6,1,55,133,28,0,28
6,3,6,17,0,29,-29
6,3,32,5,0,72,-72
6,5,6,1,102,29,73
6,5,6,9,238,200,38
6,5,6,13,120,38,82
6,5,6,17,125,119,6
6,5,6,23,26,0,26
6,5,6,37,42,0,42
6,5,6,61,67,73,-6
6,5,6,65,33,0,33
6,5,6,67,498,412,86
6,5,6,73,34,29,5
6,5,6,75,0,22,-22
6,5,6,77,207,183,24
6,5,6,81,45,0,45
6,5,6,85,100,46,54
6,5,6,87,26,0,26
6,5,6,95,37,39,-2
6,5,6,97,23,0,23
6,5,6,99,69,47,22
6,5,6,113,29,0,29
6,7,2,20,32,0,32
6,7,4,13,133,103,30
6,7,6,1,369,301,68
6,7,6,11,52,55,-3
6,7,6,13,345,261,84
6,7,6,15,38,39,-1
6,7,6,17,113,88,25
6,7,6,19,95,59,36
6,7,6,21,462,512,-50
6,7,6,23,165,119,46
6,7,6,29,82,92,-10
6,7,6,33,76,66,10
6,7,6,35,120,98,22
6,7,6,37,369,269,100
6,7,6,41,49,46,3
6,7,6,45,94,101,-7
6,7,6,47,42,30,12
6,7,6,53,95,80,15
6,7,6,55,88,73,15
6,7,6,57,150,119,31
6,7,6,59,191,130,61
6,7,6,61,288,429,-141
6,7,6,63,215,128,87
6,7,6,65,157,72,85
6,7,6,67,895,1123,-228
6,7,6,71,137,89,48
6,7,6,73,227,270,-43
6,7,6,75,81,138,-57
6,7,6,77,168,153,15
6,7,6,79,80,109,-29
6,7,6,81,140,72,68
6,7,6,83,71,52,19
6,7,6,85,395,320,75
6,7,6,87,104,94,10
6,7,6,89,432,398,34
6,7,6,93,72,73,-1
6,7,6,95,163,102,61
6,7,6,97,226,206,20
6,7,6,99,92,100,-8
6,7,6,101,511,552,-41
6,7,6,103,454,451,3
6,7,6,105,25,0,25
6,7,6,107,57,81,-24
6,7,6,109,30,0,30
6,7,6,111,89,65,24
6,7,6,113,159,163,-4
6,7,6,115,345,346,-1
6,7,8,41,31,0,31
6,7,15,3,0,39,-39
6,7,15,9,0,43,-43
6,7,16,1,0,30,-30
6,7,32,3,92,88,4
6,7,32,31,165,139,26
6,7,41,17,0,28,-28
6,7,41,29,41,26,15
6,7,41,33,0,31,-31
6,7,41,35,22,33,-11
6,7,41,39,26,58,-32
6,7,41,47,0,34,-34
6,7,41,51,43,73,-30
6,7,41,67,0,79,-79
6,7,48,439,0,31,-31
6,7,49,35,59,57,2
6,7,49,49,0,50,-50
6,7,53,33,37,81,-44
6,7,53,53,48,37,11
6,7,53,61,30,20,10
6,9,6,1,211,93,118
6,9,6,5,200,238,-38
6,9,6,13,198,107,91
6,9,6,17,0,52,-52
6,9,6,23,0,29,-29
6,9,6,37,45,29,16
6,9,6,53,26,0,26
6,9,6,59,30,0,30
6,9,6,61,53,43,10
6,9,6,67,189,174,15
6,9,6,73,60,36,24
6,9,6,75,0,22,-22
6,9,6,77,740,562,178
6,9,6,79,0,21,-21
6,9,6,81,59,0,59
6,9,6,85,166,68,98
6,9,6,87,47,39,8
6,9,6,89,0,33,-33
6,9,6,95,42,0,42
6,9,6,97,0,25,-25
6,9,6,99,224,210,14
6,9,6,109,212,204,8
6,9,6,113,26,0,26
6,9,32,31,25,30,-5
6,11,6,7,55,52,3
6,11,6,21,88,85,3
6,11,6,67,123,151,-28
6,11,6,77,0,33,-33
6,11,6,95,78,110,-32
6,11,6,101,124,145,-21
6,11,6,113,218,278,-60
6,13,2,20,40,43,-3
6,13,4,13,603,677,-74
6,13,4,19,148,123,25
6,13,4,21,45,87,-42
6,13,4,25,56,54,2
6,13,6,1,18755,13471,5284
6,13,6,5,38,120,-82
6,13,6,7,261,345,-84
6,13,6,9,107,198,-91
6,13,6,17,224,344,-120
6,13,6,19,431,283,148
6,13,6,23,73,158,-85
6,13,6,29,255,173,82
6,13,6,31,56,50,6
6,13,6,33,68,132,-64
6,13,6,37,2136,1898,238
6,13,6,39,85,101,-16
6,13,6,41,1076,960,116
6,13,6,43,0,34,-34
6,13,6,45,117,131,-14
6,13,6,47,156,154,2
6,13,6,53,194,247,-53
6,13,6,55,368,451,-83
6,13,6,57,114,177,-63
6,13,6,59,816,785,31
6,13,6,61,426,719,-293
6,13,6,63,35,33,2
6,13,6,65,483,471,12
6,13,6,67,2165,2127,38
6,13,6,71,396,273,123
6,13,6,73,1048,1237,-189
6,13,6,75,5178,4029,1149
6,13,6,77,1875,1764,111
6,13,6,79,216,235,-19
6,13,6,81,3125,2449,676
6,13,6,83,170,197,-27
6,13,6,85,3131,2165,966
6,13,6,87,191,246,-55
6,13,6,89,157,254,-97
6,13,6,93,0,31,-31
6,13,6,95,4548,4124,424
6,13,6,97,649,748,-99
6,13,6,99,678,604,74
6,13,6,101,66,69,-3
6,13,6,103,46,65,-19
6,13,6,105,0,25,-25
6,13,6,107,134,83,51
6,13,6,109,51,96,-45
6,13,6,111,245,123,122
6,13,6,113,344,413,-69
6,13,6,115,60,93,-33
6,13,8,1,0,40,-40
6,13,8,5,37,78,-41
6,13,8,13,49,121,-72
6,13,8,31,83,115,-32
6,13,8,35,62,80,-18
6,13,8,41,78,92,-14
6,13,8,59,44,52,-8
6,13,8,69,33,41,-8
6,13,8,123,0,40,-40
6,13,9,1,80,86,-6
6,13,9,3,48,0,48
6,13,9,9,50,32,18
6,13,9,11,28,0,28
6,13,10,3,42,0,42
6,13,11,1,80,99,-19
6,13,12,11,128,72,56
6,13,12,31,51,49,2
6,13,12,57,65,54,11
6,13,12,86,113,78,35
6,13,12,95,69,54,15
6,13,12,99,66,45,21
6,13,12,101,0,29,-29
6,13,12,103,0,28,-28
6,13,12,105,0,32,-32
6,13,13,67,55,67,-12
6,13,13,89,76,42,34
6,13,13,121,81,126,-45
6,13,13,135,40,47,-7
6,13,15,1,39,53,-14
6,13,15,3,234,205,29
6,13,15,9,50,40,10
6,13,16,1,66,81,-15
6,13,16,27,0,75,-75
6,13,16,55,0,29,-29
6,13,17,31,347,245,102
6,13,17,43,82,79,3
6,13,17,97,83,65,18
6,13,17,161,29,0,29
6,13,17,197,44,0,44
6,13,18,97,42,0,42
6,13,19,153,22,0,22
6,13,19,163,0,69,-69
6,13,20,91,33,43,-10
6,13,21,111,46,27,19
6,13,22,33,30,25,5
6,13,22,71,39,39,0
6,13,24,3,50,22,28
6,13,24,5,34,0,34
6,13,24,31,92,99,-7
6,13,24,33,41,28,13
6,13,25,9,0,33,-33
6,13,25,17,166,133,33
6,13,25,21,61,69,-8
6,13,25,25,46,57,-11
6,13,25,27,48,0,48
6,13,26,65,31,0,31
6,13,26,81,39,0,39
6,13,26,99,38,0,38
6,13,26,125,89,0,89
6,13,26,161,67,29,38
6,13,26,163,63,35,28
6,13,27,37,31,0,31
6,13,27,53,85,83,2
6,13,27,123,55,0,55
6,13,29,95,35,28,7
6,13,29,189,90,51,39
6,13,31,55,29,56,-27
6,13,32,3,531,598,-67
6,13,32,5,25,70,-45
6,13,32,19,0,77,-77
6,13,32,31,262,448,-186
6,13,32,510,26,33,-7
6,13,34,3,72,48,24
6,13,34,17,0,35,-35
6,13,34,23,61,60,1
6,13,34,25,43,0,43
6,13,34,27,30,53,-23
6,13,35,1,59,73,-14
6,13,35,49,0,44,-44
6,13,36,29,26,0,26
6,13,36,47,93,97,-4
6,13,36,59,0,25,-25
6,13,36,61,183,237,-54
6,13,36,81,61,56,5
6,13,36,103,58,0,58
6,13,36,119,54,60,-6
6,13,37,63,0,36,-36
6,13,37,119,70,111,-41
6,13,37,135,0,32,-32
6,13,37,183,50,123,-73
6,13,39,35,39,40,-1
6,13,39,49,44,58,-14
6,13,39,61,31,39,-8
6,13,40,109,38,0,38
6,13,40,143,35,50,-15
6,13,41,3,0,27,-27
6,13,41,5,65,119,-54
6,13,41,17,39,117,-78
6,13,41,19,0,30,-30
6,13,41,29,66,124,-58
6,13,41,33,0,53,-53
6,13,41,35,0,47,-47
6,13,41,39,44,92,-48
6,13,41,43,0,31,-31
6,13,41,47,44,52,-8
6,13,41,51,125,193,-68
6,13,41,67,127,166,-39
6,13,42,3,51,50,1
6,13,42,29,49,0,49
6,13,42,91,60,0,60
6,13,42,101,89,36,53
6,13,45,15,0,24,-24
6,13,47,37,32,25,7
6,13,47,93,26,0,26
6,13,47,157,38,53,-15
6,13,47,187,0,48,-48
6,13,48,27,27,59,-32
6,13,48,29,64,137,-73
6,13,48,39,41,0,41
6,13,48,85,37,139,-102
6,13,48,113,134,158,-24
6,13,48,121,70,74,-4
6,13,48,141,60,31,29
6,13,48,157,189,127,62
6,13,48,201,704,428,276
6,13,48,339,77,141,-64
6,13,48,439,115,177,-62
6,13,48,453,59,179,-120
6,13,48,491,0,72,-72
6,13,49,11,37,49,-12
6,13,49,35,187,169,18
6,13,49,49,127,135,-8
6,13,51,13,32,38,-6
6,13,51,59,130,75,55
6,13,51,107,34,0,34
6,13,51,510,27,0,27
6,13,51,810,34,0,34
6,13,53,11,41,118,-77
6,13,53,33,468,641,-173
6,13,53,35,36,93,-57
6,13,53,53,73,130,-57
6,13,53,61,89,128,-39
6,13,53,63,24,135,-111
6,13,53,67,0,42,-42
6,13,53,73,0,55,-55
6,13,53,77,30,0,30
6,13,55,25,29,0,29
6,13,55,79,71,0,71
6,15,6,7,39,38,1
6,15,6,23,96,134,-38
6,15,6,29,39,0,39
6,15,6,35,37,0,37
6,15,6,37,46,48,-2
6,15,6,65,30,0,30
6,15,6,67,91,75,16
6,15,6,71,46,0,46
6,15,6,73,41,27,14
6,15,6,89,0,44,-44
6,15,6,97,22,44,-22
6,15,41,15,150,132,18
6,15,41,29,66,79,-13
6,15,41,33,43,47,-4
6,15,41,39,0,36,-36
6,15,41,67,32,0,32
6,17,2,20,0,22,-22
6,17,4,13,129,148,-19
6,17,4,19,42,24,18
6,17,4,25,0,29,-29
6,17,6,1,341,202,139
6,17,6,3,29,0,29
6,17,6,5,119,125,-6
6,17,6,7,88,113,-25
6,17,6,9,52,0,52
6,17,6,13,344,224,120
6,17,6,19,92,53,39
6,17,6,23,83,72,11
6,17,6,29,54,24,30
6,17,6,33,0,32,-32
6,17,6,37,498,258,240
6,17,6,39,0,26,-26
6,17,6,41,77,46,31
6,17,6,45,48,37,11
6,17,6,51,27,32,-5
6,17,6,53,64,58,6
6,17,6,55,54,0,54
6,17,6,57,84,162,-78
6,17,6,59,219,156,63
6,17,6,61,739,867,-128
6,17,6,65,151,125,26
6,17,6,67,3808,3368,440
6,17,6,71,111,63,48
6,17,6,73,293,303,-10
6,17,6,75,99,111,-12
6,17,6,77,155,84,71
6,17,6,79,75,66,9
6,17,6,81,216,134,82
6,17,6,83,45,45,0
6,17,6,85,506,327,179
6,17,6,87,131,82,49
6,17,6,89,60,84,-24
6,17,6,95,148,113,35
6,17,6,97,168,128,40
6,17,6,99,103,68,35
6,17,6,101,26,33,-7
6,17,6,103,34,0,34
6,17,6,107,50,0,50
6,17,6,109,32,33,-1
6,17,6,111,102,63,39
6,17,6,113,136,144,-8
6,17,6,115,52,35,17
6,17,8,41,28,29,-1
6,17,8,59,26,0,26
6,17,15,1,32,29,3
6,17,15,3,77,31,46
6,17,16,1,0,32,-32
6,17,16,27,0,34,-34
6,17,26,125,36,0,36
6,17,27,53,25,0,25
6,17,32,3,101,154,-53
6,17,32,5,308,600,-292
6,17,32,19,60,56,4
6,17,32,31,174,305,-131
6,17,32,510,49,148,-99
6,17,41,17,0,26,-26
6,17,41,29,36,0,36
6,17,41,39,0,56,-56
6,17,41,51,44,56,-12
6,17,41,67,0,40,-40
6,17,48,27,0,36,-36
6,17,48,201,38,43,-5
6,17,48,453,0,52,-52
6,17,48,491,0,38,-38
6,17,49,35,35,44,-9
6,17,49,49,0,26,-26
6,17,53,33,34,102,-68
6,19,2,20,0,60,-60
6,19,4,13,485,568,-83
6,19,4,15,45,41,4
6,19,4,19,107,88,19
6,19,4,21,0,38,-38
6,19,4,25,30,38,-8
6,19,4,27,84,102,-18
6,19,6,1,618,629,-11
6,19,6,7,59,95,-36
6,19,6,13,283,431,-148
6,19,6,17,53,92,-39
6,19,6,23,38,97,-59
6,19,6,25,134,140,-6
6,19,6,29,895,826,69
6,19,6,31,1442,1813,-371
6,19,6,33,0,32,-32
6,19,6,37,2609,1625,984
6,19,6,39,2676,2818,-142
6,19,6,41,32,52,-20
6,19,6,43,59,51,8
6,19,6,45,33,0,33
6,19,6,47,909,818,91
6,19,6,53,625,726,-101
6,19,6,55,45,50,-5
6,19,6,59,734,714,20
6,19,6,61,141,175,-34
6,19,6,65,556,526,30
6,19,6,67,972,1197,-225
6,19,6,69,93,76,17
6,19,6,71,576,425,151
6,19,6,73,874,976,-102
6,19,6,75,192,311,-119
6,19,6,77,476,551,-75
6,19,6,79,435,628,-193
6,19,6,81,213,233,-20
6,19,6,83,251,251,0
6,19,6,85,1004,939,65
6,19,6,87,161,181,-20
6,19,6,89,73,101,-28
6,19,6,95,151,163,-12
6,19,6,97,181,156,25
6,19,6,99,566,519,47
6,19,6,101,41,48,-7
6,19,6,103,35,0,35
6,19,6,107,2943,2761,182
6,19,6,109,60,63,-3
6,19,6,111,350,280,70
6,19,6,113,98,154,-56
6,19,6,115,49,45,4
6,19,8,1,43,58,-15
6,19,8,5,58,49,9
6,19,8,31,55,57,-2
6,19,8,35,32,0,32
6,19,8,41,60,83,-23
6,19,8,59,34,0,34
6,19,8,69,0,36,-36
6,19,8,77,0,34,-34
6,19,8,123,29,32,-3
6,19,12,57,34,0,34
6,19,12,86,46,32,14
6,19,12,95,32,0,32
6,19,12,99,24,0,24
6,19,13,67,0,26,-26
6,19,13,135,41,0,41
6,19,15,3,106,98,8
6,19,16,1,36,120,-84
6,19,16,27,0,48,-48
6,19,17,31,93,86,7
6,19,19,193,36,0,36
6,19,25,17,26,0,26
6,19,26,81,41,0,41
6,19,26,125,54,0,54
6,19,26,163,33,0,33
6,19,27,3,0,33,-33
6,19,27,53,55,100,-45
6,19,27,123,56,80,-24
6,19,29,95,23,0,23
6,19,32,3,461,512,-51
6,19,32,5,0,64,-64
6,19,32,31,137,185,-48
6,19,32,510,0,38,-38
6,19,35,1,35,59,-24
6,19,36,47,32,24,8
6,19,36,61,28,57,-29
6,19,36,119,33,0,33
6,19,37,35,43,0,43
6,19,37,51,0,49,-49
6,19,37,133,35,0,35
6,19,40,109,0,34,-34
6,19,40,143,48,108,-60
6,19,41,5,0,83,-83
6,19,41,17,0,48,-48
6,19,41,29,0,35,-35
6,19,41,33,0,32,-32
6,19,41,35,0,31,-31
6,19,41,39,35,59,-24
6,19,41,47,33,92,-59
6,19,41,51,70,131,-61
6,19,41,67,56,105,-49
6,19,42,101,29,32,-3
6,19,47,37,0,38,-38
6,19,48,27,35,0,35
6,19,48,29,55,84,-29
6,19,48,85,0,53,-53
6,19,48,113,107,95,12
6,19,48,121,0,29,-29
6,19,48,141,48,50,-2
6,19,48,201,117,176,-59
6,19,48,215,45,52,-7
6,19,48,439,88,110,-22
6,19,48,453,0,58,-58
6,19,48,491,0,35,-35
6,19,49,5,0,41,-41
6,19,49,11,0,30,-30
6,19,49,35,87,141,-54
6,19,49,49,48,121,-73
6,19,49,57,0,33,-33
6,19,51,59,27,28,-1
6,19,53,11,40,59,-19
6,19,53,33,148,198,-50
6,19,53,35,0,28,-28
6,19,53,53,92,162,-70
6,19,53,57,0,33,-33
6,19,53,61,59,122,-63
6,19,53,63,53,75,-22
6,19,53,67,0,32,-32
6,19,53,73,0,47,-47
6,19,53,77,55,75,-20
6,19,55,79,38,0,38
6,21,6,7,512,462,50
6,21,6,11,85,88,-3
6,21,6,37,42,0,42
6,21,6,65,43,0,43
6,21,6,67,52,93,-41
6,21,6,73,28,0,28
6,21,6,89,28,47,-19
6,21,6,101,0,45,-45
6,21,6,103,190,211,-21
6,23,4,13,65,100,-35
6,23,4,19,0,40,-40
6,23,6,1,193,145,48
6,23,6,5,0,26,-26
6,23,6,7,119,165,-46
6,23,6,9,29,0,29
6,23,6,13,158,73,85
6,23,6,15,134,96,38
6,23,6,17,72,83,-11
6,23,6,19,97,38,59
6,23,6,29,46,48,-2
6,23,6,33,32,88,-56
6,23,6,35,29,0,29
6,23,6,37,331,198,133
6,23,6,41,48,44,4
6,23,6,43,21,0,21
6,23,6,45,184,182,2
6,23,6,47,47,0,47
6,23,6,53,37,48,-11
6,23,6,55,29,0,29
6,23,6,57,56,54,2
6,23,6,59,164,98,66
6,23,6,61,76,108,-32
6,23,6,63,0,37,-37
6,23,6,65,90,88,2
6,23,6,67,240,308,-68
6,23,6,71,113,81,32
6,23,6,73,260,153,107
6,23,6,75,88,124,-36
6,23,6,77,79,30,49
6,23,6,79,83,41,42
6,23,6,81,39,72,-33
6,23,6,83,46,58,-12
6,23,6,85,97,100,-3
6,23,6,87,81,64,17
6,23,6,89,282,322,-40
6,23,6,93,73,101,-28
6,23,6,95,84,71,13
6,23,6,97,203,241,-38
6,23,6,99,43,36,7
6,23,6,103,63,63,0
6,23,6,105,128,164,-36
6,23,6,107,41,32,9
6,23,6,109,0,28,-28
6,23,6,111,98,44,54
6,23,6,113,51,49,2
6,23,15,1,0,25,-25
6,23,15,3,44,0,44
6,23,16,1,0,36,-36
6,23,16,55,0,81,-81
6,23,17,31,0,32,-32
6,23,32,3,73,0,73
6,23,32,31,32,70,-38
6,23,41,3,0,38,-38
6,23,41,5,0,26,-26
6,23,41,11,0,30,-30
6,23,41,17,0,33,-33
6,23,41,19,0,41,-41
6,23,41,29,84,93,-9
6,23,41,33,0,72,-72
6,23,41,35,36,0,36
6,23,41,39,31,120,-89
6,23,41,47,0,62,-62
6,23,41,51,61,156,-95
6,23,41,67,0,49,-49
6,23,53,11,0,49,-49
6,23,53,33,47,113,-66
6,23,53,53,0,39,-39
6,23,53,63,0,35,-35
6,23,53,73,0,28,-28
6,25,4,13,344,314,30
6,25,4,15,53,51,2
6,25,4,19,69,57,12
6,25,4,27,475,836,-361
6,25,6,1,49,37,12
6,25,6,19,140,134,6
6,25,6,29,201,161,40
6,25,6,31,75,71,4
6,25,6,37,926,665,261
6,25,6,47,64,42,22
6,25,6,53,194,187,7
6,25,6,59,207,212,-5
6,25,6,65,1810,1229,581
6,25,6,67,85,74,11
6,25,6,71,447,412,35
6,25,6,73,1570,1734,-164
6,25,6,77,72,0,72
6,25,6,79,29,28,1
6,25,6,83,74,54,20
6,25,6,85,71,56,15
6,25,6,107,49,62,-13
6,25,6,111,90,58,32
6,25,31,43,0,47,-47
6,25,32,3,256,183,73
6,25,48,141,0,50,-50
6,25,48,201,0,33,-33
6,25,49,35,0,40,-40
6,25,53,33,34,0,34
6,27,4,13,34,0,34
6,27,6,29,70,107,-37
6,27,6,37,114,112,2
6,27,6,51,144,136,8
6,27,6,59,44,44,0
6,27,6,65,49,34,15
6,27,6,71,86,57,29
6,27,6,73,47,51,-4
6,27,6,111,24,0,24
6,27,32,3,0,44,-44
6,27,32,23,35,26,9
6,27,32,31,46,56,-10
6,29,2,16,38,0,38
6,29,2,20,41,83,-42
6,29,2,90,35,0,35
6,29,4,13,634,522,112
6,29,4,15,92,131,-39
6,29,4,19,128,167,-39
6,29,4,21,50,81,-31
6,29,4,25,41,46,-5
6,29,4,27,85,67,18
6,29,5,7,0,44,-44
6,29,6,1,166,299,-133
6,29,6,7,92,82,10
6,29,6,13,173,255,-82
6,29,6,15,0,39,-39
6,29,6,17,24,54,-30
6,29,6,19,826,895,-69
6,29,6,23,48,46,2
6,29,6,25,161,201,-40
6,29,6,27,107,70,37
6,29,6,31,432,304,128
6,29,6,35,0,50,-50
6,29,6,37,11667,6849,4818
6,29,6,39,88,120,-32
6,29,6,45,32,36,-4
6,29,6,47,220,160,60
6,29,6,53,511,423,88
6,29,6,55,38,62,-24
6,29,6,59,1178,894,284
6,29,6,61,69,104,-35
6,29,6,65,993,849,144
6,29,6,67,418,465,-47
6,29,6,69,43,0,43
6,29,6,71,1277,991,286
6,29,6,73,1123,1214,-91
6,29,6,75,82,130,-48
6,29,6,77,245,265,-20
6,29,6,79,454,842,-388
6,29,6,81,73,97,-24
6,29,6,83,601,521,80
6,29,6,85,343,354,-11
6,29,6,87,130,148,-18
6,29,6,89,51,52,-1
6,29,6,95,132,141,-9
6,29,6,97,83,98,-15
6,29,6,99,261,229,32
6,29,6,101,47,36,11
6,29,6,107,1442,1316,126
6,29,6,111,1666,1178,488
6,29,6,113,82,89,-7
6,29,6,115,39,0,39
6,29,8,1,0,50,-50
6,29,8,5,56,66,-10
6,29,8,31,0,75,-75
6,29,8,35,0,63,-63
6,29,8,41,112,100,12
6,29,8,45,0,28,-28
6,29,8,59,43,33,10
6,29,8,69,0,43,-43
6,29,8,77,31,107,-76
6,29,12,9,0,34,-34
6,29,12,11,38,0,38
6,29,12,31,42,0,42
6,29,12,33,50,0,50
6,29,12,57,0,41,-41
6,29,12,91,52,70,-18
6,29,12,95,0,42,-42
6,29,12,113,0,41,-41
6,29,13,67,0,28,-28
6,29,13,135,0,38,-38
6,29,15,1,0,27,-27
6,29,15,3,146,100,46
6,29,16,1,31,58,-27
6,29,16,27,0,68,-68
6,29,16,55,0,38,-38
6,29,17,31,97,97,0
6,29,17,163,0,42,-42
6,29,18,81,0,33,-33
6,29,18,97,0,36,-36
6,29,20,173,0,58,-58
6,29,24,37,67,48,19
6,29,26,81,0,39,-39
6,29,26,163,47,0,47
6,29,27,53,30,0,30
6,29,32,3,760,926,-166
6,29,32,19,0,44,-44
6,29,32,23,0,35,-35
6,29,32,31,142,179,-37
6,29,35,1,104,86,18
6,29,35,13,42,55,-13
6,29,36,47,32,0,32
6,29,36,61,24,35,-11
6,29,36,81,32,26,6
6,29,37,51,39,38,1
6,29,37,119,0,31,-31
6,29,37,133,45,47,-2
6,29,37,183,0,32,-32
6,29,39,113,61,44,17
6,29,40,109,48,116,-68
6,29,40,143,48,66,-18
6,29,41,5,0,64,-64
6,29,41,11,0,47,-47
6,29,41,17,0,38,-38
6,29,41,19,0,42,-42
6,29,41,29,0,59,-59
6,29,41,33,0,45,-45
6,29,41,39,35,95,-60
6,29,41,47,35,44,-9
6,29,41,51,53,107,-54
6,29,41,67,57,98,-41
6,29,48,27,57,67,-10
6,29,48,29,87,151,-64
6,29,48,85,0,50,-50
6,29,48,113,78,132,-54
6,29,48,121,0,49,-49
6,29,48,141,51,75,-24
6,29,48,157,47,50,-3
6,29,48,201,220,328,-108
6,29,48,215,59,126,-67
6,29,48,329,0,42,-42
6,29,48,339,0,50,-50
6,29,48,355,0,40,-40
6,29,48,439,92,189,-97
6,29,48,441,49,48,1
6,29,48,453,0,63,-63
6,29,48,491,0,57,-57
6,29,49,5,50,0,50
6,29,49,11,0,86,-86
6,29,49,35,72,155,-83
6,29,49,49,98,125,-27
6,29,49,53,0,47,-47
6,29,49,57,0,64,-64
6,29,51,59,0,47,-47
6,29,51,153,0,39,-39
6,29,51,810,88,56,32
6,29,53,5,0,26,-26
6,29,53,11,0,54,-54
6,29,53,29,58,94,-36
6,29,53,33,110,189,-79
6,29,53,35,50,58,-8
6,29,53,53,100,143,-43
6,29,53,57,0,42,-42
6,29,53,61,79,135,-56
6,29,53,63,51,99,-48
6,29,53,67,0,40,-40
6,29,53,73,0,56,-56
6,29,53,77,39,58,-19
6,29,55,79,28,0,28
6,29,56,25,28,0,28
6,29,56,37,0,34,-34
6,31,4,13,56,130,-74
6,31,6,1,82,95,-13
6,31,6,13,50,56,-6
6,31,6,19,1813,1442,371
6,31,6,25,71,75,-4
6,31,6,29,304,432,-128
6,31,6,37,445,277,168
6,31,6,39,106,86,20
6,31,6,47,69,54,15
6,31,6,53,150,137,13
6,31,6,59,106,93,13
6,31,6,61,0,38,-38
6,31,6,65,125,119,6
6,31,6,67,108,146,-38
6,31,6,71,156,95,61
6,31,6,73,520,567,-47
6,31,6,77,69,95,-26
6,31,6,79,96,165,-69
6,31,6,83,31,58,-27
6,31,6,85,96,88,8
6,31,6,87,50,0,50
6,31,6,95,40,42,-2
6,31,6,99,93,77,16
6,31,6,107,987,1323,-336
6,31,6,111,132,151,-19
6,31,8,41,38,0,38
6,31,12,19,38,0,38
6,31,12,31,101,57,44
6,31,12,33,116,0,116
6,31,15,3,106,86,20
6,31,17,31,0,31,-31
6,31,17,97,0,53,-53
6,31,24,37,36,84,-48
6,31,28,75,76,0,76
6,31,32,1,70,75,-5
6,31,32,3,67,96,-29
6,31,44,5,0,41,-41
6,31,45,13,42,40,2
6,31,48,29,0,35,-35
6,31,48,113,0,41,-41
6,31,48,201,31,48,-17
6,31,48,273,39,0,39
6,31,48,439,0,61,-61
6,31,51,550,40,0,40
6,31,51,810,181,144,37
6,31,53,29,121,129,-8
6,31,53,33,0,35,-35
6,31,53,35,51,63,-12
6,31,53,53,0,34,-34
6,31,53,61,0,41,-41
6,33,4,13,52,49,3
6,33,6,1,127,118,9
6,33,6,7,66,76,-10
6,33,6,13,132,68,64
6,33,6,17,32,0,32
6,33,6,19,32,0,32
6,33,6,23,88,32,56
6,33,6,37,111,64,47
6,33,6,41,60,28,32
6,33,6,45,430,236,194
6,33,6,55,227,144,83
6,33,6,59,47,37,10
6,33,6,61,27,35,-8
6,33,6,65,38,34,4
6,33,6,67,154,159,-5
6,33,6,71,56,0,56
6,33,6,73,61,57,4
6,33,6,75,46,34,12
6,33,6,77,0,50,-50
6,33,6,81,59,28,31
6,33,6,85,105,76,29
6,33,6,87,40,0,40
6,33,6,89,0,59,-59
6,33,6,95,86,73,13
6,33,6,97,714,642,72
6,33,6,111,29,0,29
6,33,6,113,0,49,-49
6,33,6,115,0,31,-31
6,33,32,3,42,43,-1
6,33,32,31,29,30,-1
6,35,4,13,0,24,-24
6,35,6,7,98,120,-22
6,35,6,15,0,37,-37
6,35,6,23,0,29,-29
6,35,6,29,50,0,50
6,35,6,37,46,0,46
6,35,6,49,45,0,45
6,35,6,61,0,36,-36
6,35,6,63,124,77,47
6,35,6,67,98,136,-38
6,35,6,71,63,0,63
6,35,6,73,46,41,5
6,35,6,77,0,30,-30
6,35,6,85,28,0,28
6,35,6,89,123,131,-8
6,35,6,95,42,0,42
6,35,6,103,58,45,13
6,35,32,31,160,195,-35
6,37,1,3,35,42,-7
6,37,1,73,167,166,1
6,37,1,81,58,36,22
6,37,1,89,84,199,-115
6,37,1,97,59,133,-74
6,37,1,101,88,118,-30
6,37,1,117,46,60,-14
6,37,1,125,28,32,-4
6,37,2,20,242,291,-49
6,37,2,90,58,86,-28
6,37,2,122,21,0,21
6,37,4,3,112,161,-49
6,37,4,5,107,179,-72
6,37,4,7,0,48,-48
6,37,4,12,0,32,-32
6,37,4,13,5796,10856,-5060
6,37,4,15,482,999,-517
6,37,4,17,33,57,-24
6,37,4,19,1096,1588,-492
6,37,4,21,251,1106,-855
6,37,4,23,58,75,-17
6,37,4,25,230,569,-339
6,37,4,27,251,558,-307
6,37,5,5,0,27,-27
6,37,5,7,134,413,-279
6,37,5,15,0,39,-39
6,37,5,33,0,59,-59
6,37,5,45,0,46,-46
6,37,5,51,0,74,-74
6,37,5,69,25,0,25
6,37,5,115,0,82,-82
6,37,5,119,155,235,-80
6,37,5,125,0,55,-55
6,37,5,131,83,111,-28
6,37,5,143,95,260,-165
6,37,6,1,3563,4141,-578
6,37,6,5,0,42,-42
6,37,6,7,269,369,-100
6,37,6,9,29,45,-16
6,37,6,13,1898,2136,-238
6,37,6,15,48,46,2
6,37,6,17,258,498,-240
6,37,6,19,1625,2609,-984
6,37,6,21,0,42,-42
6,37,6,23,198,331,-133
6,37,6,25,665,926,-261
6,37,6,27,112,114,-2
6,37,6,29,6849,11667,-4818
6,37,6,31,277,445,-168
6,37,6,33,64,111,-47
6,37,6,35,0,46,-46
6,37,6,39,179,373,-194
6,37,6,41,512,665,-153
6,37,6,43,31,70,-39
6,37,6,45,75,119,-44
6,37,6,47,335,426,-91
6,37,6,51,91,181,-90
6,37,6,53,749,944,-195
6,37,6,55,235,262,-27
6,37,6,57,154,208,-54
6,37,6,59,39486,49745,-10259
6,37,6,61,472,835,-363
6,37,6,63,35,30,5
6,37,6,65,17317,30796,-13479
6,37,6,67,2506,2898,-392
6,37,6,69,67,82,-15
6,37,6,71,33585,51294,-17709
6,37,6,73,12936,14061,-1125
6,37,6,75,3471,3893,-422
6,37,6,77,951,804,147
6,37,6,79,925,1451,-526
6,37,6,81,1697,1890,-193
6,37,6,83,2478,2285,193
6,37,6,85,3824,5136,-1312
6,37,6,87,512,554,-42
6,37,6,89,170,322,-152
6,37,6,93,41,83,-42
6,37,6,95,601,722,-121
6,37,6,97,667,746,-79
6,37,6,99,690,788,-98
6,37,6,101,98,151,-53
6,37,6,103,62,94,-32
6,37,6,107,970,1594,-624
6,37,6,109,75,73,2
6,37,6,111,10124,13923,-3799
6,37,6,113,489,590,-101
6,37,6,115,90,114,-24
6,37,8,1,266,594,-328
6,37,8,5,648,1063,-415
6,37,8,7,0,25,-25
6,37,8,13,339,509,-170
6,37,8,14,70,125,-55
6,37,8,31,854,1035,-181
6,37,8,35,255,686,-431
6,37,8,37,63,79,-16
6,37,8,41,566,889,-323
6,37,8,45,59,147,-88
6,37,8,51,0,23,-23
6,37,8,59,282,457,-175
6,37,8,67,35,46,-11
6,37,8,69,139,397,-258
6,37,8,77,98,150,-52
6,37,8,85,0,53,-53
6,37,8,97,41,32,9
6,37,8,101,66,111,-45
6,37,8,107,0,35,-35
6,37,8,117,25,44,-19
6,37,8,123,127,203,-76
6,37,9,1,478,533,-55
6,37,9,3,369,231,138
6,37,9,5,25,46,-21
6,37,9,7,47,28,19
6,37,9,9,359,276,83
6,37,9,11,98,66,32
6,37,9,13,31,28,3
6,37,10,1,25,36,-11
6,37,10,3,208,132,76
6,37,10,5,35,0,35
6,37,11,1,912,781,131
6,37,12,1,119,101,18
6,37,12,5,52,49,3
6,37,12,9,254,183,71
6,37,12,11,844,770,74
6,37,12,15,44,44,0
6,37,12,19,37,59,-22
6,37,12,21,92,105,-13
6,37,12,31,353,360,-7
6,37,12,33,106,142,-36
6,37,12,35,0,46,-46
6,37,12,53,33,47,-14
6,37,12,57,423,469,-46
6,37,12,61,39,30,9
6,37,12,69,44,70,-26
6,37,12,71,205,170,35
6,37,12,73,145,73,72
6,37,12,81,76,105,-29
6,37,12,83,71,46,25
6,37,12,85,51,32,19
6,37,12,86,1377,1127,250
6,37,12,87,23,44,-21
6,37,12,91,123,87,36
6,37,12,95,936,541,395
6,37,12,97,123,100,23
6,37,12,99,594,475,119
6,37,12,101,121,122,-1
6,37,12,103,307,271,36
6,37,12,105,144,124,20
6,37,12,109,45,44,1
6,37,12,111,81,65,16
6,37,12,113,22,55,-33
6,37,12,115,100,177,-77
6,37,12,117,241,165,76
6,37,12,119,0,33,-33
6,37,12,127,129,103,26
6,37,13,21,31,31,0
6,37,13,51,187,134,53
6,37,13,53,30,0,30
6,37,13,57,83,132,-49
6,37,13,59,91,65,26
6,37,13,63,141,205,-64
6,37,13,67,451,687,-236
6,37,13,77,34,73,-39
6,37,13,89,498,625,-127
6,37,13,97,51,117,-66
6,37,13,113,36,95,-59
6,37,13,117,47,155,-108
6,37,13,121,902,1131,-229
6,37,13,127,39,0,39
6,37,13,129,0,71,-71
6,37,13,135,625,889,-264
6,37,13,139,68,138,-70
6,37,13,151,62,149,-87
6,37,13,153,44,37,7
6,37,13,179,67,37,30
6,37,13,185,40,38,2
6,37,13,213,0,38,-38
6,37,13,215,35,58,-23
6,37,13,217,0,46,-46
6,37,13,223,0,82,-82
6,37,13,245,68,61,7
6,37,13,247,0,56,-56
6,37,13,313,52,58,-6
6,37,15,1,175,297,-122
6,37,15,3,1775,1587,188
6,37,15,7,85,109,-24
6,37,15,9,231,399,-168
6,37,16,1,193,644,-451
6,37,16,5,0,63,-63
6,37,16,13,49,30,19
6,37,16,17,0,44,-44
6,37,16,19,0,176,-176
6,37,16,27,77,461,-384
6,37,16,39,0,28,-28
6,37,16,55,82,268,-186
6,37,16,57,0,35,-35
6,37,16,65,0,38,-38
6,37,16,83,29,84,-55
6,37,17,19,155,111,44
6,37,17,31,4160,3157,1003
6,37,17,43,528,400,128
6,37,17,77,49,0,49
6,37,17,89,145,185,-40
6,37,17,93,29,41,-12
6,37,17,97,342,336,6
6,37,17,111,89,81,8
6,37,17,113,59,49,10
6,37,17,119,35,64,-29
6,37,17,143,49,32,17
6,37,17,161,97,38,59
6,37,17,163,58,58,0
6,37,17,167,48,41,7
6,37,17,179,28,25,3
6,37,17,197,219,205,14
6,37,17,201,80,107,-27
6,37,18,3,116,98,18
6,37,18,17,29,0,29
6,37,18,19,0,42,-42
6,37,18,35,40,0,40
6,37,18,39,64,71,-7
6,37,18,57,107,226,-119
6,37,18,63,0,72,-72
6,37,18,81,29,60,-31
6,37,18,89,142,99,43
6,37,18,91,21,0,21
6,37,18,97,415,555,-140
6,37,18,105,95,89,6
6,37,18,127,47,37,10
6,37,18,141,111,105,6
6,37,18,157,111,79,32
6,37,18,163,28,44,-16
6,37,18,167,26,0,26
6,37,19,13,38,0,38
6,37,19,21,39,30,9
6,37,19,49,26,61,-35
6,37,19,103,103,57,46
6,37,19,113,88,84,4
6,37,19,153,174,212,-38
6,37,19,155,0,29,-29
6,37,19,163,54,171,-117
6,37,19,169,42,31,11
6,37,19,193,49,46,3
6,37,20,45,87,61,26
6,37,20,55,0,54,-54
6,37,20,57,0,71,-71
6,37,20,61,58,105,-47
6,37,20,91,363,434,-71
6,37,20,111,34,0,34
6,37,20,161,60,40,20
6,37,20,173,193,309,-116
6,37,20,177,29,99,-70
6,37,20,209,55,132,-77
6,37,21,15,0,46,-46
6,37,21,47,72,34,38
6,37,21,67,108,144,-36
6,37,21,93,29,38,-9
6,37,21,111,224,183,41
6,37,21,117,51,24,27
6,37,21,227,32,40,-8
6,37,22,5,30,0,30
6,37,22,15,41,74,-33
6,37,22,17,96,133,-37
6,37,22,19,0,40,-40
6,37,22,33,144,181,-37
6,37,22,51,124,213,-89
6,37,22,55,59,104,-45
6,37,22,61,0,36,-36
6,37,22,71,166,299,-133
6,37,22,73,42,39,3
6,37,22,79,0,32,-32
6,37,22,97,0,35,-35
6,37,22,101,0,29,-29
6,37,22,103,29,88,-59
6,37,22,105,0,46,-46
6,37,22,109,37,0,37
6,37,22,115,39,0,39
6,37,23,5,130,118,12
6,37,23,11,28,0,28
6,37,23,19,33,0,33
6,37,23,31,23,71,-48
6,37,24,3,196,206,-10
6,37,24,5,298,223,75
6,37,24,13,26,32,-6
6,37,24,21,63,83,-20
6,37,24,25,57,44,13
6,37,24,27,156,158,-2
6,37,24,31,750,782,-32
6,37,24,33,352,274,78
6,37,24,37,0,47,-47
6,37,24,43,31,0,31
6,37,24,510,266,227,39
6,37,25,1,72,75,-3
6,37,25,3,43,0,43
6,37,25,5,159,55,104
6,37,25,9,279,165,114
6,37,25,13,113,62,51
6,37,25,15,89,54,35
6,37,25,17,1418,1069,349
6,37,25,21,429,382,47
6,37,25,23,126,98,28
6,37,25,25,985,604,381
6,37,25,27,275,183,92
6,37,26,5,22,23,-1
6,37,26,21,47,41,6
6,37,26,25,26,0,26
6,37,26,49,94,60,34
6,37,26,55,35,27,8
6,37,26,65,166,108,58
6,37,26,77,110,71,39
6,37,26,81,209,141,68
6,37,26,93,46,31,15
6,37,26,99,274,97,177
6,37,26,115,26,0,26
6,37,26,121,27,35,-8
6,37,26,125,811,409,402
6,37,26,139,58,66,-8
6,37,26,147,23,0,23
6,37,26,161,423,216,207
6,37,26,163,647,334,313
6,37,27,3,71,65,6
6,37,27,19,38,22,16
6,37,27,37,160,185,-25
6,37,27,53,904,732,172
6,37,27,109,38,42,-4
6,37,27,123,225,201,24
6,37,27,131,0,35,-35
6,37,27,139,56,33,23
6,37,27,141,28,0,28
6,37,27,145,67,0,67
6,37,27,163,68,73,-5
6,37,28,33,40,128,-88
6,37,28,47,62,61,1
6,37,28,49,81,70,11
6,37,28,59,0,34,-34
6,37,28,87,29,0,29
6,37,28,89,0,50,-50
6,37,28,121,0,39,-39
6,37,29,19,71,67,4
6,37,29,21,0,27,-27
6,37,29,37,26,0,26
6,37,29,43,0,30,-30
6,37,29,47,66,76,-10
6,37,29,77,113,94,19
6,37,29,95,290,383,-93
6,37,29,97,59,56,3
6,37,29,99,35,0,35
6,37,29,169,28,41,-13
6,37,29,183,96,108,-12
6,37,29,189,567,411,156
6,37,29,510,211,155,56
6,37,30,13,0,68,-68
6,37,30,29,41,70,-29
6,37,30,31,75,75,0
6,37,30,49,25,43,-18
6,37,30,63,72,67,5
6,37,30,81,0,42,-42
6,37,30,111,36,58,-22
6,37,31,55,230,379,-149
6,37,31,79,25,63,-38
6,37,31,109,132,72,60
6,37,31,151,0,42,-42
6,37,31,153,63,81,-18
6,37,32,1,0,33,-33
6,37,32,3,8128,15651,-7523
6,37,32,5,73,245,-172
6,37,32,19,0,137,-137
6,37,32,23,97,164,-67
6,37,32,31,678,1022,-344
6,37,32,510,90,140,-50
6,37,33,1,24,0,24
6,37,33,5,20,0,20
6,37,33,9,44,37,7
6,37,33,11,137,158,-21
6,37,33,13,57,26,31
6,37,33,15,95,80,15
6,37,33,17,27,32,-5
6,37,34,1,86,37,49
6,37,34,3,584,430,154
6,37,34,5,154,119,35
6,37,34,7,154,101,53
6,37,34,13,287,207,80
6,37,34,15,49,24,25
6,37,34,17,600,507,93
6,37,34,19,48,42,6
6,37,34,21,219,219,0
6,37,34,23,588,326,262
6,37,34,25,217,180,37
6,37,34,27,252,212,40
6,37,34,29,145,108,37
6,37,34,31,109,95,14
6,37,34,35,166,95,71
6,37,34,37,32,0,32
6,37,34,39,187,119,68
6,37,34,41,22,0,22
6,37,35,1,592,1180,-588
6,37,35,5,45,141,-96
6,37,35,9,39,40,-1
6,37,35,13,124,278,-154
6,37,35,17,0,27,-27
6,37,35,25,0,49,-49
6,37,35,35,52,31,21
6,37,35,39,0,32,-32
6,37,35,43,106,300,-194
6,37,35,45,25,49,-24
6,37,35,49,160,219,-59
6,37,35,55,24,28,-4
6,37,35,61,29,83,-54
6,37,36,1,118,41,77
6,37,36,5,559,331,228
6,37,36,7,46,22,24
6,37,36,13,23,0,23
6,37,36,21,26,0,26
6,37,36,27,73,80,-7
6,37,36,29,276,206,70
6,37,36,45,73,80,-7
6,37,36,47,1830,1566,264
6,37,36,55,307,167,140
6,37,36,59,576,402,174
6,37,36,61,4427,3867,560
6,37,36,63,40,24,16
6,37,36,65,31,28,3
6,37,36,67,163,110,53
6,37,36,71,103,70,33
6,37,36,79,24,0,24
6,37,36,81,1394,1051,343
6,37,36,83,44,21,23
6,37,36,85,133,107,26
6,37,36,87,83,99,-16
6,37,36,91,76,59,17
6,37,36,93,48,42,6
6,37,36,103,482,348,134
6,37,36,105,22,0,22
6,37,36,109,110,82,28
6,37,36,111,0,48,-48
6,37,36,119,505,441,64
6,37,37,1,33,45,-12
6,37,37,19,0,25,-25
6,37,37,21,56,139,-83
6,37,37,25,0,68,-68
6,37,37,35,0,53,-53
6,37,37,37,30,36,-6
6,37,37,49,42,48,-6
6,37,37,51,241,255,-14
6,37,37,63,132,247,-115
6,37,37,67,109,189,-80
6,37,37,71,0,62,-62
6,37,37,81,100,163,-63
6,37,37,85,41,35,6
6,37,37,89,0,34,-34
6,37,37,97,0,93,-93
6,37,37,101,0,74,-74
6,37,37,109,48,36,12
6,37,37,119,452,734,-282
6,37,37,125,0,26,-26
6,37,37,129,59,96,-37
6,37,37,133,154,155,-1
6,37,37,135,83,120,-37
6,37,37,147,27,41,-14
6,37,37,155,37,0,37
6,37,37,159,0,42,-42
6,37,37,179,38,113,-75
6,37,37,183,327,749,-422
6,37,37,193,0,43,-43
6,37,38,15,0,23,-23
6,37,38,17,22,40,-18
6,37,38,35,28,35,-7
6,37,38,101,38,46,-8
6,37,39,9,34,0,34
6,37,39,17,95,82,13
6,37,39,25,45,48,-3
6,37,39,35,501,379,122
6,37,39,41,42,58,-16
6,37,39,49,734,596,138
6,37,39,55,24,0,24
6,37,39,57,74,77,-3
6,37,39,61,369,292,77
6,37,39,85,41,40,1
6,37,39,93,38,48,-10
6,37,39,95,134,68,66
6,37,39,99,47,49,-2
6,37,39,103,42,0,42
6,37,39,113,248,129,119
6,37,39,133,44,41,3
6,37,39,151,62,64,-2
6,37,39,153,193,139,54
6,37,39,155,49,24,25
6,37,39,165,61,78,-17
6,37,39,173,30,0,30
6,37,40,27,98,158,-60
6,37,40,31,83,75,8
6,37,40,109,316,588,-272
6,37,40,111,0,33,-33
6,37,40,119,37,0,37
6,37,40,143,344,458,-114
6,37,41,3,59,116,-57
6,37,41,5,235,527,-292
6,37,41,7,38,31,7
6,37,41,11,36,61,-25
6,37,41,15,21,44,-23
6,37,41,17,109,440,-331
6,37,41,19,51,111,-60
6,37,41,27,0,43,-43
6,37,41,29,155,395,-240
6,37,41,31,34,43,-9
6,37,41,33,44,183,-139
6,37,41,35,45,90,-45
6,37,41,39,278,588,-310
6,37,41,41,40,66,-26
6,37,41,43,0,100,-100
6,37,41,47,160,496,-336
6,37,41,51,753,1544,-791
6,37,41,53,34,79,-45
6,37,41,59,36,48,-12
6,37,41,67,556,1194,-638
6,37,41,71,45,174,-129
6,37,42,1,31,0,31
6,37,42,3,509,389,120
6,37,42,7,32,34,-2
6,37,42,11,64,52,12
6,37,42,17,176,131,45
6,37,42,19,27,0,27
6,37,42,27,96,41,55
6,37,42,29,165,147,18
6,37,42,41,57,57,0
6,37,42,43,61,52,9
6,37,42,45,218,130,88
6,37,42,49,58,51,7
6,37,42,69,41,29,12
6,37,42,71,83,73,10
6,37,42,75,27,0,27
6,37,42,77,101,62,39
6,37,42,79,38,33,5
6,37,42,89,29,23,6
6,37,42,91,363,263,100
6,37,42,95,67,70,-3
6,37,42,101,702,564,138
6,37,42,125,47,46,1
6,37,42,129,63,26,37
6,37,42,133,84,46,38
6,37,44,3,42,37,5
6,37,44,5,71,31,40
6,37,44,7,235,207,28
6,37,44,9,43,0,43
6,37,45,3,0,38,-38
6,37,45,7,0,35,-35
6,37,45,13,73,89,-16
6,37,45,15,64,29,35
6,37,45,19,127,143,-16
6,37,45,35,30,53,-23
6,37,45,45,102,188,-86
6,37,45,51,47,95,-48
6,37,45,63,37,83,-46
6,37,45,79,96,96,0
6,37,45,83,42,54,-12
6,37,45,85,44,0,44
6,37,45,91,33,90,-57
6,37,46,99,77,106,-29
6,37,46,103,29,46,-17
6,37,47,9,0,45,-45
6,37,47,37,379,642,-263
6,37,47,65,54,99,-45
6,37,47,93,137,172,-35
6,37,47,119,0,37,-37
6,37,47,125,110,118,-8
6,37,47,141,0,44,-44
6,37,47,149,76,144,-68
6,37,47,157,429,454,-25
6,37,47,163,29,25,4
6,37,47,165,0,76,-76
6,37,47,187,68,224,-156
6,37,47,189,0,50,-50
6,37,48,21,0,39,-39
6,37,48,27,268,420,-152
6,37,48,29,936,3364,-2428
6,37,48,37,0,36,-36
6,37,48,39,85,217,-132
6,37,48,41,105,81,24
6,37,48,61,63,112,-49
6,37,48,85,569,1413,-844
6,37,48,91,0,168,-168
6,37,48,99,46,87,-41
6,37,48,113,1510,3112,-1602
6,37,48,117,0,43,-43
6,37,48,121,365,834,-469
6,37,48,135,0,67,-67
6,37,48,139,0,183,-183
6,37,48,141,763,1374,-611
6,37,48,157,306,774,-468
6,37,48,167,108,208,-100
6,37,48,179,0,39,-39
6,37,48,183,38,89,-51
6,37,48,187,57,174,-117
6,37,48,201,2207,5103,-2896
6,37,48,209,46,175,-129
6,37,48,215,220,281,-61
6,37,48,221,0,31,-31
6,37,48,223,0,35,-35
6,37,48,245,62,76,-14
6,37,48,251,0,106,-106
6,37,48,257,0,51,-51
6,37,48,303,84,110,-26
6,37,48,309,64,99,-35
6,37,48,323,40,28,12
6,37,48,329,31,73,-42
6,37,48,339,201,427,-226
6,37,48,355,146,68,78
6,37,48,367,0,40,-40
6,37,48,373,0,29,-29
6,37,48,375,0,71,-71
6,37,48,381,26,0,26
6,37,48,397,0,123,-123
6,37,48,423,54,146,-92
6,37,48,439,990,2748,-1758
6,37,48,441,64,65,-1
6,37,48,451,0,52,-52
6,37,48,453,788,1821,-1033
6,37,48,479,71,100,-29
6,37,48,485,29,81,-52
6,37,48,491,201,940,-739
6,37,49,5,61,212,-151
6,37,49,11,188,624,-436
6,37,49,21,40,127,-87
6,37,49,35,933,2421,-1488
6,37,49,43,63,96,-33
6,37,49,45,0,50,-50
6,37,49,49,461,1206,-745
6,37,49,51,0,65,-65
6,37,49,53,139,378,-239
6,37,49,57,135,403,-268
6,37,50,7,52,54,-2
6,37,51,3,66,88,-22
6,37,51,13,401,339,62
6,37,51,41,80,110,-30
6,37,51,59,866,898,-32
6,37,51,61,0,38,-38
6,37,51,87,99,114,-15
6,37,51,95,31,37,-6
6,37,51,107,214,193,21
6,37,51,121,47,0,47
6,37,51,153,219,285,-66
6,37,51,177,40,26,14
6,37,51,179,53,77,-24
6,37,51,199,0,55,-55
6,37,51,510,197,230,-33
6,37,51,540,68,24,44
6,37,51,550,76,42,34
6,37,51,600,25,0,25
6,37,51,650,85,58,27
6,37,51,680,0,26,-26
6,37,51,700,109,99,10
6,37,51,710,142,103,39
6,37,51,740,33,34,-1
6,37,51,760,65,105,-40
6,37,51,810,264,235,29
6,37,53,5,107,214,-107
6,37,53,7,45,76,-31
6,37,53,9,38,96,-58
6,37,53,11,225,664,-439
6,37,53,15,0,68,-68
6,37,53,17,0,46,-46
6,37,53,21,58,105,-47
6,37,53,25,0,108,-108
6,37,53,27,0,29,-29
6,37,53,29,106,116,-10
6,37,53,31,0,54,-54
6,37,53,33,2610,3700,-1090
6,37,53,35,163,268,-105
6,37,53,39,0,33,-33
6,37,53,41,39,38,1
6,37,53,45,0,25,-25
6,37,53,53,609,1094,-485
6,37,53,57,72,128,-56
6,37,53,61,564,891,-327
6,37,53,63,223,523,-300
6,37,53,67,130,297,-167
6,37,53,71,47,41,6
6,37,53,73,152,257,-105
6,37,53,75,61,26,35
6,37,53,77,164,252,-88
6,37,54,3,0,31,-31
6,37,54,39,36,24,12
6,37,54,61,31,0,31
6,37,55,9,41,49,-8
6,37,55,25,305,283,22
6,37,55,35,23,24,-1
6,37,55,59,47,0,47
6,37,55,63,30,0,30
6,37,55,79,354,315,39
6,37,55,87,30,31,-1
6,37,55,89,27,0,27
6,37,55,101,48,49,-1
6,37,55,131,27,0,27
6,37,55,133,147,73,74
6,37,55,139,50,0,50
6,37,56,1,28,29,-1
6,37,56,21,0,63,-63
6,37,56,25,23,59,-36
6,37,56,29,0,27,-27
6,37,56,37,0,45,-45
6,37,56,39,22,32,-10
6,37,56,41,0,80,-80
6,39,4,13,33,91,-58
6,39,6,1,151,125,26
6,39,6,13,101,85,16
6,39,6,17,26,0,26
6,39,6,19,2818,2676,142
6,39,6,29,120,88,32
6,39,6,31,86,106,-20
6,39,6,37,373,179,194
6,39,6,43,93,117,-24
6,39,6,47,541,554,-13
6,39,6,53,164,193,-29
6,39,6,59,89,83,6
6,39,6,65,102,93,9
6,39,6,67,151,128,23
6,39,6,69,33,0,33
6,39,6,71,138,87,51
6,39,6,73,117,128,-11
6,39,6,75,30,0,30
6,39,6,77,167,93,74
6,39,6,79,59,57,2
6,39,6,81,53,53,0
6,39,6,83,38,35,3
6,39,6,85,395,307,88
6,39,6,87,83,54,29
6,39,6,95,39,0,39
6,39,6,99,199,186,13
6,39,6,107,183,139,44
6,39,6,111,49,49,0
6,39,32,3,84,70,14
6,39,32,31,34,0,34
6,39,53,33,0,40,-40
6,41,4,13,111,100,11
6,41,4,19,44,50,-6
6,41,6,1,1027,907,120
6,41,6,7,46,49,-3
6,41,6,13,960,1076,-116
6,41,6,17,46,77,-31
6,41,6,19,52,32,20
6,41,6,23,44,48,-4
6,41,6,33,28,60,-32
6,41,6,37,665,512,153
6,41,6,45,28,102,-74
6,41,6,53,95,75,20
6,41,6,55,122,177,-55
6,41,6,57,51,88,-37
6,41,6,59,161,155,6
6,41,6,61,65,157,-92
6,41,6,65,65,127,-62
6,41,6,67,235,230,5
6,41,6,71,50,49,1
6,41,6,73,297,282,15
6,41,6,75,3058,1871,1187
6,41,6,77,52,56,-4
6,41,6,79,67,31,36
6,41,6,81,492,451,41
6,41,6,83,86,64,22
6,41,6,85,345,327,18
6,41,6,87,85,109,-24
6,41,6,89,28,51,-23
6,41,6,95,468,473,-5
6,41,6,97,1712,2534,-822
6,41,6,99,49,36,13
6,41,6,111,104,34,70
6,41,6,113,67,67,0
6,41,8,13,32,0,32
6,41,8,31,65,34,31
6,41,8,97,0,24,-24
6,41,9,1,53,42,11
6,41,11,1,31,35,-4
6,41,12,11,35,32,3
6,41,12,86,58,45,13
6,41,12,99,25,28,-3
6,41,15,1,0,40,-40
6,41,15,3,85,48,37
6,41,15,9,29,49,-20
6,41,17,31,94,74,20
6,41,24,31,0,31,-31
6,41,25,17,54,77,-23
6,41,25,21,47,0,47
6,41,25,25,47,23,24
6,41,27,53,39,31,8
6,41,32,3,82,94,-12
6,41,32,31,55,90,-35
6,41,35,49,0,26,-26
6,41,36,47,71,43,28
6,41,36,61,133,118,15
6,41,36,81,0,21,-21
6,41,36,119,35,34,1
6,41,39,35,27,0,27
6,41,39,49,30,0,30
6,41,41,29,22,23,-1
6,41,41,39,27,44,-17
6,41,41,51,73,92,-19
6,41,41,67,47,35,12
6,41,48,113,43,31,12
6,41,48,201,47,40,7
6,41,48,453,0,50,-50
6,41,49,35,0,38,-38
6,41,51,13,25,0,25
6,41,51,59,57,37,20
6,41,53,33,147,163,-16
6,41,53,53,0,23,-23
6,43,6,1,48,29,19
6,43,6,13,34,0,34
6,43,6,19,51,59,-8
6,43,6,23,0,21,-21
6,43,6,37,70,31,39
6,43,6,39,117,93,24
6,43,6,47,164,171,-7
6,43,6,67,45,0,45
6,43,6,73,49,0,49
6,43,6,77,27,0,27
6,43,6,85,43,0,43
6,43,6,99,116,131,-15
6,43,6,109,78,67,11
6,43,41,51,0,23,-23
6,45,4,13,42,55,-13
6,45,6,1,91,113,-22
6,45,6,7,101,94,7
6,45,6,13,131,117,14
6,45,6,17,37,48,-11
6,45,6,19,0,33,-33
6,45,6,23,182,184,-2
6,45,6,29,36,32,4
6,45,6,33,236,430,-194
6,45,6,37,119,75,44
6,45,6,41,102,28,74
6,45,6,53,30,0,30
6,45,6,55,47,33,14
6,45,6,59,77,0,77
6,45,6,61,60,41,19
6,45,6,65,34,35,-1
6,45,6,67,149,190,-41
6,45,6,71,39,35,4
6,45,6,73,77,51,26
6,45,6,75,113,71,42
6,45,6,77,48,49,-1
6,45,6,79,30,24,6
6,45,6,81,67,44,23
6,45,6,85,78,54,24
6,45,6,87,50,51,-1
6,45,6,89,55,66,-11
6,45,6,93,43,0,43
6,45,6,95,48,34,14
6,45,6,97,501,610,-109
6,45,6,99,47,0,47
6,45,6,101,33,0,33
6,45,6,107,35,0,35
6,45,6,113,24,45,-21
6,45,15,1,0,23,-23
6,45,32,3,44,44,0
6,45,32,31,0,41,-41
6,45,41,19,0,36,-36
6,45,41,33,0,28,-28
6,45,41,39,0,24,-24
6,45,41,51,28,35,-7
6,45,53,33,0,31,-31
6,47,2,20,0,55,-55
6,47,4,13,134,153,-19
6,47,4,27,29,0,29
6,47,6,1,377,350,27
6,47,6,7,30,42,-12
6,47,6,13,154,156,-2
6,47,6,19,818,909,-91
6,47,6,23,0,47,-47
6,47,6,25,42,64,-22
6,47,6,29,160,220,-60
6,47,6,31,54,69,-15
6,47,6,37,426,335,91
6,47,6,39,554,541,13
6,47,6,43,171,164,7
6,47,6,53,355,516,-161
6,47,6,55,39,0,39
6,47,6,59,152,138,14
6,47,6,61,38,58,-20
6,47,6,65,131,120,11
6,47,6,67,413,558,-145
6,47,6,69,280,409,-129
6,47,6,71,141,104,37
6,47,6,73,221,367,-146
6,47,6,75,64,95,-31
6,47,6,77,586,510,76
6,47,6,79,30,93,-63
6,47,6,81,118,119,-1
6,47,6,83,38,38,0
6,47,6,85,1674,1816,-142
6,47,6,87,188,262,-74
6,47,6,89,0,59,-59
6,47,6,95,83,89,-6
6,47,6,97,31,65,-34
6,47,6,99,3303,3481,-178
6,47,6,103,0,39,-39
6,47,6,107,133,178,-45
6,47,6,109,88,86,2
6,47,6,111,72,35,37
6,47,6,113,48,60,-12
6,47,17,31,0,42,-42
6,47,26,81,0,22,-22
6,47,32,3,113,195,-82
6,47,32,31,60,52,8
6,47,41,29,0,35,-35
6,47,41,47,0,40,-40
6,47,41,51,32,0,32
6,47,41,67,0,42,-42
6,47,48,27,0,34,-34
6,47,48,29,0,51,-51
6,47,48,113,0,27,-27
6,47,48,141,0,41,-41
6,47,48,439,0,30,-30
6,47,48,453,0,34,-34
6,47,53,33,38,60,-22
6,49,6,35,0,45,-45
6,49,6,89,49,61,-12
6,49,41,35,52,34,18
6,51,6,17,32,27,5
6,51,6,27,136,144,-8
6,51,6,37,181,91,90
6,51,6,59,102,52,50
6,51,6,65,48,48,0
6,51,6,71,53,60,-7
6,51,6,73,104,88,16
6,51,6,83,0,28,-28
6,51,32,5,0,87,-87
6,51,32,31,27,52,-25
6,53,2,20,65,0,65
6,53,2,90,0,38,-38
6,53,4,3,44,66,-22
6,53,4,13,322,364,-42
6,53,4,19,152,149,3
6,53,4,21,0,30,-30
6,53,4,25,0,40,-40
6,53,4,27,382,542,-160
6,53,5,7,0,63,-63
6,53,6,1,395,385,10
6,53,6,7,80,95,-15
6,53,6,9,0,26,-26
6,53,6,13,247,194,53
6,53,6,17,58,64,-6
6,53,6,19,726,625,101
6,53,6,23,48,37,11
6,53,6,25,187,194,-7
6,53,6,29,423,511,-88
6,53,6,31,137,150,-13
6,53,6,37,944,749,195
6,53,6,39,193,164,29
6,53,6,41,75,95,-20
6,53,6,45,0,30,-30
6,53,6,47,516,355,161
6,53,6,55,60,68,-8
6,53,6,57,46,44,2
6,53,6,59,335,238,97
6,53,6,61,118,187,-69
6,53,6,65,311,310,1
6,53,6,67,514,644,-130
6,53,6,69,494,429,65
6,53,6,71,257,184,73
6,53,6,73,702,864,-162
6,53,6,75,242,325,-83
6,53,6,77,297,230,67
6,53,6,79,293,480,-187
6,53,6,81,195,229,-34
6,53,6,83,237,182,55
6,53,6,85,1244,1496,-252
6,53,6,87,1665,1493,172
6,53,6,89,46,70,-24
6,53,6,95,100,145,-45
6,53,6,97,113,135,-22
6,53,6,99,285,161,124
6,53,6,101,60,31,29
6,53,6,107,223,292,-69
6,53,6,109,38,47,-9
6,53,6,111,358,471,-113
6,53,6,113,96,115,-19
6,53,6,115,0,36,-36
6,53,8,5,32,0,32
6,53,8,31,0,47,-47
6,53,8,41,110,160,-50
6,53,8,69,0,34,-34
6,53,9,1,27,0,27
6,53,9,11,0,56,-56
6,53,11,1,36,56,-20
6,53,12,9,24,0,24
6,53,12,11,56,0,56
6,53,12,31,90,35,55
6,53,12,33,31,0,31
6,53,12,57,50,72,-22
6,53,12,86,33,39,-6
6,53,12,91,65,36,29
6,53,12,95,33,0,33
6,53,12,113,0,44,-44
6,53,13,73,0,87,-87
6,53,13,245,44,220,-176
6,53,15,1,24,47,-23
6,53,15,3,340,496,-156
6,53,16,1,30,70,-40
6,53,17,31,108,149,-41
6,53,17,43,0,35,-35
6,53,17,97,0,39,-39
6,53,17,163,0,36,-36
6,53,18,97,37,0,37
6,53,20,91,29,38,-9
6,53,24,3,116,333,-217
6,53,24,5,0,36,-36
6,53,24,27,0,42,-42
6,53,24,31,39,62,-23
6,53,24,33,0,64,-64
6,53,25,17,55,0,55
6,53,26,125,43,0,43
6,53,27,53,50,29,21
6,53,28,47,0,39,-39
6,53,29,95,28,0,28
6,53,29,189,39,0,39
6,53,31,55,0,37,-37
6,53,31,153,52,370,-318
6,53,32,3,353,423,-70
6,53,32,31,107,156,-49
6,53,35,1,37,42,-5
6,53,36,45,34,57,-23
6,53,36,47,0,28,-28
6,53,36,61,54,39,15
6,53,36,71,0,36,-36
6,53,37,51,98,124,-26
6,53,37,133,78,78,0
6,53,39,49,42,28,14
6,53,40,109,0,54,-54
6,53,40,143,27,0,27
6,53,41,5,30,39,-9
6,53,41,17,0,57,-57
6,53,41,29,45,93,-48
6,53,41,39,45,65,-20
6,53,41,47,0,48,-48
6,53,41,51,53,120,-67
6,53,41,67,49,69,-20
6,53,42,3,32,0,32
6,53,42,101,0,20,-20
6,53,44,5,0,173,-173
6,53,45,79,0,36,-36
6,53,47,125,67,43,24
6,53,47,157,0,47,-47
6,53,48,27,108,112,-4
6,53,48,29,159,282,-123
6,53,48,85,0,42,-42
6,53,48,113,72,103,-31
6,53,48,121,0,42,-42
6,53,48,141,50,51,-1
6,53,48,201,75,116,-41
6,53,48,215,49,44,5
6,53,48,355,50,0,50
6,53,48,439,55,121,-66
6,53,48,451,0,502,-502
6,53,48,453,26,35,-9
6,53,48,485,0,25,-25
6,53,48,491,0,34,-34
6,53,49,11,32,40,-8
6,53,49,35,50,148,-98
6,53,49,49,82,106,-24
6,53,51,13,68,50,18
6,53,51,59,103,266,-163
6,53,51,107,0,45,-45
6,53,51,153,62,131,-69
6,53,51,179,0,133,-133
6,53,51,510,0,51,-51
6,53,51,550,58,64,-6
6,53,51,710,34,39,-5
6,53,51,810,186,78,108
6,53,53,11,0,38,-38
6,53,53,33,110,169,-59
6,53,53,35,92,74,18
6,53,53,53,103,121,-18
6,53,53,61,62,45,17
6,53,53,63,42,0,42
6,53,53,67,55,44,11
6,53,53,77,37,0,37
6,55,4,13,86,54,32
6,55,6,1,278,284,-6
6,55,6,7,73,88,-15
6,55,6,13,451,368,83
6,55,6,17,0,54,-54
6,55,6,19,50,45,5
6,55,6,23,0,29,-29
6,55,6,29,62,38,24
6,55,6,33,144,227,-83
6,55,6,37,262,235,27
6,55,6,41,177,122,55
6,55,6,45,33,47,-14
6,55,6,47,0,39,-39
6,55,6,53,68,60,8
6,55,6,57,38,26,12
6,55,6,59,84,79,5
6,55,6,61,97,107,-10
6,55,6,65,91,69,22
6,55,6,67,278,316,-38
6,55,6,71,87,50,37
6,55,6,73,160,120,40
6,55,6,75,313,221,92
6,55,6,77,68,97,-29
6,55,6,79,44,38,6
6,55,6,81,209,126,83
6,55,6,83,53,25,28
6,55,6,85,149,137,12
6,55,6,87,37,47,-10
6,55,6,89,24,45,-21
6,55,6,95,2269,1889,380
6,55,6,97,631,661,-30
6,55,6,99,68,0,68
6,55,6,107,42,0,42
6,55,6,111,30,43,-13
6,55,6,113,82,135,-53
6,55,6,115,0,39,-39
6,55,15,3,47,0,47
6,55,17,31,31,0,31
6,55,32,3,36,65,-29
6,55,32,31,0,49,-49
6,55,36,61,38,35,3
6,55,41,29,0,34,-34
6,55,41,39,0,40,-40
6,55,41,51,0,59,-59
6,55,41,67,0,42,-42
6,55,53,33,0,72,-72
6,57,4,13,49,53,-4
6,57,4,19,25,0,25
6,57,6,1,177,98,79
6,57,6,7,119,150,-31
6,57,6,13,177,114,63
6,57,6,17,162,84,78
6,57,6,23,54,56,-2
6,57,6,37,208,154,54
6,57,6,41,88,51,37
6,57,6,53,44,46,-2
6,57,6,55,26,38,-12
6,57,6,59,113,83,30
6,57,6,61,1261,1106,155
6,57,6,63,34,48,-14
6,57,6,65,95,47,48
6,57,6,67,459,514,-55
6,57,6,71,70,26,44
6,57,6,73,167,113,54
6,57,6,75,134,128,6
6,57,6,77,39,50,-11
6,57,6,79,49,36,13
6,57,6,81,166,51,115
6,57,6,83,36,0,36
6,57,6,85,231,116,115
6,57,6,87,101,115,-14
6,57,6,89,37,34,3
6,57,6,91,34,44,-10
6,57,6,95,71,27,44
6,57,6,97,123,111,12
6,57,6,99,38,0,38
6,57,6,101,56,84,-28
6,57,6,109,0,27,-27
6,57,6,111,41,29,12
6,57,6,113,78,52,26
6,57,6,115,212,210,2
6,57,15,1,30,0,30
6,57,15,3,0,41,-41
6,57,17,31,0,24,-24
6,57,32,3,46,43,3
6,57,32,31,338,561,-223
6,57,41,17,0,32,-32
6,57,41,39,0,32,-32
6,57,41,51,0,44,-44
6,57,49,35,0,31,-31
6,57,53,33,34,50,-16
6,59,1,73,29,59,-30
6,59,1,89,0,84,-84
6,59,1,97,0,37,-37
6,59,1,101,29,0,29
6,59,2,20,65,84,-19
6,59,2,90,30,39,-9
6,59,4,3,41,51,-10
6,59,4,5,74,75,-1
6,59,4,7,0,41,-41
6,59,4,12,0,38,-38
6,59,4,13,2743,4340,-1597
6,59,4,15,315,568,-253
6,59,4,17,0,25,-25
6,59,4,19,484,617,-133
6,59,4,21,75,359,-284
6,59,4,25,157,417,-260
6,59,4,27,84,196,-112
6,59,5,7,41,124,-83
6,59,5,119,48,63,-15
6,59,5,143,0,101,-101
6,59,6,1,1288,1365,-77
6,59,6,7,130,191,-61
6,59,6,9,0,30,-30
6,59,6,13,785,816,-31
6,59,6,17,156,219,-63
6,59,6,19,714,734,-20
6,59,6,23,98,164,-66
6,59,6,25,212,207,5
6,59,6,27,44,44,0
6,59,6,29,894,1178,-284
6,59,6,31,93,106,-13
6,59,6,33,37,47,-10
6,59,6,37,49745,39486,10259
6,59,6,39,83,89,-6
6,59,6,41,155,161,-6
6,59,6,45,0,77,-77
6,59,6,47,138,152,-14
6,59,6,51,52,102,-50
6,59,6,53,238,335,-97
6,59,6,55,79,84,-5
6,59,6,57,83,113,-30
6,59,6,61,335,425,-90
6,59,6,65,19480,22942,-3462
6,59,6,67,1039,1002,37
6,59,6,71,8961,9468,-507
6,59,6,73,8370,8621,-251
6,59,6,75,782,1168,-386
6,59,6,77,362,384,-22
6,59,6,79,462,625,-163
6,59,6,81,497,613,-116
6,59,6,83,729,712,17
6,59,6,85,1796,1908,-112
6,59,6,87,220,202,18
6,59,6,89,89,159,-70
6,59,6,93,0,30,-30
6,59,6,95,189,263,-74
6,59,6,97,257,378,-121
6,59,6,99,245,239,6
6,59,6,101,0,34,-34
6,59,6,107,326,474,-148
6,59,6,109,35,51,-16
6,59,6,111,1433,1177,256
6,59,6,113,161,212,-51
6,59,6,115,0,41,-41
6,59,8,1,114,219,-105
6,59,8,5,245,429,-184
6,59,8,13,143,180,-37
6,59,8,14,60,104,-44
6,59,8,31,265,372,-107
6,59,8,35,192,1110,-918
6,59,8,37,24,35,-11
6,59,8,41,229,509,-280
6,59,8,45,0,38,-38
6,59,8,59,143,327,-184
6,59,8,67,0,27,-27
6,59,8,69,83,208,-125
6,59,8,77,47,94,-47
6,59,8,85,0,31,-31
6,59,8,101,0,57,-57
6,59,8,117,32,0,32
6,59,8,123,59,86,-27
6,59,9,1,203,122,81
6,59,9,3,162,87,75
6,59,9,5,38,0,38
6,59,9,9,85,73,12
6,59,9,11,40,31,9
6,59,10,3,88,42,46
6,59,11,1,99,229,-130
6,59,12,1,45,0,45
6,59,12,5,0,34,-34
6,59,12,9,114,88,26
6,59,12,11,266,265,1
6,59,12,21,0,45,-45
6,59,12,31,154,115,39
6,59,12,33,35,41,-6
6,59,12,53,34,0,34
6,59,12,57,191,168,23
6,59,12,71,70,107,-37
6,59,12,73,0,38,-38
6,59,12,81,29,70,-41
6,59,12,86,239,237,2
6,59,12,91,38,42,-4
6,59,12,95,279,237,42
6,59,12,97,56,47,9
6,59,12,99,224,140,84
6,59,12,101,61,0,61
6,59,12,103,111,137,-26
6,59,12,105,27,45,-18
6,59,12,109,51,81,-30
6,59,12,111,0,34,-34
6,59,12,115,47,33,14
6,59,12,117,49,49,0
6,59,12,127,40,60,-20
6,59,13,51,0,57,-57
6,59,13,57,37,79,-42
6,59,13,67,169,222,-53
6,59,13,89,112,177,-65
6,59,13,113,0,26,-26
6,59,13,117,46,38,8
6,59,13,121,228,373,-145
6,59,13,135,208,237,-29
6,59,13,139,0,29,-29
6,59,15,1,144,155,-11
6,59,15,3,754,771,-17
6,59,15,7,57,73,-16
6,59,15,9,119,177,-58
6,59,16,1,156,397,-241
6,59,16,13,43,0,43
6,59,16,17,0,29,-29
6,59,16,19,0,47,-47
6,59,16,27,55,174,-119
6,59,16,55,59,125,-66
6,59,17,19,38,0,38
6,59,17,31,1067,958,109
6,59,17,43,262,221,41
6,59,17,89,104,85,19
6,59,17,97,203,147,56
6,59,17,111,46,0,46
6,59,17,167,25,0,25
6,59,17,197,131,111,20
6,59,17,201,37,29,8
6,59,18,3,35,0,35
6,59,18,57,41,90,-49
6,59,18,89,30,0,30
6,59,18,97,129,105,24
6,59,18,105,0,25,-25
6,59,18,141,42,41,1
6,59,18,157,29,0,29
6,59,19,103,47,31,16
6,59,19,113,42,34,8
6,59,19,153,53,90,-37
6,59,19,163,0,88,-88
6,59,20,45,33,0,33
6,59,20,61,0,22,-22
6,59,20,91,125,255,-130
6,59,20,173,68,70,-2
6,59,21,15,0,39,-39
6,59,21,67,37,74,-37
6,59,21,111,66,134,-68
6,59,22,33,38,50,-12
6,59,22,51,41,53,-12
6,59,22,71,0,59,-59
6,59,22,103,0,61,-61
6,59,23,5,35,33,2
6,59,24,3,88,45,43
6,59,24,5,82,79,3
6,59,24,21,0,43,-43
6,59,24,27,28,45,-17
6,59,24,31,212,192,20
6,59,24,33,73,53,20
6,59,24,510,38,41,-3
6,59,25,5,35,0,35
6,59,25,9,144,80,64
6,59,25,13,38,0,38
6,59,25,17,317,279,38
6,59,25,21,166,106,60
6,59,25,23,55,40,15
6,59,25,25,231,319,-88
6,59,25,27,103,102,1
6,59,26,49,45,0,45
6,59,26,65,48,0,48
6,59,26,77,47,32,15
6,59,26,81,105,92,13
6,59,26,93,46,0,46
6,59,26,99,140,78,62
6,59,26,125,405,222,183
6,59,26,139,45,28,17
6,59,26,161,142,92,50
6,59,26,163,235,127,108
6,59,27,3,41,49,-8
6,59,27,19,0,34,-34
6,59,27,37,48,25,23
6,59,27,53,317,287,30
6,59,27,123,77,41,36
6,59,27,137,29,0,29
6,59,27,163,43,38,5
6,59,28,47,0,41,-41
6,59,29,19,27,35,-8
6,59,29,47,31,0,31
6,59,29,77,50,69,-19
6,59,29,95,96,150,-54
6,59,29,183,69,74,-5
6,59,29,189,206,182,24
6,59,29,510,54,35,19
6,59,30,29,63,75,-12
6,59,30,31,25,44,-19
6,59,30,63,29,32,-3
6,59,30,111,0,30,-30
6,59,31,55,93,100,-7
6,59,31,109,83,31,52
6,59,32,3,2544,3352,-808
6,59,32,5,34,52,-18
6,59,32,19,28,71,-43
6,59,32,23,31,74,-43
6,59,32,31,307,396,-89
6,59,32,510,30,37,-7
6,59,33,11,64,54,10
6,59,33,15,26,36,-10
6,59,34,1,58,0,58
6,59,34,3,241,151,90
6,59,34,5,51,0,51
6,59,34,7,65,32,33
6,59,34,13,104,28,76
6,59,34,15,37,0,37
6,59,34,17,139,169,-30
6,59,34,21,76,35,41
6,59,34,23,244,122,122
6,59,34,25,106,26,80
6,59,34,27,146,99,47
6,59,34,29,58,31,27
6,59,34,31,91,33,58
6,59,34,35,77,41,36
6,59,34,39,61,62,-1
6,59,35,1,179,332,-153
6,59,35,13,39,68,-29
6,59,35,43,34,96,-62
6,59,35,49,30,70,-40
6,59,36,1,56,30,26
6,59,36,5,198,56,142
6,59,36,29,78,58,20
6,59,36,45,34,33,1
6,59,36,47,216,224,-8
6,59,36,55,74,71,3
6,59,36,59,164,75,89
6,59,36,61,615,728,-113
6,59,36,67,31,46,-15
6,59,36,71,45,59,-14
6,59,36,81,206,170,36
6,59,36,87,24,0,24
6,59,36,91,0,32,-32
6,59,36,103,190,114,76
6,59,36,119,119,88,31
6,59,37,21,0,30,-30
6,59,37,49,0,58,-58
6,59,37,51,67,78,-11
6,59,37,63,63,83,-20
6,59,37,67,45,53,-8
6,59,37,81,68,90,-22
6,59,37,97,0,78,-78
6,59,37,119,218,366,-148
6,59,37,129,24,57,-33
6,59,37,133,95,105,-10
6,59,37,135,33,60,-27
6,59,37,179,0,47,-47
6,59,37,183,104,362,-258
6,59,38,17,27,0,27
6,59,39,17,31,37,-6
6,59,39,35,152,99,53
6,59,39,49,183,181,2
6,59,39,61,98,64,34
6,59,39,85,26,33,-7
6,59,39,93,0,45,-45
6,59,39,95,50,0,50
6,59,39,113,63,43,20
6,59,39,151,23,0,23
6,59,39,153,61,53,8
6,59,39,165,48,31,17
6,59,40,17,0,24,-24
6,59,40,27,47,60,-13
6,59,40,109,99,171,-72
6,59,40,143,119,149,-30
6,59,41,3,43,58,-15
6,59,41,5,124,304,-180
6,59,41,11,0,49,-49
6,59,41,17,81,263,-182
6,59,41,19,0,44,-44
6,59,41,29,98,188,-90
6,59,41,33,27,89,-62
6,59,41,35,39,40,-1
6,59,41,39,129,268,-139
6,59,41,41,0,23,-23
6,59,41,43,0,70,-70
6,59,41,47,109,134,-25
6,59,41,51,237,491,-254
6,59,41,53,0,34,-34
6,59,41,67,304,522,-218
6,59,41,71,0,42,-42
6,59,42,3,156,108,48
6,59,42,11,33,34,-1
6,59,42,17,48,74,-26
6,59,42,27,0,28,-28
6,59,42,29,107,48,59
6,59,42,43,24,0,24
6,59,42,45,64,38,26
6,59,42,49,25,0,25
6,59,42,71,39,0,39
6,59,42,77,55,0,55
6,59,42,91,136,114,22
6,59,42,101,174,109,65
6,59,44,5,0,27,-27
6,59,44,7,88,53,35
6,59,45,13,43,107,-64
6,59,45,15,0,28,-28
6,59,45,19,30,58,-28
6,59,45,35,0,25,-25
6,59,45,45,53,103,-50
6,59,45,51,0,29,-29
6,59,45,79,33,0,33
6,59,45,91,0,58,-58
6,59,46,99,33,54,-21
6,59,46,103,0,35,-35
6,59,47,37,144,114,30
6,59,47,93,55,58,-3
6,59,47,125,34,37,-3
6,59,47,149,0,39,-39
6,59,47,157,107,145,-38
6,59,47,165,0,44,-44
6,59,47,187,71,187,-116
6,59,48,21,0,23,-23
6,59,48,27,100,103,-3
6,59,48,29,301,801,-500
6,59,48,39,0,59,-59
6,59,48,41,0,38,-38
6,59,48,61,0,30,-30
6,59,48,85,261,656,-395
6,59,48,91,0,65,-65
6,59,48,113,494,1080,-586
6,59,48,121,199,507,-308
6,59,48,139,0,45,-45
6,59,48,141,168,213,-45
6,59,48,157,150,268,-118
6,59,48,167,56,73,-17
6,59,48,187,0,48,-48
6,59,48,201,697,1439,-742
6,59,48,209,28,73,-45
6,59,48,215,61,45,16
6,59,48,245,44,51,-7
6,59,48,251,0,50,-50
6,59,48,303,22,39,-17
6,59,48,309,25,44,-19
6,59,48,329,0,34,-34
6,59,48,339,90,212,-122
6,59,48,355,52,45,7
6,59,48,397,0,46,-46
6,59,48,423,0,64,-64
6,59,48,439,407,866,-459
6,59,48,453,274,926,-652
6,59,48,491,122,505,-383
6,59,49,5,0,69,-69
6,59,49,11,90,180,-90
6,59,49,21,0,57,-57
6,59,49,35,427,1134,-707
6,59,49,43,30,55,-25
6,59,49,45,0,43,-43
6,59,49,49,300,519,-219
6,59,49,51,0,31,-31
6,59,49,53,83,178,-95
6,59,49,57,56,116,-60
6,59,50,7,39,0,39
6,59,51,3,0,33,-33
6,59,51,13,114,134,-20
6,59,51,41,34,46,-12
6,59,51,59,367,340,27
6,59,51,87,38,48,-10
6,59,51,107,79,128,-49
6,59,51,153,86,141,-55
6,59,51,179,0,56,-56
6,59,51,510,46,53,-7
6,59,51,550,29,0,29
6,59,51,710,41,45,-4
6,59,51,760,0,46,-46
6,59,51,810,112,86,26
6,59,53,5,0,94,-94
6,59,53,9,36,67,-31
6,59,53,11,109,223,-114
6,59,53,15,0,53,-53
6,59,53,21,35,64,-29
6,59,53,25,0,39,-39
6,59,53,29,34,68,-34
6,59,53,31,0,34,-34
6,59,53,33,975,1529,-554
6,59,53,35,101,180,-79
6,59,53,41,0,38,-38
6,59,53,53,235,388,-153
6,59,53,57,47,63,-16
6,59,53,61,331,459,-128
6,59,53,63,126,216,-90
6,59,53,67,66,147,-81
6,59,53,73,86,157,-71
6,59,53,75,0,29,-29
6,59,53,77,50,47,3
6,59,55,9,0,31,-31
6,59,55,25,93,99,-6
6,59,55,79,122,79,43
6,59,55,133,58,45,13
6,59,55,139,0,31,-31
6,59,56,21,0,34,-34
6,59,56,37,0,47,-47
6,61,2,20,35,0,35
6,61,4,13,315,225,90
6,61,4,19,64,33,31
6,61,4,21,0,29,-29
6,61,4,25,31,31,0
6,61,6,1,685,390,295
6,61,6,5,73,67,6
6,61,6,7,429,288,141
6,61,6,9,43,53,-10
6,61,6,13,719,426,293
6,61,6,17,867,739,128
6,61,6,19,175,141,34
6,61,6,23,108,76,32
6,61,6,29,104,69,35
6,61,6,31,38,0,38
6,61,6,33,35,27,8
6,61,6,35,36,0,36
6,61,6,37,835,472,363
6,61,6,41,157,65,92
6,61,6,45,41,60,-19
6,61,6,47,58,38,20
6,61,6,53,187,118,69
6,61,6,55,107,97,10
6,61,6,57,1106,1261,-155
6,61,6,59,425,335,90
6,61,6,63,48,32,16
6,61,6,65,292,189,103
6,61,6,67,12942,8680,4262
6,61,6,69,31,0,31
6,61,6,71,232,89,143
6,61,6,73,475,484,-9
6,61,6,75,246,270,-24
6,61,6,77,411,193,218
6,61,6,79,123,124,-1
6,61,6,81,451,245,206
6,61,6,83,119,61,58
6,61,6,85,1098,503,595
6,61,6,87,143,137,6
6,61,6,89,177,78,99
6,61,6,93,34,27,7
6,61,6,95,422,204,218
6,61,6,97,352,174,178
6,61,6,99,197,131,66
6,61,6,101,373,233,140
6,61,6,103,28,49,-21
6,61,6,107,101,71,30
6,61,6,109,23,0,23
6,61,6,111,133,81,52
6,61,6,113,446,362,84
6,61,6,115,656,719,-63
6,61,8,13,0,42,-42
6,61,8,31,0,33,-33
6,61,8,35,0,36,-36
6,61,8,41,83,58,25
6,61,8,59,0,31,-31
6,61,8,69,0,30,-30
6,61,12,86,27,0,27
6,61,12,95,35,0,35
6,61,15,3,121,100,21
6,61,15,9,36,51,-15
6,61,16,1,64,106,-42
6,61,16,27,0,45,-45
6,61,17,31,61,37,24
6,61,17,43,40,0,40
6,61,20,91,37,0,37
6,61,24,31,27,0,27
6,61,25,17,26,0,26
6,61,32,3,207,166,41
6,61,32,5,52,46,6
6,61,32,19,37,46,-9
6,61,32,31,458,608,-150
6,61,32,510,32,37,-5
6,61,36,61,0,28,-28
6,61,37,119,0,39,-39
6,61,37,183,0,33,-33
6,61,41,5,56,35,21
6,61,41,17,52,34,18
6,61,41,29,49,40,9
6,61,41,33,0,33,-33
6,61,41,39,0,40,-40
6,61,41,47,0,34,-34
6,61,41,51,50,54,-4
6,61,41,67,93,72,21
6,61,48,29,43,40,3
6,61,48,85,38,33,5
6,61,48,113,0,43,-43
6,61,48,121,0,34,-34
6,61,48,201,64,59,5
6,61,48,439,29,50,-21
6,61,48,491,0,35,-35
6,61,49,35,58,80,-22
6,61,49,49,51,99,-48
6,61,51,59,0,36,-36
6,61,53,11,58,85,-27
6,61,53,33,135,235,-100
6,61,53,35,36,0,36
6,61,53,53,73,74,-1
6,61,53,61,74,44,30
6,61,53,63,54,36,18
6,61,53,67,0,33,-33
6,63,4,13,0,35,-35
6,63,6,1,30,0,30
6,63,6,7,128,215,-87
6,63,6,13,33,35,-2
6,63,6,23,37,0,37
6,63,6,35,77,124,-47
6,63,6,37,30,35,-5
6,63,6,57,48,34,14
6,63,6,61,32,48,-16
6,63,6,67,40,46,-6
6,63,6,71,31,0,31
6,63,6,73,27,0,27
6,63,6,85,28,0,28
6,63,6,89,0,50,-50
6,63,6,91,38,0,38
6,63,32,31,149,198,-49
6,65,1,73,34,36,-2
6,65,1,89,0,64,-64
6,65,1,97,0,25,-25
6,65,2,20,82,52,30
6,65,2,90,40,41,-1
6,65,4,3,44,92,-48
6,65,4,5,52,92,-40
6,65,4,7,0,24,-24
6,65,4,12,98,186,-88
6,65,4,13,1903,2907,-1004
6,65,4,15,507,699,-192
6,65,4,17,48,53,-5
6,65,4,19,348,474,-126
6,65,4,21,185,486,-301
6,65,4,25,178,331,-153
6,65,4,27,283,406,-123
6,65,5,7,0,99,-99
6,65,5,119,34,78,-44
6,65,6,1,573,582,-9
6,65,6,5,0,33,-33
6,65,6,7,72,157,-85
6,65,6,13,471,483,-12
6,65,6,15,0,30,-30
6,65,6,17,125,151,-26
6,65,6,19,526,556,-30
6,65,6,21,0,43,-43
6,65,6,23,88,90,-2
6,65,6,25,1229,1810,-581
6,65,6,27,34,49,-15
6,65,6,29,849,993,-144
6,65,6,31,119,125,-6
6,65,6,33,34,38,-4
6,65,6,37,30796,17317,13479
6,65,6,39,93,102,-9
6,65,6,41,127,65,62
6,65,6,45,35,34,1
6,65,6,47,120,131,-11
6,65,6,51,48,48,0
6,65,6,53,310,311,-1
6,65,6,55,69,91,-22
6,65,6,57,47,95,-48
6,65,6,59,22942,19480,3462
6,65,6,61,189,292,-103
6,65,6,67,622,683,-61
6,65,6,69,39,33,6
6,65,6,71,32489,23277,9212
6,65,6,73,14553,14535,18
6,65,6,75,315,329,-14
6,65,6,77,390,197,193
6,65,6,79,233,334,-101
6,65,6,81,242,217,25
6,65,6,83,388,401,-13
6,65,6,85,802,780,22
6,65,6,87,123,113,10
6,65,6,89,116,179,-63
6,65,6,93,0,37,-37
6,65,6,95,225,213,12
6,65,6,97,208,213,-5
6,65,6,99,232,268,-36
6,65,6,101,56,61,-5
6,65,6,103,0,48,-48
6,65,6,107,319,358,-39
6,65,6,109,0,46,-46
6,65,6,111,1004,974,30
6,65,6,113,74,131,-57
6,65,6,115,40,56,-16
6,65,8,1,75,109,-34
6,65,8,5,164,199,-35
6,65,8,13,42,85,-43
6,65,8,31,89,144,-55
6,65,8,35,72,162,-90
6,65,8,37,0,35,-35
6,65,8,41,184,389,-205
6,65,8,45,0,96,-96
6,65,8,59,85,101,-16
6,65,8,69,57,114,-57
6,65,8,77,54,88,-34
6,65,8,101,31,91,-60
6,65,8,119,0,37,-37
6,65,8,123,29,104,-75
6,65,9,3,37,58,-21
6,65,9,9,62,34,28
6,65,10,3,0,36,-36
6,65,11,1,48,62,-14
6,65,12,1,0,26,-26
6,65,12,9,58,42,16
6,65,12,11,189,175,14
6,65,12,31,93,116,-23
6,65,12,33,60,57,3
6,65,12,57,70,101,-31
6,65,12,71,67,44,23
6,65,12,73,0,29,-29
6,65,12,81,0,36,-36
6,65,12,83,0,38,-38
6,65,12,86,144,123,21
6,65,12,91,0,56,-56
6,65,12,95,107,109,-2
6,65,12,97,34,34,0
6,65,12,99,107,79,28
6,65,12,103,60,55,5
6,65,12,105,44,0,44
6,65,12,111,0,43,-43
6,65,12,113,0,24,-24
6,65,12,115,28,0,28
6,65,12,117,0,29,-29
6,65,12,127,0,35,-35
6,65,13,51,0,30,-30
6,65,13,57,50,41,9
6,65,13,67,62,93,-31
6,65,13,89,51,0,51
6,65,13,97,0,31,-31
6,65,13,121,77,146,-69
6,65,13,135,93,161,-68
6,65,13,151,0,48,-48
6,65,15,1,79,118,-39
6,65,15,3,469,412,57
6,65,15,7,51,58,-7
6,65,15,9,92,121,-29
6,65,16,1,71,307,-236
6,65,16,5,0,29,-29
6,65,16,27,66,171,-105
6,65,16,55,46,159,-113
6,65,16,65,0,35,-35
6,65,16,83,0,54,-54
6,65,17,19,24,0,24
6,65,17,31,391,342,49
6,65,17,43,82,65,17
6,65,17,89,40,66,-26
6,65,17,97,122,87,35
6,65,17,197,60,55,5
6,65,17,201,0,37,-37
6,65,18,3,31,35,-4
6,65,18,57,35,41,-6
6,65,18,63,0,24,-24
6,65,18,89,37,37,0
6,65,18,97,64,137,-73
6,65,18,141,27,45,-18
6,65,18,157,0,30,-30
6,65,19,113,0,49,-49
6,65,19,153,41,37,4
6,65,20,91,76,70,6
6,65,20,173,52,93,-41
6,65,20,177,0,28,-28
6,65,20,209,0,37,-37
6,65,21,47,36,0,36
6,65,21,111,27,31,-4
6,65,22,17,48,28,20
6,65,22,51,0,40,-40
6,65,22,71,0,42,-42
6,65,24,3,43,38,5
6,65,24,5,41,0,41
6,65,24,31,96,70,26
6,65,24,33,48,36,12
6,65,24,510,26,0,26
6,65,25,9,45,30,15
6,65,25,13,37,0,37
6,65,25,17,105,88,17
6,65,25,21,42,32,10
6,65,25,25,55,51,4
6,65,25,27,36,44,-8
6,65,26,21,32,0,32
6,65,26,65,32,0,32
6,65,26,81,77,28,49
6,65,26,99,118,0,118
6,65,26,125,141,56,85
6,65,26,163,134,53,81
6,65,27,37,30,0,30
6,65,27,53,148,121,27
6,65,27,123,48,34,14
6,65,27,163,35,0,35
6,65,28,47,0,31,-31
6,65,29,47,0,44,-44
6,65,29,77,36,83,-47
6,65,29,95,73,107,-34
6,65,29,97,0,46,-46
6,65,29,183,36,64,-28
6,65,29,189,90,95,-5
6,65,30,29,0,76,-76
6,65,30,31,32,28,4
6,65,30,63,0,65,-65
6,65,31,55,75,81,-6
6,65,31,109,45,33,12
6,65,32,3,2212,2925,-713
6,65,32,5,67,71,-4
6,65,32,19,30,0,30
6,65,32,23,59,93,-34
6,65,32,31,225,360,-135
6,65,32,510,53,44,9
6,65,33,11,38,0,38
6,65,34,3,73,0,73
6,65,34,5,28,36,-8
6,65,34,13,54,0,54
6,65,34,15,31,0,31
6,65,34,17,40,0,40
6,65,34,23,67,0,67
6,65,34,25,35,0,35
6,65,34,27,42,0,42
6,65,34,29,30,0,30
6,65,34,31,42,0,42
6,65,34,35,30,0,30
6,65,35,1,160,262,-102
6,65,35,13,46,100,-54
6,65,35,43,32,76,-44
6,65,35,49,28,67,-39
6,65,36,5,123,66,57
6,65,36,29,50,57,-7
6,65,36,45,0,33,-33
6,65,36,47,92,93,-1
6,65,36,55,42,36,6
6,65,36,59,56,38,18
6,65,36,61,162,126,36
6,65,36,67,56,0,56
6,65,36,81,112,82,30
6,65,36,103,96,35,61
6,65,36,119,46,43,3
6,65,37,21,0,32,-32
6,65,37,49,38,39,-1
6,65,37,51,75,103,-28
6,65,37,67,0,42,-42
6,65,37,81,30,61,-31
6,65,37,119,63,147,-84
6,65,37,133,133,106,27
6,65,37,179,0,61,-61
6,65,37,183,61,150,-89
6,65,39,35,80,50,30
6,65,39,41,0,40,-40
6,65,39,49,124,117,7
6,65,39,57,38,0,38
6,65,39,61,43,46,-3
6,65,39,95,32,0,32
6,65,39,113,35,34,1
6,65,39,151,40,0,40
6,65,39,153,44,31,13
6,65,40,27,0,69,-69
6,65,40,31,0,40,-40
6,65,40,101,0,35,-35
6,65,40,109,57,100,-43
6,65,40,143,74,153,-79
6,65,41,5,86,157,-71
6,65,41,11,0,43,-43
6,65,41,17,73,165,-92
6,65,41,19,54,71,-17
6,65,41,29,68,154,-86
6,65,41,33,0,97,-97
6,65,41,35,28,45,-17
6,65,41,39,78,209,-131
6,65,41,41,29,0,29
6,65,41,43,0,74,-74
6,65,41,47,72,178,-106
6,65,41,51,146,230,-84
6,65,41,53,0,54,-54
6,65,41,59,0,30,-30
6,65,41,67,158,223,-65
6,65,41,71,50,32,18
6,65,42,3,69,71,-2
6,65,42,17,31,0,31
6,65,42,29,0,58,-58
6,65,42,77,44,0,44
6,65,42,91,43,37,6
6,65,42,101,81,73,8
6,65,42,133,0,35,-35
6,65,44,7,44,0,44
6,65,45,13,33,50,-17
6,65,45,15,25,42,-17
6,65,45,19,31,36,-5
6,65,45,45,0,51,-51
6,65,45,51,0,27,-27
6,65,45,79,0,33,-33
6,65,46,99,34,29,5
6,65,47,37,68,74,-6
6,65,47,93,0,38,-38
6,65,47,125,52,47,5
6,65,47,149,0,33,-33
6,65,47,157,128,99,29
6,65,47,165,0,53,-53
6,65,47,187,0,69,-69
6,65,48,27,109,113,-4
6,65,48,29,253,699,-446
6,65,48,39,0,70,-70
6,65,48,61,0,46,-46
6,65,48,85,112,319,-207
6,65,48,91,0,96,-96
6,65,48,113,298,446,-148
6,65,48,121,109,246,-137
6,65,48,141,178,251,-73
6,65,48,157,56,129,-73
6,65,48,167,0,58,-58
6,65,48,187,0,62,-62
6,65,48,201,316,718,-402
6,65,48,209,0,100,-100
6,65,48,215,0,94,-94
6,65,48,245,0,36,-36
6,65,48,309,35,49,-14
6,65,48,329,0,36,-36
6,65,48,339,56,144,-88
6,65,48,355,44,27,17
6,65,48,373,46,33,13
6,65,48,375,0,39,-39
6,65,48,397,0,68,-68
6,65,48,423,0,50,-50
6,65,48,439,275,738,-463
6,65,48,453,153,322,-169
6,65,48,491,66,293,-227
6,65,49,5,0,75,-75
6,65,49,11,87,147,-60
6,65,49,21,0,65,-65
6,65,49,35,245,688,-443
6,65,49,43,0,32,-32
6,65,49,49,205,438,-233
6,65,49,53,88,181,-93
6,65,49,57,74,152,-78
6,65,51,13,31,25,6
6,65,51,41,29,35,-6
6,65,51,59,116,134,-18
6,65,51,153,79,103,-24
6,65,51,510,0,23,-23
6,65,51,550,32,0,32
6,65,51,710,45,0,45
6,65,51,810,132,108,24
6,65,53,5,41,73,-32
6,65,53,7,0,42,-42
6,65,53,9,0,48,-48
6,65,53,11,155,197,-42
6,65,53,15,0,43,-43
6,65,53,21,0,75,-75
6,65,53,29,42,69,-27
6,65,53,33,497,629,-132
6,65,53,35,130,112,18
6,65,53,41,33,39,-6
6,65,53,53,288,378,-90
6,65,53,57,50,59,-9
6,65,53,61,212,348,-136
6,65,53,63,104,153,-49
6,65,53,65,0,34,-34
6,65,53,67,73,96,-23
6,65,53,71,0,39,-39
6,65,53,73,57,86,-29
6,65,53,77,48,119,-71
6,65,55,25,47,49,-2
6,65,55,79,72,49,23
6,65,55,133,0,25,-25
6,65,56,37,0,26,-26
6,67,1,73,35,0,35
6,67,1,89,0,31,-31
6,67,2,20,120,130,-10
6,67,2,170,25,0,25
6,67,4,3,29,0,29
6,67,4,13,834,873,-39
6,67,4,15,62,68,-6
6,67,4,19,155,215,-60
6,67,4,21,77,72,5
6,67,4,25,47,52,-5
6,67,4,27,55,36,19
6,67,5,119,47,31,16
6,67,6,1,3189,2921,268
6,67,6,5,412,498,-86
6,67,6,7,1123,895,228
6,67,6,9,174,189,-15
6,67,6,11,151,123,28
6,67,6,13,2127,2165,-38
6,67,6,15,75,91,-16
6,67,6,17,3368,3808,-440
6,67,6,19,1197,972,225
6,67,6,21,93,52,41
6,67,6,23,308,240,68
6,67,6,25,74,85,-11
6,67,6,29,465,418,47
6,67,6,31,146,108,38
6,67,6,33,159,154,5
6,67,6,35,136,98,38
6,67,6,37,2898,2506,392
6,67,6,39,128,151,-23
6,67,6,41,230,235,-5
6,67,6,43,0,45,-45
6,67,6,45,190,149,41
6,67,6,47,558,413,145
6,67,6,53,644,514,130
6,67,6,55,316,278,38
6,67,6,57,514,459,55
6,67,6,59,1002,1039,-37
6,67,6,61,8680,12942,-4262
6,67,6,63,46,40,6
6,67,6,65,683,622,61
6,67,6,69,83,38,45
6,67,6,71,708,658,50
6,67,6,73,1719,1719,0
6,67,6,75,1293,1435,-142
6,67,6,77,4037,3123,914
6,67,6,79,287,285,2
6,67,6,81,1441,1093,348
6,67,6,83,279,233,46
6,67,6,85,2651,2507,144
6,67,6,87,349,323,26
6,67,6,89,588,439,149
6,67,6,93,110,136,-26
6,67,6,95,3113,2161,952
6,67,6,97,826,657,169
6,67,6,99,1164,746,418
6,67,6,101,958,737,221
6,67,6,103,180,198,-18
6,67,6,105,0,25,-25
6,67,6,107,338,307,31
6,67,6,109,100,146,-46
6,67,6,111,381,284,97
6,67,6,113,5627,5188,439
6,67,6,115,1291,1499,-208
6,67,8,1,68,37,31
6,67,8,5,83,135,-52
6,67,8,13,33,50,-17
6,67,8,31,77,88,-11
6,67,8,35,83,71,12
6,67,8,41,155,180,-25
6,67,8,59,40,50,-10
6,67,8,67,0,33,-33
6,67,8,69,51,63,-12
6,67,8,77,0,37,-37
6,67,8,101,0,38,-38
6,67,8,123,0,45,-45
6,67,9,3,40,29,11
6,67,9,9,51,0,51
6,67,10,3,35,0,35
6,67,11,1,69,101,-32
6,67,12,9,0,36,-36
6,67,12,11,85,104,-19
6,67,12,31,74,70,4
6,67,12,33,40,38,2
6,67,12,57,81,107,-26
6,67,12,71,46,36,10
6,67,12,86,61,72,-11
6,67,12,91,0,29,-29
6,67,12,95,103,67,36
6,67,12,99,72,53,19
6,67,12,103,67,48,19
6,67,12,105,0,26,-26
6,67,12,117,0,34,-34
6,67,13,51,36,0,36
6,67,13,57,33,0,33
6,67,13,63,0,38,-38
6,67,13,67,50,63,-13
6,67,13,89,54,31,23
6,67,13,117,0,34,-34
6,67,13,121,85,100,-15
6,67,13,135,66,74,-8
6,67,15,1,72,99,-27
6,67,15,3,314,296,18
6,67,15,7,0,29,-29
6,67,15,9,84,80,4
6,67,16,1,149,206,-57
6,67,16,17,0,26,-26
6,67,16,27,60,140,-80
6,67,16,55,42,74,-32
6,67,16,83,0,42,-42
6,67,17,31,261,227,34
6,67,17,43,50,77,-27
6,67,17,97,49,33,16
6,67,17,143,42,0,42
6,67,17,197,33,0,33
6,67,17,201,0,28,-28
6,67,18,57,0,50,-50
6,67,18,97,65,63,2
6,67,19,153,53,45,8
6,67,19,163,0,30,-30
6,67,20,91,45,44,1
6,67,20,173,42,0,42
6,67,20,209,0,34,-34
6,67,21,67,0,28,-28
6,67,21,111,46,47,-1
6,67,22,33,32,0,32
6,67,22,71,0,28,-28
6,67,24,3,31,29,2
6,67,24,5,42,0,42
6,67,24,31,83,74,9
6,67,24,33,45,0,45
6,67,24,510,44,21,23
6,67,25,5,0,25,-25
6,67,25,9,32,0,32
6,67,25,17,106,98,8
6,67,25,21,27,40,-13
6,67,25,25,69,44,25
6,67,25,27,37,44,-7
6,67,26,65,28,0,28
6,67,26,81,43,0,43
6,67,26,99,29,0,29
6,67,26,125,103,60,43
6,67,26,161,38,26,12
6,67,26,163,74,0,74
6,67,27,37,0,44,-44
6,67,27,53,124,98,26
6,67,27,123,61,53,8
6,67,28,47,0,38,-38
6,67,29,47,0,26,-26
6,67,29,77,0,48,-48
6,67,29,95,41,46,-5
6,67,29,189,77,48,29
6,67,30,31,22,0,22
6,67,30,63,26,0,26
6,67,30,111,34,0,34
6,67,31,55,63,40,23
6,67,31,109,0,30,-30
6,67,32,3,822,802,20
6,67,32,5,65,88,-23
6,67,32,7,0,44,-44
6,67,32,19,62,121,-59
6,67,32,31,754,745,9
6,67,32,510,60,48,12
6,67,34,3,36,0,36
6,67,34,17,31,27,4
6,67,34,21,25,0,25
6,67,34,23,39,39,0
6,67,35,1,123,146,-23
6,67,35,13,43,0,43
6,67,35,43,0,23,-23
6,67,35,45,0,26,-26
6,67,36,5,35,32,3
6,67,36,29,47,30,17
6,67,36,45,0,35,-35
6,67,36,47,71,91,-20
6,67,36,55,36,0,36
6,67,36,61,109,137,-28
6,67,36,81,58,56,2
6,67,36,103,40,27,13
6,67,37,35,32,0,32
6,67,37,51,48,71,-23
6,67,37,63,36,0,36
6,67,37,119,51,161,-110
6,67,37,133,34,42,-8
6,67,37,183,51,71,-20
6,67,39,35,101,0,101
6,67,39,49,85,83,2
6,67,39,61,22,0,22
6,67,39,95,20,36,-16
6,67,40,27,34,26,8
6,67,40,109,83,78,5
6,67,40,143,55,122,-67
6,67,41,3,26,0,26
6,67,41,5,56,162,-106
6,67,41,11,0,51,-51
6,67,41,15,0,39,-39
6,67,41,17,65,106,-41
6,67,41,19,44,60,-16
6,67,41,29,117,220,-103
6,67,41,33,27,81,-54
6,67,41,35,67,40,27
6,67,41,39,94,193,-99
6,67,41,43,44,42,2
6,67,41,47,81,165,-84
6,67,41,51,238,364,-126
6,67,41,53,0,27,-27
6,67,41,67,208,280,-72
6,67,41,71,28,44,-16
6,67,42,3,54,54,0
6,67,42,91,27,0,27
6,67,42,101,67,46,21
6,67,44,7,43,28,15
6,67,45,83,0,68,-68
6,67,47,37,48,67,-19
6,67,47,93,0,23,-23
6,67,47,125,34,0,34
6,67,47,149,0,34,-34
6,67,47,157,61,48,13
6,67,48,27,59,108,-49
6,67,48,29,140,249,-109
6,67,48,85,60,126,-66
6,67,48,91,0,38,-38
6,67,48,113,180,198,-18
6,67,48,121,59,77,-18
6,67,48,141,102,99,3
6,67,48,157,29,77,-48
6,67,48,167,31,28,3
6,67,48,187,0,39,-39
6,67,48,201,274,419,-145
6,67,48,209,0,39,-39
6,67,48,215,0,31,-31
6,67,48,339,0,54,-54
6,67,48,439,152,247,-95
6,67,48,453,96,215,-119
6,67,48,491,78,126,-48
6,67,49,5,0,41,-41
6,67,49,11,91,59,32
6,67,49,35,184,283,-99
6,67,49,49,133,213,-80
6,67,49,57,44,83,-39
6,67,51,13,39,36,3
6,67,51,59,106,109,-3
6,67,51,107,0,33,-33
6,67,51,153,0,29,-29
6,67,51,510,30,42,-12
6,67,51,700,28,0,28
6,67,51,710,39,28,11
6,67,51,760,0,27,-27
6,67,51,810,46,34,12
6,67,53,5,0,56,-56
6,67,53,9,0,31,-31
6,67,53,11,116,192,-76
6,67,53,15,0,38,-38
6,67,53,21,0,43,-43
6,67,53,25,0,41,-41
6,67,53,29,29,0,29
6,67,53,33,471,774,-303
6,67,53,35,47,81,-34
6,67,53,53,246,299,-53
6,67,53,61,118,238,-120
6,67,53,63,107,155,-48
6,67,53,67,111,126,-15
6,67,53,73,42,63,-21
6,67,53,77,40,34,6
6,67,55,25,50,39,11
6,67,55,79,60,37,23
6,69,4,13,30,88,-58
6,69,6,1,52,56,-4
6,69,6,19,76,93,-17
6,69,6,29,0,43,-43
6,69,6,37,82,67,15
6,69,6,39,0,33,-33
6,69,6,47,409,280,129
6,69,6,53,429,494,-65
6,69,6,61,0,31,-31
6,69,6,65,33,39,-6
6,69,6,67,38,83,-45
6,69,6,71,37,0,37
6,69,6,73,56,47,9
6,69,6,75,0,36,-36
6,69,6,77,50,55,-5
6,69,6,81,39,32,7
6,69,6,85,1112,1192,-80
6,69,6,87,335,261,74
6,69,6,99,53,68,-15
6,69,32,3,41,0,41
6,71,1,73,46,58,-12
6,71,1,89,45,59,-14
6,71,2,20,123,141,-18
6,71,2,90,127,92,35
6,71,4,3,106,178,-72
6,71,4,5,53,115,-62
6,71,4,7,0,32,-32
6,71,4,12,49,89,-40
6,71,4,13,1462,3052,-1590
6,71,4,15,723,1302,-579
6,71,4,17,0,72,-72
6,71,4,19,207,500,-293
6,71,4,21,99,396,-297
6,71,4,25,99,233,-134
6,71,4,27,123,344,-221
6,71,5,7,28,106,-78
6,71,5,119,0,49,-49
6,71,5,131,28,0,28
6,71,5,143,0,46,-46
6,71,6,1,443,585,-142
6,71,6,7,89,137,-48
6,71,6,13,273,396,-123
6,71,6,15,0,46,-46
6,71,6,17,63,111,-48
6,71,6,19,425,576,-151
6,71,6,23,81,113,-32
6,71,6,25,412,447,-35
6,71,6,27,57,86,-29
6,71,6,29,991,1277,-286
6,71,6,31,95,156,-61
6,71,6,33,0,56,-56
6,71,6,35,0,63,-63
6,71,6,37,51294,33585,17709
6,71,6,39,87,138,-51
6,71,6,41,49,50,-1
6,71,6,45,35,39,-4
6,71,6,47,104,141,-37
6,71,6,51,60,53,7
6,71,6,53,184,257,-73
6,71,6,55,50,87,-37
6,71,6,57,26,70,-44
6,71,6,59,9468,8961,507
6,71,6,61,89,232,-143
6,71,6,63,0,31,-31
6,71,6,65,23277,32489,-9212
6,71,6,67,658,708,-50
6,71,6,69,0,37,-37
6,71,6,73,3826,4910,-1084
6,71,6,75,187,216,-29
6,71,6,77,270,342,-72
6,71,6,79,231,371,-140
6,71,6,81,177,213,-36
6,71,6,83,321,380,-59
6,71,6,85,534,435,99
6,71,6,87,76,101,-25
6,71,6,89,80,172,-92
6,71,6,93,0,47,-47
6,71,6,95,176,171,5
6,71,6,97,122,213,-91
6,71,6,99,225,233,-8
6,71,6,101,60,32,28
6,71,6,103,0,82,-82
6,71,6,107,263,453,-190
6,71,6,109,28,49,-21
6,71,6,111,741,845,-104
6,71,6,113,71,61,10
6,71,6,115,0,42,-42
6,71,8,1,94,246,-152
6,71,8,5,161,163,-2
6,71,8,13,27,46,-19
6,71,8,14,0,35,-35
6,71,8,31,115,140,-25
6,71,8,35,69,151,-82
6,71,8,41,305,438,-133
6,71,8,45,0,52,-52
6,71,8,59,67,107,-40
6,71,8,67,0,40,-40
6,71,8,69,47,162,-115
6,71,8,77,39,105,-66
6,71,8,85,0,33,-33
6,71,8,101,0,68,-68
6,71,8,123,49,131,-82
6,71,9,1,31,40,-9
6,71,9,3,43,0,43
6,71,9,9,38,0,38
6,71,9,11,0,33,-33
6,71,11,1,64,42,22
6,71,12,1,25,0,25
6,71,12,5,23,0,23
6,71,12,9,41,41,0
6,71,12,11,168,108,60
6,71,12,19,0,34,-34
6,71,12,21,0,24,-24
6,71,12,31,114,78,36
6,71,12,33,81,87,-6
6,71,12,57,102,95,7
6,71,12,71,54,24,30
6,71,12,86,124,113,11
6,71,12,91,53,61,-8
6,71,12,95,106,104,2
6,71,12,97,37,0,37
6,71,12,99,59,46,13
6,71,12,101,41,42,-1
6,71,12,103,45,65,-20
6,71,12,105,43,38,5
6,71,12,117,29,37,-8
6,71,12,127,30,40,-10
6,71,13,39,30,33,-3
6,71,13,51,36,63,-27
6,71,13,53,53,48,5
6,71,13,57,0,36,-36
6,71,13,63,0,89,-89
6,71,13,67,74,99,-25
6,71,13,89,62,70,-8
6,71,13,97,0,39,-39
6,71,13,121,53,159,-106
6,71,13,135,97,164,-67
6,71,13,151,31,38,-7
6,71,13,153,0,45,-45
6,71,13,179,55,91,-36
6,71,13,215,82,42,40
6,71,13,245,36,65,-29
6,71,15,1,36,75,-39
6,71,15,3,464,568,-104
6,71,15,7,0,47,-47
6,71,15,9,67,76,-9
6,71,16,1,75,271,-196
6,71,16,5,0,58,-58
6,71,16,17,0,51,-51
6,71,16,19,0,73,-73
6,71,16,27,44,231,-187
6,71,16,55,28,123,-95
6,71,16,83,0,41,-41
6,71,17,19,31,0,31
6,71,17,31,363,344,19
6,71,17,43,63,102,-39
6,71,17,89,50,92,-42
6,71,17,97,64,91,-27
6,71,17,111,30,0,30
6,71,17,119,0,29,-29
6,71,17,167,32,0,32
6,71,17,197,52,69,-17
6,71,17,201,39,0,39
6,71,18,3,46,52,-6
6,71,18,39,48,0,48
6,71,18,89,35,50,-15
6,71,18,97,107,155,-48
6,71,18,141,58,36,22
6,71,18,157,0,33,-33
6,71,19,153,36,74,-38
6,71,20,61,80,152,-72
6,71,20,91,72,71,1
6,71,20,103,0,131,-131
6,71,20,161,0,65,-65
6,71,20,173,76,148,-72
6,71,21,47,132,97,35
6,71,21,67,0,30,-30
6,71,21,93,96,120,-24
6,71,21,111,55,53,2
6,71,21,163,0,47,-47
6,71,22,17,0,32,-32
6,71,22,33,0,56,-56
6,71,22,51,0,49,-49
6,71,22,71,0,34,-34
6,71,22,115,84,34,50
6,71,24,3,67,76,-9
6,71,24,5,48,29,19
6,71,24,17,0,33,-33
6,71,24,25,77,70,7
6,71,24,31,94,118,-24
6,71,24,33,53,41,12
6,71,24,510,25,33,-8
6,71,25,9,33,49,-16
6,71,25,17,76,86,-10
6,71,25,21,0,28,-28
6,71,25,25,39,42,-3
6,71,25,27,52,48,4
6,71,26,21,34,0,34
6,71,26,49,45,0,45
6,71,26,65,0,26,-26
6,71,26,81,34,46,-12
6,71,26,99,40,40,0
6,71,26,125,75,52,23
6,71,26,139,29,29,0
6,71,26,161,39,0,39
6,71,26,163,121,57,64
6,71,27,53,93,68,25
6,71,27,123,29,37,-8
6,71,28,47,28,27,1
6,71,29,47,0,52,-52
6,71,29,77,45,93,-48
6,71,29,95,75,100,-25
6,71,29,97,0,33,-33
6,71,29,145,0,23,-23
6,71,29,169,88,65,23
6,71,29,183,54,0,54
6,71,29,189,78,61,17
6,71,29,213,0,27,-27
6,71,29,225,0,29,-29
6,71,29,510,33,0,33
6,71,30,13,0,36,-36
6,71,30,29,30,44,-14
6,71,30,31,0,42,-42
6,71,30,63,0,43,-43
6,71,30,111,0,57,-57
6,71,31,55,66,93,-27
6,71,31,109,0,42,-42
6,71,32,3,2452,3807,-1355
6,71,32,5,45,59,-14
6,71,32,7,0,53,-53
6,71,32,19,63,75,-12
6,71,32,23,83,110,-27
6,71,32,31,191,281,-90
6,71,32,510,0,36,-36
6,71,34,3,34,30,4
6,71,34,7,30,0,30
6,71,34,13,33,0,33
6,71,34,17,38,38,0
6,71,34,23,116,43,73
6,71,34,25,25,0,25
6,71,34,29,29,0,29
6,71,34,39,34,0,34
6,71,35,1,142,259,-117
6,71,35,5,0,58,-58
6,71,35,13,47,129,-82
6,71,35,35,0,33,-33
6,71,35,43,35,101,-66
6,71,35,45,0,35,-35
6,71,35,61,0,61,-61
6,71,36,5,87,40,47
6,71,36,29,30,39,-9
6,71,36,45,167,94,73
6,71,36,47,70,142,-72
6,71,36,55,30,33,-3
6,71,36,59,48,0,48
6,71,36,61,102,115,-13
6,71,36,81,106,95,11
6,71,36,103,30,52,-22
6,71,36,119,44,38,6
6,71,37,25,0,46,-46
6,71,37,49,111,156,-45
6,71,37,51,177,227,-50
6,71,37,63,0,54,-54
6,71,37,67,0,28,-28
6,71,37,71,0,31,-31
6,71,37,81,0,78,-78
6,71,37,119,76,149,-73
6,71,37,133,376,398,-22
6,71,37,183,71,96,-25
6,71,39,17,0,43,-43
6,71,39,35,103,83,20
6,71,39,49,98,127,-29
6,71,39,61,52,0,52
6,71,39,95,35,0,35
6,71,39,113,0,44,-44
6,71,39,151,26,0,26
6,71,39,153,32,30,2
6,71,40,27,51,56,-5
6,71,40,31,116,97,19
6,71,40,109,113,162,-49
6,71,40,143,117,151,-34
6,71,41,3,22,58,-36
6,71,41,5,84,117,-33
6,71,41,11,0,59,-59
6,71,41,15,0,26,-26
6,71,41,17,35,111,-76
6,71,41,19,35,71,-36
6,71,41,29,66,128,-62
6,71,41,33,33,65,-32
6,71,41,35,0,71,-71
6,71,41,39,106,147,-41
6,71,41,43,0,100,-100
6,71,41,47,57,126,-69
6,71,41,51,122,221,-99
6,71,41,53,0,49,-49
6,71,41,59,0,36,-36
6,71,41,67,83,168,-85
6,71,41,71,0,35,-35
6,71,42,3,66,76,-10
6,71,42,17,38,0,38
6,71,42,29,0,30,-30
6,71,42,45,27,0,27
6,71,42,101,67,58,9
6,71,44,7,50,28,22
6,71,45,7,0,36,-36
6,71,45,13,94,178,-84
6,71,45,19,0,47,-47
6,71,45,45,27,36,-9
6,71,45,79,78,96,-18
6,71,45,91,0,40,-40
6,71,46,103,0,30,-30
6,71,47,37,41,117,-76
6,71,47,65,41,47,-6
6,71,47,93,0,60,-60
6,71,47,125,168,190,-22
6,71,47,149,0,36,-36
6,71,47,157,56,81,-25
6,71,47,165,0,29,-29
6,71,47,187,0,46,-46
6,71,48,27,378,471,-93
6,71,48,29,334,1012,-678
6,71,48,39,0,49,-49
6,71,48,41,30,26,4
6,71,48,61,33,75,-42
6,71,48,85,123,315,-192
6,71,48,91,0,70,-70
6,71,48,99,80,120,-40
6,71,48,113,263,539,-276
6,71,48,121,78,240,-162
6,71,48,135,31,0,31
6,71,48,139,0,45,-45
6,71,48,141,306,533,-227
6,71,48,157,53,104,-51
6,71,48,167,0,59,-59
6,71,48,187,0,71,-71
6,71,48,201,393,944,-551
6,71,48,209,0,66,-66
6,71,48,215,34,114,-80
6,71,48,245,0,56,-56
6,71,48,251,25,53,-28
6,71,48,257,0,44,-44
6,71,48,303,50,33,17
6,71,48,309,0,34,-34
6,71,48,329,0,52,-52
6,71,48,339,53,139,-86
6,71,48,355,33,40,-7
6,71,48,367,0,37,-37
6,71,48,373,0,31,-31
6,71,48,375,0,47,-47
6,71,48,381,0,37,-37
6,71,48,423,0,37,-37
6,71,48,439,361,792,-431
6,71,48,453,90,261,-171
6,71,48,485,0,29,-29
6,71,48,491,78,271,-193
6,71,49,5,0,69,-69
6,71,49,11,78,166,-88
6,71,49,21,0,86,-86
6,71,49,35,223,745,-522
6,71,49,45,0,48,-48
6,71,49,49,156,333,-177
6,71,49,51,0,35,-35
6,71,49,53,82,198,-116
6,71,49,57,48,140,-92
6,71,51,13,0,28,-28
6,71,51,59,112,148,-36
6,71,51,107,36,31,5
6,71,51,153,179,170,9
6,71,51,177,39,39,0
6,71,51,179,116,94,22
6,71,51,510,0,24,-24
6,71,51,550,0,38,-38
6,71,51,700,69,46,23
6,71,51,710,73,46,27
6,71,51,810,144,68,76
6,71,53,5,0,66,-66
6,71,53,11,83,222,-139
6,71,53,15,0,46,-46
6,71,53,21,0,75,-75
6,71,53,25,0,46,-46
6,71,53,29,38,51,-13
6,71,53,33,311,564,-253
6,71,53,35,133,105,28
6,71,53,53,368,586,-218
6,71,53,57,0,32,-32
6,71,53,61,147,284,-137
6,71,53,63,135,186,-51
6,71,53,67,61,140,-79
6,71,53,71,29,0,29
6,71,53,73,48,59,-11
6,71,53,77,65,117,-52
6,71,55,25,35,29,6
6,71,55,79,77,45,32
6,71,56,21,40,40,0
6,71,56,25,0,31,-31
6,73,1,3,0,51,-51
6,73,1,73,92,150,-58
6,73,1,81,0,25,-25
6,73,1,89,71,120,-49
6,73,1,97,96,91,5
6,73,1,101,75,49,26
6,73,1,117,28,48,-20
6,73,1,125,0,32,-32
6,73,2,13,0,27,-27
6,73,2,16,32,0,32
6,73,2,20,175,195,-20
6,73,2,90,88,74,14
6,73,2,110,0,43,-43
6,73,2,122,0,43,-43
6,73,2,150,29,54,-25
6,73,2,170,30,50,-20
6,73,4,1,42,63,-21
6,73,4,3,134,203,-69
6,73,4,5,161,163,-2
6,73,4,7,35,64,-29
6,73,4,9,0,38,-38
6,73,4,13,3967,4998,-1031
6,73,4,15,372,454,-82
6,73,4,17,73,123,-50
6,73,4,19,1062,1178,-116
6,73,4,21,224,517,-293
6,73,4,23,62,58,4
6,73,4,25,374,417,-43
6,73,4,27,750,816,-66
6,73,5,7,64,84,-20
6,73,5,31,29,0,29
6,73,5,51,0,48,-48
6,73,5,119,97,95,2
6,73,5,131,33,43,-10
6,73,5,143,65,58,7
6,73,6,1,1705,1852,-147
6,73,6,5,29,34,-5
6,73,6,7,270,227,43
6,73,6,9,36,60,-24
6,73,6,13,1237,1048,189
6,73,6,15,27,41,-14
6,73,6,17,303,293,10
6,73,6,19,976,874,102
6,73,6,21,0,28,-28
6,73,6,23,153,260,-107
6,73,6,25,1734,1570,164
6,73,6,27,51,47,4
6,73,6,29,1214,1123,91
6,73,6,31,567,520,47
6,73,6,33,57,61,-4
6,73,6,35,41,46,-5
6,73,6,37,14061,12936,1125
6,73,6,39,128,117,11
6,73,6,41,282,297,-15
6,73,6,43,0,49,-49
6,73,6,45,51,77,-26
6,73,6,47,367,221,146
6,73,6,51,88,104,-16
6,73,6,53,864,702,162
6,73,6,55,120,160,-40
6,73,6,57,113,167,-54
6,73,6,59,8621,8370,251
6,73,6,61,484,475,9
6,73,6,63,0,27,-27
6,73,6,65,14535,14553,-18
6,73,6,67,1719,1719,0
6,73,6,69,47,56,-9
6,73,6,71,4910,3826,1084
6,73,6,75,1297,1811,-514
6,73,6,77,711,510,201
6,73,6,79,625,596,29
6,73,6,81,909,1047,-138
6,73,6,83,969,778,191
6,73,6,85,2311,2439,-128
6,73,6,87,388,376,12
6,73,6,89,212,224,-12
6,73,6,93,46,38,8
6,73,6,95,480,434,46
6,73,6,97,566,516,50
6,73,6,99,483,383,100
6,73,6,101,78,58,20
6,73,6,103,0,76,-76
6,73,6,105,0,32,-32
6,73,6,107,446,537,-91
6,73,6,109,75,49,26
6,73,6,111,2103,1527,576
6,73,6,113,407,317,90
6,73,6,115,46,54,-8
6,73,8,1,242,262,-20
6,73,8,5,378,486,-108
6,73,8,13,311,280,31
6,73,8,14,63,107,-44
6,73,8,31,440,501,-61
6,73,8,35,211,342,-131
6,73,8,37,64,53,11
6,73,8,41,417,700,-283
6,73,8,45,35,44,-9
6,73,8,59,238,392,-154
6,73,8,67,55,62,-7
6,73,8,69,259,280,-21
6,73,8,77,98,146,-48
6,73,8,83,0,33,-33
6,73,8,85,0,32,-32
6,73,8,97,0,29,-29
6,73,8,101,44,63,-19
6,73,8,107,25,0,25
6,73,8,117,25,22,3
6,73,8,123,96,149,-53
6,73,9,1,235,191,44
6,73,9,3,243,187,56
6,73,9,5,39,26,13
6,73,9,7,71,0,71
6,73,9,9,214,208,6
6,73,9,11,309,209,100
6,73,9,13,22,22,0
6,73,9,15,0,31,-31
6,73,10,1,33,29,4
6,73,10,3,112,79,33
6,73,10,5,29,0,29
6,73,11,1,385,452,-67
6,73,12,1,95,100,-5
6,73,12,5,74,92,-18
6,73,12,9,124,178,-54
6,73,12,11,431,312,119
6,73,12,15,32,30,2
6,73,12,17,29,0,29
6,73,12,19,126,217,-91
6,73,12,21,71,44,27
6,73,12,31,941,622,319
6,73,12,33,1002,428,574
6,73,12,35,26,29,-3
6,73,12,53,31,28,3
6,73,12,57,384,434,-50
6,73,12,61,0,49,-49
6,73,12,69,43,58,-15
6,73,12,71,123,120,3
6,73,12,73,79,37,42
6,73,12,81,116,100,16
6,73,12,83,48,62,-14
6,73,12,85,31,35,-4
6,73,12,86,478,447,31
6,73,12,87,56,59,-3
6,73,12,89,32,0,32
6,73,12,91,181,153,28
6,73,12,95,266,327,-61
6,73,12,97,64,71,-7
6,73,12,99,337,261,76
6,73,12,101,73,98,-25
6,73,12,103,236,208,28
6,73,12,105,94,72,22
6,73,12,109,74,66,8
6,73,12,111,61,53,8
6,73,12,113,361,173,188
6,73,12,115,57,77,-20
6,73,12,117,136,87,49
6,73,12,127,145,114,31
6,73,13,15,0,34,-34
6,73,13,21,33,0,33
6,73,13,39,140,72,68
6,73,13,51,63,76,-13
6,73,13,57,46,66,-20
6,73,13,59,57,32,25
6,73,13,63,69,48,21
6,73,13,67,234,223,11
6,73,13,73,0,33,-33
6,73,13,89,228,220,8
6,73,13,95,50,62,-12
6,73,13,97,0,42,-42
6,73,13,117,0,43,-43
6,73,13,121,327,317,10
6,73,13,135,181,266,-85
6,73,13,139,38,32,6
6,73,13,151,0,58,-58
6,73,13,153,28,41,-13
6,73,13,179,49,40,9
6,73,13,185,34,24,10
6,73,13,215,46,57,-11
6,73,13,217,0,28,-28
6,73,13,223,0,64,-64
6,73,13,245,41,69,-28
6,73,15,1,234,272,-38
6,73,15,3,2717,2053,664
6,73,15,7,118,161,-43
6,73,15,9,199,246,-47
6,73,16,1,256,470,-214
6,73,16,5,0,49,-49
6,73,16,13,30,20,10
6,73,16,17,0,42,-42
6,73,16,19,31,85,-54
6,73,16,27,84,218,-134
6,73,16,55,89,220,-131
6,73,16,83,33,41,-8
6,73,17,19,112,71,41
6,73,17,31,1620,1393,227
6,73,17,37,21,0,21
6,73,17,43,349,262,87
6,73,17,77,28,28,0
6,73,17,89,170,131,39
6,73,17,91,23,40,-17
6,73,17,93,0,34,-34
6,73,17,97,710,551,159
6,73,17,99,33,36,-3
6,73,17,111,106,118,-12
6,73,17,113,30,44,-14
6,73,17,115,0,26,-26
6,73,17,119,48,87,-39
6,73,17,143,61,72,-11
6,73,17,161,63,33,30
6,73,17,163,94,86,8
6,73,17,167,44,37,7
6,73,17,179,28,34,-6
6,73,17,183,33,0,33
6,73,17,197,138,146,-8
6,73,17,201,53,70,-17
6,73,18,3,94,67,27
6,73,18,35,0,26,-26
6,73,18,39,0,29,-29
6,73,18,57,103,95,8
6,73,18,63,34,53,-19
6,73,18,81,0,31,-31
6,73,18,89,80,80,0
6,73,18,91,0,39,-39
6,73,18,97,253,220,33
6,73,18,105,37,93,-56
6,73,18,127,52,62,-10
6,73,18,141,94,84,10
6,73,18,157,96,50,46
6,73,18,163,0,38,-38
6,73,19,61,27,0,27
6,73,19,103,90,48,42
6,73,19,113,36,70,-34
6,73,19,153,103,156,-53
6,73,19,155,35,0,35
6,73,19,163,62,70,-8
6,73,19,169,0,28,-28
6,73,19,193,0,31,-31
6,73,20,45,34,44,-10
6,73,20,61,40,38,2
6,73,20,91,298,264,34
6,73,20,103,60,63,-3
6,73,20,161,49,30,19
6,73,20,173,136,193,-57
6,73,20,177,54,36,18
6,73,20,209,0,38,-38
6,73,21,15,45,0,45
6,73,21,47,41,35,6
6,73,21,67,68,105,-37
6,73,21,93,39,55,-16
6,73,21,111,132,171,-39
6,73,21,117,27,45,-18
6,73,21,151,0,28,-28
6,73,22,15,37,0,37
6,73,22,17,52,48,4
6,73,22,19,35,50,-15
6,73,22,33,71,81,-10
6,73,22,51,153,146,7
6,73,22,55,54,68,-14
6,73,22,71,94,171,-77
6,73,22,73,0,36,-36
6,73,22,75,54,48,6
6,73,22,79,33,0,33
6,73,22,103,60,133,-73
6,73,23,1,22,0,22
6,73,23,5,187,97,90
6,73,23,19,67,46,21
6,73,23,23,60,42,18
6,73,23,31,68,55,13
6,73,24,3,454,296,158
6,73,24,5,195,130,65
6,73,24,9,35,30,5
6,73,24,17,86,63,23
6,73,24,21,85,81,4
6,73,24,25,75,50,25
6,73,24,27,140,88,52
6,73,24,31,548,411,137
6,73,24,33,205,165,40
6,73,24,37,174,193,-19
6,73,24,45,0,31,-31
6,73,24,510,118,95,23
6,73,25,1,90,57,33
6,73,25,3,36,26,10
6,73,25,5,97,67,30
6,73,25,9,193,157,36
6,73,25,13,74,106,-32
6,73,25,15,45,39,6
6,73,25,17,812,582,230
6,73,25,21,274,242,32
6,73,25,23,164,98,66
6,73,25,25,389,332,57
6,73,25,27,223,120,103
6,73,26,5,31,0,31
6,73,26,17,23,0,23
6,73,26,21,47,51,-4
6,73,26,25,0,38,-38
6,73,26,49,101,85,16
6,73,26,55,27,32,-5
6,73,26,65,113,53,60
6,73,26,73,28,0,28
6,73,26,75,28,0,28
6,73,26,77,83,64,19
6,73,26,81,139,115,24
6,73,26,93,30,0,30
6,73,26,99,295,134,161
6,73,26,103,32,0,32
6,73,26,111,53,0,53
6,73,26,115,39,0,39
6,73,26,121,32,0,32
6,73,26,125,499,278,221
6,73,26,139,76,49,27
6,73,26,145,56,0,56
6,73,26,147,42,0,42
6,73,26,161,366,168,198
6,73,26,163,363,219,144
6,73,27,3,78,68,10
6,73,27,13,22,0,22
6,73,27,37,125,103,22
6,73,27,53,563,418,145
6,73,27,109,25,29,-4
6,73,27,123,150,104,46
6,73,27,137,56,0,56
6,73,27,139,45,33,12
6,73,27,145,26,0,26
6,73,27,163,48,86,-38
6,73,27,171,36,0,36
6,73,28,33,0,34,-34
6,73,28,47,144,227,-83
6,73,28,49,36,0,36
6,73,28,59,226,143,83
6,73,28,75,78,70,8
6,73,28,121,0,38,-38
6,73,29,19,67,53,14
6,73,29,29,0,31,-31
6,73,29,37,72,53,19
6,73,29,43,0,47,-47
6,73,29,47,79,48,31
6,73,29,77,80,132,-52
6,73,29,95,234,252,-18
6,73,29,97,0,40,-40
6,73,29,99,45,47,-2
6,73,29,145,0,42,-42
6,73,29,161,28,0,28
6,73,29,165,46,29,17
6,73,29,169,90,79,11
6,73,29,183,92,87,5
6,73,29,189,361,296,65
6,73,29,510,70,74,-4
6,73,30,13,44,44,0
6,73,30,29,59,149,-90
6,73,30,31,48,67,-19
6,73,30,49,32,35,-3
6,73,30,63,51,95,-44
6,73,30,81,29,34,-5
6,73,30,111,29,144,-115
6,73,31,55,188,192,-4
6,73,31,109,108,105,3
6,73,31,153,73,92,-19
6,73,32,1,135,142,-7
6,73,32,3,3284,3986,-702
6,73,32,5,89,88,1
6,73,32,7,31,0,31
6,73,32,19,60,121,-61
6,73,32,23,39,60,-21
6,73,32,31,596,467,129
6,73,32,510,0,72,-72
6,73,33,9,27,33,-6
6,73,33,11,132,139,-7
6,73,33,13,37,0,37
6,73,33,15,92,97,-5
6,73,33,17,43,32,11
6,73,34,1,64,37,27
6,73,34,3,248,222,26
6,73,34,5,114,73,41
6,73,34,7,69,62,7
6,73,34,9,40,33,7
6,73,34,13,122,85,37
6,73,34,15,36,32,4
6,73,34,17,212,167,45
6,73,34,19,39,0,39
6,73,34,21,104,85,19
6,73,34,23,233,160,73
6,73,34,25,181,93,88
6,73,34,27,165,101,64
6,73,34,29,112,122,-10
6,73,34,31,50,55,-5
6,73,34,35,88,60,28
6,73,34,37,48,0,48
6,73,34,39,89,69,20
6,73,35,1,431,549,-118
6,73,35,5,26,38,-12
6,73,35,13,136,196,-60
6,73,35,15,0,45,-45
6,73,35,17,0,30,-30
6,73,35,31,45,0,45
6,73,35,35,59,51,8
6,73,35,43,52,144,-92
6,73,35,45,39,85,-46
6,73,35,49,79,114,-35
6,73,35,61,0,54,-54
6,73,36,1,107,49,58
6,73,36,5,96,125,-29
6,73,36,7,51,32,19
6,73,36,19,29,0,29
6,73,36,27,94,62,32
6,73,36,29,195,164,31
6,73,36,45,50,90,-40
6,73,36,47,347,442,-95
6,73,36,55,208,145,63
6,73,36,59,284,144,140
6,73,36,61,695,829,-134
6,73,36,63,34,36,-2
6,73,36,65,38,35,3
6,73,36,67,138,108,30
6,73,36,69,0,37,-37
6,73,36,71,104,65,39
6,73,36,79,22,0,22
6,73,36,81,431,297,134
6,73,36,83,25,39,-14
6,73,36,85,78,32,46
6,73,36,87,47,30,17
6,73,36,91,93,99,-6
6,73,36,93,45,0,45
6,73,36,101,25,36,-11
6,73,36,103,366,217,149
6,73,36,109,50,74,-24
6,73,36,111,42,0,42
6,73,36,117,0,26,-26
6,73,36,119,226,150,76
6,73,37,1,25,0,25
6,73,37,21,70,84,-14
6,73,37,25,24,52,-28
6,73,37,31,45,72,-27
6,73,37,49,306,286,20
6,73,37,51,158,185,-27
6,73,37,63,73,133,-60
6,73,37,67,102,50,52
6,73,37,71,28,0,28
6,73,37,81,78,79,-1
6,73,37,89,0,41,-41
6,73,37,97,0,33,-33
6,73,37,101,0,37,-37
6,73,37,105,0,24,-24
6,73,37,119,190,454,-264
6,73,37,129,105,103,2
6,73,37,133,982,1059,-77
6,73,37,135,45,95,-50
6,73,37,147,0,33,-33
6,73,37,179,0,51,-51
6,73,37,183,252,426,-174
6,73,38,17,54,36,18
6,73,38,35,31,39,-8
6,73,38,101,31,0,31
6,73,39,9,27,0,27
6,73,39,17,74,73,1
6,73,39,25,0,35,-35
6,73,39,35,355,241,114
6,73,39,41,32,76,-44
6,73,39,49,380,382,-2
6,73,39,57,40,33,7
6,73,39,61,209,172,37
6,73,39,85,51,28,23
6,73,39,89,27,41,-14
6,73,39,93,86,47,39
6,73,39,95,67,60,7
6,73,39,99,45,34,11
6,73,39,103,28,44,-16
6,73,39,113,96,97,-1
6,73,39,139,27,0,27
6,73,39,151,70,66,4
6,73,39,153,109,112,-3
6,73,39,155,41,27,14
6,73,39,165,36,37,-1
6,73,39,173,30,0,30
6,73,40,17,27,49,-22
6,73,40,27,72,126,-54
6,73,40,31,90,84,6
6,73,40,109,253,315,-62
6,73,40,131,0,38,-38
6,73,40,143,180,241,-61
6,73,41,3,70,78,-8
6,73,41,5,247,325,-78
6,73,41,7,32,50,-18
6,73,41,9,0,27,-27
6,73,41,11,0,60,-60
6,73,41,15,0,27,-27
6,73,41,17,103,276,-173
6,73,41,19,42,111,-69
6,73,41,29,171,228,-57
6,73,41,33,67,120,-53
6,73,41,35,43,80,-37
6,73,41,39,226,336,-110
6,73,41,41,38,32,6
6,73,41,43,48,87,-39
6,73,41,47,123,218,-95
6,73,41,51,484,818,-334
6,73,41,53,32,47,-15
6,73,41,57,27,0,27
6,73,41,59,0,28,-28
6,73,41,67,428,571,-143
6,73,41,71,40,50,-10
6,73,42,3,278,274,4
6,73,42,11,70,41,29
6,73,42,17,141,108,33
6,73,42,19,28,0,28
6,73,42,21,27,35,-8
6,73,42,27,44,36,8
6,73,42,29,136,132,4
6,73,42,41,67,62,5
6,73,42,43,58,40,18
6,73,42,45,116,118,-2
6,73,42,49,49,35,14
6,73,42,69,28,34,-6
6,73,42,71,68,59,9
6,73,42,77,79,53,26
6,73,42,79,40,61,-21
6,73,42,85,0,30,-30
6,73,42,89,36,33,3
6,73,42,91,248,234,14
6,73,42,95,48,0,48
6,73,42,101,268,218,50
6,73,42,129,59,54,5
6,73,42,133,99,97,2
6,73,44,3,40,38,2
6,73,44,5,222,292,-70
6,73,44,7,132,61,71
6,73,44,9,71,27,44
6,73,45,3,39,0,39
6,73,45,7,39,29,10
6,73,45,13,447,441,6
6,73,45,15,261,171,90
6,73,45,19,210,175,35
6,73,45,35,28,70,-42
6,73,45,45,81,105,-24
6,73,45,51,31,65,-34
6,73,45,57,0,35,-35
6,73,45,63,0,41,-41
6,73,45,79,56,64,-8
6,73,45,83,0,43,-43
6,73,45,91,36,63,-27
6,73,46,99,53,79,-26
6,73,46,103,31,61,-30
6,73,47,37,303,206,97
6,73,47,65,50,62,-12
6,73,47,93,85,149,-64
6,73,47,125,91,105,-14
6,73,47,149,63,134,-71
6,73,47,157,341,347,-6
6,73,47,165,45,51,-6
6,73,47,167,0,40,-40
6,73,47,187,30,106,-76
6,73,47,189,31,0,31
6,73,48,27,223,278,-55
6,73,48,29,732,1306,-574
6,73,48,39,66,128,-62
6,73,48,41,80,81,-1
6,73,48,61,85,145,-60
6,73,48,85,324,532,-208
6,73,48,91,45,78,-33
6,73,48,99,0,42,-42
6,73,48,113,781,1043,-262
6,73,48,121,234,439,-205
6,73,48,135,27,79,-52
6,73,48,139,33,53,-20
6,73,48,141,618,680,-62
6,73,48,157,142,382,-240
6,73,48,167,129,117,12
6,73,48,181,0,34,-34
6,73,48,183,29,40,-11
6,73,48,187,41,69,-28
6,73,48,201,1166,1670,-504
6,73,48,209,51,110,-59
6,73,48,213,0,33,-33
6,73,48,215,113,175,-62
6,73,48,221,0,46,-46
6,73,48,245,50,72,-22
6,73,48,251,0,67,-67
6,73,48,257,48,62,-14
6,73,48,265,0,31,-31
6,73,48,273,68,31,37
6,73,48,291,0,34,-34
6,73,48,303,70,104,-34
6,73,48,309,97,81,16
6,73,48,329,35,75,-40
6,73,48,339,127,319,-192
6,73,48,355,319,412,-93
6,73,48,361,0,26,-26
6,73,48,367,33,64,-31
6,73,48,373,26,0,26
6,73,48,375,39,0,39
6,73,48,397,43,54,-11
6,73,48,409,182,148,34
6,73,48,423,25,97,-72
6,73,48,439,728,1181,-453
6,73,48,441,35,63,-28
6,73,48,451,75,76,-1
6,73,48,453,522,915,-393
6,73,48,465,0,38,-38
6,73,48,471,0,23,-23
6,73,48,479,56,113,-57
6,73,48,485,46,71,-25
6,73,48,491,173,510,-337
6,73,49,5,81,56,25
6,73,49,11,140,178,-38
6,73,49,21,48,113,-65
6,73,49,35,680,884,-204
6,73,49,43,38,53,-15
6,73,49,45,0,40,-40
6,73,49,49,285,383,-98
6,73,49,53,62,168,-106
6,73,49,57,77,165,-88
6,73,50,7,64,62,2
6,73,50,23,0,27,-27
6,73,50,27,0,25,-25
6,73,51,3,49,67,-18
6,73,51,13,333,283,50
6,73,51,41,86,89,-3
6,73,51,59,896,948,-52
6,73,51,87,46,68,-22
6,73,51,95,34,49,-15
6,73,51,99,140,60,80
6,73,51,107,172,177,-5
6,73,51,121,32,0,32
6,73,51,153,614,736,-122
6,73,51,161,27,0,27
6,73,51,177,108,174,-66
6,73,51,179,344,457,-113
6,73,51,199,54,55,-1
6,73,51,510,171,179,-8
6,73,51,550,301,293,8
6,73,51,630,37,42,-5
6,73,51,650,163,132,31
6,73,51,700,191,148,43
6,73,51,710,531,430,101
6,73,51,740,156,91,65
6,73,51,760,65,60,5
6,73,51,800,83,73,10
6,73,51,810,1061,1119,-58
6,73,53,5,63,98,-35
6,73,53,7,32,47,-15
6,73,53,9,42,87,-45
6,73,53,11,247,444,-197
6,73,53,15,29,70,-41
6,73,53,21,0,62,-62
6,73,53,25,0,40,-40
6,73,53,29,412,462,-50
6,73,53,31,26,49,-23
6,73,53,33,1621,2064,-443
6,73,53,35,797,877,-80
6,73,53,37,43,0,43
6,73,53,41,25,37,-12
6,73,53,45,51,66,-15
6,73,53,47,0,51,-51
6,73,53,53,524,731,-207
6,73,53,57,78,137,-59
6,73,53,61,680,811,-131
6,73,53,63,262,398,-136
6,73,53,65,0,42,-42
6,73,53,67,130,247,-117
6,73,53,73,173,248,-75
6,73,53,75,0,42,-42
6,73,53,77,97,109,-12
6,73,55,9,59,99,-40
6,73,55,25,216,168,48
6,73,55,35,28,0,28
6,73,55,59,63,73,-10
6,73,55,63,26,26,0
6,73,55,73,24,0,24
6,73,55,79,247,228,19
6,73,55,87,44,0,44
6,73,55,89,25,0,25
6,73,55,101,43,45,-2
6,73,55,105,22,32,-10
6,73,55,117,33,0,33
6,73,55,127,28,30,-2
6,73,55,131,41,0,41
6,73,55,133,92,137,-45
6,73,55,139,36,26,10
6,73,56,21,28,38,-10
6,73,56,25,0,49,-49
6,73,56,29,0,25,-25
6,73,56,39,23,30,-7
6,75,1,73,32,25,7
6,75,2,20,34,29,5
6,75,4,13,515,494,21
6,75,4,19,159,81,78
6,75,6,1,7215,10526,-3311
6,75,6,5,22,0,22
6,75,6,7,138,81,57
6,75,6,9,22,0,22
6,75,6,13,4029,5178,-1149
6,75,6,17,111,99,12
6,75,6,19,311,192,119
6,75,6,23,124,88,36
6,75,6,29,130,82,48
6,75,6,33,34,46,-12
6,75,6,37,3893,3471,422
6,75,6,39,0,30,-30
6,75,6,41,1871,3058,-1187
6,75,6,45,71,113,-42
6,75,6,47,95,64,31
6,75,6,53,325,242,83
6,75,6,55,221,313,-92
6,75,6,57,128,134,-6
6,75,6,59,1168,782,386
6,75,6,61,270,246,24
6,75,6,65,329,315,14
6,75,6,67,1435,1293,142
6,75,6,69,36,0,36
6,75,6,71,216,187,29
6,75,6,73,1811,1297,514
6,75,6,77,429,411,18
6,75,6,79,306,149,157
6,75,6,81,9209,13190,-3981
6,75,6,83,491,200,291
6,75,6,85,5079,3687,1392
6,75,6,87,665,340,325
6,75,6,89,84,58,26
6,75,6,93,0,41,-41
6,75,6,95,776,927,-151
6,75,6,97,1095,1145,-50
6,75,6,99,277,217,60
6,75,6,101,23,28,-5
6,75,6,107,86,55,31
6,75,6,109,36,26,10
6,75,6,111,296,185,111
6,75,6,113,356,272,84
6,75,8,1,0,26,-26
6,75,8,5,103,38,65
6,75,8,13,183,144,39
6,75,8,31,249,260,-11
6,75,8,35,26,0,26
6,75,8,41,59,39,20
6,75,8,59,43,38,5
6,75,8,69,27,28,-1
6,75,8,97,21,0,21
6,75,9,1,173,89,84
6,75,9,3,101,58,43
6,75,9,9,169,84,85
6,75,10,3,43,0,43
6,75,11,1,549,375,174
6,75,12,1,39,0,39
6,75,12,9,29,0,29
6,75,12,11,113,120,-7
6,75,12,31,33,44,-11
6,75,12,57,92,175,-83
6,75,12,73,20,0,20
6,75,12,86,237,181,56
6,75,12,95,137,24,113
6,75,12,99,79,38,41
6,75,12,103,48,34,14
6,75,12,115,27,0,27
6,75,12,117,28,0,28
6,75,13,51,24,0,24
6,75,13,67,44,31,13
6,75,13,89,94,79,15
6,75,13,121,213,131,82
6,75,13,135,44,0,44
6,75,15,1,68,72,-4
6,75,15,3,387,350,37
6,75,15,7,0,25,-25
6,75,15,9,56,56,0
6,75,16,1,57,42,15
6,75,17,19,29,0,29
6,75,17,31,1163,990,173
6,75,17,43,62,48,14
6,75,17,89,24,0,24
6,75,17,97,75,23,52
6,75,18,57,21,0,21
6,75,18,97,44,36,8
6,75,18,105,23,0,23
6,75,18,157,20,0,20
6,75,19,103,52,0,52
6,75,19,153,28,0,28
6,75,20,45,21,0,21
6,75,20,91,63,36,27
6,75,21,111,41,48,-7
6,75,22,33,26,26,0
6,75,22,51,24,0,24
6,75,22,71,52,62,-10
6,75,23,5,58,34,24
6,75,24,3,34,0,34
6,75,24,5,62,41,21
6,75,24,27,24,0,24
6,75,24,31,196,137,59
6,75,24,33,27,28,-1
6,75,24,510,101,70,31
6,75,25,1,28,27,1
6,75,25,3,20,0,20
6,75,25,5,0,24,-24
6,75,25,9,75,64,11
6,75,25,11,23,0,23
6,75,25,13,30,0,30
6,75,25,15,78,0,78
6,75,25,17,775,416,359
6,75,25,21,170,113,57
6,75,25,23,46,36,10
6,75,25,25,689,353,336
6,75,25,27,78,42,36
6,75,26,65,49,0,49
6,75,26,77,23,0,23
6,75,26,81,55,0,55
6,75,26,99,24,0,24
6,75,26,125,162,57,105
6,75,26,161,198,115,83
6,75,26,163,64,31,33
6,75,27,37,31,0,31
6,75,27,53,312,160,152
6,75,27,123,75,47,28
6,75,29,19,27,0,27
6,75,29,77,27,0,27
6,75,29,95,74,35,39
6,75,29,189,116,50,66
6,75,29,510,74,41,33
6,75,30,63,39,21,18
6,75,31,55,37,38,-1
6,75,32,3,355,478,-123
6,75,32,5,29,30,-1
6,75,32,31,171,149,22
6,75,33,9,33,26,7
6,75,33,11,35,21,14
6,75,33,15,33,0,33
6,75,34,3,83,74,9
6,75,34,5,24,0,24
6,75,34,7,37,0,37
6,75,34,13,69,33,36
6,75,34,17,161,82,79
6,75,34,21,50,36,14
6,75,34,23,48,49,-1
6,75,34,25,31,37,-6
6,75,34,27,46,45,1
6,75,34,35,43,26,17
6,75,34,39,47,0,47
6,75,35,1,81,102,-21
6,75,35,49,45,38,7
6,75,36,1,25,0,25
6,75,36,5,52,56,-4
6,75,36,7,23,0,23
6,75,36,27,23,0,23
6,75,36,29,60,23,37
6,75,36,47,759,828,-69
6,75,36,55,79,27,52
6,75,36,59,100,59,41
6,75,36,61,1999,1800,199
6,75,36,67,52,0,52
6,75,36,81,289,239,50
6,75,36,87,34,0,34
6,75,36,103,115,52,63
6,75,36,109,49,40,9
6,75,36,119,114,106,8
6,75,37,21,0,34,-34
6,75,37,63,70,59,11
6,75,37,119,100,62,38
6,75,37,135,70,62,8
6,75,37,183,72,69,3
6,75,39,35,124,76,48
6,75,39,49,125,85,40
6,75,39,61,101,49,52
6,75,39,95,22,0,22
6,75,39,113,26,0,26
6,75,39,153,29,0,29
6,75,40,109,0,32,-32
6,75,40,143,0,29,-29
6,75,41,5,62,66,-4
6,75,41,17,23,39,-16
6,75,41,29,38,59,-21
6,75,41,39,112,62,50
6,75,41,51,363,770,-407
6,75,41,67,123,158,-35
6,75,42,3,155,68,87
6,75,42,17,55,0,55
6,75,42,29,46,39,7
6,75,42,45,32,28,4
6,75,42,91,117,73,44
6,75,42,101,324,243,81
6,75,44,7,73,37,36
6,75,45,19,20,22,-2
6,75,47,37,75,79,-4
6,75,47,157,52,0,52
6,75,48,29,76,86,-10
6,75,48,85,62,60,2
6,75,48,113,263,205,58
6,75,48,121,39,27,12
6,75,48,141,30,40,-10
6,75,48,157,39,64,-25
6,75,48,201,290,241,49
6,75,48,439,74,50,24
6,75,48,453,225,388,-163
6,75,48,491,35,0,35
6,75,49,35,173,117,56
6,75,49,49,69,0,69
6,75,50,7,56,29,27
6,75,51,3,40,0,40
6,75,51,13,230,70,160
6,75,51,41,23,0,23
6,75,51,59,201,71,130
6,75,51,87,22,0,22
6,75,51,107,36,0,36
6,75,51,510,58,43,15
6,75,51,760,40,28,12
6,75,53,11,0,34,-34
6,75,53,33,1120,953,167
6,75,53,35,27,35,-8
6,75,53,53,38,61,-23
6,75,53,61,56,51,5
6,75,53,63,44,53,-9
6,75,53,67,33,33,0
6,75,53,73,41,27,14
6,75,55,25,86,101,-15
6,75,55,79,105,70,35
6,75,55,133,27,0,27
6,77,2,20,0,47,-47
6,77,4,13,314,476,-162
6,77,4,15,0,34,-34
6,77,4,19,62,68,-6
6,77,4,21,44,54,-10
6,77,4,27,33,79,-46
6,77,6,1,6525,6058,467
6,77,6,5,183,207,-24
6,77,6,7,153,168,-15
6,77,6,9,562,740,-178
6,77,6,11,33,0,33
6,77,6,13,1764,1875,-111
6,77,6,17,84,155,-71
6,77,6,19,551,476,75
6,77,6,23,30,79,-49
6,77,6,25,0,72,-72
6,77,6,29,265,245,20
6,77,6,31,95,69,26
6,77,6,33,50,0,50
6,77,6,35,30,0,30
6,77,6,37,804,951,-147
6,77,6,39,93,167,-74
6,77,6,41,56,52,4
6,77,6,43,0,27,-27
6,77,6,45,49,48,1
6,77,6,47,510,586,-76
6,77,6,53,230,297,-67
6,77,6,55,97,68,29
6,77,6,57,50,39,11
6,77,6,59,384,362,22
6,77,6,61,193,411,-218
6,77,6,65,197,390,-193
6,77,6,67,3123,4037,-914
6,77,6,69,55,50,5
6,77,6,71,342,270,72
6,77,6,73,510,711,-201
6,77,6,75,411,429,-18
6,77,6,79,98,93,5
6,77,6,81,793,777,16
6,77,6,83,91,84,7
6,77,6,85,3376,3328,48
6,77,6,87,97,157,-60
6,77,6,89,98,134,-36
6,77,6,95,428,445,-17
6,77,6,97,152,199,-47
6,77,6,99,5052,4219,833
6,77,6,101,105,94,11
6,77,6,103,0,83,-83
6,77,6,107,146,253,-107
6,77,6,109,125,188,-63
6,77,6,111,110,129,-19
6,77,6,113,122,176,-54
6,77,6,115,75,56,19
6,77,8,1,0,38,-38
6,77,8,31,0,27,-27
6,77,8,35,0,41,-41
6,77,8,41,56,55,1
6,77,12,11,33,0,33
6,77,12,86,33,0,33
6,77,13,13,0,48,-48
6,77,13,121,34,40,-6
6,77,13,135,0,55,-55
6,77,13,179,31,0,31
6,77,15,3,128,120,8
6,77,16,1,0,95,-95
6,77,16,27,0,49,-49
6,77,16,55,0,34,-34
6,77,17,31,88,81,7
6,77,18,57,0,37,-37
6,77,25,17,0,42,-42
6,77,26,139,59,0,59
6,77,26,163,66,0,66
6,77,27,53,47,34,13
6,77,32,3,400,351,49
6,77,32,19,27,52,-25
6,77,32,31,162,228,-66
6,77,32,510,24,0,24
6,77,35,1,0,72,-72
6,77,35,13,0,42,-42
6,77,36,61,0,39,-39
6,77,36,81,0,24,-24
6,77,37,51,0,35,-35
6,77,37,119,0,31,-31
6,77,37,133,35,0,35
6,77,37,183,0,39,-39
6,77,39,49,35,0,35
6,77,40,143,0,36,-36
6,77,41,5,0,51,-51
6,77,41,17,0,43,-43
6,77,41,29,37,29,8
6,77,41,33,0,38,-38
6,77,41,39,33,76,-43
6,77,41,47,0,60,-60
6,77,41,51,57,102,-45
6,77,41,67,40,104,-64
6,77,46,103,0,32,-32
6,77,47,37,0,29,-29
6,77,48,27,23,60,-37
6,77,48,29,0,129,-129
6,77,48,85,0,53,-53
6,77,48,113,70,98,-28
6,77,48,141,51,99,-48
6,77,48,201,76,194,-118
6,77,48,215,0,55,-55
6,77,48,439,43,133,-90
6,77,48,453,0,49,-49
6,77,48,491,0,71,-71
6,77,49,11,55,0,55
6,77,49,35,51,129,-78
6,77,49,49,0,48,-48
6,77,49,57,0,53,-53
6,77,51,810,42,0,42
6,77,53,11,0,50,-50
6,77,53,33,103,223,-120
6,77,53,35,31,52,-21
6,77,53,53,82,154,-72
6,77,53,61,56,112,-56
6,77,53,63,34,0,34
6,77,53,67,25,52,-27
6,77,53,77,0,53,-53
6,77,55,79,0,33,-33
6,79,4,13,209,232,-23
6,79,4,15,71,32,39
6,79,4,19,50,71,-21
6,79,4,21,0,36,-36
6,79,4,25,42,52,-10
6,79,6,1,260,295,-35
6,79,6,7,109,80,29
6,79,6,9,21,0,21
6,79,6,13,235,216,19
6,79,6,17,66,75,-9
6,79,6,19,628,435,193
6,79,6,23,41,83,-42
6,79,6,25,28,29,-1
6,79,6,29,842,454,388
6,79,6,31,165,96,69
6,79,6,37,1451,925,526
6,79,6,39,57,59,-2
6,79,6,41,31,67,-36
6,79,6,45,24,30,-6
6,79,6,47,93,30,63
6,79,6,53,480,293,187
6,79,6,55,38,44,-6
6,79,6,57,36,49,-13
6,79,6,59,625,462,163
6,79,6,61,124,123,1
6,79,6,65,334,233,101
6,79,6,67,285,287,-2
6,79,6,71,371,231,140
6,79,6,73,596,625,-29
6,79,6,75,149,306,-157
6,79,6,77,93,98,-5
6,79,6,81,104,143,-39
6,79,6,83,2072,1849,223
6,79,6,85,419,525,-106
6,79,6,87,136,209,-73
6,79,6,89,76,92,-16
6,79,6,95,38,59,-21
6,79,6,97,138,165,-27
6,79,6,99,146,98,48
6,79,6,107,492,221,271
6,79,6,109,43,38,5
6,79,6,111,523,369,154
6,79,6,113,62,68,-6
6,79,8,5,27,0,27
6,79,8,13,27,30,-3
6,79,8,31,0,32,-32
6,79,8,41,50,72,-22
6,79,15,1,0,28,-28
6,79,15,3,58,67,-9
6,79,15,9,27,27,0
6,79,16,1,27,68,-41
6,79,16,55,0,42,-42
6,79,17,31,42,39,3
6,79,25,17,37,0,37
6,79,32,3,239,169,70
6,79,32,31,100,63,37
6,79,35,1,0,38,-38
6,79,36,47,0,24,-24
6,79,36,61,0,33,-33
6,79,41,5,0,34,-34
6,79,41,17,0,83,-83
6,79,41,19,0,34,-34
6,79,41,29,32,54,-22
6,79,41,33,0,26,-26
6,79,41,39,41,42,-1
6,79,41,47,0,34,-34
6,79,41,51,45,127,-82
6,79,41,67,0,59,-59
6,79,48,29,0,46,-46
6,79,48,201,46,29,17
6,79,48,439,0,49,-49
6,79,49,11,0,27,-27
6,79,49,35,41,29,12
6,79,49,49,0,32,-32
6,79,49,53,30,25,5
6,79,51,59,0,30,-30
6,79,53,11,27,0,27
6,79,53,33,113,123,-10
6,79,53,35,30,0,30
6,79,53,53,29,57,-28
6,79,53,61,28,53,-25
6,79,53,63,0,30,-30
6,79,53,67,26,0,26
6,81,2,20,0,31,-31
6,81,4,13,376,428,-52
6,81,4,19,69,106,-37
6,81,6,1,5109,6594,-1485
6,81,6,5,0,45,-45
6,81,6,7,72,140,-68
6,81,6,9,0,59,-59
6,81,6,13,2449,3125,-676
6,81,6,17,134,216,-82
6,81,6,19,233,213,20
6,81,6,23,72,39,33
6,81,6,29,97,73,24
6,81,6,33,28,59,-31
6,81,6,37,1890,1697,193
6,81,6,39,53,53,0
6,81,6,41,451,492,-41
6,81,6,45,44,67,-23
6,81,6,47,119,118,1
6,81,6,53,229,195,34
6,81,6,55,126,209,-83
6,81,6,57,51,166,-115
6,81,6,59,613,497,116
6,81,6,61,245,451,-206
6,81,6,65,217,242,-25
6,81,6,67,1093,1441,-348
6,81,6,69,32,39,-7
6,81,6,71,213,177,36
6,81,6,73,1047,909,138
6,81,6,75,13190,9209,3981
6,81,6,77,777,793,-16
6,81,6,79,143,104,39
6,81,6,83,160,128,32
6,81,6,85,8936,8736,200
6,81,6,87,319,390,-71
6,81,6,89,50,104,-54
6,81,6,93,24,40,-16
6,81,6,95,700,727,-27
6,81,6,97,411,579,-168
6,81,6,99,600,471,129
6,81,6,101,0,23,-23
6,81,6,103,0,47,-47
6,81,6,107,77,40,37
6,81,6,109,28,48,-20
6,81,6,111,224,101,123
6,81,6,113,249,246,3
6,81,8,1,0,32,-32
6,81,8,5,50,53,-3
6,81,8,13,47,60,-13
6,81,8,31,78,101,-23
6,81,8,35,0,63,-63
6,81,8,41,44,46,-2
6,81,8,59,24,31,-7
6,81,8,69,28,42,-14
6,81,9,1,61,72,-11
6,81,9,3,43,0,43
6,81,9,9,78,30,48
6,81,9,11,28,0,28
6,81,11,1,90,93,-3
6,81,12,11,100,37,63
6,81,12,57,41,40,1
6,81,12,71,0,31,-31
6,81,12,86,115,99,16
6,81,12,95,77,37,40
6,81,12,99,34,36,-2
6,81,13,67,30,0,30
6,81,13,89,68,40,28
6,81,13,121,57,44,13
6,81,13,135,28,0,28
6,81,15,1,49,49,0
6,81,15,3,286,246,40
6,81,15,9,30,55,-25
6,81,16,1,30,50,-20
6,81,17,19,23,0,23
6,81,17,31,430,204,226
6,81,17,43,52,40,12
6,81,17,97,47,50,-3
6,81,17,197,28,0,28
6,81,18,97,41,0,41
6,81,20,91,50,0,50
6,81,22,71,0,31,-31
6,81,23,5,34,0,34
6,81,24,31,97,94,3
6,81,24,510,29,0,29
6,81,25,9,37,0,37
6,81,25,17,260,182,78
6,81,25,21,81,51,30
6,81,25,25,150,85,65
6,81,25,27,34,23,11
6,81,26,125,75,34,41
6,81,26,161,89,0,89
6,81,26,163,61,0,61
6,81,27,53,103,77,26
6,81,29,95,0,27,-27
6,81,29,189,83,30,53
6,81,29,510,35,0,35
6,81,31,55,57,0,57
6,81,32,3,343,525,-182
6,81,32,31,145,207,-62
6,81,34,3,79,0,79
6,81,34,13,40,0,40
6,81,34,17,76,40,36
6,81,34,21,56,0,56
6,81,34,23,92,43,49
6,81,34,27,49,0,49
6,81,35,1,55,66,-11
6,81,36,5,0,29,-29
6,81,36,29,33,0,33
6,81,36,47,91,100,-9
6,81,36,55,36,31,5
6,81,36,59,52,0,52
6,81,36,61,324,279,45
6,81,36,81,105,115,-10
6,81,36,103,42,0,42
6,81,36,109,28,0,28
6,81,36,119,37,47,-10
6,81,37,63,29,33,-4
6,81,37,119,36,58,-22
6,81,37,183,37,88,-51
6,81,39,35,50,33,17
6,81,39,49,48,40,8
6,81,39,61,27,0,27
6,81,41,3,0,27,-27
6,81,41,5,0,59,-59
6,81,41,17,0,66,-66
6,81,41,29,27,85,-58
6,81,41,33,0,35,-35
6,81,41,39,79,42,37
6,81,41,51,98,164,-66
6,81,41,67,50,142,-92
6,81,42,3,81,29,52
6,81,42,17,45,0,45
6,81,42,29,29,0,29
6,81,42,45,35,0,35
6,81,42,91,92,55,37
6,81,42,101,102,58,44
6,81,47,37,50,35,15
6,81,47,157,31,0,31
6,81,48,27,0,37,-37
6,81,48,29,42,44,-2
6,81,48,85,66,76,-10
6,81,48,113,114,113,1
6,81,48,121,0,48,-48
6,81,48,141,25,35,-10
6,81,48,157,0,39,-39
6,81,48,201,170,181,-11
6,81,48,439,86,69,17
6,81,48,453,128,149,-21
6,81,48,491,28,55,-27
6,81,49,35,135,120,15
6,81,49,49,61,60,1
6,81,51,13,77,34,43
6,81,51,59,129,69,60
6,81,53,5,0,34,-34
6,81,53,11,34,122,-88
6,81,53,33,460,502,-42
6,81,53,35,24,34,-10
6,81,53,53,47,96,-49
6,81,53,61,54,78,-24
6,81,53,63,29,0,29
6,81,53,73,0,56,-56
6,81,55,25,66,31,35
6,81,55,79,33,0,33
6,83,1,89,0,42,-42
6,83,2,20,46,36,10
6,83,4,5,0,37,-37
6,83,4,13,307,424,-117
6,83,4,15,22,31,-9
6,83,4,19,91,111,-20
6,83,4,25,28,81,-53
6,83,4,27,40,35,5
6,83,6,1,251,357,-106
6,83,6,7,52,71,-19
6,83,6,13,197,170,27
6,83,6,17,45,45,0
6,83,6,19,251,251,0
6,83,6,23,58,46,12
6,83,6,25,54,74,-20
6,83,6,29,521,601,-80
6,83,6,31,58,31,27
6,83,6,37,2285,2478,-193
6,83,6,39,35,38,-3
6,83,6,41,64,86,-22
6,83,6,47,38,38,0
6,83,6,51,28,0,28
6,83,6,53,182,237,-55
6,83,6,55,25,53,-28
6,83,6,57,0,36,-36
6,83,6,59,712,729,-17
6,83,6,61,61,119,-58
6,83,6,65,401,388,13
6,83,6,67,233,279,-46
6,83,6,71,380,321,59
6,83,6,73,778,969,-191
6,83,6,75,200,491,-291
6,83,6,77,84,91,-7
6,83,6,79,1849,2072,-223
6,83,6,81,128,160,-32
6,83,6,85,328,449,-121
6,83,6,87,118,136,-18
6,83,6,89,51,67,-16
6,83,6,95,87,109,-22
6,83,6,97,92,121,-29
6,83,6,99,94,69,25
6,83,6,107,125,143,-18
6,83,6,111,2098,2379,-281
6,83,6,113,51,76,-25
6,83,8,1,0,26,-26
6,83,8,5,31,62,-31
6,83,8,13,40,84,-44
6,83,8,31,36,79,-43
6,83,8,35,0,62,-62
6,83,8,41,506,367,139
6,83,8,59,22,36,-14
6,83,8,69,22,58,-36
6,83,9,1,31,0,31
6,83,11,1,38,24,14
6,83,12,9,0,79,-79
6,83,12,57,35,47,-12
6,83,12,86,32,44,-12
6,83,12,91,0,41,-41
6,83,12,95,32,43,-11
6,83,12,103,22,28,-6
6,83,13,135,0,38,-38
6,83,15,1,29,26,3
6,83,15,3,139,156,-17
6,83,15,9,36,69,-33
6,83,16,1,31,51,-20
6,83,16,55,0,37,-37
6,83,17,31,126,109,17
6,83,17,43,28,0,28
6,83,20,173,0,36,-36
6,83,24,31,0,35,-35
6,83,25,17,62,104,-42
6,83,25,21,29,23,6
6,83,25,25,24,37,-13
6,83,27,53,38,53,-15
6,83,29,189,0,29,-29
6,83,30,13,112,124,-12
6,83,31,153,31,0,31
6,83,32,3,342,430,-88
6,83,32,31,53,68,-15
6,83,35,1,40,77,-37
6,83,35,13,0,27,-27
6,83,35,43,0,34,-34
6,83,35,49,23,0,23
6,83,36,47,40,68,-28
6,83,36,61,69,100,-31
6,83,36,81,0,22,-22
6,83,36,103,23,22,1
6,83,36,119,0,39,-39
6,83,37,51,0,34,-34
6,83,37,119,32,0,32
6,83,37,183,0,41,-41
6,83,38,101,77,118,-41
6,83,39,35,23,0,23
6,83,39,49,24,24,0
6,83,39,57,0,37,-37
6,83,39,113,44,0,44
6,83,40,109,37,36,1
6,83,41,5,27,54,-27
6,83,41,17,25,57,-32
6,83,41,29,45,68,-23
6,83,41,39,0,75,-75
6,83,41,51,61,134,-73
6,83,41,67,41,76,-35
6,83,42,3,42,0,42
6,83,42,101,39,38,1
6,83,47,157,36,0,36
6,83,48,27,35,0,35
6,83,48,29,76,132,-56
6,83,48,113,42,70,-28
6,83,48,121,0,44,-44
6,83,48,141,38,42,-4
6,83,48,201,58,114,-56
6,83,48,439,44,77,-33
6,83,48,453,34,98,-64
6,83,48,491,0,49,-49
6,83,49,11,0,29,-29
6,83,49,35,52,128,-76
6,83,49,49,0,56,-56
6,83,49,57,0,61,-61
6,83,51,59,66,73,-7
6,83,51,107,0,32,-32
6,83,53,11,25,31,-6
6,83,53,33,164,214,-50
6,83,53,53,66,66,0
6,83,53,61,73,101,-28
6,83,53,63,47,50,-3
6,83,55,25,0,34,-34
6,83,56,21,68,106,-38
6,85,1,73,68,0,68
6,85,1,89,25,52,-27
6,85,2,20,52,39,13
6,85,2,90,26,30,-4
6,85,4,13,1261,1403,-142
6,85,4,15,0,41,-41
6,85,4,19,329,205,124
6,85,4,21,36,142,-106
6,85,4,25,0,54,-54
6,85,4,27,32,50,-18
6,85,5,7,0,40,-40
6,85,5,119,0,31,-31
6,85,6,1,10157,11839,-1682
6,85,6,5,46,100,-54
6,85,6,7,320,395,-75
6,85,6,9,68,166,-98
6,85,6,13,2165,3131,-966
6,85,6,17,327,506,-179
6,85,6,19,939,1004,-65
6,85,6,23,100,97,3
6,85,6,25,56,71,-15
6,85,6,29,354,343,11
6,85,6,31,88,96,-8
6,85,6,33,76,105,-29
6,85,6,35,0,28,-28
6,85,6,37,5136,3824,1312
6,85,6,39,307,395,-88
6,85,6,41,327,345,-18
6,85,6,43,0,43,-43
6,85,6,45,54,78,-24
6,85,6,47,1816,1674,142
6,85,6,53,1496,1244,252
6,85,6,55,137,149,-12
6,85,6,57,116,231,-115
6,85,6,59,1908,1796,112
6,85,6,61,503,1098,-595
6,85,6,63,0,28,-28
6,85,6,65,780,802,-22
6,85,6,67,2507,2651,-144
6,85,6,69,1192,1112,80
6,85,6,71,435,534,-99
6,85,6,73,2439,2311,128
6,85,6,75,3687,5079,-1392
6,85,6,77,3328,3376,-48
6,85,6,79,525,419,106
6,85,6,81,8736,8936,-200
6,85,6,83,449,328,121
6,85,6,87,2360,2374,-14
6,85,6,89,135,242,-107
6,85,6,93,29,38,-9
6,85,6,95,507,454,53
6,85,6,97,555,579,-24
6,85,6,99,2367,1896,471
6,85,6,101,125,77,48
6,85,6,103,33,90,-57
6,85,6,107,232,308,-76
6,85,6,109,96,177,-81
6,85,6,111,398,379,19
6,85,6,113,396,341,55
6,85,6,115,81,121,-40
6,85,8,1,75,63,12
6,85,8,5,117,129,-12
6,85,8,13,217,204,13
6,85,8,14,34,62,-28
6,85,8,31,163,159,4
6,85,8,35,58,192,-134
6,85,8,41,172,211,-39
6,85,8,59,82,138,-56
6,85,8,69,87,113,-26
6,85,8,123,0,62,-62
6,85,9,1,160,96,64
6,85,9,3,79,44,35
6,85,9,9,132,77,55
6,85,9,11,29,0,29
6,85,9,13,27,0,27
6,85,10,3,78,43,35
6,85,11,1,223,186,37
6,85,12,1,119,0,119
6,85,12,9,54,43,11
6,85,12,11,129,94,35
6,85,12,21,30,0,30
6,85,12,31,68,51,17
6,85,12,33,34,0,34
6,85,12,57,91,79,12
6,85,12,71,36,29,7
6,85,12,73,52,31,21
6,85,12,86,177,117,60
6,85,12,95,133,73,60
6,85,12,97,0,29,-29
6,85,12,99,151,77,74
6,85,12,103,67,56,11
6,85,12,105,33,0,33
6,85,12,117,25,0,25
6,85,13,51,35,0,35
6,85,13,67,136,98,38
6,85,13,89,139,76,63
6,85,13,117,0,33,-33
6,85,13,121,305,141,164
6,85,13,135,101,116,-15
6,85,15,1,84,98,-14
6,85,15,3,447,381,66
6,85,15,7,0,44,-44
6,85,15,9,54,92,-38
6,85,16,1,370,255,115
6,85,16,27,30,49,-19
6,85,17,19,263,23,240
6,85,17,31,1007,599,408
6,85,17,43,261,112,149
6,85,17,77,29,0,29
6,85,17,89,68,0,68
6,85,17,97,152,85,67
6,85,17,111,0,35,-35
6,85,17,113,33,0,33
6,85,17,161,27,0,27
6,85,17,197,51,25,26
6,85,18,97,101,52,49
6,85,18,105,85,0,85
6,85,18,141,44,0,44
6,85,18,157,123,42,81
6,85,19,103,54,0,54
6,85,19,113,0,29,-29
6,85,19,153,49,53,-4
6,85,19,163,0,142,-142
6,85,19,169,30,0,30
6,85,20,45,45,0,45
6,85,20,91,112,61,51
6,85,20,173,113,0,113
6,85,21,67,81,0,81
6,85,21,111,31,40,-9
6,85,22,33,28,0,28
6,85,22,51,25,35,-10
6,85,22,55,32,0,32
6,85,22,71,38,42,-4
6,85,23,5,53,0,53
6,85,24,3,54,43,11
6,85,24,5,87,48,39
6,85,24,27,62,62,0
6,85,24,31,280,183,97
6,85,24,33,116,34,82
6,85,24,510,69,34,35
6,85,25,1,24,0,24
6,85,25,5,50,0,50
6,85,25,9,98,49,49
6,85,25,15,61,23,38
6,85,25,17,769,482,287
6,85,25,21,167,90,77
6,85,25,25,206,163,43
6,85,25,27,113,48,65
6,85,26,65,55,0,55
6,85,26,77,34,0,34
6,85,26,81,50,31,19
6,85,26,99,56,0,56
6,85,26,125,267,103,164
6,85,26,139,33,0,33
6,85,26,161,334,95,239
6,85,26,163,120,56,64
6,85,27,3,38,0,38
6,85,27,37,49,44,5
6,85,27,53,287,155,132
6,85,27,123,78,51,27
6,85,27,163,35,40,-5
6,85,29,19,32,0,32
6,85,29,77,0,39,-39
6,85,29,95,70,63,7
6,85,29,161,33,0,33
6,85,29,189,183,98,85
6,85,29,510,41,0,41
6,85,30,29,0,27,-27
6,85,30,31,0,30,-30
6,85,31,55,50,37,13
6,85,31,109,43,26,17
6,85,32,3,835,1213,-378
6,85,32,5,43,160,-117
6,85,32,19,39,60,-21
6,85,32,31,348,521,-173
6,85,32,510,32,62,-30
6,85,33,9,32,0,32
6,85,33,11,101,38,63
6,85,33,15,34,0,34
6,85,34,3,157,134,23
6,85,34,5,36,0,36
6,85,34,7,43,0,43
6,85,34,13,71,40,31
6,85,34,17,194,161,33
6,85,34,21,87,49,38
6,85,34,23,372,167,205
6,85,34,25,91,35,56
6,85,34,27,126,61,65
6,85,34,31,41,0,41
6,85,34,35,73,63,10
6,85,34,39,35,0,35
6,85,35,1,121,102,19
6,85,35,13,30,59,-29
6,85,35,43,0,74,-74
6,85,35,49,26,38,-12
6,85,36,1,66,34,32
6,85,36,5,76,95,-19
6,85,36,7,37,0,37
6,85,36,27,74,0,74
6,85,36,29,122,29,93
6,85,36,47,226,195,31
6,85,36,55,146,58,88
6,85,36,59,90,42,48
6,85,36,61,632,736,-104
6,85,36,67,77,24,53
6,85,36,71,0,45,-45
6,85,36,81,171,157,14
6,85,36,83,41,0,41
6,85,36,91,49,0,49
6,85,36,103,109,70,39
6,85,36,109,110,42,68
6,85,36,119,167,87,80
6,85,37,51,26,37,-11
6,85,37,63,116,101,15
6,85,37,81,27,33,-6
6,85,37,119,110,118,-8
6,85,37,129,0,53,-53
6,85,37,133,59,0,59
6,85,37,135,65,44,21
6,85,37,183,306,400,-94
6,85,39,35,150,77,73
6,85,39,49,186,93,93
6,85,39,61,95,49,46
6,85,39,95,39,0,39
6,85,39,113,0,31,-31
6,85,39,153,41,26,15
6,85,40,31,35,0,35
6,85,40,109,32,46,-14
6,85,40,143,66,50,16
6,85,41,3,58,38,20
6,85,41,5,103,199,-96
6,85,41,17,46,115,-69
6,85,41,19,0,34,-34
6,85,41,29,73,187,-114
6,85,41,33,0,70,-70
6,85,41,35,0,38,-38
6,85,41,39,139,166,-27
6,85,41,47,58,149,-91
6,85,41,51,220,414,-194
6,85,41,67,408,505,-97
6,85,42,3,319,107,212
6,85,42,17,84,0,84
6,85,42,27,54,0,54
6,85,42,29,78,57,21
6,85,42,45,47,0,47
6,85,42,77,51,28,23
6,85,42,91,140,68,72
6,85,42,101,228,142,86
6,85,44,7,48,41,7
6,85,45,45,0,30,-30
6,85,45,77,24,0,24
6,85,45,79,0,30,-30
6,85,47,37,89,74,15
6,85,47,93,43,37,6
6,85,47,157,79,75,4
6,85,48,27,41,63,-22
6,85,48,29,141,294,-153
6,85,48,39,52,0,52
6,85,48,41,83,0,83
6,85,48,85,369,391,-22
6,85,48,91,0,45,-45
6,85,48,113,449,453,-4
6,85,48,121,122,109,13
6,85,48,141,83,110,-27
6,85,48,157,74,200,-126
6,85,48,201,522,720,-198
6,85,48,209,0,56,-56
6,85,48,215,37,56,-19
6,85,48,303,38,0,38
6,85,48,339,39,136,-97
6,85,48,439,237,280,-43
6,85,48,453,590,670,-80
6,85,48,491,141,311,-170
6,85,49,5,26,0,26
6,85,49,11,43,62,-19
6,85,49,35,221,382,-161
6,85,49,49,181,223,-42
6,85,49,57,41,0,41
6,85,50,7,73,30,43
6,85,51,3,49,0,49
6,85,51,13,97,75,22
6,85,51,59,405,282,123
6,85,51,87,57,33,24
6,85,51,107,94,72,22
6,85,51,153,60,45,15
6,85,51,510,42,44,-2
6,85,51,540,34,0,34
6,85,51,710,34,0,34
6,85,51,810,68,55,13
6,85,53,5,32,28,4
6,85,53,9,0,33,-33
6,85,53,11,89,283,-194
6,85,53,29,0,28,-28
6,85,53,33,1249,1270,-21
6,85,53,35,68,88,-20
6,85,53,53,162,263,-101
6,85,53,61,184,181,3
6,85,53,63,70,137,-67
6,85,53,67,51,68,-17
6,85,53,73,25,89,-64
6,85,53,75,26,0,26
6,85,53,77,34,48,-14
6,85,54,61,24,0,24
6,85,55,25,155,74,81
6,85,55,79,75,35,40
6,85,55,133,55,0,55
6,87,4,13,108,177,-69
6,87,4,19,30,40,-10
6,87,6,1,444,605,-161
6,87,6,5,0,26,-26
6,87,6,7,94,104,-10
6,87,6,9,39,47,-8
6,87,6,13,246,191,55
6,87,6,17,82,131,-49
6,87,6,19,181,161,20
6,87,6,23,64,81,-17
6,87,6,29,148,130,18
6,87,6,31,0,50,-50
6,87,6,33,0,40,-40
6,87,6,37,554,512,42
6,87,6,39,54,83,-29
6,87,6,41,109,85,24
6,87,6,45,51,50,1
6,87,6,47,262,188,74
6,87,6,53,1493,1665,-172
6,87,6,55,47,37,10
6,87,6,57,115,101,14
6,87,6,59,202,220,-18
6,87,6,61,137,143,-6
6,87,6,65,113,123,-10
6,87,6,67,323,349,-26
6,87,6,69,261,335,-74
6,87,6,71,101,76,25
6,87,6,73,376,388,-12
6,87,6,75,340,665,-325
6,87,6,77,157,97,60
6,87,6,79,209,136,73
6,87,6,81,390,319,71
6,87,6,83,136,118,18
6,87,6,85,2374,2360,14
6,87,6,89,48,82,-34
6,87,6,95,68,56,12
6,87,6,97,171,158,13
6,87,6,99,187,123,64
6,87,6,107,118,55,63
6,87,6,109,71,42,29
6,87,6,111,184,127,57
6,87,6,113,106,46,60
6,87,8,13,31,27,4
6,87,8,31,0,26,-26
6,87,8,41,0,26,-26
6,87,11,1,0,34,-34
6,87,15,1,38,59,-21
6,87,15,3,59,53,6
6,87,15,7,0,25,-25
6,87,15,9,35,42,-7
6,87,16,1,0,57,-57
6,87,16,27,0,45,-45
6,87,17,31,53,69,-16
6,87,25,17,31,32,-1
6,87,27,53,21,0,21
6,87,32,3,94,128,-34
6,87,32,31,58,78,-20
6,87,35,1,0,36,-36
6,87,35,49,0,29,-29
6,87,36,47,28,30,-2
6,87,36,61,37,67,-30
6,87,41,17,0,44,-44
6,87,41,29,0,73,-73
6,87,41,33,0,35,-35
6,87,41,39,39,89,-50
6,87,41,51,77,138,-61
6,87,41,67,31,79,-48
6,87,48,201,29,0,29
6,87,48,439,0,25,-25
6,87,48,453,44,53,-9
6,87,49,35,31,0,31
6,87,53,11,0,33,-33
6,87,53,33,90,131,-41
6,87,53,53,25,0,25
6,87,53,61,0,47,-47
6,87,53,63,0,28,-28
6,89,2,20,0,27,-27
6,89,4,13,82,140,-58
6,89,4,19,26,0,26
6,89,6,1,197,126,71
6,89,6,7,398,432,-34
6,89,6,9,33,0,33
6,89,6,13,254,157,97
6,89,6,15,44,0,44
6,89,6,17,84,60,24
6,89,6,19,101,73,28
6,89,6,21,47,28,19
6,89,6,23,322,282,40
6,89,6,29,52,51,1
6,89,6,33,59,0,59
6,89,6,35,131,123,8
6,89,6,37,322,170,152
6,89,6,41,51,28,23
6,89,6,45,66,55,11
6,89,6,47,59,0,59
6,89,6,49,61,49,12
6,89,6,53,70,46,24
6,89,6,55,45,24,21
6,89,6,57,34,37,-3
6,89,6,59,159,89,70
6,89,6,61,78,177,-99
6,89,6,63,50,0,50
6,89,6,65,179,116,63
6,89,6,67,439,588,-149
6,89,6,71,172,80,92
6,89,6,73,224,212,12
6,89,6,75,58,84,-26
6,89,6,77,134,98,36
6,89,6,79,92,76,16
6,89,6,81,104,50,54
6,89,6,83,67,51,16
6,89,6,85,242,135,107
6,89,6,87,82,48,34
6,89,6,93,270,265,5
6,89,6,95,145,87,58
6,89,6,97,181,194,-13
6,89,6,99,76,66,10
6,89,6,101,58,47,11
6,89,6,103,920,927,-7
6,89,6,105,223,131,92
6,89,6,107,70,41,29
6,89,6,109,40,33,7
6,89,6,111,72,50,22
6,89,6,113,115,72,43
6,89,6,115,41,40,1
6,89,15,1,26,0,26
6,89,15,3,42,0,42
6,89,16,1,29,57,-28
6,89,16,27,0,49,-49
6,89,16,55,0,28,-28
6,89,30,63,30,0,30
6,89,32,3,121,60,61
6,89,32,31,115,147,-32
6,89,41,5,0,31,-31
6,89,41,11,0,35,-35
6,89,41,15,0,37,-37
6,89,41,17,35,82,-47
6,89,41,19,30,38,-8
6,89,41,29,86,132,-46
6,89,41,33,0,63,-63
6,89,41,35,53,59,-6
6,89,41,39,60,66,-6
6,89,41,47,23,43,-20
6,89,41,51,53,68,-15
6,89,41,67,0,71,-71
6,89,48,201,27,0,27
6,89,48,439,0,50,-50
6,89,49,35,26,21,5
6,89,49,49,0,33,-33
6,89,53,11,0,30,-30
6,89,53,33,88,79,9
6,89,53,53,55,46,9
6,89,53,61,36,58,-22
6,89,53,63,42,27,15
6,91,6,57,44,34,10
6,91,6,63,0,38,-38
6,91,32,31,31,77,-46
6,93,4,13,0,28,-28
6,93,6,1,59,0,59
6,93,6,7,73,72,1
6,93,6,13,31,0,31
6,93,6,23,101,73,28
6,93,6,37,83,41,42
6,93,6,45,0,43,-43
6,93,6,59,30,0,30
6,93,6,61,27,34,-7
6,93,6,65,37,0,37
6,93,6,67,136,110,26
6,93,6,71,47,0,47
6,93,6,73,38,46,-8
6,93,6,75,41,0,41
6,93,6,81,40,24,16
6,93,6,85,38,29,9
6,93,6,89,265,270,-5
6,93,6,95,67,0,67
6,93,6,97,42,46,-4
6,93,6,103,37,45,-8
6,93,6,113,0,36,-36
6,93,32,3,29,29,0
6,93,32,31,25,49,-24
6,93,41,19,0,27,-27
6,93,41,29,135,196,-61
6,93,41,33,0,27,-27
6,93,41,35,83,108,-25
6,93,41,39,26,0,26
6,93,41,51,0,38,-38
6,93,53,33,0,26,-26
6,95,1,101,54,0,54
6,95,2,20,113,84,29
6,95,2,90,46,0,46
6,95,4,13,251,315,-64
6,95,4,19,52,69,-17
6,95,4,21,0,46,-46
6,95,6,1,2247,2033,214
6,95,6,5,39,37,2
6,95,6,7,102,163,-61
6,95,6,9,0,42,-42
6,95,6,11,110,78,32
6,95,6,13,4124,4548,-424
6,95,6,17,113,148,-35
6,95,6,19,163,151,12
6,95,6,23,71,84,-13
6,95,6,29,141,132,9
6,95,6,31,42,40,2
6,95,6,33,73,86,-13
6,95,6,35,0,42,-42
6,95,6,37,722,601,121
6,95,6,39,0,39,-39
6,95,6,41,473,468,5
6,95,6,45,34,48,-14
6,95,6,47,89,83,6
6,95,6,53,145,100,45
6,95,6,55,1889,2269,-380
6,95,6,57,27,71,-44
6,95,6,59,263,189,74
6,95,6,61,204,422,-218
6,95,6,65,213,225,-12
6,95,6,67,2161,3113,-952
6,95,6,71,171,176,-5
6,95,6,73,434,480,-46
6,95,6,75,927,776,151
6,95,6,77,445,428,17
6,95,6,79,59,38,21
6,95,6,81,727,700,27
6,95,6,83,109,87,22
6,95,6,85,454,507,-53
6,95,6,87,56,68,-12
6,95,6,89,87,145,-58
6,95,6,93,0,67,-67
6,95,6,97,549,672,-123
6,95,6,99,260,181,79
6,95,6,101,102,133,-31
6,95,6,103,60,65,-5
6,95,6,107,65,68,-3
6,95,6,111,112,66,46
6,95,6,113,1068,1370,-302
6,95,6,115,85,150,-65
6,95,8,5,0,34,-34
6,95,8,41,72,119,-47
6,95,11,1,20,0,20
6,95,12,5,0,33,-33
6,95,12,11,30,48,-18
6,95,12,57,50,33,17
6,95,12,86,27,0,27
6,95,12,91,44,63,-19
6,95,12,95,34,34,0
6,95,13,89,42,0,42
6,95,13,121,0,46,-46
6,95,13,135,0,31,-31
6,95,13,153,0,47,-47
6,95,15,3,229,229,0
6,95,16,1,0,73,-73
6,95,16,27,0,35,-35
6,95,17,31,77,56,21
6,95,17,163,82,60,22
6,95,20,173,0,51,-51
6,95,24,31,40,28,12
6,95,24,33,34,24,10
6,95,25,17,25,0,25
6,95,26,163,41,0,41
6,95,28,47,30,44,-14
6,95,28,87,49,0,49
6,95,29,189,0,42,-42
6,95,32,3,326,455,-129
6,95,32,31,113,178,-65
6,95,34,5,0,36,-36
6,95,35,1,48,66,-18
6,95,36,45,0,37,-37
6,95,36,47,0,34,-34
6,95,36,61,0,47,-47
6,95,37,51,41,45,-4
6,95,39,35,0,42,-42
6,95,40,47,39,56,-17
6,95,40,65,47,0,47
6,95,40,109,50,37,13
6,95,41,17,37,53,-16
6,95,41,29,0,39,-39
6,95,41,33,0,32,-32
6,95,41,39,0,45,-45
6,95,41,51,44,42,2
6,95,41,67,55,84,-29
6,95,42,101,33,0,33
6,95,48,27,47,60,-13
6,95,48,29,228,289,-61
6,95,48,85,34,65,-31
6,95,48,113,61,84,-23
6,95,48,121,0,46,-46
6,95,48,141,33,0,33
6,95,48,201,73,151,-78
6,95,48,439,50,70,-20
6,95,48,453,31,61,-30
6,95,48,465,36,0,36
6,95,48,485,70,0,70
6,95,49,35,75,93,-18
6,95,49,49,38,56,-18
6,95,49,53,0,39,-39
6,95,51,59,46,73,-27
6,95,51,153,0,47,-47
6,95,53,11,28,59,-31
6,95,53,33,128,124,4
6,95,53,35,42,41,1
6,95,53,53,133,112,21
6,95,53,61,70,80,-10
6,95,53,63,36,69,-33
6,95,53,67,0,49,-49
6,97,2,20,0,41,-41
6,97,2,150,0,35,-35
6,97,4,13,312,282,30
6,97,4,19,56,99,-43
6,97,4,21,0,41,-41
6,97,4,25,53,31,22
6,97,4,27,0,28,-28
6,97,6,1,888,935,-47
6,97,6,5,0,23,-23
6,97,6,7,206,226,-20
6,97,6,9,25,0,25
6,97,6,13,748,649,99
6,97,6,15,44,22,22
6,97,6,17,128,168,-40
6,97,6,19,156,181,-25
6,97,6,23,241,203,38
6,97,6,29,98,83,15
6,97,6,33,642,714,-72
6,97,6,37,746,667,79
6,97,6,41,2534,1712,822
6,97,6,45,610,501,109
6,97,6,47,65,31,34
6,97,6,53,135,113,22
6,97,6,55,661,631,30
6,97,6,57,111,123,-12
6,97,6,59,378,257,121
6,97,6,61,174,352,-178
6,97,6,65,213,208,5
6,97,6,67,657,826,-169
6,97,6,71,213,122,91
6,97,6,73,516,566,-50
6,97,6,75,1145,1095,50
6,97,6,77,199,152,47
6,97,6,79,165,138,27
6,97,6,81,579,411,168
6,97,6,83,121,92,29
6,97,6,85,579,555,24
6,97,6,87,158,171,-13
6,97,6,89,194,181,13
6,97,6,93,46,42,4
6,97,6,95,672,549,123
6,97,6,99,240,171,69
6,97,6,101,31,60,-29
6,97,6,103,44,69,-25
6,97,6,107,78,45,33
6,97,6,111,152,102,50
6,97,6,113,222,238,-16
6,97,6,115,42,66,-24
6,97,8,5,0,22,-22
6,97,8,13,45,37,8
6,97,8,31,43,26,17
6,97,8,41,24,52,-28
6,97,8,59,0,29,-29
6,97,8,69,0,37,-37
6,97,9,3,24,0,24
6,97,11,1,26,0,26
6,97,12,11,0,28,-28
6,97,12,86,45,30,15
6,97,12,99,33,0,33
6,97,12,103,35,23,12
6,97,15,1,55,74,-19
6,97,15,3,138,85,53
6,97,15,7,0,24,-24
6,97,15,9,54,43,11
6,97,16,1,44,112,-68
6,97,16,27,0,65,-65
6,97,16,55,0,37,-37
6,97,17,31,95,60,35
6,97,24,31,37,22,15
6,97,25,17,48,35,13
6,97,25,25,29,0,29
6,97,26,161,32,0,32
6,97,27,53,50,0,50
6,97,30,29,0,29,-29
6,97,32,3,192,177,15
6,97,32,5,24,44,-20
6,97,32,19,31,31,0
6,97,32,31,151,164,-13
6,97,32,510,0,31,-31
6,97,35,1,29,23,6
6,97,36,47,40,24,16
6,97,36,61,30,67,-37
6,97,37,183,0,37,-37
6,97,41,5,27,86,-59
6,97,41,17,0,76,-76
6,97,41,19,0,45,-45
6,97,41,29,87,108,-21
6,97,41,33,0,59,-59
6,97,41,39,56,106,-50
6,97,41,51,92,142,-50
6,97,41,67,37,105,-68
6,97,42,3,20,0,20
6,97,48,29,27,55,-28
6,97,48,85,0,35,-35
6,97,48,113,0,63,-63
6,97,48,201,70,64,6
6,97,48,439,39,27,12
6,97,48,453,35,69,-34
6,97,48,491,0,41,-41
6,97,49,35,29,83,-54
6,97,49,49,0,42,-42
6,97,51,59,0,36,-36
6,97,53,11,0,65,-65
6,97,53,33,173,214,-41
6,97,53,35,38,39,-1
6,97,53,53,41,77,-36
6,97,53,61,50,51,-1
6,97,53,63,36,65,-29
6,97,53,67,23,22,1
6,97,53,73,29,30,-1
6,97,55,25,0,32,-32
6,99,4,13,246,343,-97
6,99,4,19,77,70,7
6,99,4,21,0,62,-62
6,99,4,27,0,41,-41
6,99,6,1,2170,2087,83
6,99,6,5,47,69,-22
6,99,6,7,100,92,8
6,99,6,9,210,224,-14
6,99,6,13,604,678,-74
6,99,6,17,68,103,-35
6,99,6,19,519,566,-47
6,99,6,23,36,43,-7
6,99,6,29,229,261,-32
6,99,6,31,77,93,-16
6,99,6,37,788,690,98
6,99,6,39,186,199,-13
6,99,6,41,36,49,-13
6,99,6,43,131,116,15
6,99,6,45,0,47,-47
6,99,6,47,3481,3303,178
6,99,6,53,161,285,-124
6,99,6,55,0,68,-68
6,99,6,57,0,38,-38
6,99,6,59,239,245,-6
6,99,6,61,131,197,-66
6,99,6,65,268,232,36
6,99,6,67,746,1164,-418
6,99,6,69,68,53,15
6,99,6,71,233,225,8
6,99,6,73,383,483,-100
6,99,6,75,217,277,-60
6,99,6,77,4219,5052,-833
6,99,6,79,98,146,-48
6,99,6,81,471,600,-129
6,99,6,83,69,94,-25
6,99,6,85,1896,2367,-471
6,99,6,87,123,187,-64
6,99,6,89,66,76,-10
6,99,6,95,181,260,-79
6,99,6,97,171,240,-69
6,99,6,101,32,67,-35
6,99,6,103,0,27,-27
6,99,6,107,165,282,-117
6,99,6,109,449,482,-33
6,99,6,111,104,109,-5
6,99,6,113,104,127,-23
6,99,6,115,0,48,-48
6,99,8,31,0,29,-29
6,99,8,41,53,69,-16
6,99,15,3,75,61,14
6,99,15,9,0,43,-43
6,99,16,1,30,56,-26
6,99,16,27,0,33,-33
6,99,16,83,0,37,-37
6,99,17,31,61,108,-47
6,99,29,95,0,28,-28
6,99,32,3,212,350,-138
6,99,32,19,0,49,-49
6,99,32,31,164,181,-17
6,99,37,51,0,49,-49
6,99,40,109,0,37,-37
6,99,40,143,0,34,-34
6,99,41,5,0,67,-67
6,99,41,17,0,56,-56
6,99,41,19,29,54,-25
6,99,41,29,0,46,-46
6,99,41,33,28,0,28
6,99,41,35,0,36,-36
6,99,41,39,31,60,-29
6,99,41,47,0,48,-48
6,99,41,51,36,62,-26
6,99,41,67,56,79,-23
6,99,48,27,34,59,-25
6,99,48,29,43,153,-110
6,99,48,85,33,49,-16
6,99,48,111,0,38,-38
6,99,48,113,43,81,-38
6,99,48,141,44,56,-12
6,99,48,201,59,131,-72
6,99,48,439,66,93,-27
6,99,48,453,0,47,-47
6,99,49,35,0,149,-149
6,99,49,49,32,71,-39
6,99,49,57,0,40,-40
6,99,53,11,0,63,-63
6,99,53,33,98,111,-13
6,99,53,35,0,56,-56
6,99,53,53,72,94,-22
6,99,53,61,44,33,11
6,99,53,63,24,52,-28
6,99,53,77,0,53,-53
6,101,4,13,39,71,-32
6,101,6,1,101,77,24
6,101,6,7,552,511,41
6,101,6,11,145,124,21
6,101,6,13,69,66,3
6,101,6,17,33,26,7
6,101,6,19,48,41,7
6,101,6,21,45,0,45
6,101,6,29,36,47,-11
6,101,6,37,151,98,53
6,101,6,45,0,33,-33
6,101,6,53,31,60,-29
6,101,6,57,84,56,28
6,101,6,59,34,0,34
6,101,6,61,233,373,-140
6,101,6,65,61,56,5
6,101,6,67,737,958,-221
6,101,6,71,32,60,-28
6,101,6,73,58,78,-20
6,101,6,75,28,23,5
6,101,6,77,94,105,-11
6,101,6,81,23,0,23
6,101,6,85,77,125,-48
6,101,6,89,47,58,-11
6,101,6,95,133,102,31
6,101,6,97,60,31,29
6,101,6,99,67,32,35
6,101,6,103,42,29,13
6,101,6,113,260,276,-16
6,101,6,115,2248,2197,51
6,101,15,3,37,0,37
6,101,32,3,45,60,-15
6,101,32,31,0,67,-67
6,101,53,33,0,47,-47
6,101,53,53,0,30,-30
6,103,4,13,43,39,4
6,103,6,1,89,26,63
6,103,6,7,451,454,-3
6,103,6,13,65,46,19
6,103,6,17,0,34,-34
6,103,6,19,0,35,-35
6,103,6,21,211,190,21
6,103,6,23,63,63,0
6,103,6,35,45,58,-13
6,103,6,37,94,62,32
6,103,6,47,39,0,39
6,103,6,61,49,28,21
6,103,6,65,48,0,48
6,103,6,67,198,180,18
6,103,6,71,82,0,82
6,103,6,73,76,0,76
6,103,6,77,83,0,83
6,103,6,81,47,0,47
6,103,6,85,90,33,57
6,103,6,89,927,920,7
6,103,6,93,45,37,8
6,103,6,95,65,60,5
6,103,6,97,69,44,25
6,103,6,99,27,0,27
6,103,6,101,29,42,-13
6,103,6,113,59,0,59
6,103,32,3,42,28,14
6,103,32,31,40,27,13
6,103,41,29,38,34,4
6,105,6,7,0,25,-25
6,105,6,13,25,0,25
6,105,6,23,164,128,36
6,105,6,67,25,0,25
6,105,6,73,32,0,32
6,105,6,89,131,223,-92
6,107,4,13,224,250,-26
6,107,4,15,59,0,59
6,107,4,19,60,59,1
6,107,4,21,0,42,-42
6,107,4,27,41,51,-10
6,107,5,7,0,45,-45
6,107,6,1,181,140,41
6,107,6,7,81,57,24
6,107,6,13,83,134,-51
6,107,6,17,0,50,-50
6,107,6,19,2761,2943,-182
6,107,6,23,32,41,-9
6,107,6,25,62,49,13
6,107,6,29,1316,1442,-126
6,107,6,31,1323,987,336
6,107,6,37,1594,970,624
6,107,6,39,139,183,-44
6,107,6,45,0,35,-35
6,107,6,47,178,133,45
6,107,6,53,292,223,69
6,107,6,55,0,42,-42
6,107,6,59,474,326,148
6,107,6,61,71,101,-30
6,107,6,65,358,319,39
6,107,6,67,307,338,-31
6,107,6,71,453,263,190
6,107,6,73,537,446,91
6,107,6,75,55,86,-31
6,107,6,77,253,146,107
6,107,6,79,221,492,-271
6,107,6,81,40,77,-37
6,107,6,83,143,125,18
6,107,6,85,308,232,76
6,107,6,87,55,118,-63
6,107,6,89,41,70,-29
6,107,6,95,68,65,3
6,107,6,97,45,78,-33
6,107,6,99,282,165,117
6,107,6,111,265,245,20
6,107,6,113,49,57,-8
6,107,8,41,39,0,39
6,107,15,1,0,33,-33
6,107,15,3,84,36,48
6,107,16,1,45,0,45
6,107,17,31,31,47,-16
6,107,32,3,295,304,-9
6,107,32,31,83,49,34
6,107,41,47,53,0,53
6,107,41,51,0,54,-54
6,107,48,27,51,35,16
6,107,48,29,44,0,44
6,107,48,113,44,31,13
6,107,48,141,39,61,-22
6,107,48,201,0,70,-70
6,107,48,215,0,41,-41
6,107,48,439,49,75,-26
6,107,49,35,0,100,-100
6,107,49,49,30,57,-27
6,107,53,11,0,39,-39
6,107,53,33,71,87,-16
6,107,53,53,31,53,-22
6,107,53,61,0,39,-39
6,107,53,63,0,33,-33
6,107,53,77,71,0,71
6,109,6,1,188,101,87
6,109,6,7,0,30,-30
6,109,6,9,204,212,-8
6,109,6,13,96,51,45
6,109,6,17,33,32,1
6,109,6,19,63,60,3
6,109,6,23,28,0,28
6,109,6,37,73,75,-2
6,109,6,43,67,78,-11
6,109,6,47,86,88,-2
6,109,6,53,47,38,9
6,109,6,57,27,0,27
6,109,6,59,51,35,16
6,109,6,61,0,23,-23
6,109,6,65,46,0,46
6,109,6,67,146,100,46
6,109,6,71,49,28,21
6,109,6,73,49,75,-26
6,109,6,75,26,36,-10
6,109,6,77,188,125,63
6,109,6,79,38,43,-5
6,109,6,81,48,28,20
6,109,6,85,177,96,81
6,109,6,87,42,71,-29
6,109,6,89,33,40,-7
6,109,6,99,482,449,33
6,109,6,113,0,22,-22
6,109,32,3,0,33,-33
6,111,1,89,0,42,-42
6,111,2,20,36,27,9
6,111,4,3,0,33,-33
6,111,4,5,0,44,-44
6,111,4,13,716,1167,-451
6,111,4,15,92,199,-107
6,111,4,19,115,169,-54
6,111,4,21,29,117,-88
6,111,4,25,67,137,-70
6,111,4,27,48,69,-21
6,111,5,7,0,46,-46
6,111,5,143,0,49,-49
6,111,6,1,271,351,-80
6,111,6,7,65,89,-24
6,111,6,13,123,245,-122
6,111,6,17,63,102,-39
6,111,6,19,280,350,-70
6,111,6,23,44,98,-54
6,111,6,25,58,90,-32
6,111,6,27,0,24,-24
6,111,6,29,1178,1666,-488
6,111,6,31,151,132,19
6,111,6,33,0,29,-29
6,111,6,37,13923,10124,3799
6,111,6,39,49,49,0
6,111,6,41,34,104,-70
6,111,6,47,35,72,-37
6,111,6,53,471,358,113
6,111,6,55,43,30,13
6,111,6,57,29,41,-12
6,111,6,59,1177,1433,-256
6,111,6,61,81,133,-52
6,111,6,65,974,1004,-30
6,111,6,67,284,381,-97
6,111,6,71,845,741,104
6,111,6,73,1527,2103,-576
6,111,6,75,185,296,-111
6,111,6,77,129,110,19
6,111,6,79,369,523,-154
6,111,6,81,101,224,-123
6,111,6,83,2379,2098,281
6,111,6,85,379,398,-19
6,111,6,87,127,184,-57
6,111,6,89,50,72,-22
6,111,6,95,66,112,-46
6,111,6,97,102,152,-50
6,111,6,99,109,104,5
6,111,6,107,245,265,-20
6,111,6,113,58,50,8
6,111,8,1,41,118,-77
6,111,8,5,71,124,-53
6,111,8,13,33,142,-109
6,111,8,14,0,38,-38
6,111,8,31,51,99,-48
6,111,8,35,64,124,-60
6,111,8,41,72,150,-78
6,111,8,59,47,94,-47
6,111,8,69,45,82,-37
6,111,8,77,0,36,-36
6,111,8,123,0,50,-50
6,111,9,1,37,53,-16
6,111,9,3,27,0,27
6,111,9,9,26,0,26
6,111,11,1,28,49,-21
6,111,12,5,0,35,-35
6,111,12,11,53,70,-17
6,111,12,19,0,33,-33
6,111,12,31,70,81,-11
6,111,12,33,69,38,31
6,111,12,57,39,72,-33
6,111,12,86,50,61,-11
6,111,12,95,70,28,42
6,111,12,99,51,0,51
6,111,12,103,38,0,38
6,111,13,67,33,43,-10
6,111,13,121,54,61,-7
6,111,13,135,36,74,-38
6,111,15,1,45,80,-35
6,111,15,3,271,221,50
6,111,15,7,0,36,-36
6,111,15,9,32,59,-27
6,111,16,1,72,107,-35
6,111,16,27,0,122,-122
6,111,16,55,31,100,-69
6,111,17,31,139,149,-10
6,111,17,43,45,40,5
6,111,17,97,82,85,-3
6,111,18,97,39,39,0
6,111,18,141,33,0,33
6,111,20,91,0,46,-46
6,111,24,31,47,32,15
6,111,24,33,46,0,46
6,111,25,17,58,89,-31
6,111,25,21,22,0,22
6,111,25,25,0,38,-38
6,111,26,99,44,0,44
6,111,26,125,90,37,53
6,111,26,163,40,0,40
6,111,27,53,74,41,33
6,111,27,123,30,0,30
6,111,28,47,0,84,-84
6,111,29,95,31,0,31
6,111,29,183,0,47,-47
6,111,29,189,58,123,-65
6,111,29,510,27,0,27
6,111,31,55,0,30,-30
6,111,32,1,0,38,-38
6,111,32,3,779,1043,-264
6,111,32,5,26,0,26
6,111,32,23,0,36,-36
6,111,32,31,92,161,-69
6,111,33,11,25,0,25
6,111,34,17,29,0,29
6,111,34,23,38,0,38
6,111,34,29,36,0,36
6,111,35,1,64,105,-41
6,111,35,13,0,38,-38
6,111,35,49,0,32,-32
6,111,36,47,40,56,-16
6,111,36,59,43,0,43
6,111,36,61,59,115,-56
6,111,36,81,33,39,-6
6,111,36,103,0,33,-33
6,111,37,51,25,27,-2
6,111,37,63,0,37,-37
6,111,37,67,0,34,-34
6,111,37,119,34,81,-47
6,111,37,183,45,128,-83
6,111,39,35,42,35,7
6,111,39,49,56,39,17
6,111,40,27,0,39,-39
6,111,40,109,54,37,17
6,111,40,143,0,56,-56
6,111,41,5,33,101,-68
6,111,41,17,29,80,-51
6,111,41,19,0,35,-35
6,111,41,29,35,91,-56
6,111,41,33,0,42,-42
6,111,41,39,0,93,-93
6,111,41,43,0,35,-35
6,111,41,47,0,56,-56
6,111,41,51,86,149,-63
6,111,41,67,60,140,-80
6,111,41,71,0,46,-46
6,111,42,3,0,31,-31
6,111,42,17,44,39,5
6,111,42,29,31,53,-22
6,111,42,91,35,27,8
6,111,42,101,33,0,33
6,111,45,15,0,33,-33
6,111,47,37,31,0,31
6,111,47,93,0,26,-26
6,111,47,157,46,79,-33
6,111,47,187,0,34,-34
6,111,48,27,0,41,-41
6,111,48,29,50,220,-170
6,111,48,61,33,0,33
6,111,48,85,70,161,-91
6,111,48,113,97,191,-94
6,111,48,121,63,137,-74
6,111,48,141,67,67,0
6,111,48,157,0,44,-44
6,111,48,201,164,305,-141
6,111,48,209,0,41,-41
6,111,48,339,0,32,-32
6,111,48,355,41,0,41
6,111,48,439,104,302,-198
6,111,48,453,64,170,-106
6,111,48,491,0,168,-168
6,111,49,11,0,67,-67
6,111,49,35,110,218,-108
6,111,49,49,78,174,-96
6,111,49,53,26,42,-16
6,111,49,57,0,62,-62
6,111,51,59,109,118,-9
6,111,51,153,0,39,-39
6,111,51,550,0,46,-46
6,111,51,710,97,68,29
6,111,51,810,142,130,12
6,111,53,5,0,47,-47
6,111,53,11,28,75,-47
6,111,53,29,116,126,-10
6,111,53,33,249,397,-148
6,111,53,35,96,148,-52
6,111,53,53,92,122,-30
6,111,53,57,0,32,-32
6,111,53,61,120,119,1
6,111,53,63,35,122,-87
6,111,53,67,37,46,-9
6,111,53,73,0,42,-42
6,111,53,77,0,28,-28
6,111,55,79,0,36,-36
6,113,4,13,90,142,-52
6,113,4,19,28,56,-28
6,113,6,1,553,555,-2
6,113,6,5,0,29,-29
6,113,6,7,163,159,4
6,113,6,9,0,26,-26
6,113,6,11,278,218,60
6,113,6,13,413,344,69
6,113,6,17,144,136,8
6,113,6,19,154,98,56
6,113,6,23,49,51,-2
6,113,6,29,89,82,7
6,113,6,33,49,0,49
6,113,6,37,590,489,101
6,113,6,41,67,67,0
6,113,6,45,45,24,21
6,113,6,47,60,48,12
6,113,6,53,115,96,19
6,113,6,55,135,82,53
6,113,6,57,52,78,-26
6,113,6,59,212,161,51
6,113,6,61,362,446,-84
6,113,6,65,131,74,57
6,113,6,67,5188,5627,-439
6,113,6,71,61,71,-10
6,113,6,73,317,407,-90
6,113,6,75,272,356,-84
6,113,6,77,176,122,54
6,113,6,79,68,62,6
6,113,6,81,246,249,-3
6,113,6,83,76,51,25
6,113,6,85,341,396,-55
6,113,6,87,46,106,-60
6,113,6,89,72,115,-43
6,113,6,93,36,0,36
6,113,6,95,1370,1068,302
6,113,6,97,238,222,16
6,113,6,99,127,104,23
6,113,6,101,276,260,16
6,113,6,103,0,59,-59
6,113,6,107,57,49,8
6,113,6,109,22,0,22
6,113,6,111,50,58,-8
6,113,6,115,139,181,-42
6,113,8,13,0,26,-26
6,113,8,31,0,23,-23
6,113,15,3,63,31,32
6,113,17,31,59,65,-6
6,113,24,31,46,29,17
6,113,25,17,36,39,-3
6,113,25,21,29,0,29
6,113,25,25,0,22,-22
6,113,32,3,70,111,-41
6,113,32,31,112,103,9
6,113,36,61,37,35,2
6,113,36,81,0,22,-22
6,113,41,3,25,0,25
6,113,41,29,34,0,34
6,113,41,39,0,50,-50
6,113,41,51,43,41,2
6,113,41,67,26,34,-8
6,113,48,201,0,43,-43
6,113,48,453,0,36,-36
6,113,49,35,36,29,7
6,113,53,11,0,36,-36
6,113,53,33,93,107,-14
6,113,53,53,0,24,-24
6,115,2,20,38,44,-6
6,115,2,90,62,0,62
6,115,4,13,60,75,-15
6,115,6,1,89,60,29
6,115,6,7,346,345,1
6,115,6,13,93,60,33
6,115,6,17,35,52,-17
6,115,6,19,45,49,-4
6,115,6,29,0,39,-39
6,115,6,33,31,0,31
6,115,6,37,114,90,24
6,115,6,53,36,0,36
6,115,6,55,39,0,39
6,115,6,57,210,212,-2
6,115,6,59,41,0,41
6,115,6,61,719,656,63
6,115,6,65,56,40,16
6,115,6,67,1499,1291,208
6,115,6,71,42,0,42
6,115,6,73,54,46,8
6,115,6,77,56,75,-19
6,115,6,85,121,81,40
6,115,6,89,40,41,-1
6,115,6,95,150,85,65
6,115,6,97,66,42,24
6,115,6,99,48,0,48
6,115,6,101,2197,2248,-51
6,115,6,113,181,139,42
6,115,8,41,0,44,-44
6,115,15,3,54,45,9
6,115,16,39,43,0,43
6,115,32,3,55,93,-38
6,115,32,31,28,0,28
6,115,48,29,46,55,-9
6,115,48,451,37,0,37
6,115,53,53,41,44,-3
8,1,2,20,0,77,-77
8,1,2,170,0,33,-33
8,1,4,13,576,563,13
8,1,4,15,0,27,-27
8,1,4,19,101,95,6
8,1,6,1,79,35,44
8,1,6,13,40,0,40
8,1,6,19,58,43,15
8,1,6,29,50,0,50
8,1,6,37,594,266,328
8,1,6,59,219,114,105
8,1,6,65,109,75,34
8,1,6,67,37,68,-31
8,1,6,71,246,94,152
8,1,6,73,262,242,20
8,1,6,75,26,0,26
8,1,6,77,38,0,38
8,1,6,81,32,0,32
8,1,6,83,26,0,26
8,1,6,85,63,75,-12
8,1,6,111,118,41,77
8,1,8,3,29,41,-12
8,1,8,5,6951,6770,181
8,1,8,13,1831,1592,239
8,1,8,14,4058,3409,649
8,1,8,15,25,0,25
8,1,8,19,37,38,-1
8,1,8,29,0,55,-55
8,1,8,31,11406,9936,1470
8,1,8,35,794,906,-112
8,1,8,37,207,102,105
8,1,8,39,87,86,1
8,1,8,41,641,427,214
8,1,8,43,54,32,22
8,1,8,45,92,87,5
8,1,8,47,0,50,-50
8,1,8,49,28,38,-10
8,1,8,51,39,0,39
8,1,8,59,6952,6093,859
8,1,8,67,60,54,6
8,1,8,69,902,629,273
8,1,8,71,33,42,-9
8,1,8,75,59,64,-5
8,1,8,77,166,270,-104
8,1,8,81,0,31,-31
8,1,8,85,23,38,-15
8,1,8,87,151,141,10
8,1,8,89,33,0,33
8,1,8,93,61,58,3
8,1,8,101,209,189,20
8,1,8,105,31,52,-21
8,1,8,107,31,75,-44
8,1,8,117,74,42,32
8,1,8,123,2597,3083,-486
8,1,12,11,73,0,73
8,1,12,31,63,34,29
8,1,12,33,0,37,-37
8,1,12,57,53,37,16
8,1,12,71,33,38,-5
8,1,12,86,37,36,1
8,1,12,95,60,31,29
8,1,12,101,41,0,41
8,1,12,103,34,45,-11
8,1,12,117,37,0,37
8,1,15,3,51,50,1
8,1,16,1,62,49,13
8,1,17,31,149,94,55
8,1,17,89,55,0,55
8,1,17,197,28,0,28
8,1,18,97,41,0,41
8,1,19,153,38,41,-3
8,1,20,91,64,91,-27
8,1,20,173,46,48,-2
8,1,25,17,32,29,3
8,1,26,49,42,0,42
8,1,26,81,32,0,32
8,1,26,125,45,0,45
8,1,27,37,26,0,26
8,1,27,53,72,56,16
8,1,29,47,0,31,-31
8,1,29,77,40,0,40
8,1,29,95,37,30,7
8,1,29,189,28,0,28
8,1,30,111,47,47,0
8,1,31,55,113,57,56
8,1,31,109,75,34,41
8,1,31,111,0,39,-39
8,1,31,153,30,31,-1
8,1,32,3,313,360,-47
8,1,32,31,39,35,4
8,1,35,1,194,187,7
8,1,35,13,43,67,-24
8,1,35,25,0,44,-44
8,1,35,43,30,0,30
8,1,35,45,0,36,-36
8,1,35,49,34,41,-7
8,1,36,61,0,29,-29
8,1,36,81,39,0,39
8,1,37,119,43,0,43
8,1,37,133,0,35,-35
8,1,37,183,0,28,-28
8,1,39,35,31,0,31
8,1,40,27,39,0,39
8,1,40,109,42,53,-11
8,1,40,143,66,48,18
8,1,41,51,47,27,20
8,1,41,67,55,39,16
8,1,42,101,27,0,27
8,1,46,103,32,46,-14
8,1,47,157,0,43,-43
8,1,48,29,66,83,-17
8,1,48,85,81,63,18
8,1,48,113,75,74,1
8,1,48,121,40,44,-4
8,1,48,141,235,269,-34
8,1,48,167,0,32,-32
8,1,48,201,184,161,23
8,1,48,303,34,0,34
8,1,48,339,42,34,8
8,1,48,355,0,30,-30
8,1,48,375,0,46,-46
8,1,48,439,116,162,-46
8,1,48,453,57,55,2
8,1,49,11,42,41,1
8,1,49,35,100,139,-39
8,1,49,49,28,48,-20
8,1,51,59,48,35,13
8,1,53,11,32,0,32
8,1,53,33,111,124,-13
8,1,53,35,45,0,45
8,1,53,53,42,44,-2
8,1,53,61,52,44,8
8,1,55,79,38,0,38
8,1,55,133,26,0,26
8,1,56,1,36,0,36
8,1,56,21,78,120,-42
8,1,56,25,81,81,0
8,1,56,37,41,39,2
8,3,4,13,0,34,-34
8,3,8,1,41,29,12
8,3,8,5,0,33,-33
8,3,8,21,143,126,17
8,3,8,23,58,0,58
8,3,8,31,38,42,-4
8,3,8,41,60,86,-26
8,3,8,59,48,60,-12
8,3,8,69,0,30,-30
8,3,8,101,40,86,-46
8,3,8,105,209,172,37
8,5,1,73,32,0,32
8,5,2,20,73,34,39
8,5,2,90,36,0,36
8,5,4,3,0,39,-39
8,5,4,5,23,0,23
8,5,4,13,931,788,143
8,5,4,15,0,34,-34
8,5,4,19,230,151,79
8,5,4,21,29,73,-44
8,5,4,25,39,22,17
8,5,4,27,0,40,-40
8,5,5,119,39,0,39
8,5,6,1,114,86,28
8,5,6,13,78,37,41
8,5,6,19,49,58,-9
8,5,6,29,66,56,10
8,5,6,37,1063,648,415
8,5,6,53,0,32,-32
8,5,6,59,429,245,184
8,5,6,65,199,164,35
8,5,6,67,135,83,52
8,5,6,71,163,161,2
8,5,6,73,486,378,108
8,5,6,75,38,103,-65
8,5,6,79,0,27,-27
8,5,6,81,53,50,3
8,5,6,83,62,31,31
8,5,6,85,129,117,12
8,5,6,95,34,0,34
8,5,6,97,22,0,22
8,5,6,111,124,71,53
8,5,8,1,6770,6951,-181
8,5,8,3,33,0,33
8,5,8,13,680,585,95
8,5,8,14,515,464,51
8,5,8,15,0,48,-48
8,5,8,19,46,55,-9
8,5,8,29,29,51,-22
8,5,8,31,20935,18840,2095
8,5,8,35,6127,6987,-860
8,5,8,37,116,136,-20
8,5,8,39,269,379,-110
8,5,8,41,1420,951,469
8,5,8,43,80,58,22
8,5,8,45,104,67,37
8,5,8,47,25,0,25
8,5,8,49,36,85,-49
8,5,8,51,44,36,8
8,5,8,59,5150,5018,132
8,5,8,63,0,23,-23
8,5,8,65,31,39,-8
8,5,8,67,60,49,11
8,5,8,69,772,669,103
8,5,8,71,24,0,24
8,5,8,75,37,41,-4
8,5,8,77,228,277,-49
8,5,8,85,50,70,-20
8,5,8,87,74,46,28
8,5,8,93,44,107,-63
8,5,8,101,275,279,-4
8,5,8,107,68,109,-41
8,5,8,117,132,112,20
8,5,8,119,53,32,21
8,5,8,123,713,655,58
8,5,8,125,25,0,25
8,5,9,1,45,44,1
8,5,9,3,46,0,46
8,5,9,9,26,29,-3
8,5,10,3,33,0,33
8,5,11,1,43,52,-9
8,5,12,9,46,51,-5
8,5,12,11,149,74,75
8,5,12,31,102,69,33
8,5,12,33,42,0,42
8,5,12,57,102,98,4
8,5,12,71,52,49,3
8,5,12,73,37,0,37
8,5,12,83,34,0,34
8,5,12,86,97,57,40
8,5,12,91,64,0,64
8,5,12,95,129,78,51
8,5,12,99,67,89,-22
8,5,12,101,33,28,5
8,5,12,103,51,50,1
8,5,12,105,37,0,37
8,5,12,115,45,34,11
8,5,12,117,44,29,15
8,5,13,67,32,59,-27
8,5,13,89,66,46,20
8,5,13,121,39,89,-50
8,5,13,135,70,80,-10
8,5,15,3,168,148,20
8,5,16,1,87,67,20
8,5,17,19,38,0,38
8,5,17,31,299,294,5
8,5,17,43,84,52,32
8,5,17,97,60,62,-2
8,5,17,119,0,32,-32
8,5,17,197,46,37,9
8,5,18,57,0,56,-56
8,5,18,89,45,0,45
8,5,18,97,58,88,-30
8,5,19,103,36,0,36
8,5,19,113,39,0,39
8,5,19,153,62,62,0
8,5,19,169,22,0,22
8,5,20,45,29,0,29
8,5,20,91,139,86,53
8,5,20,173,92,113,-21
8,5,20,177,31,0,31
8,5,21,111,41,0,41
8,5,22,33,38,0,38
8,5,22,51,0,42,-42
8,5,22,71,29,0,29
8,5,24,3,76,82,-6
8,5,24,5,42,0,42
8,5,24,31,60,51,9
8,5,24,33,47,0,47
8,5,24,510,40,0,40
8,5,25,9,25,0,25
8,5,25,17,102,54,48
8,5,25,21,39,0,39
8,5,25,25,36,53,-17
8,5,25,27,0,37,-37
8,5,26,65,27,0,27
8,5,26,77,36,0,36
8,5,26,81,39,26,13
8,5,26,99,27,0,27
8,5,26,125,62,62,0
8,5,26,161,55,0,55
8,5,26,163,79,0,79
8,5,27,37,49,29,20
8,5,27,53,203,74,129
8,5,27,123,50,31,19
8,5,27,163,21,0,21
8,5,29,19,41,0,41
8,5,29,47,37,0,37
8,5,29,77,0,25,-25
8,5,29,95,96,72,24
8,5,29,189,105,71,34
8,5,29,510,0,32,-32
8,5,30,13,39,0,39
8,5,30,31,0,50,-50
8,5,30,63,46,35,11
8,5,30,111,0,63,-63
8,5,31,19,25,0,25
8,5,31,55,160,107,53
8,5,31,109,110,42,68
8,5,31,153,70,42,28
8,5,31,157,40,0,40
8,5,32,3,559,501,58
8,5,32,31,90,44,46
8,5,34,3,33,0,33
8,5,34,5,32,0,32
8,5,34,17,24,26,-2
8,5,35,1,246,219,27
8,5,35,13,43,52,-9
8,5,35,43,44,28,16
8,5,35,45,32,54,-22
8,5,35,49,29,44,-15
8,5,36,5,36,0,36
8,5,36,29,42,44,-2
8,5,36,47,69,50,19
8,5,36,55,33,0,33
8,5,36,59,29,0,29
8,5,36,61,74,113,-39
8,5,36,67,34,0,34
8,5,36,81,63,73,-10
8,5,36,103,43,0,43
8,5,37,51,0,27,-27
8,5,37,81,29,0,29
8,5,37,119,98,95,3
8,5,37,133,62,33,29
8,5,37,183,36,50,-14
8,5,38,17,32,0,32
8,5,39,35,60,43,17
8,5,39,49,107,80,27
8,5,39,57,0,31,-31
8,5,39,61,33,33,0
8,5,39,165,37,0,37
8,5,40,27,37,36,1
8,5,40,109,78,94,-16
8,5,40,143,100,79,21
8,5,41,5,25,49,-24
8,5,41,39,52,42,10
8,5,41,47,29,0,29
8,5,41,51,58,96,-38
8,5,41,67,91,100,-9
8,5,42,3,65,38,27
8,5,42,17,38,0,38
8,5,42,45,31,0,31
8,5,42,95,27,0,27
8,5,42,101,44,60,-16
8,5,45,79,38,0,38
8,5,46,99,56,33,23
8,5,46,103,32,59,-27
8,5,47,37,52,58,-6
8,5,47,93,24,0,24
8,5,47,125,39,0,39
8,5,47,157,57,85,-28
8,5,48,27,38,29,9
8,5,48,29,155,143,12
8,5,48,85,87,90,-3
8,5,48,113,205,244,-39
8,5,48,121,106,87,19
8,5,48,141,193,213,-20
8,5,48,157,42,98,-56
8,5,48,167,34,0,34
8,5,48,201,355,343,12
8,5,48,303,55,31,24
8,5,48,339,57,46,11
8,5,48,381,29,0,29
8,5,48,439,186,226,-40
8,5,48,441,34,0,34
8,5,48,451,33,0,33
8,5,48,453,114,126,-12
8,5,48,485,28,0,28
8,5,48,491,28,59,-31
8,5,49,11,59,101,-42
8,5,49,35,197,290,-93
8,5,49,49,111,98,13
8,5,49,53,0,35,-35
8,5,49,57,0,71,-71
8,5,50,7,33,0,33
8,5,51,13,36,59,-23
8,5,51,59,137,114,23
8,5,51,107,36,49,-13
8,5,51,153,0,33,-33
8,5,51,510,0,29,-29
8,5,51,710,28,0,28
8,5,51,810,36,39,-3
8,5,53,5,0,27,-27
8,5,53,11,42,94,-52
8,5,53,33,206,202,4
8,5,53,35,0,34,-34
8,5,53,53,73,132,-59
8,5,53,61,97,109,-12
8,5,53,63,74,45,29
8,5,53,67,0,35,-35
8,5,55,25,41,30,11
8,5,55,79,37,0,37
8,5,55,133,37,0,37
8,5,56,1,48,49,-1
8,5,56,21,121,67,54
8,5,56,25,69,45,24
8,7,4,13,63,40,23
8,7,6,37,25,0,25
8,7,8,59,29,0,29
8,7,8,67,95,122,-27
8,7,8,77,0,28,-28
8,7,35,1,32,0,32
8,7,35,45,28,0,28
8,11,8,89,51,45,6
8,11,8,99,51,40,11
8,11,8,101,43,26,17
8,13,2,20,38,0,38
8,13,2,90,31,0,31
8,13,4,5,34,0,34
8,13,4,13,337,263,74
8,13,4,19,151,97,54
8,13,4,25,48,31,17
8,13,6,1,186,144,42
8,13,6,13,121,49,72
8,13,6,37,509,339,170
8,13,6,41,0,32,-32
8,13,6,59,180,143,37
8,13,6,61,42,0,42
8,13,6,65,85,42,43
8,13,6,67,50,33,17
8,13,6,71,46,27,19
8,13,6,73,280,311,-31
8,13,6,75,144,183,-39
8,13,6,79,30,27,3
8,13,6,81,60,47,13
8,13,6,83,84,40,44
8,13,6,85,204,217,-13
8,13,6,87,27,31,-4
8,13,6,97,37,45,-8
8,13,6,111,142,33,109
8,13,6,113,26,0,26
8,13,8,1,1592,1831,-239
8,13,8,5,585,680,-95
8,13,8,14,1423,2233,-810
8,13,8,15,0,37,-37
8,13,8,19,0,24,-24
8,13,8,29,39,27,12
8,13,8,31,1602,2740,-1138
8,13,8,35,290,346,-56
8,13,8,37,135,112,23
8,13,8,41,447,289,158
8,13,8,43,24,29,-5
8,13,8,45,55,124,-69
8,13,8,47,85,93,-8
8,13,8,49,33,30,3
8,13,8,51,57,54,3
8,13,8,59,1162,1382,-220
8,13,8,65,0,24,-24
8,13,8,67,57,57,0
8,13,8,69,1337,1614,-277
8,13,8,75,0,38,-38
8,13,8,77,144,89,55
8,13,8,85,29,35,-6
8,13,8,87,29,0,29
8,13,8,93,0,27,-27
8,13,8,97,38,36,2
8,13,8,101,66,53,13
8,13,8,107,80,96,-16
8,13,8,109,0,34,-34
8,13,8,113,28,0,28
8,13,8,117,166,150,16
8,13,8,123,1828,2834,-1006
8,13,9,1,74,36,38
8,13,9,3,49,0,49
8,13,9,9,63,36,27
8,13,11,1,68,52,16
8,13,12,11,62,43,19
8,13,12,31,33,0,33
8,13,12,57,72,0,72
8,13,12,61,27,0,27
8,13,12,71,0,35,-35
8,13,12,86,133,54,79
8,13,12,95,65,35,30
8,13,12,99,49,28,21
8,13,12,103,57,24,33
8,13,12,115,26,0,26
8,13,13,67,33,0,33
8,13,13,89,61,34,27
8,13,13,121,63,40,23
8,13,13,135,33,0,33
8,13,15,1,31,27,4
8,13,15,3,62,53,9
8,13,15,9,0,30,-30
8,13,16,1,38,46,-8
8,13,17,19,32,0,32
8,13,17,31,348,224,124
8,13,17,43,50,37,13
8,13,17,97,78,41,37
8,13,17,197,20,0,20
8,13,18,97,36,27,9
8,13,18,105,38,0,38
8,13,20,91,60,60,0
8,13,20,173,31,0,31
8,13,21,67,32,0,32
8,13,21,111,36,0,36
8,13,22,71,0,24,-24
8,13,23,5,52,28,24
8,13,24,3,37,0,37
8,13,24,5,26,0,26
8,13,24,27,34,0,34
8,13,24,31,77,73,4
8,13,24,33,42,0,42
8,13,24,510,29,0,29
8,13,25,9,31,36,-5
8,13,25,17,231,130,101
8,13,25,21,58,33,25
8,13,25,25,63,48,15
8,13,25,27,24,26,-2
8,13,26,65,28,0,28
8,13,26,81,43,0,43
8,13,26,125,62,41,21
8,13,26,161,82,21,61
8,13,26,163,27,0,27
8,13,27,53,131,84,47
8,13,27,123,32,0,32
8,13,29,95,41,0,41
8,13,29,189,91,36,55
8,13,29,510,23,0,23
8,13,30,29,38,0,38
8,13,30,31,41,46,-5
8,13,30,63,0,33,-33
8,13,31,55,32,36,-4
8,13,31,109,0,35,-35
8,13,32,3,100,113,-13
8,13,32,31,36,35,1
8,13,33,11,26,25,1
8,13,34,3,42,0,42
8,13,34,13,33,0,33
8,13,34,23,39,0,39
8,13,34,27,49,0,49
8,13,35,1,127,88,39
8,13,35,49,62,68,-6
8,13,36,47,89,108,-19
8,13,36,55,49,26,23
8,13,36,59,40,0,40
8,13,36,61,127,136,-9
8,13,36,81,41,36,5
8,13,36,91,34,0,34
8,13,36,103,66,0,66
8,13,36,119,38,35,3
8,13,37,21,35,22,13
8,13,37,63,35,0,35
8,13,37,119,0,31,-31
8,13,37,183,50,55,-5
8,13,39,35,51,43,8
8,13,39,49,43,0,43
8,13,39,61,45,33,12
8,13,39,113,35,0,35
8,13,39,153,27,0,27
8,13,40,109,40,29,11
8,13,40,143,22,0,22
8,13,41,5,0,44,-44
8,13,41,17,0,28,-28
8,13,41,29,26,0,26
8,13,41,39,36,52,-16
8,13,41,51,104,138,-34
8,13,41,67,31,46,-15
8,13,42,3,53,28,25
8,13,42,17,44,0,44
8,13,42,27,32,0,32
8,13,42,29,39,0,39
8,13,42,77,39,0,39
8,13,42,91,0,46,-46
8,13,42,101,39,31,8
8,13,44,7,23,0,23
8,13,46,103,0,27,-27
8,13,47,37,29,0,29
8,13,47,157,55,0,55
8,13,48,29,76,39,37
8,13,48,85,61,35,26
8,13,48,113,119,72,47
8,13,48,121,49,47,2
8,13,48,141,47,99,-52
8,13,48,201,147,107,40
8,13,48,303,39,0,39
8,13,48,439,95,49,46
8,13,48,453,140,113,27
8,13,48,491,0,49,-49
8,13,49,35,96,118,-22
8,13,49,49,29,34,-5
8,13,50,7,47,48,-1
8,13,51,13,57,32,25
8,13,51,59,92,64,28
8,13,51,107,42,0,42
8,13,51,510,44,20,24
8,13,51,810,29,0,29
8,13,53,11,25,28,-3
8,13,53,33,242,304,-62
8,13,53,35,27,0,27
8,13,53,53,37,46,-9
8,13,53,61,50,35,15
8,13,53,67,0,56,-56
8,13,53,73,45,29,16
8,13,55,25,91,42,49
8,13,55,79,39,0,39
8,13,55,133,30,0,30
8,13,56,1,37,46,-9
8,13,56,21,59,39,20
8,13,56,25,49,0,49
8,13,56,39,42,26,16
8,14,4,13,227,138,89
8,14,4,19,34,33,1
8,14,6,37,125,70,55
8,14,6,59,104,60,44
8,14,6,71,35,0,35
8,14,6,73,107,63,44
8,14,6,85,62,34,28
8,14,6,111,38,0,38
8,14,8,1,3409,4058,-649
8,14,8,5,464,515,-51
8,14,8,13,2233,1423,810
8,14,8,31,888,1112,-224
8,14,8,35,200,210,-10
8,14,8,37,32,34,-2
8,14,8,41,144,70,74
8,14,8,45,0,33,-33
8,14,8,59,2093,1825,268
8,14,8,69,259,182,77
8,14,8,77,61,59,2
8,14,8,101,32,36,-4
8,14,8,117,40,0,40
8,14,8,123,354,598,-244
8,14,12,95,25,0,25
8,14,17,31,82,53,29
8,14,17,43,32,0,32
8,14,20,91,31,0,31
8,14,31,55,38,0,38
8,14,32,3,73,35,38
8,14,35,1,35,27,8
8,14,40,109,40,0,40
8,14,48,29,0,37,-37
8,14,48,113,39,0,39
8,14,48,141,31,0,31
8,14,48,201,55,29,26
8,14,48,439,38,34,4
8,14,48,453,61,48,13
8,14,49,35,0,29,-29
8,14,49,49,0,33,-33
8,14,53,33,56,41,15
8,15,4,13,38,0,38
8,15,8,1,0,25,-25
8,15,8,5,48,0,48
8,15,8,13,37,0,37
8,15,8,31,58,41,17
8,15,8,35,32,0,32
8,15,8,41,79,89,-10
8,15,8,43,97,96,1
8,15,8,45,25,0,25
8,15,8,51,31,31,0
8,15,8,59,62,75,-13
8,15,8,65,50,0,50
8,15,8,69,39,43,-4
8,15,8,77,0,44,-44
8,15,8,93,48,28,20
8,15,8,101,22,63,-41
8,15,8,117,45,0,45
8,19,8,1,38,37,1
8,19,8,5,55,46,9
8,19,8,13,24,0,24
8,19,8,31,85,92,-7
8,19,8,59,219,327,-108
8,19,8,117,35,0,35
8,21,8,3,126,143,-17
8,23,8,3,0,58,-58
8,25,8,89,57,81,-24
8,25,8,101,57,62,-5
8,27,8,41,35,44,-9
8,27,8,43,71,75,-4
8,27,8,101,31,32,-1
8,29,4,13,28,34,-6
8,29,8,1,55,0,55
8,29,8,5,51,29,22
8,29,8,13,27,39,-12
8,29,8,31,36,0,36
8,29,8,41,87,0,87
8,29,8,45,61,49,12
8,29,8,51,49,0,49
8,29,8,59,83,55,28
8,29,8,69,53,53,0
8,29,8,77,388,311,77
8,29,8,85,268,324,-56
8,29,8,107,34,0,34
8,29,8,123,60,0,60
8,29,32,3,56,0,56
8,31,1,73,38,26,12
8,31,2,20,77,54,23
8,31,2,90,23,0,23
8,31,4,5,65,37,28
8,31,4,13,795,721,74
8,31,4,15,38,25,13
8,31,4,19,173,129,44
8,31,4,21,0,41,-41
8,31,4,25,33,31,2
8,31,5,7,0,25,-25
8,31,5,119,52,38,14
8,31,6,1,121,160,-39
8,31,6,13,115,83,32
8,31,6,19,57,55,2
8,31,6,29,75,0,75
8,31,6,37,1035,854,181
8,31,6,41,34,65,-31
8,31,6,53,47,0,47
8,31,6,59,372,265,107
8,31,6,61,33,0,33
8,31,6,65,144,89,55
8,31,6,67,88,77,11
8,31,6,71,140,115,25
8,31,6,73,501,440,61
8,31,6,75,260,249,11
8,31,6,77,27,0,27
8,31,6,79,32,0,32
8,31,6,81,101,78,23
8,31,6,83,79,36,43
8,31,6,85,159,163,-4
8,31,6,87,26,0,26
8,31,6,97,26,43,-17
8,31,6,99,29,0,29
8,31,6,111,99,51,48
8,31,6,113,23,0,23
8,31,8,1,9936,11406,-1470
8,31,8,3,42,38,4
8,31,8,5,18840,20935,-2095
8,31,8,13,2740,1602,1138
8,31,8,14,1112,888,224
8,31,8,15,41,58,-17
8,31,8,19,92,85,7
8,31,8,29,0,36,-36
8,31,8,35,2972,3115,-143
8,31,8,37,354,326,28
8,31,8,39,95,102,-7
8,31,8,41,1310,763,547
8,31,8,43,77,60,17
8,31,8,45,155,172,-17
8,31,8,47,27,44,-17
8,31,8,49,118,81,37
8,31,8,51,73,42,31
8,31,8,59,11283,12746,-1463
8,31,8,65,30,47,-17
8,31,8,67,153,118,35
8,31,8,69,1296,639,657
8,31,8,71,52,0,52
8,31,8,75,47,41,6
8,31,8,77,218,225,-7
8,31,8,85,49,43,6
8,31,8,87,90,143,-53
8,31,8,89,36,0,36
8,31,8,93,98,86,12
8,31,8,97,62,97,-35
8,31,8,99,29,0,29
8,31,8,101,327,290,37
8,31,8,105,21,39,-18
8,31,8,107,127,112,15
8,31,8,113,24,23,1
8,31,8,117,339,246,93
8,31,8,119,32,0,32
8,31,8,123,803,806,-3
8,31,9,1,87,56,31
8,31,9,3,53,25,28
8,31,9,9,48,0,48
8,31,11,1,271,164,107
8,31,12,1,30,0,30
8,31,12,9,26,31,-5
8,31,12,11,138,111,27
8,31,12,21,0,25,-25
8,31,12,31,74,63,11
8,31,12,33,0,23,-23
8,31,12,57,152,125,27
8,31,12,71,62,36,26
8,31,12,73,58,0,58
8,31,12,81,35,30,5
8,31,12,86,131,90,41
8,31,12,91,32,0,32
8,31,12,95,104,82,22
8,31,12,99,123,53,70
8,31,12,103,104,71,33
8,31,12,115,54,27,27
8,31,12,117,39,0,39
8,31,12,127,50,0,50
8,31,13,51,41,0,41
8,31,13,67,77,71,6
8,31,13,89,114,92,22
8,31,13,121,170,126,44
8,31,13,135,51,0,51
8,31,15,3,165,88,77
8,31,15,9,28,30,-2
8,31,16,1,79,53,26
8,31,17,19,31,0,31
8,31,17,31,812,575,237
8,31,17,43,123,80,43
8,31,17,89,59,40,19
8,31,17,97,90,65,25
8,31,17,111,33,0,33
8,31,17,119,28,0,28
8,31,17,143,22,0,22
8,31,17,163,31,0,31
8,31,17,167,25,0,25
8,31,18,39,32,0,32
8,31,18,57,33,0,33
8,31,18,89,25,0,25
8,31,18,97,100,91,9
8,31,18,127,24,0,24
8,31,18,141,26,0,26
8,31,19,13,22,0,22
8,31,19,61,32,0,32
8,31,19,103,76,36,40
8,31,19,113,51,0,51
8,31,19,153,154,96,58
8,31,19,163,24,36,-12
8,31,19,169,35,0,35
8,31,20,45,62,0,62
8,31,20,91,164,101,63
8,31,20,161,36,0,36
8,31,20,173,62,82,-20
8,31,20,177,37,35,2
8,31,21,67,28,0,28
8,31,21,111,47,31,16
8,31,22,33,43,0,43
8,31,22,51,32,31,1
8,31,22,71,75,108,-33
8,31,23,5,51,20,31
8,31,23,31,24,0,24
8,31,24,3,44,0,44
8,31,24,5,43,33,10
8,31,24,21,23,0,23
8,31,24,31,122,100,22
8,31,24,33,32,42,-10
8,31,24,510,54,76,-22
8,31,25,1,27,0,27
8,31,25,9,49,0,49
8,31,25,17,173,160,13
8,31,25,21,109,36,73
8,31,25,23,30,0,30
8,31,25,25,131,110,21
8,31,25,27,59,0,59
8,31,26,65,44,0,44
8,31,26,77,31,0,31
8,31,26,81,93,29,64
8,31,26,99,56,0,56
8,31,26,125,187,72,115
8,31,26,161,86,35,51
8,31,26,163,76,0,76
8,31,27,37,57,28,29
8,31,27,53,298,192,106
8,31,27,109,29,0,29
8,31,27,123,86,55,31
8,31,28,47,0,25,-25
8,31,29,19,28,0,28
8,31,29,95,108,111,-3
8,31,29,165,27,0,27
8,31,29,189,161,144,17
8,31,29,510,50,50,0
8,31,30,29,23,0,23
8,31,30,31,55,31,24
8,31,30,49,25,0,25
8,31,30,63,44,29,15
8,31,30,111,63,55,8
8,31,31,19,23,0,23
8,31,31,55,198,128,70
8,31,31,109,121,47,74
8,31,31,153,41,0,41
8,31,31,157,36,0,36
8,31,32,3,434,524,-90
8,31,32,31,79,61,18
8,31,33,11,24,0,24
8,31,33,15,33,0,33
8,31,34,3,25,28,-3
8,31,34,17,53,37,16
8,31,34,23,34,32,2
8,31,34,25,28,0,28
8,31,34,27,39,0,39
8,31,34,39,33,0,33
8,31,35,1,292,223,69
8,31,35,13,82,64,18
8,31,35,43,59,0,59
8,31,35,45,50,43,7
8,31,35,47,0,31,-31
8,31,35,49,95,99,-4
8,31,36,1,28,25,3
8,31,36,5,24,39,-15
8,31,36,27,0,32,-32
8,31,36,29,47,21,26
8,31,36,47,143,156,-13
8,31,36,55,48,31,17
8,31,36,59,38,45,-7
8,31,36,61,349,347,2
8,31,36,65,26,0,26
8,31,36,67,49,0,49
8,31,36,81,69,65,4
8,31,36,103,44,20,24
8,31,36,119,47,34,13
8,31,37,21,27,29,-2
8,31,37,51,0,29,-29
8,31,37,63,33,33,0
8,31,37,81,0,27,-27
8,31,37,119,106,74,32
8,31,37,129,22,0,22
8,31,37,133,0,26,-26
8,31,37,135,28,0,28
8,31,37,183,61,67,-6
8,31,38,15,23,0,23
8,31,38,17,32,0,32
8,31,38,35,30,0,30
8,31,39,35,131,66,65
8,31,39,41,27,0,27
8,31,39,49,185,75,110
8,31,39,61,96,39,57
8,31,39,95,25,0,25
8,31,39,113,45,0,45
8,31,39,151,28,0,28
8,31,39,153,33,0,33
8,31,40,27,27,0,27
8,31,40,109,112,74,38
8,31,40,143,117,74,43
8,31,41,5,29,30,-1
8,31,41,17,27,25,2
8,31,41,29,28,0,28
8,31,41,39,49,50,-1
8,31,41,47,38,0,38
8,31,41,51,143,247,-104
8,31,41,67,90,123,-33
8,31,42,3,84,72,12
8,31,42,17,42,0,42
8,31,42,29,41,34,7
8,31,42,71,28,0,28
8,31,42,91,53,43,10
8,31,42,101,105,98,7
8,31,44,7,39,0,39
8,31,45,19,38,48,-10
8,31,46,99,32,44,-12
8,31,46,103,55,52,3
8,31,47,37,119,56,63
8,31,47,157,102,45,57
8,31,48,27,35,39,-4
8,31,48,29,156,159,-3
8,31,48,41,20,0,20
8,31,48,61,23,0,23
8,31,48,85,85,104,-19
8,31,48,113,348,244,104
8,31,48,121,75,45,30
8,31,48,141,248,364,-116
8,31,48,157,40,0,40
8,31,48,201,450,370,80
8,31,48,303,41,29,12
8,31,48,329,0,32,-32
8,31,48,339,44,32,12
8,31,48,355,32,0,32
8,31,48,439,165,188,-23
8,31,48,441,29,0,29
8,31,48,453,181,192,-11
8,31,48,491,30,62,-32
8,31,49,11,0,40,-40
8,31,49,35,164,223,-59
8,31,49,43,22,0,22
8,31,49,49,59,40,19
8,31,50,7,56,26,30
8,31,51,13,160,85,75
8,31,51,59,168,133,35
8,31,51,87,29,0,29
8,31,51,107,37,26,11
8,31,51,510,53,51,2
8,31,51,760,36,0,36
8,31,51,810,38,0,38
8,31,53,11,31,44,-13
8,31,53,33,366,487,-121
8,31,53,35,0,30,-30
8,31,53,53,83,48,35
8,31,53,61,47,37,10
8,31,53,63,55,40,15
8,31,55,25,113,57,56
8,31,55,79,135,60,75
8,31,55,87,23,0,23
8,31,55,101,23,0,23
8,31,55,133,39,0,39
8,31,56,1,73,33,40
8,31,56,21,113,105,8
8,31,56,25,56,41,15
8,31,56,37,28,0,28
8,31,56,39,31,24,7
8,33,8,83,47,0,47
8,35,1,47,0,37,-37
8,35,1,89,56,0,56
8,35,2,20,36,0,36
8,35,4,13,762,522,240
8,35,4,15,0,38,-38
8,35,4,19,105,116,-11
8,35,4,21,0,54,-54
8,35,4,25,30,0,30
8,35,6,1,76,54,22
8,35,6,13,80,62,18
8,35,6,19,0,32,-32
8,35,6,29,63,0,63
8,35,6,37,686,255,431
8,35,6,59,1110,192,918
8,35,6,61,36,0,36
8,35,6,65,162,72,90
8,35,6,67,71,83,-12
8,35,6,71,151,69,82
8,35,6,73,342,211,131
8,35,6,75,0,26,-26
8,35,6,77,41,0,41
8,35,6,81,63,0,63
8,35,6,83,62,0,62
8,35,6,85,192,58,134
8,35,6,111,124,64,60
8,35,8,1,906,794,112
8,35,8,5,6987,6127,860
8,35,8,13,346,290,56
8,35,8,14,210,200,10
8,35,8,15,0,32,-32
8,35,8,31,3115,2972,143
8,35,8,37,69,69,0
8,35,8,39,506,754,-248
8,35,8,41,1347,934,413
8,35,8,43,24,29,-5
8,35,8,45,69,54,15
8,35,8,49,44,56,-12
8,35,8,51,31,39,-8
8,35,8,59,2989,2180,809
8,35,8,67,39,44,-5
8,35,8,69,378,390,-12
8,35,8,77,160,100,60
8,35,8,85,29,55,-26
8,35,8,93,50,72,-22
8,35,8,101,142,126,16
8,35,8,107,53,0,53
8,35,8,117,82,89,-7
8,35,8,119,72,61,11
8,35,8,123,265,228,37
8,35,9,3,0,37,-37
8,35,12,9,63,48,15
8,35,12,11,125,70,55
8,35,12,21,26,0,26
8,35,12,31,29,38,-9
8,35,12,57,89,53,36
8,35,12,71,31,55,-24
8,35,12,86,33,24,9
8,35,12,95,96,36,60
8,35,12,99,75,0,75
8,35,12,103,51,38,13
8,35,12,117,63,0,63
8,35,13,67,66,51,15
8,35,13,121,53,31,22
8,35,13,135,33,0,33
8,35,15,3,91,55,36
8,35,16,1,56,43,13
8,35,17,31,147,89,58
8,35,17,43,77,52,25
8,35,17,89,0,43,-43
8,35,17,97,49,33,16
8,35,17,197,76,0,76
8,35,18,97,34,0,34
8,35,19,153,45,0,45
8,35,20,91,192,84,108
8,35,20,173,82,42,40
8,35,24,3,42,30,12
8,35,24,5,29,0,29
8,35,24,27,46,0,46
8,35,25,17,39,0,39
8,35,26,65,33,0,33
8,35,26,99,27,0,27
8,35,26,125,110,35,75
8,35,26,163,64,55,9
8,35,27,37,52,0,52
8,35,27,53,103,81,22
8,35,29,95,52,32,20
8,35,29,183,37,37,0
8,35,29,189,57,41,16
8,35,30,63,27,37,-10
8,35,30,111,31,37,-6
8,35,31,55,109,85,24
8,35,31,109,59,38,21
8,35,32,3,305,218,87
8,35,32,31,48,34,14
8,35,35,1,92,34,58
8,35,35,13,0,31,-31
8,35,35,43,0,42,-42
8,35,36,47,0,25,-25
8,35,36,61,0,30,-30
8,35,37,119,78,57,21
8,35,37,183,0,41,-41
8,35,39,35,60,0,60
8,35,39,41,44,0,44
8,35,39,49,59,31,28
8,35,39,113,28,0,28
8,35,39,153,36,0,36
8,35,40,109,79,63,16
8,35,40,143,68,57,11
8,35,41,67,59,60,-1
8,35,42,3,29,50,-21
8,35,42,17,50,0,50
8,35,42,91,38,0,38
8,35,47,37,0,38,-38
8,35,47,157,58,0,58
8,35,48,27,0,32,-32
8,35,48,29,113,93,20
8,35,48,85,120,171,-51
8,35,48,113,118,92,26
8,35,48,121,103,139,-36
8,35,48,141,29,0,29
8,35,48,157,58,44,14
8,35,48,201,207,158,49
8,35,48,209,0,43,-43
8,35,48,339,135,61,74
8,35,48,439,182,112,70
8,35,48,453,97,82,15
8,35,48,491,49,53,-4
8,35,49,11,57,64,-7
8,35,49,35,146,121,25
8,35,49,49,105,145,-40
8,35,51,41,45,0,45
8,35,51,59,115,87,28
8,35,51,107,76,43,33
8,35,51,153,50,0,50
8,35,51,810,29,0,29
8,35,53,11,0,56,-56
8,35,53,33,184,219,-35
8,35,53,53,41,43,-2
8,35,53,61,50,53,-3
8,35,53,63,45,39,6
8,35,55,25,30,0,30
8,35,55,133,41,0,41
8,35,56,1,21,0,21
8,35,56,21,68,52,16
8,35,56,25,36,0,36
8,37,4,13,94,71,23
8,37,6,37,79,63,16
8,37,6,59,35,24,11
8,37,6,65,35,0,35
8,37,6,73,53,64,-11
8,37,8,1,102,207,-105
8,37,8,5,136,116,20
8,37,8,13,112,135,-23
8,37,8,14,34,32,2
8,37,8,31,326,354,-28
8,37,8,35,69,69,0
8,37,8,41,120,72,48
8,37,8,45,287,530,-243
8,37,8,49,0,27,-27
8,37,8,51,0,29,-29
8,37,8,59,207,144,63
8,37,8,65,73,92,-19
8,37,8,69,60,94,-34
8,37,8,77,83,111,-28
8,37,8,97,260,221,39
8,37,8,107,0,52,-52
8,37,8,117,146,86,60
8,37,8,123,73,46,27
8,37,15,9,25,0,25
8,37,17,31,72,60,12
8,37,26,81,25,0,25
8,37,26,125,35,0,35
8,37,27,53,31,0,31
8,37,31,55,25,0,25
8,37,32,3,60,41,19
8,37,36,47,0,20,-20
8,37,36,61,0,25,-25
8,37,41,51,0,20,-20
8,37,48,113,39,27,12
8,37,48,141,0,56,-56
8,37,48,201,25,0,25
8,37,53,33,29,0,29
8,39,8,1,86,87,-1
8,39,8,5,379,269,110
8,39,8,31,102,95,7
8,39,8,35,754,506,248
8,39,8,41,148,148,0
8,39,8,59,150,85,65
8,39,8,69,26,47,-21
8,39,8,123,0,31,-31
8,41,1,1,73,0,73
8,41,1,45,44,53,-9
8,41,1,73,48,36,12
8,41,1,89,66,131,-65
8,41,1,97,27,52,-25
8,41,1,101,65,98,-33
8,41,1,113,40,0,40
8,41,2,20,251,158,93
8,41,2,90,94,88,6
8,41,2,122,0,36,-36
8,41,2,170,0,53,-53
8,41,4,3,126,133,-7
8,41,4,5,101,0,101
8,41,4,13,1246,1296,-50
8,41,4,15,94,59,35
8,41,4,17,0,34,-34
8,41,4,19,336,359,-23
8,41,4,21,38,216,-178
8,41,4,25,111,58,53
8,41,4,27,0,54,-54
8,41,5,7,29,48,-19
8,41,5,119,59,61,-2
8,41,5,143,38,0,38
8,41,6,1,145,130,15
8,41,6,7,0,31,-31
8,41,6,13,92,78,14
8,41,6,17,29,28,1
8,41,6,19,83,60,23
8,41,6,29,100,112,-12
8,41,6,31,0,38,-38
8,41,6,37,889,566,323
8,41,6,53,160,110,50
8,41,6,59,509,229,280
8,41,6,61,58,83,-25
8,41,6,65,389,184,205
8,41,6,67,180,155,25
8,41,6,71,438,305,133
8,41,6,73,700,417,283
8,41,6,75,39,59,-20
8,41,6,77,55,56,-1
8,41,6,79,72,50,22
8,41,6,81,46,44,2
8,41,6,83,367,506,-139
8,41,6,85,211,172,39
8,41,6,87,26,0,26
8,41,6,95,119,72,47
8,41,6,97,52,24,28
8,41,6,99,69,53,16
8,41,6,107,0,39,-39
8,41,6,111,150,72,78
8,41,6,115,44,0,44
8,41,8,1,427,641,-214
8,41,8,3,86,60,26
8,41,8,5,951,1420,-469
8,41,8,13,289,447,-158
8,41,8,14,70,144,-74
8,41,8,15,89,79,10
8,41,8,27,44,35,9
8,41,8,29,0,87,-87
8,41,8,31,763,1310,-547
8,41,8,35,934,1347,-413
8,41,8,37,72,120,-48
8,41,8,39,148,148,0
8,41,8,43,396,398,-2
8,41,8,45,62,124,-62
8,41,8,49,0,34,-34
8,41,8,51,63,51,12
8,41,8,55,26,31,-5
8,41,8,59,617,771,-154
8,41,8,63,46,42,4
8,41,8,65,0,30,-30
8,41,8,67,96,94,2
8,41,8,69,497,646,-149
8,41,8,71,86,62,24
8,41,8,73,83,60,23
8,41,8,75,0,26,-26
8,41,8,77,177,333,-156
8,41,8,81,33,42,-9
8,41,8,83,41,38,3
8,41,8,85,82,74,8
8,41,8,87,34,0,34
8,41,8,89,88,95,-7
8,41,8,93,65,89,-24
8,41,8,97,0,37,-37
8,41,8,99,49,42,7
8,41,8,101,1272,1523,-251
8,41,8,105,82,68,14
8,41,8,107,35,56,-21
8,41,8,117,95,101,-6
8,41,8,119,989,820,169
8,41,8,123,372,404,-32
8,41,9,1,45,23,22
8,41,9,3,44,30,14
8,41,9,9,36,0,36
8,41,9,11,29,44,-15
8,41,10,1,33,0,33
8,41,10,3,40,0,40
8,41,11,1,49,85,-36
8,41,12,1,37,0,37
8,41,12,5,63,65,-2
8,41,12,9,156,119,37
8,41,12,11,120,95,25
8,41,12,15,23,0,23
8,41,12,19,0,40,-40
8,41,12,31,103,76,27
8,41,12,33,98,95,3
8,41,12,53,33,0,33
8,41,12,57,204,257,-53
8,41,12,69,44,33,11
8,41,12,71,107,97,10
8,41,12,73,0,40,-40
8,41,12,81,56,0,56
8,41,12,86,195,121,74
8,41,12,87,33,0,33
8,41,12,91,172,208,-36
8,41,12,95,130,78,52
8,41,12,97,37,0,37
8,41,12,99,105,85,20
8,41,12,101,78,49,29
8,41,12,103,83,97,-14
8,41,12,105,79,45,34
8,41,12,109,0,36,-36
8,41,12,113,71,95,-24
8,41,12,115,49,28,21
8,41,12,117,50,45,5
8,41,12,127,77,72,5
8,41,13,51,80,63,17
8,41,13,53,70,88,-18
8,41,13,67,73,71,2
8,41,13,73,96,61,35
8,41,13,89,37,48,-11
8,41,13,113,0,39,-39
8,41,13,121,85,48,37
8,41,13,135,57,70,-13
8,41,13,153,64,45,19
8,41,13,179,93,90,3
8,41,13,185,0,36,-36
8,41,13,215,129,116,13
8,41,13,245,94,95,-1
8,41,15,1,43,32,11
8,41,15,3,626,446,180
8,41,15,9,31,0,31
8,41,16,1,80,132,-52
8,41,16,19,0,39,-39
8,41,16,27,0,33,-33
8,41,16,39,46,44,2
8,41,17,31,297,216,81
8,41,17,43,132,64,68
8,41,17,89,32,39,-7
8,41,17,97,73,57,16
8,41,17,111,52,0,52
8,41,17,119,49,33,16
8,41,17,161,34,0,34
8,41,17,163,94,90,4
8,41,17,167,0,27,-27
8,41,17,183,23,0,23
8,41,17,197,36,35,1
8,41,17,201,45,0,45
8,41,18,3,35,35,0
8,41,18,57,44,35,9
8,41,18,89,30,32,-2
8,41,18,97,79,87,-8
8,41,18,141,32,0,32
8,41,18,157,31,0,31
8,41,18,163,30,0,30
8,41,19,61,0,34,-34
8,41,19,103,35,27,8
8,41,19,113,28,45,-17
8,41,19,153,55,71,-16
8,41,19,163,31,48,-17
8,41,19,193,33,0,33
8,41,20,45,45,29,16
8,41,20,55,44,0,44
8,41,20,61,85,182,-97
8,41,20,91,178,125,53
8,41,20,103,183,57,126
8,41,20,161,48,126,-78
8,41,20,173,171,159,12
8,41,20,177,29,22,7
8,41,21,47,121,108,13
8,41,21,93,125,178,-53
8,41,21,111,55,58,-3
8,41,21,163,67,55,12
8,41,22,15,53,71,-18
8,41,22,17,0,30,-30
8,41,22,33,25,0,25
8,41,22,51,28,37,-9
8,41,22,55,29,0,29
8,41,22,63,0,42,-42
8,41,22,71,0,50,-50
8,41,22,115,143,74,69
8,41,23,5,51,0,51
8,41,24,3,154,132,22
8,41,24,5,55,0,55
8,41,24,21,53,55,-2
8,41,24,25,84,79,5
8,41,24,27,44,37,7
8,41,24,31,100,118,-18
8,41,24,33,82,77,5
8,41,24,510,39,0,39
8,41,25,1,38,0,38
8,41,25,9,0,25,-25
8,41,25,17,118,126,-8
8,41,25,21,43,0,43
8,41,25,25,22,43,-21
8,41,25,27,42,38,4
8,41,26,49,52,0,52
8,41,26,65,46,0,46
8,41,26,81,58,52,6
8,41,26,99,49,0,49
8,41,26,125,129,50,79
8,41,26,139,54,29,25
8,41,26,145,37,0,37
8,41,26,161,61,0,61
8,41,26,163,165,46,119
8,41,27,3,49,0,49
8,41,27,37,47,0,47
8,41,27,53,131,105,26
8,41,27,109,28,0,28
8,41,27,123,27,56,-29
8,41,27,137,38,0,38
8,41,27,163,0,31,-31
8,41,28,47,55,77,-22
8,41,28,59,0,52,-52
8,41,28,87,0,97,-97
8,41,29,19,37,36,1
8,41,29,47,43,0,43
8,41,29,77,79,42,37
8,41,29,95,119,109,10
8,41,29,97,0,23,-23
8,41,29,99,0,26,-26
8,41,29,165,22,0,22
8,41,29,169,163,120,43
8,41,29,183,26,0,26
8,41,29,189,117,65,52
8,41,30,13,174,69,105
8,41,30,29,28,0,28
8,41,30,31,46,28,18
8,41,30,63,0,49,-49
8,41,30,111,41,60,-19
8,41,31,55,119,103,16
8,41,31,109,90,63,27
8,41,31,153,186,100,86
8,41,31,157,38,0,38
8,41,32,3,666,698,-32
8,41,32,31,120,67,53
8,41,33,11,53,39,14
8,41,34,3,32,0,32
8,41,34,5,84,74,10
8,41,34,7,37,0,37
8,41,34,23,41,0,41
8,41,34,25,28,31,-3
8,41,34,29,42,0,42
8,41,35,1,381,283,98
8,41,35,5,40,0,40
8,41,35,7,29,0,29
8,41,35,9,32,0,32
8,41,35,13,131,118,13
8,41,35,31,29,0,29
8,41,35,35,116,80,36
8,41,35,43,57,117,-60
8,41,35,45,51,70,-19
8,41,35,47,33,0,33
8,41,35,49,65,56,9
8,41,35,55,35,44,-9
8,41,35,61,34,30,4
8,41,36,5,27,0,27
8,41,36,29,36,42,-6
8,41,36,45,238,103,135
8,41,36,47,43,43,0
8,41,36,55,43,29,14
8,41,36,59,41,0,41
8,41,36,61,48,53,-5
8,41,36,65,42,0,42
8,41,36,71,49,56,-7
8,41,36,81,38,49,-11
8,41,36,103,69,46,23
8,41,37,21,24,0,24
8,41,37,49,32,0,32
8,41,37,51,509,412,97
8,41,37,67,40,0,40
8,41,37,81,0,37,-37
8,41,37,85,37,54,-17
8,41,37,93,45,0,45
8,41,37,119,74,98,-24
8,41,37,125,42,40,2
8,41,37,129,31,0,31
8,41,37,133,67,77,-10
8,41,37,183,82,108,-26
8,41,37,191,40,37,3
8,41,38,35,40,42,-2
8,41,38,67,30,0,30
8,41,38,101,89,38,51
8,41,39,17,0,34,-34
8,41,39,35,89,48,41
8,41,39,49,100,88,12
8,41,39,57,117,80,37
8,41,39,61,57,36,21
8,41,39,85,37,0,37
8,41,39,95,68,0,68
8,41,39,113,118,99,19
8,41,39,153,51,50,1
8,41,40,27,69,70,-1
8,41,40,31,253,173,80
8,41,40,47,0,116,-116
8,41,40,65,43,0,43
8,41,40,109,145,134,11
8,41,40,143,96,107,-11
8,41,41,5,48,52,-4
8,41,41,17,31,49,-18
8,41,41,29,35,39,-4
8,41,41,33,24,0,24
8,41,41,39,48,72,-24
8,41,41,47,0,43,-43
8,41,41,51,77,92,-15
8,41,41,67,113,307,-194
8,41,42,3,90,70,20
8,41,42,17,0,29,-29
8,41,42,19,33,0,33
8,41,42,41,45,39,6
8,41,42,71,43,0,43
8,41,42,77,39,0,39
8,41,42,91,28,28,0
8,41,42,101,48,28,20
8,41,42,133,0,40,-40
8,41,44,5,86,0,86
8,41,45,15,0,28,-28
8,41,45,19,51,63,-12
8,41,45,35,37,39,-2
8,41,45,45,57,0,57
8,41,45,79,127,213,-86
8,41,45,85,69,40,29
8,41,46,93,33,49,-16
8,41,46,99,38,31,7
8,41,46,103,68,89,-21
8,41,47,37,37,63,-26
8,41,47,65,0,32,-32
8,41,47,93,31,0,31
8,41,47,125,215,162,53
8,41,47,149,0,35,-35
8,41,47,157,102,96,6
8,41,48,27,1861,369,1492
8,41,48,29,581,610,-29
8,41,48,39,43,45,-2
8,41,48,41,42,0,42
8,41,48,61,55,54,1
8,41,48,85,100,144,-44
8,41,48,99,550,48,502
8,41,48,113,248,235,13
8,41,48,121,156,122,34
8,41,48,141,429,410,19
8,41,48,157,47,57,-10
8,41,48,167,52,0,52
8,41,48,187,50,96,-46
8,41,48,201,390,355,35
8,41,48,209,0,33,-33
8,41,48,215,57,41,16
8,41,48,281,44,0,44
8,41,48,303,68,66,2
8,41,48,309,66,0,66
8,41,48,339,91,67,24
8,41,48,355,49,40,9
8,41,48,375,39,0,39
8,41,48,381,41,56,-15
8,41,48,423,50,37,13
8,41,48,439,323,274,49
8,41,48,441,76,61,15
8,41,48,451,84,118,-34
8,41,48,453,123,265,-142
8,41,48,465,0,142,-142
8,41,48,485,83,89,-6
8,41,48,491,115,204,-89
8,41,49,11,104,110,-6
8,41,49,35,144,276,-132
8,41,49,49,105,201,-96
8,41,49,53,38,0,38
8,41,49,57,55,55,0
8,41,51,3,0,40,-40
8,41,51,13,58,88,-30
8,41,51,41,0,51,-51
8,41,51,59,414,343,71
8,41,51,87,0,49,-49
8,41,51,107,80,114,-34
8,41,51,149,49,64,-15
8,41,51,153,155,150,5
8,41,51,177,26,0,26
8,41,51,179,69,0,69
8,41,51,199,73,0,73
8,41,51,510,29,54,-25
8,41,51,650,48,56,-8
8,41,51,700,84,74,10
8,41,51,710,52,35,17
8,41,51,730,29,0,29
8,41,51,810,129,61,68
8,41,53,11,56,85,-29
8,41,53,29,30,0,30
8,41,53,33,232,263,-31
8,41,53,35,68,63,5
8,41,53,53,314,357,-43
8,41,53,61,109,124,-15
8,41,53,63,164,110,54
8,41,53,67,96,136,-40
8,41,53,73,24,30,-6
8,41,53,77,27,30,-3
8,41,55,9,33,0,33
8,41,55,25,58,56,2
8,41,55,79,81,65,16
8,41,55,87,32,0,32
8,41,55,133,53,37,16
8,41,56,1,30,33,-3
8,41,56,5,32,31,1
8,41,56,21,189,126,63
8,41,56,25,50,0,50
8,41,56,33,0,32,-32
8,41,56,37,28,55,-27
8,43,4,13,39,26,13
8,43,8,1,32,54,-22
8,43,8,5,58,80,-22
8,43,8,13,29,24,5
8,43,8,15,96,97,-1
8,43,8,27,75,71,4
8,43,8,31,60,77,-17
8,43,8,35,29,24,5
8,43,8,41,398,396,2
8,43,8,59,90,77,13
8,43,8,69,0,57,-57
8,43,8,77,0,36,-36
8,43,8,101,297,362,-65
8,43,8,119,77,36,41
8,43,32,3,42,0,42
8,45,4,13,140,66,74
8,45,4,19,41,0,41
8,45,6,29,28,0,28
8,45,6,37,147,59,88
8,45,6,59,38,0,38
8,45,6,65,96,0,96
8,45,6,71,52,0,52
8,45,6,73,44,35,9
8,45,8,1,87,92,-5
8,45,8,5,67,104,-37
8,45,8,13,124,55,69
8,45,8,14,33,0,33
8,45,8,15,0,25,-25
8,45,8,29,49,61,-12
8,45,8,31,172,155,17
8,45,8,35,54,69,-15
8,45,8,37,530,287,243
8,45,8,41,124,62,62
8,45,8,51,0,45,-45
8,45,8,59,141,85,56
8,45,8,67,0,43,-43
8,45,8,69,118,137,-19
8,45,8,77,429,855,-426
8,45,8,81,46,41,5
8,45,8,83,0,28,-28
8,45,8,85,0,36,-36
8,45,8,97,349,204,145
8,45,8,101,0,28,-28
8,45,8,103,44,33,11
8,45,8,117,43,0,43
8,45,8,123,104,106,-2
8,45,17,31,39,0,39
8,45,30,29,0,28,-28
8,45,32,3,40,71,-31
8,45,35,45,35,0,35
8,45,39,61,29,0,29
8,45,41,51,0,22,-22
8,45,48,201,74,49,25
8,45,49,35,0,37,-37
8,45,49,49,0,45,-45
8,47,8,1,50,0,50
8,47,8,5,0,25,-25
8,47,8,13,93,85,8
8,47,8,31,44,27,17
8,47,8,59,125,179,-54
8,49,4,13,0,32,-32
8,49,8,1,38,28,10
8,49,8,5,85,36,49
8,49,8,13,30,33,-3
8,49,8,31,81,118,-37
8,49,8,35,56,44,12
8,49,8,37,27,0,27
8,49,8,41,34,0,34
8,49,8,59,97,83,14
8,49,8,69,44,73,-29
8,49,8,77,0,56,-56
8,49,8,117,70,27,43
8,49,8,123,44,0,44
8,51,6,37,23,0,23
8,51,8,1,0,39,-39
8,51,8,5,36,44,-8
8,51,8,13,54,57,-3
8,51,8,15,31,31,0
8,51,8,29,0,49,-49
8,51,8,31,42,73,-31
8,51,8,35,39,31,8
8,51,8,37,29,0,29
8,51,8,41,51,63,-12
8,51,8,45,45,0,45
8,51,8,59,43,48,-5
8,51,8,67,0,29,-29
8,51,8,69,47,54,-7
8,51,8,77,42,63,-21
8,51,8,85,36,84,-48
8,55,8,41,31,26,5
8,55,8,71,44,34,10
8,55,8,101,117,119,-2
8,57,8,123,0,27,-27
8,59,2,20,65,42,23
8,59,4,5,66,0,66
8,59,4,13,577,477,100
8,59,4,15,25,46,-21
8,59,4,19,105,139,-34
8,59,4,21,0,44,-44
8,59,4,25,33,30,3
8,59,5,7,26,0,26
8,59,6,1,48,52,-4
8,59,6,13,52,44,8
8,59,6,17,0,26,-26
8,59,6,19,0,34,-34
8,59,6,29,33,43,-10
8,59,6,37,457,282,175
8,59,6,59,327,143,184
8,59,6,61,31,0,31
8,59,6,65,101,85,16
8,59,6,67,50,40,10
8,59,6,71,107,67,40
8,59,6,73,392,238,154
8,59,6,75,38,43,-5
8,59,6,81,31,24,7
8,59,6,83,36,22,14
8,59,6,85,138,82,56
8,59,6,97,29,0,29
8,59,6,111,94,47,47
8,59,8,1,6093,6952,-859
8,59,8,3,60,48,12
8,59,8,5,5018,5150,-132
8,59,8,7,0,29,-29
8,59,8,13,1382,1162,220
8,59,8,14,1825,2093,-268
8,59,8,15,75,62,13
8,59,8,19,327,219,108
8,59,8,29,55,83,-28
8,59,8,31,12746,11283,1463
8,59,8,35,2180,2989,-809
8,59,8,37,144,207,-63
8,59,8,39,85,150,-65
8,59,8,41,771,617,154
8,59,8,43,77,90,-13
8,59,8,45,85,141,-56
8,59,8,47,179,125,54
8,59,8,49,83,97,-14
8,59,8,51,48,43,5
8,59,8,65,46,33,13
8,59,8,67,105,118,-13
8,59,8,69,623,707,-84
8,59,8,75,52,30,22
8,59,8,77,252,311,-59
8,59,8,81,32,44,-12
8,59,8,85,43,84,-41
8,59,8,87,29,29,0
8,59,8,93,375,290,85
8,59,8,101,168,203,-35
8,59,8,105,28,0,28
8,59,8,107,56,99,-43
8,59,8,117,249,206,43
8,59,8,119,29,34,-5
8,59,8,123,665,826,-161
8,59,9,3,29,0,29
8,59,9,9,0,28,-28
8,59,11,1,26,29,-3
8,59,12,9,41,27,14
8,59,12,11,100,47,53
8,59,12,31,48,39,9
8,59,12,57,70,40,30
8,59,12,71,27,33,-6
8,59,12,73,34,0,34
8,59,12,86,37,42,-5
8,59,12,91,32,0,32
8,59,12,95,48,50,-2
8,59,12,99,70,40,30
8,59,12,101,26,0,26
8,59,12,103,51,50,1
8,59,12,105,34,0,34
8,59,12,115,0,29,-29
8,59,13,89,31,0,31
8,59,13,121,50,35,15
8,59,15,1,32,31,1
8,59,15,3,82,67,15
8,59,15,9,68,37,31
8,59,16,1,82,46,36
8,59,17,31,200,141,59
8,59,17,43,74,36,38
8,59,17,97,32,0,32
8,59,17,197,38,0,38
8,59,18,97,36,31,5
8,59,19,153,57,30,27
8,59,20,45,25,0,25
8,59,20,51,20,0,20
8,59,20,91,89,53,36
8,59,20,173,64,31,33
8,59,21,111,39,0,39
8,59,23,19,23,0,23
8,59,24,3,45,0,45
8,59,24,5,41,0,41
8,59,24,31,54,0,54
8,59,25,17,57,57,0
8,59,25,21,38,0,38
8,59,25,25,34,0,34
8,59,26,81,39,0,39
8,59,26,125,82,30,52
8,59,26,139,35,0,35
8,59,26,163,55,0,55
8,59,27,37,0,31,-31
8,59,27,53,103,65,38
8,59,27,123,34,0,34
8,59,29,47,30,37,-7
8,59,29,77,36,0,36
8,59,29,95,64,33,31
8,59,29,189,73,34,39
8,59,30,31,21,25,-4
8,59,30,111,29,43,-14
8,59,31,55,81,64,17
8,59,31,109,68,26,42
8,59,31,157,29,37,-8
8,59,32,3,281,350,-69
8,59,32,31,67,44,23
8,59,34,17,32,0,32
8,59,35,1,176,126,50
8,59,35,13,54,32,22
8,59,35,43,0,35,-35
8,59,35,45,27,31,-4
8,59,35,49,50,0,50
8,59,36,29,34,0,34
8,59,36,47,30,32,-2
8,59,36,61,48,80,-32
8,59,36,67,32,0,32
8,59,36,81,29,28,1
8,59,36,103,29,0,29
8,59,37,51,0,23,-23
8,59,37,119,64,0,64
8,59,37,133,0,25,-25
8,59,37,183,70,36,34
8,59,39,35,50,0,50
8,59,39,49,48,29,19
8,59,39,61,31,0,31
8,59,40,109,32,45,-13
8,59,40,143,63,48,15
8,59,41,5,31,0,31
8,59,41,39,38,30,8
8,59,41,51,63,74,-11
8,59,41,67,31,53,-22
8,59,42,3,46,0,46
8,59,42,17,37,0,37
8,59,46,99,0,31,-31
8,59,46,103,37,36,1
8,59,47,37,43,28,15
8,59,47,93,0,33,-33
8,59,47,157,42,0,42
8,59,48,27,30,0,30
8,59,48,29,90,100,-10
8,59,48,85,82,79,3
8,59,48,113,111,110,1
8,59,48,121,63,64,-1
8,59,48,141,142,123,19
8,59,48,157,36,0,36
8,59,48,201,207,228,-21
8,59,48,339,79,33,46
8,59,48,439,155,88,67
8,59,48,453,98,95,3
8,59,48,491,0,69,-69
8,59,49,11,31,0,31
8,59,49,35,187,129,58
8,59,49,49,56,89,-33
8,59,49,53,0,27,-27
8,59,51,13,39,0,39
8,59,51,59,86,45,41
8,59,51,107,42,0,42
8,59,51,510,33,0,33
8,59,51,810,36,0,36
8,59,53,11,0,32,-32
8,59,53,33,146,186,-40
8,59,53,35,34,0,34
8,59,53,53,62,84,-22
8,59,53,61,56,56,0
8,59,53,63,42,47,-5
8,59,55,25,45,0,45
8,59,55,79,40,0,40
8,59,56,1,33,28,5
8,59,56,13,0,28,-28
8,59,56,21,75,56,19
8,59,56,25,36,28,8
8,63,8,5,23,0,23
8,63,8,41,42,46,-4
8,63,8,73,0,30,-30
8,63,8,123,37,28,9
8,63,8,125,0,37,-37
8,63,20,181,0,36,-36
8,65,8,5,39,31,8
8,65,8,13,24,0,24
8,65,8,15,0,50,-50
8,65,8,31,47,30,17
8,65,8,37,92,73,19
8,65,8,41,30,0,30
8,65,8,59,33,46,-13
8,65,8,117,70,69,1
8,67,4,5,37,0,37
8,67,4,13,188,117,71
8,67,4,19,57,41,16
8,67,4,25,60,0,60
8,67,6,37,46,35,11
8,67,6,59,27,0,27
8,67,6,67,33,0,33
8,67,6,71,40,0,40
8,67,6,73,62,55,7
8,67,8,1,54,60,-6
8,67,8,5,49,60,-11
8,67,8,7,122,95,27
8,67,8,13,57,57,0
8,67,8,31,118,153,-35
8,67,8,35,44,39,5
8,67,8,41,94,96,-2
8,67,8,45,43,0,43
8,67,8,51,29,0,29
8,67,8,59,118,105,13
8,67,8,69,86,92,-6
8,67,8,77,67,102,-35
8,67,8,83,182,183,-1
8,67,8,85,0,48,-48
8,67,8,105,45,0,45
8,67,8,117,23,0,23
8,67,8,123,33,0,33
8,67,17,31,0,30,-30
8,67,32,3,33,39,-6
8,67,35,1,93,79,14
8,67,35,31,37,0,37
8,67,35,45,300,394,-94
8,67,35,49,23,29,-6
8,67,41,51,0,21,-21
8,67,48,201,48,42,6
8,67,49,35,38,46,-8
8,69,2,20,94,36,58
8,69,4,5,70,23,47
8,69,4,13,586,391,195
8,69,4,15,33,0,33
8,69,4,19,122,76,46
8,69,4,21,76,32,44
8,69,4,25,55,33,22
8,69,5,119,42,0,42
8,69,6,1,73,51,22
8,69,6,13,41,33,8
8,69,6,19,36,0,36
8,69,6,29,43,0,43
8,69,6,37,397,139,258
8,69,6,53,34,0,34
8,69,6,59,208,83,125
8,69,6,61,30,0,30
8,69,6,65,114,57,57
8,69,6,67,63,51,12
8,69,6,71,162,47,115
8,69,6,73,280,259,21
8,69,6,75,28,27,1
8,69,6,81,42,28,14
8,69,6,83,58,22,36
8,69,6,85,113,87,26
8,69,6,97,37,0,37
8,69,6,111,82,45,37
8,69,8,1,629,902,-273
8,69,8,3,30,0,30
8,69,8,5,669,772,-103
8,69,8,13,1614,1337,277
8,69,8,14,182,259,-77
8,69,8,15,43,39,4
8,69,8,29,53,53,0
8,69,8,31,639,1296,-657
8,69,8,35,390,378,12
8,69,8,37,94,60,34
8,69,8,39,47,26,21
8,69,8,41,646,497,149
8,69,8,43,57,0,57
8,69,8,45,137,118,19
8,69,8,49,73,44,29
8,69,8,51,54,47,7
8,69,8,59,707,623,84
8,69,8,67,92,86,6
8,69,8,75,89,77,12
8,69,8,77,256,222,34
8,69,8,81,0,34,-34
8,69,8,83,36,0,36
8,69,8,85,56,67,-11
8,69,8,87,129,86,43
8,69,8,89,32,31,1
8,69,8,101,145,68,77
8,69,8,107,84,133,-49
8,69,8,113,32,0,32
8,69,8,117,79,82,-3
8,69,8,119,38,0,38
8,69,8,121,30,0,30
8,69,8,123,3024,3967,-943
8,69,8,125,48,0,48
8,69,11,1,0,35,-35
8,69,12,9,0,35,-35
8,69,12,11,57,33,24
8,69,12,31,27,0,27
8,69,12,57,30,34,-4
8,69,12,71,30,0,30
8,69,12,95,43,25,18
8,69,12,99,44,31,13
8,69,12,103,64,0,64
8,69,12,115,44,0,44
8,69,12,117,20,0,20
8,69,12,127,32,0,32
8,69,13,89,22,0,22
8,69,13,121,39,25,14
8,69,15,1,0,44,-44
8,69,15,3,63,52,11
8,69,16,1,58,59,-1
8,69,17,19,43,0,43
8,69,17,31,164,109,55
8,69,17,43,44,26,18
8,69,17,89,36,25,11
8,69,17,97,29,36,-7
8,69,17,111,34,0,34
8,69,17,201,29,0,29
8,69,19,103,39,0,39
8,69,19,153,46,38,8
8,69,20,91,61,40,21
8,69,20,161,30,0,30
8,69,20,173,25,33,-8
8,69,24,31,46,35,11
8,69,25,17,52,51,1
8,69,25,25,0,23,-23
8,69,26,65,32,0,32
8,69,26,81,27,0,27
8,69,26,125,38,0,38
8,69,26,161,0,31,-31
8,69,26,163,26,0,26
8,69,27,37,31,0,31
8,69,27,53,72,59,13
8,69,27,123,33,27,6
8,69,29,77,33,0,33
8,69,29,95,37,32,5
8,69,29,183,33,0,33
8,69,29,189,46,37,9
8,69,30,13,26,0,26
8,69,30,29,30,0,30
8,69,30,31,57,62,-5
8,69,30,63,0,31,-31
8,69,30,111,33,44,-11
8,69,31,19,42,0,42
8,69,31,55,90,64,26
8,69,31,109,106,71,35
8,69,31,111,34,0,34
8,69,31,153,35,0,35
8,69,31,157,51,55,-4
8,69,32,3,199,172,27
8,69,32,31,35,35,0
8,69,33,11,47,0,47
8,69,35,1,139,98,41
8,69,35,13,42,0,42
8,69,35,28,27,0,27
8,69,35,43,28,0,28
8,69,35,49,27,0,27
8,69,36,47,24,0,24
8,69,36,55,58,0,58
8,69,36,61,0,51,-51
8,69,36,103,39,27,12
8,69,37,21,0,35,-35
8,69,37,51,0,31,-31
8,69,37,183,55,47,8
8,69,38,17,28,0,28
8,69,38,35,25,0,25
8,69,39,35,37,0,37
8,69,39,49,52,0,52
8,69,39,61,0,25,-25
8,69,39,113,33,0,33
8,69,40,109,37,31,6
8,69,40,143,33,45,-12
8,69,41,3,30,0,30
8,69,41,5,36,0,36
8,69,41,17,0,25,-25
8,69,41,29,0,34,-34
8,69,41,39,27,37,-10
8,69,41,51,71,82,-11
8,69,41,67,62,48,14
8,69,42,29,29,0,29
8,69,42,91,34,0,34
8,69,46,81,33,0,33
8,69,46,103,77,49,28
8,69,47,37,0,22,-22
8,69,48,29,34,60,-26
8,69,48,85,48,55,-7
8,69,48,113,82,51,31
8,69,48,121,43,28,15
8,69,48,141,0,52,-52
8,69,48,201,88,115,-27
8,69,48,439,85,83,2
8,69,48,453,102,111,-9
8,69,48,491,0,60,-60
8,69,49,11,36,54,-18
8,69,49,35,96,76,20
8,69,49,49,53,57,-4
8,69,50,7,27,0,27
8,69,51,13,31,0,31
8,69,51,59,65,33,32
8,69,53,11,0,30,-30
8,69,53,33,110,186,-76
8,69,53,53,29,43,-14
8,69,53,61,30,27,3
8,69,53,63,32,62,-30
8,69,53,67,0,33,-33
8,69,55,25,48,48,0
8,69,55,79,50,0,50
8,69,56,1,161,118,43
8,69,56,5,34,36,-2
8,69,56,7,40,45,-5
8,69,56,9,0,27,-27
8,69,56,13,30,0,30
8,69,56,15,0,27,-27
8,69,56,21,462,353,109
8,69,56,25,113,95,18
8,69,56,33,29,33,-4
8,69,56,37,49,43,6
8,69,56,39,0,37,-37
8,71,8,1,42,33,9
8,71,8,5,0,24,-24
8,71,8,31,0,52,-52
8,71,8,41,62,86,-24
8,71,8,55,34,44,-10
8,71,8,101,128,117,11
8,71,35,7,59,63,-4
8,73,8,41,60,83,-23
8,73,8,63,30,0,30
8,75,8,1,64,59,5
8,75,8,5,41,37,4
8,75,8,13,38,0,38
8,75,8,31,41,47,-6
8,75,8,41,26,0,26
8,75,8,59,30,52,-22
8,75,8,69,77,89,-12
8,75,8,87,73,82,-9
8,75,8,95,65,55,10
8,75,8,121,43,48,-5
8,75,8,123,128,146,-18
8,75,8,125,0,59,-59
8,77,2,20,48,0,48
8,77,4,13,323,189,134
8,77,4,15,40,0,40
8,77,4,19,43,32,11
8,77,4,25,30,44,-14
8,77,6,1,26,0,26
8,77,6,19,34,0,34
8,77,6,29,107,31,76
8,77,6,37,150,98,52
8,77,6,59,94,47,47
8,77,6,65,88,54,34
8,77,6,67,37,0,37
8,77,6,71,105,39,66
8,77,6,73,146,98,48
8,77,6,111,36,0,36
8,77,8,1,270,166,104
8,77,8,5,277,228,49
8,77,8,7,28,0,28
8,77,8,13,89,144,-55
8,77,8,14,59,61,-2
8,77,8,15,44,0,44
8,77,8,29,311,388,-77
8,77,8,31,225,218,7
8,77,8,35,100,160,-60
8,77,8,37,111,83,28
8,77,8,41,333,177,156
8,77,8,43,36,0,36
8,77,8,45,855,429,426
8,77,8,49,56,0,56
8,77,8,51,63,42,21
8,77,8,59,311,252,59
8,77,8,67,102,67,35
8,77,8,69,222,256,-34
8,77,8,81,131,60,71
8,77,8,83,79,62,17
8,77,8,85,306,359,-53
8,77,8,91,0,39,-39
8,77,8,97,28,25,3
8,77,8,101,53,97,-44
8,77,8,103,164,69,95
8,77,8,107,86,25,61
8,77,8,113,39,0,39
8,77,8,117,45,0,45
8,77,8,123,188,132,56
8,77,16,1,42,26,16
8,77,17,31,46,0,46
8,77,30,63,27,0,27
8,77,31,55,0,23,-23
8,77,32,3,232,150,82
8,77,32,31,33,0,33
8,77,35,1,65,46,19
8,77,35,45,154,82,72
8,77,41,39,0,25,-25
8,77,41,51,0,23,-23
8,77,48,27,0,26,-26
8,77,48,113,36,0,36
8,77,48,141,44,0,44
8,77,48,201,99,46,53
8,77,48,221,0,34,-34
8,77,48,439,30,45,-15
8,77,49,7,49,31,18
8,77,49,19,86,67,19
8,77,49,35,159,109,50
8,77,49,47,131,51,80
8,77,49,49,86,76,10
8,77,49,53,49,33,16
8,77,49,57,31,0,31
8,77,53,33,39,38,1
8,77,53,53,0,28,-28
8,77,56,1,0,24,-24
8,77,56,13,50,0,50
8,77,56,21,0,39,-39
8,77,56,25,101,31,70
8,77,56,35,50,0,50
8,77,56,37,183,47,136
8,77,56,41,61,0,61
8,81,8,1,31,0,31
8,81,8,41,42,33,9
8,81,8,45,41,46,-5
8,81,8,59,44,32,12
8,81,8,69,34,0,34
8,81,8,77,60,131,-71
8,81,8,85,0,32,-32
8,81,8,103,46,41,5
8,81,8,107,120,106,14
8,83,4,1,39,58,-19
8,83,4,13,56,97,-41
8,83,4,15,34,35,-1
8,83,6,73,33,0,33
8,83,8,33,56,47,9
8,83,8,41,38,41,-3
8,83,8,45,28,0,28
8,83,8,67,183,182,1
8,83,8,69,0,36,-36
8,83,8,77,62,79,-17
8,83,8,85,0,33,-33
8,83,35,1,38,0,38
8,83,35,45,294,262,32
8,83,49,35,40,0,40
8,83,49,37,50,45,5
8,85,4,13,89,54,35
8,85,4,25,29,0,29
8,85,6,37,53,0,53
8,85,6,59,31,0,31
8,85,6,71,33,0,33
8,85,6,73,32,0,32
8,85,8,1,38,23,15
8,85,8,5,70,50,20
8,85,8,13,35,29,6
8,85,8,29,324,268,56
8,85,8,31,43,49,-6
8,85,8,35,55,29,26
8,85,8,41,74,82,-8
8,85,8,45,36,0,36
8,85,8,51,84,36,48
8,85,8,59,84,43,41
8,85,8,67,48,0,48
8,85,8,69,67,56,11
8,85,8,77,359,306,53
8,85,8,81,32,0,32
8,85,8,83,33,0,33
8,85,8,91,79,55,24
8,85,8,113,105,69,36
8,85,8,123,37,43,-6
8,85,32,3,69,0,69
8,85,35,45,0,36,-36
8,87,8,1,141,151,-10
8,87,8,5,46,74,-28
8,87,8,13,0,29,-29
8,87,8,31,143,90,53
8,87,8,41,0,34,-34
8,87,8,59,29,29,0
8,87,8,69,86,129,-43
8,87,8,75,82,73,9
8,87,8,121,56,0,56
8,87,8,123,303,515,-212
8,87,8,125,50,38,12
8,89,8,1,0,33,-33
8,89,8,11,45,51,-6
8,89,8,25,81,57,24
8,89,8,31,0,36,-36
8,89,8,41,95,88,7
8,89,8,69,31,32,-1
8,89,8,99,40,0,40
8,89,8,101,163,300,-137
8,91,8,77,39,0,39
8,91,8,85,55,79,-24
8,91,8,113,48,29,19
8,93,8,1,58,61,-3
8,93,8,5,107,44,63
8,93,8,13,27,0,27
8,93,8,15,28,48,-20
8,93,8,31,86,98,-12
8,93,8,35,72,50,22
8,93,8,41,89,65,24
8,93,8,59,290,375,-85
8,93,8,117,117,50,67
8,93,8,119,52,51,1
8,93,8,123,0,42,-42
8,95,8,75,55,65,-10
8,97,4,13,32,0,32
8,97,6,37,32,41,-9
8,97,6,41,24,0,24
8,97,6,73,29,0,29
8,97,6,75,0,21,-21
8,97,8,13,36,38,-2
8,97,8,31,97,62,35
8,97,8,37,221,260,-39
8,97,8,41,37,0,37
8,97,8,45,204,349,-145
8,97,8,77,25,28,-3
8,97,12,99,22,0,22
8,97,17,31,42,20,22
8,97,36,61,37,35,2
8,99,8,11,40,51,-11
8,99,8,31,0,29,-29
8,99,8,41,42,49,-7
8,99,8,89,0,40,-40
8,99,8,101,38,77,-39
8,99,8,123,0,31,-31
8,101,4,13,159,170,-11
8,101,4,15,55,0,55
8,101,4,19,45,39,6
8,101,6,37,111,66,45
8,101,6,59,57,0,57
8,101,6,65,91,31,60
8,101,6,67,38,0,38
8,101,6,71,68,0,68
8,101,6,73,63,44,19
8,101,8,1,189,209,-20
8,101,8,3,86,40,46
8,101,8,5,279,275,4
8,101,8,11,26,43,-17
8,101,8,13,53,66,-13
8,101,8,14,36,32,4
8,101,8,15,63,22,41
8,101,8,25,62,57,5
8,101,8,27,32,31,1
8,101,8,31,290,327,-37
8,101,8,35,126,142,-16
8,101,8,41,1523,1272,251
8,101,8,43,362,297,65
8,101,8,45,28,0,28
8,101,8,55,119,117,2
8,101,8,59,203,168,35
8,101,8,69,68,145,-77
8,101,8,71,117,128,-11
8,101,8,77,97,53,44
8,101,8,89,300,163,137
8,101,8,99,77,38,39
8,101,8,105,54,37,17
8,101,8,119,28,37,-9
8,101,8,123,89,110,-21
8,101,15,3,0,30,-30
8,101,32,3,113,101,12
8,101,35,1,81,56,25
8,101,35,45,35,0,35
8,101,48,27,45,0,45
8,101,48,29,33,0,33
8,101,48,201,48,42,6
8,101,48,453,24,39,-15
8,101,53,33,36,0,36
8,101,56,21,0,26,-26
8,103,8,45,33,44,-11
8,103,8,77,69,164,-95
8,103,8,81,41,46,-5
8,103,49,47,28,0,28
8,105,8,1,52,31,21
8,105,8,3,172,209,-37
8,105,8,31,39,21,18
8,105,8,41,68,82,-14
8,105,8,59,0,28,-28
8,105,8,67,0,45,-45
8,105,8,101,37,54,-17
8,105,8,109,43,0,43
8,107,4,13,33,31,2
8,107,6,37,35,0,35
8,107,6,73,0,25,-25
8,107,8,1,75,31,44
8,107,8,5,109,68,41
8,107,8,13,96,80,16
8,107,8,29,0,34,-34
8,107,8,31,112,127,-15
8,107,8,35,0,53,-53
8,107,8,37,52,0,52
8,107,8,41,56,35,21
8,107,8,59,99,56,43
8,107,8,69,133,84,49
8,107,8,77,25,86,-61
8,107,8,81,106,120,-14
8,107,8,117,47,0,47
8,107,8,123,59,0,59
8,107,53,33,34,0,34
8,109,8,13,34,0,34
8,109,8,105,0,43,-43
8,113,4,13,27,0,27
8,113,8,13,0,28,-28
8,113,8,31,23,24,-1
8,113,8,69,0,32,-32
8,113,8,77,0,39,-39
8,113,8,85,69,105,-36
8,113,8,91,29,48,-19
8,117,4,13,44,71,-27
8,117,6,37,44,25,19
8,117,6,59,0,32,-32
8,117,6,73,22,25,-3
8,117,8,1,42,74,-32
8,117,8,5,112,132,-20
8,117,8,13,150,166,-16
8,117,8,14,0,40,-40
8,117,8,15,0,45,-45
8,117,8,19,0,35,-35
8,117,8,31,246,339,-93
8,117,8,35,89,82,7
8,117,8,37,86,146,-60
8,117,8,41,101,95,6
8,117,8,45,0,43,-43
8,117,8,49,27,70,-43
8,117,8,59,206,249,-43
8,117,8,65,69,70,-1
8,117,8,67,0,23,-23
8,117,8,69,82,79,3
8,117,8,77,0,45,-45
8,117,8,93,50,117,-67
8,117,8,107,0,47,-47
8,117,8,123,0,32,-32
8,117,17,31,67,32,35
8,117,25,17,22,0,22
8,117,27,53,20,25,-5
8,117,32,3,0,28,-28
8,117,35,1,0,34,-34
8,117,36,61,23,0,23
8,117,39,35,29,0,29
8,117,48,201,23,0,23
8,119,4,13,0,60,-60
8,119,6,65,37,0,37
8,119,8,5,32,53,-21
8,119,8,31,0,32,-32
8,119,8,35,61,72,-11
8,119,8,41,820,989,-169
8,119,8,43,36,77,-41
8,119,8,59,34,29,5
8,119,8,69,0,38,-38
8,119,8,93,51,52,-1
8,119,8,101,37,28,9
8,119,48,439,35,0,35
8,121,8,69,0,30,-30
8,121,8,75,48,43,5
8,121,8,87,0,56,-56
8,121,8,123,0,32,-32
8,121,8,125,0,60,-60
8,123,2,20,24,0,24
8,123,4,13,334,256,78
8,123,4,15,30,0,30
8,123,4,19,43,71,-28
8,123,4,21,24,41,-17
8,123,6,13,40,0,40
8,123,6,19,32,29,3
8,123,6,37,203,127,76
8,123,6,59,86,59,27
8,123,6,65,104,29,75
8,123,6,67,45,0,45
8,123,6,71,131,49,82
8,123,6,73,149,96,53
8,123,6,85,62,0,62
8,123,6,111,50,0,50
8,123,8,1,3083,2597,486
8,123,8,5,655,713,-58
8,123,8,13,2834,1828,1006
8,123,8,14,598,354,244
8,123,8,29,0,60,-60
8,123,8,31,806,803,3
8,123,8,35,228,265,-37
8,123,8,37,46,73,-27
8,123,8,39,31,0,31
8,123,8,41,404,372,32
8,123,8,45,106,104,2
8,123,8,49,0,44,-44
8,123,8,57,27,0,27
8,123,8,59,826,665,161
8,123,8,63,28,37,-9
8,123,8,67,0,33,-33
8,123,8,69,3967,3024,943
8,123,8,75,146,128,18
8,123,8,77,132,188,-56
8,123,8,85,43,37,6
8,123,8,87,515,303,212
8,123,8,93,42,0,42
8,123,8,99,31,0,31
8,123,8,101,110,89,21
8,123,8,107,0,59,-59
8,123,8,117,32,0,32
8,123,8,121,32,0,32
8,123,8,125,85,53,32
8,123,15,3,38,31,7
8,123,17,31,60,37,23
8,123,17,43,37,0,37
8,123,19,153,0,22,-22
8,123,20,173,0,41,-41
8,123,26,81,35,0,35
8,123,27,53,31,0,31
8,123,29,189,34,0,34
8,123,31,55,45,0,45
8,123,31,79,25,0,25
8,123,31,109,0,32,-32
8,123,31,111,34,31,3
8,123,31,157,0,36,-36
8,123,32,3,145,123,22
8,123,35,1,78,56,22
8,123,35,13,67,35,32
8,123,41,39,0,26,-26
8,123,41,67,36,0,36
8,123,46,99,26,0,26
8,123,46,103,32,0,32
8,123,48,27,0,31,-31
8,123,48,29,53,73,-20
8,123,48,113,45,59,-14
8,123,48,141,80,135,-55
8,123,48,201,87,64,23
8,123,48,303,33,0,33
8,123,48,439,0,48,-48
8,123,48,453,0,43,-43
8,123,49,35,68,76,-8
8,123,49,49,0,64,-64
8,123,53,33,43,66,-23
8,123,56,1,41,34,7
8,123,56,5,49,37,12
8,123,56,21,274,207,67
8,123,56,25,75,53,22
8,123,56,37,31,39,-8
8,125,8,5,0,25,-25
8,125,8,63,37,0,37
8,125,8,69,0,48,-48
8,125,8,75,59,0,59
8,125,8,87,38,50,-12
8,125,8,121,60,0,60
8,125,8,123,53,85,-32
9,1,4,13,155,366,-211
9,1,4,19,33,91,-58
9,1,6,1,92,96,-4
9,1,6,13,86,80,6
9,1,6,37,533,478,55
9,1,6,41,42,53,-11
9,1,6,53,0,27,-27
9,1,6,59,122,203,-81
9,1,6,71,40,31,9
9,1,6,73,191,235,-44
9,1,6,75,89,173,-84
9,1,6,81,72,61,11
9,1,6,83,0,31,-31
9,1,6,85,96,160,-64
9,1,6,111,53,37,16
9,1,8,5,44,45,-1
9,1,8,13,36,74,-38
9,1,8,31,56,87,-31
9,1,8,41,23,45,-22
9,1,9,3,1109,1178,-69
9,1,9,5,1213,1524,-311
9,1,9,7,233,316,-83
9,1,9,9,6201,9144,-2943
9,1,9,11,219,233,-14
9,1,9,13,142,132,10
9,1,10,3,69,73,-4
9,1,11,1,136,191,-55
9,1,12,9,50,71,-21
9,1,12,11,277,367,-90
9,1,12,15,0,48,-48
9,1,12,19,0,31,-31
9,1,12,21,74,116,-42
9,1,12,31,74,87,-13
9,1,12,35,33,59,-26
9,1,12,53,0,40,-40
9,1,12,57,141,265,-124
9,1,12,61,27,95,-68
9,1,12,69,0,55,-55
9,1,12,71,91,181,-90
9,1,12,81,47,96,-49
9,1,12,83,0,86,-86
9,1,12,85,34,47,-13
9,1,12,86,215,267,-52
9,1,12,87,0,25,-25
9,1,12,95,163,206,-43
9,1,12,97,64,95,-31
9,1,12,99,315,468,-153
9,1,12,101,56,100,-44
9,1,12,103,80,211,-131
9,1,12,105,31,57,-26
9,1,12,109,0,87,-87
9,1,12,111,32,99,-67
9,1,12,115,63,132,-69
9,1,12,117,28,71,-43
9,1,12,119,0,51,-51
9,1,12,127,67,61,6
9,1,13,51,27,46,-19
9,1,13,67,95,137,-42
9,1,13,89,59,140,-81
9,1,13,117,0,35,-35
9,1,13,121,134,206,-72
9,1,13,135,68,147,-79
9,1,13,151,0,48,-48
9,1,13,217,0,33,-33
9,1,15,3,43,52,-9
9,1,17,31,403,392,11
9,1,17,43,114,99,15
9,1,17,97,55,75,-20
9,1,19,163,0,42,-42
9,1,20,91,30,0,30
9,1,23,5,49,74,-25
9,1,23,31,37,31,6
9,1,24,3,40,59,-19
9,1,24,5,81,67,14
9,1,24,27,38,36,2
9,1,24,31,107,166,-59
9,1,24,33,53,48,5
9,1,24,510,62,61,1
9,1,25,1,40,156,-116
9,1,25,3,70,0,70
9,1,25,5,57,74,-17
9,1,25,7,0,31,-31
9,1,25,9,106,124,-18
9,1,25,13,133,107,26
9,1,25,15,47,77,-30
9,1,25,17,446,635,-189
9,1,25,19,0,32,-32
9,1,25,21,211,332,-121
9,1,25,23,76,93,-17
9,1,25,25,300,448,-148
9,1,25,27,179,139,40
9,1,26,125,127,57,70
9,1,26,161,68,32,36
9,1,26,163,57,36,21
9,1,27,53,127,102,25
9,1,27,123,35,0,35
9,1,29,189,61,61,0
9,1,32,3,55,145,-90
9,1,32,31,0,28,-28
9,1,33,1,0,27,-27
9,1,33,5,0,35,-35
9,1,33,9,35,26,9
9,1,33,11,86,105,-19
9,1,33,13,22,0,22
9,1,33,15,32,87,-55
9,1,33,17,0,36,-36
9,1,34,1,22,0,22
9,1,34,3,409,261,148
9,1,34,5,38,51,-13
9,1,34,7,62,43,19
9,1,34,13,108,139,-31
9,1,34,17,359,336,23
9,1,34,21,112,97,15
9,1,34,23,206,280,-74
9,1,34,25,114,127,-13
9,1,34,27,133,158,-25
9,1,34,29,34,59,-25
9,1,34,31,72,65,7
9,1,34,35,84,101,-17
9,1,34,37,0,28,-28
9,1,34,39,137,70,67
9,1,35,1,0,25,-25
9,1,35,49,0,24,-24
9,1,36,1,85,67,18
9,1,36,5,1468,622,846
9,1,36,7,24,37,-13
9,1,36,17,0,24,-24
9,1,36,27,239,243,-4
9,1,36,29,98,90,8
9,1,36,47,866,741,125
9,1,36,55,83,90,-7
9,1,36,59,451,323,128
9,1,36,61,2896,2713,183
9,1,36,65,24,0,24
9,1,36,67,71,56,15
9,1,36,71,133,105,28
9,1,36,79,522,261,261
9,1,36,81,1121,682,439
9,1,36,85,73,40,33
9,1,36,87,210,115,95
9,1,36,91,43,65,-22
9,1,36,93,0,34,-34
9,1,36,103,381,329,52
9,1,36,109,37,0,37
9,1,36,111,44,57,-13
9,1,36,113,0,27,-27
9,1,36,119,4503,2383,2120
9,1,37,19,0,52,-52
9,1,37,37,0,29,-29
9,1,37,51,39,0,39
9,1,37,63,0,59,-59
9,1,37,67,0,51,-51
9,1,37,81,0,44,-44
9,1,37,97,0,42,-42
9,1,37,101,0,32,-32
9,1,37,119,106,427,-321
9,1,37,129,0,88,-88
9,1,37,133,42,58,-16
9,1,37,135,0,30,-30
9,1,37,179,0,66,-66
9,1,37,183,99,342,-243
9,1,39,35,73,90,-17
9,1,39,49,82,74,8
9,1,39,61,81,85,-4
9,1,39,113,0,31,-31
9,1,41,51,23,36,-13
9,1,42,3,106,88,18
9,1,42,11,35,34,1
9,1,42,17,61,81,-20
9,1,42,29,72,113,-41
9,1,42,43,0,40,-40
9,1,42,45,51,54,-3
9,1,42,71,0,48,-48
9,1,42,77,39,40,-1
9,1,42,79,26,0,26
9,1,42,91,102,107,-5
9,1,42,101,130,204,-74
9,1,42,133,0,36,-36
9,1,44,3,0,44,-44
9,1,44,5,47,28,19
9,1,44,7,143,136,7
9,1,44,9,52,77,-25
9,1,45,13,0,94,-94
9,1,45,15,0,34,-34
9,1,45,19,28,54,-26
9,1,45,35,0,33,-33
9,1,45,45,0,37,-37
9,1,45,51,27,100,-73
9,1,45,79,22,71,-49
9,1,45,83,0,52,-52
9,1,45,91,0,41,-41
9,1,47,37,0,55,-55
9,1,47,157,53,0,53
9,1,48,27,0,31,-31
9,1,48,29,40,41,-1
9,1,48,85,98,104,-6
9,1,48,113,151,124,27
9,1,48,121,0,70,-70
9,1,48,157,0,87,-87
9,1,48,201,119,226,-107
9,1,48,339,0,40,-40
9,1,48,439,38,124,-86
9,1,48,453,40,148,-108
9,1,49,35,36,58,-22
9,1,49,49,0,26,-26
9,1,50,1,0,23,-23
9,1,50,3,0,30,-30
9,1,50,7,64,50,14
9,1,50,21,30,0,30
9,1,50,25,0,45,-45
9,1,51,3,0,39,-39
9,1,51,13,65,116,-51
9,1,51,41,0,49,-49
9,1,51,59,176,136,40
9,1,51,87,82,70,12
9,1,51,107,36,78,-42
9,1,51,153,39,0,39
9,1,51,510,0,38,-38
9,1,51,700,0,32,-32
9,1,51,710,36,0,36
9,1,51,760,36,44,-8
9,1,51,810,27,58,-31
9,1,53,33,138,188,-50
9,1,53,61,0,35,-35
9,1,55,25,0,42,-42
9,1,55,79,27,34,-7
9,1,55,133,0,30,-30
9,1,56,39,0,32,-32
9,3,1,97,25,0,25
9,3,4,13,212,303,-91
9,3,4,19,27,83,-56
9,3,4,25,0,31,-31
9,3,6,1,60,77,-17
9,3,6,13,0,48,-48
9,3,6,37,231,369,-138
9,3,6,59,87,162,-75
9,3,6,65,58,37,21
9,3,6,67,29,40,-11
9,3,6,71,0,43,-43
9,3,6,73,187,243,-56
9,3,6,75,58,101,-43
9,3,6,81,0,43,-43
9,3,6,85,44,79,-35
9,3,6,97,0,24,-24
9,3,6,111,0,27,-27
9,3,8,5,0,46,-46
9,3,8,13,0,49,-49
9,3,8,31,25,53,-28
9,3,8,35,37,0,37
9,3,8,41,30,44,-14
9,3,8,59,0,29,-29
9,3,9,1,1178,1109,69
9,3,9,5,1904,1717,187
9,3,9,7,3072,3482,-410
9,3,9,9,5052,3953,1099
9,3,9,11,1082,1065,17
9,3,9,13,4238,5317,-1079
9,3,10,3,49,63,-14
9,3,11,1,76,155,-79
9,3,12,9,91,143,-52
9,3,12,11,257,290,-33
9,3,12,15,0,61,-61
9,3,12,17,0,43,-43
9,3,12,21,52,96,-44
9,3,12,31,68,94,-26
9,3,12,33,0,33,-33
9,3,12,35,0,27,-27
9,3,12,53,0,46,-46
9,3,12,57,122,242,-120
9,3,12,61,0,38,-38
9,3,12,69,0,76,-76
9,3,12,71,43,198,-155
9,3,12,81,32,68,-36
9,3,12,83,40,88,-48
9,3,12,85,33,82,-49
9,3,12,86,138,200,-62
9,3,12,95,244,327,-83
9,3,12,97,107,143,-36
9,3,12,99,180,362,-182
9,3,12,101,88,89,-1
9,3,12,103,124,215,-91
9,3,12,105,62,119,-57
9,3,12,109,0,33,-33
9,3,12,111,59,83,-24
9,3,12,115,60,114,-54
9,3,12,117,62,81,-19
9,3,12,119,0,61,-61
9,3,12,127,95,115,-20
9,3,13,51,0,24,-24
9,3,13,63,0,51,-51
9,3,13,67,95,92,3
9,3,13,89,80,125,-45
9,3,13,121,116,178,-62
9,3,13,135,68,156,-88
9,3,15,3,66,59,7
9,3,17,31,246,249,-3
9,3,17,43,45,69,-24
9,3,17,97,59,0,59
9,3,18,57,0,39,-39
9,3,18,97,41,36,5
9,3,19,153,29,0,29
9,3,19,163,0,119,-119
9,3,20,91,51,0,51
9,3,21,111,0,52,-52
9,3,23,1,20,44,-24
9,3,23,3,0,54,-54
9,3,23,5,69,107,-38
9,3,23,11,0,31,-31
9,3,23,19,28,76,-48
9,3,23,31,22,67,-45
9,3,24,3,45,52,-7
9,3,24,5,61,81,-20
9,3,24,27,0,40,-40
9,3,24,31,99,106,-7
9,3,24,33,49,69,-20
9,3,24,510,65,60,5
9,3,25,1,84,152,-68
9,3,25,3,50,85,-35
9,3,25,5,119,113,6
9,3,25,9,135,191,-56
9,3,25,11,58,33,25
9,3,25,13,1775,1507,268
9,3,25,15,289,196,93
9,3,25,17,438,701,-263
9,3,25,21,262,328,-66
9,3,25,23,91,90,1
9,3,25,25,322,576,-254
9,3,25,27,344,423,-79
9,3,26,65,33,0,33
9,3,26,99,34,0,34
9,3,26,125,117,61,56
9,3,26,161,51,41,10
9,3,26,163,91,0,91
9,3,27,53,84,94,-10
9,3,27,123,36,0,36
9,3,27,163,45,0,45
9,3,29,189,56,50,6
9,3,32,3,85,151,-66
9,3,33,3,0,26,-26
9,3,33,5,38,63,-25
9,3,33,9,38,46,-8
9,3,33,11,113,118,-5
9,3,33,13,54,27,27
9,3,33,15,90,91,-1
9,3,33,17,29,38,-9
9,3,33,19,0,26,-26
9,3,34,3,124,124,0
9,3,34,5,50,24,26
9,3,34,7,48,47,1
9,3,34,13,90,78,12
9,3,34,17,181,183,-2
9,3,34,21,55,39,16
9,3,34,23,148,179,-31
9,3,34,25,47,66,-19
9,3,34,27,117,130,-13
9,3,34,29,43,43,0
9,3,34,31,49,63,-14
9,3,34,35,64,34,30
9,3,34,39,92,59,33
9,3,35,1,0,39,-39
9,3,36,1,94,79,15
9,3,36,5,384,278,106
9,3,36,27,91,35,56
9,3,36,29,81,69,12
9,3,36,45,30,22,8
9,3,36,47,414,445,-31
9,3,36,55,107,98,9
9,3,36,59,192,130,62
9,3,36,61,406,638,-232
9,3,36,65,37,0,37
9,3,36,67,98,81,17
9,3,36,71,65,0,65
9,3,36,79,33,0,33
9,3,36,81,407,395,12
9,3,36,83,42,46,-4
9,3,36,85,46,34,12
9,3,36,87,41,30,11
9,3,36,91,55,50,5
9,3,36,93,25,29,-4
9,3,36,103,203,128,75
9,3,36,111,0,32,-32
9,3,36,119,224,174,50
9,3,37,19,0,33,-33
9,3,37,25,0,37,-37
9,3,37,51,0,38,-38
9,3,37,63,54,35,19
9,3,37,67,38,35,3
9,3,37,81,30,55,-25
9,3,37,97,0,33,-33
9,3,37,119,124,269,-145
9,3,37,129,0,25,-25
9,3,37,133,46,66,-20
9,3,37,135,0,33,-33
9,3,37,179,0,53,-53
9,3,37,183,48,232,-184
9,3,39,35,98,49,49
9,3,39,49,91,78,13
9,3,39,61,64,31,33
9,3,40,109,0,32,-32
9,3,41,51,23,46,-23
9,3,41,67,28,25,3
9,3,42,3,78,95,-17
9,3,42,11,0,41,-41
9,3,42,17,63,37,26
9,3,42,29,64,80,-16
9,3,42,43,0,48,-48
9,3,42,45,0,55,-55
9,3,42,49,0,33,-33
9,3,42,69,35,37,-2
9,3,42,71,34,49,-15
9,3,42,77,47,36,11
9,3,42,79,48,0,48
9,3,42,89,26,0,26
9,3,42,91,90,167,-77
9,3,42,101,155,194,-39
9,3,44,1,0,31,-31
9,3,44,3,73,87,-14
9,3,44,5,46,36,10
9,3,44,7,280,226,54
9,3,44,9,53,154,-101
9,3,45,13,0,42,-42
9,3,45,19,0,40,-40
9,3,45,45,47,118,-71
9,3,45,51,33,96,-63
9,3,45,63,0,32,-32
9,3,45,79,0,57,-57
9,3,45,91,0,41,-41
9,3,47,37,27,51,-24
9,3,47,93,33,0,33
9,3,47,157,40,42,-2
9,3,48,27,0,50,-50
9,3,48,29,99,80,19
9,3,48,85,50,113,-63
9,3,48,113,72,104,-32
9,3,48,121,0,32,-32
9,3,48,201,102,194,-92
9,3,48,439,58,87,-29
9,3,48,453,42,74,-32
9,3,49,35,0,48,-48
9,3,50,7,60,108,-48
9,3,50,21,0,33,-33
9,3,50,23,0,24,-24
9,3,50,25,36,49,-13
9,3,50,27,27,45,-18
9,3,51,13,34,82,-48
9,3,51,41,0,50,-50
9,3,51,59,129,118,11
9,3,51,87,34,61,-27
9,3,51,107,36,44,-8
9,3,51,153,0,29,-29
9,3,51,510,0,38,-38
9,3,51,700,0,36,-36
9,3,51,710,0,28,-28
9,3,51,760,0,34,-34
9,3,51,810,32,55,-23
9,3,53,33,94,119,-25
9,3,53,53,0,36,-36
9,3,55,25,45,48,-3
9,3,55,79,28,45,-17
9,3,55,133,0,37,-37
9,5,4,13,0,73,-73
9,5,4,19,0,22,-22
9,5,6,37,46,25,21
9,5,6,59,0,38,-38
9,5,6,73,26,39,-13
9,5,9,1,1524,1213,311
9,5,9,3,1717,1904,-187
9,5,9,7,99,139,-40
9,5,9,9,2517,1859,658
9,5,9,11,84,97,-13
9,5,9,13,70,105,-35
9,5,12,9,23,0,23
9,5,12,11,0,21,-21
9,5,12,57,0,26,-26
9,5,12,71,22,34,-12
9,5,12,81,0,23,-23
9,5,12,83,0,43,-43
9,5,12,95,0,29,-29
9,5,12,99,34,47,-13
9,5,12,103,33,28,5
9,5,12,127,45,35,10
9,5,23,5,0,33,-33
9,5,25,1,20,40,-20
9,5,25,3,141,141,0
9,5,25,5,0,24,-24
9,5,25,9,0,33,-33
9,5,25,13,58,44,14
9,5,25,17,58,91,-33
9,5,25,21,24,37,-13
9,5,25,25,22,99,-77
9,5,25,27,0,31,-31
9,5,32,3,0,35,-35
9,5,33,5,0,26,-26
9,5,33,11,0,32,-32
9,5,34,3,27,0,27
9,5,34,17,0,21,-21
9,5,36,5,71,32,39
9,5,36,21,32,0,32
9,5,36,27,201,126,75
9,5,36,47,64,95,-31
9,5,36,59,27,0,27
9,5,36,61,196,158,38
9,5,36,79,67,0,67
9,5,36,81,105,68,37
9,5,36,103,84,33,51
9,5,36,119,180,78,102
9,5,37,119,0,38,-38
9,5,37,183,0,66,-66
9,5,39,49,32,0,32
9,5,42,101,30,26,4
9,5,44,7,23,40,-17
9,5,45,51,0,44,-44
9,5,48,201,0,33,-33
9,5,50,7,0,29,-29
9,5,51,59,21,0,21
9,5,53,33,0,28,-28
9,7,4,13,0,68,-68
9,7,6,37,28,47,-19
9,7,6,73,0,71,-71
9,7,9,1,316,233,83
9,7,9,3,3482,3072,410
9,7,9,5,139,99,40
9,7,9,9,2833,2039,794
9,7,9,11,971,990,-19
9,7,9,13,297,262,35
9,7,11,1,0,31,-31
9,7,12,9,0,45,-45
9,7,12,11,37,0,37
9,7,12,21,0,27,-27
9,7,12,57,0,38,-38
9,7,12,69,0,30,-30
9,7,12,71,0,47,-47
9,7,12,95,27,35,-8
9,7,12,99,30,45,-15
9,7,12,103,0,39,-39
9,7,12,127,0,30,-30
9,7,17,31,40,42,-2
9,7,19,163,0,47,-47
9,7,23,5,0,23,-23
9,7,25,1,27,23,4
9,7,25,5,30,0,30
9,7,25,9,0,26,-26
9,7,25,13,59,62,-3
9,7,25,15,22,0,22
9,7,25,17,102,119,-17
9,7,25,21,39,43,-4
9,7,25,23,0,31,-31
9,7,25,25,48,90,-42
9,7,25,27,39,85,-46
9,7,26,161,96,0,96
9,7,26,163,41,0,41
9,7,33,11,0,42,-42
9,7,34,17,0,32,-32
9,7,36,5,35,0,35
9,7,36,47,47,61,-14
9,7,36,59,34,31,3
9,7,36,61,70,128,-58
9,7,36,81,54,61,-7
9,7,36,103,70,46,24
9,7,36,119,67,0,67
9,7,37,119,0,37,-37
9,7,42,17,0,28,-28
9,7,42,91,0,32,-32
9,7,42,101,0,28,-28
9,7,44,3,0,23,-23
9,7,44,7,52,28,24
9,7,44,9,41,47,-6
9,7,45,51,0,27,-27
9,7,48,201,0,33,-33
9,7,50,7,35,0,35
9,7,51,59,0,35,-35
9,9,1,89,0,48,-48
9,9,4,13,137,274,-137
9,9,4,19,50,61,-11
9,9,6,1,72,124,-52
9,9,6,13,32,50,-18
9,9,6,37,276,359,-83
9,9,6,59,73,85,-12
9,9,6,65,34,62,-28
9,9,6,67,0,51,-51
9,9,6,71,0,38,-38
9,9,6,73,208,214,-6
9,9,6,75,84,169,-85
9,9,6,81,30,78,-48
9,9,6,85,77,132,-55
9,9,6,111,0,26,-26
9,9,8,5,29,26,3
9,9,8,13,36,63,-27
9,9,8,31,0,48,-48
9,9,8,41,0,36,-36
9,9,8,59,28,0,28
9,9,9,1,9144,6201,2943
9,9,9,3,3953,5052,-1099
9,9,9,5,1859,2517,-658
9,9,9,7,2039,2833,-794
9,9,9,11,641,772,-131
9,9,9,13,280,373,-93
9,9,10,3,53,38,15
9,9,11,1,167,222,-55
9,9,12,1,35,31,4
9,9,12,9,70,125,-55
9,9,12,11,204,256,-52
9,9,12,15,40,47,-7
9,9,12,17,28,45,-17
9,9,12,19,0,46,-46
9,9,12,21,45,98,-53
9,9,12,31,40,96,-56
9,9,12,33,0,25,-25
9,9,12,35,0,32,-32
9,9,12,53,34,79,-45
9,9,12,57,147,208,-61
9,9,12,61,0,48,-48
9,9,12,69,34,60,-26
9,9,12,71,101,158,-57
9,9,12,81,37,53,-16
9,9,12,83,0,83,-83
9,9,12,85,0,40,-40
9,9,12,86,168,188,-20
9,9,12,95,177,268,-91
9,9,12,97,56,95,-39
9,9,12,99,141,375,-234
9,9,12,101,41,103,-62
9,9,12,103,79,192,-113
9,9,12,105,61,112,-51
9,9,12,109,0,44,-44
9,9,12,111,49,93,-44
9,9,12,115,41,117,-76
9,9,12,117,45,100,-55
9,9,12,119,0,49,-49
9,9,12,127,88,123,-35
9,9,13,67,27,84,-57
9,9,13,89,74,95,-21
9,9,13,121,91,125,-34
9,9,13,135,51,90,-39
9,9,15,3,48,37,11
9,9,17,19,23,0,23
9,9,17,31,246,211,35
9,9,17,43,55,54,1
9,9,17,97,37,43,-6
9,9,18,97,0,31,-31
9,9,19,163,0,35,-35
9,9,20,91,31,0,31
9,9,21,67,0,24,-24
9,9,21,111,26,45,-19
9,9,23,5,78,71,7
9,9,23,11,0,27,-27
9,9,23,19,0,72,-72
9,9,23,31,26,54,-28
9,9,24,3,46,52,-6
9,9,24,5,75,53,22
9,9,24,27,0,31,-31
9,9,24,31,111,128,-17
9,9,24,33,56,71,-15
9,9,24,510,62,71,-9
9,9,25,1,52,72,-20
9,9,25,3,49,25,24
9,9,25,5,107,86,21
9,9,25,9,138,128,10
9,9,25,11,22,0,22
9,9,25,13,205,194,11
9,9,25,15,66,81,-15
9,9,25,17,476,619,-143
9,9,25,21,176,199,-23
9,9,25,23,49,44,5
9,9,25,25,245,470,-225
9,9,25,27,176,183,-7
9,9,26,125,58,42,16
9,9,26,161,37,34,3
9,9,26,163,62,26,36
9,9,27,53,58,75,-17
9,9,27,123,28,0,28
9,9,29,189,51,60,-9
9,9,32,3,59,134,-75
9,9,33,5,38,72,-34
9,9,33,9,0,61,-61
9,9,33,11,80,99,-19
9,9,33,13,46,31,15
9,9,33,15,69,65,4
9,9,33,19,0,37,-37
9,9,34,1,0,24,-24
9,9,34,3,102,176,-74
9,9,34,5,35,31,4
9,9,34,7,0,45,-45
9,9,34,13,91,67,24
9,9,34,17,115,147,-32
9,9,34,21,71,66,5
9,9,34,23,109,149,-40
9,9,34,25,54,47,7
9,9,34,27,87,136,-49
9,9,34,29,34,56,-22
9,9,34,31,89,76,13
9,9,34,35,45,83,-38
9,9,34,37,35,0,35
9,9,34,39,55,41,14
9,9,35,1,32,28,4
9,9,35,61,0,34,-34
9,9,36,1,52,52,0
9,9,36,5,895,410,485
9,9,36,27,111,97,14
9,9,36,29,55,63,-8
9,9,36,47,653,561,92
9,9,36,55,107,51,56
9,9,36,59,184,112,72
9,9,36,61,854,994,-140
9,9,36,67,51,52,-1
9,9,36,71,71,44,27
9,9,36,79,61,50,11
9,9,36,81,620,453,167
9,9,36,83,0,41,-41
9,9,36,85,57,47,10
9,9,36,87,29,58,-29
9,9,36,91,54,64,-10
9,9,36,93,34,27,7
9,9,36,103,230,219,11
9,9,36,109,0,33,-33
9,9,36,119,657,377,280
9,9,37,1,0,32,-32
9,9,37,19,0,43,-43
9,9,37,21,0,33,-33
9,9,37,25,0,50,-50
9,9,37,51,0,56,-56
9,9,37,63,65,76,-11
9,9,37,67,30,35,-5
9,9,37,81,33,58,-25
9,9,37,101,0,38,-38
9,9,37,119,127,274,-147
9,9,37,129,0,42,-42
9,9,37,133,56,56,0
9,9,37,135,32,0,32
9,9,37,147,0,51,-51
9,9,37,179,0,54,-54
9,9,37,183,65,263,-198
9,9,39,35,41,91,-50
9,9,39,49,44,72,-28
9,9,39,61,0,30,-30
9,9,40,143,0,33,-33
9,9,41,51,39,50,-11
9,9,42,3,102,94,8
9,9,42,11,0,42,-42
9,9,42,17,44,92,-48
9,9,42,29,0,44,-44
9,9,42,41,0,37,-37
9,9,42,43,0,38,-38
9,9,42,45,42,42,0
9,9,42,69,29,0,29
9,9,42,71,31,48,-17
9,9,42,77,51,51,0
9,9,42,79,0,27,-27
9,9,42,91,59,98,-39
9,9,42,95,0,39,-39
9,9,42,101,182,244,-62
9,9,44,3,59,69,-10
9,9,44,5,36,39,-3
9,9,44,7,161,171,-10
9,9,44,9,58,37,21
9,9,45,19,29,77,-48
9,9,45,35,0,45,-45
9,9,45,45,0,28,-28
9,9,45,51,0,134,-134
9,9,45,63,0,32,-32
9,9,45,79,34,35,-1
9,9,45,83,0,35,-35
9,9,47,37,36,57,-21
9,9,47,157,37,31,6
9,9,48,29,29,79,-50
9,9,48,85,27,48,-21
9,9,48,113,66,124,-58
9,9,48,121,0,47,-47
9,9,48,157,0,51,-51
9,9,48,201,95,181,-86
9,9,48,439,50,61,-11
9,9,48,453,50,80,-30
9,9,49,35,41,52,-11
9,9,49,49,43,0,43
9,9,50,3,0,40,-40
9,9,50,7,41,40,1
9,9,50,25,30,39,-9
9,9,50,27,21,34,-13
9,9,51,13,53,75,-22
9,9,51,41,0,27,-27
9,9,51,59,88,108,-20
9,9,51,87,37,49,-12
9,9,51,107,32,30,2
9,9,51,153,27,43,-16
9,9,51,510,0,45,-45
9,9,51,710,0,28,-28
9,9,51,760,0,25,-25
9,9,51,810,54,48,6
9,9,53,33,82,147,-65
9,9,53,53,35,0,35
9,9,53,61,0,44,-44
9,9,55,25,60,26,34
9,9,55,79,33,37,-4
9,11,4,13,82,78,4
9,11,4,19,0,22,-22
9,11,6,1,0,30,-30
9,11,6,13,0,28,-28
9,11,6,37,66,98,-32
9,11,6,53,56,0,56
9,11,6,59,31,40,-9
9,11,6,71,33,0,33
9,11,6,73,209,309,-100
9,11,6,81,0,28,-28
9,11,6,85,0,29,-29
9,11,8,41,44,29,15
9,11,9,1,233,219,14
9,11,9,3,1065,1082,-17
9,11,9,7,990,971,19
9,11,9,9,772,641,131
9,11,9,13,399,436,-37
9,11,9,15,1532,1559,-27
9,11,10,3,0,32,-32
9,11,11,1,25,33,-8
9,11,12,9,57,68,-11
9,11,12,11,67,70,-3
9,11,12,21,0,42,-42
9,11,12,31,114,106,8
9,11,12,33,0,53,-53
9,11,12,57,49,64,-15
9,11,12,71,39,65,-26
9,11,12,81,0,32,-32
9,11,12,83,39,49,-10
9,11,12,86,22,85,-63
9,11,12,95,57,53,4
9,11,12,97,0,49,-49
9,11,12,99,42,100,-58
9,11,12,101,0,26,-26
9,11,12,103,53,81,-28
9,11,12,105,0,42,-42
9,11,12,111,0,37,-37
9,11,12,113,0,40,-40
9,11,12,115,53,50,3
9,11,12,117,0,43,-43
9,11,12,127,42,52,-10
9,11,13,39,157,281,-124
9,11,15,3,160,219,-59
9,11,17,31,52,36,16
9,11,17,97,34,0,34
9,11,23,5,26,49,-23
9,11,23,31,113,116,-3
9,11,24,3,45,45,0
9,11,24,5,42,0,42
9,11,24,31,48,0,48
9,11,24,33,28,31,-3
9,11,25,1,41,58,-17
9,11,25,5,76,42,34
9,11,25,9,53,36,17
9,11,25,13,98,74,24
9,11,25,15,23,32,-9
9,11,25,17,119,238,-119
9,11,25,21,65,97,-32
9,11,25,23,57,32,25
9,11,25,25,85,153,-68
9,11,25,27,137,94,43
9,11,26,77,109,0,109
9,11,26,93,130,0,130
9,11,26,125,68,0,68
9,11,26,161,895,0,895
9,11,26,163,158,0,158
9,11,29,189,0,33,-33
9,11,32,3,56,185,-129
9,11,33,11,39,39,0
9,11,33,15,98,118,-20
9,11,33,17,36,42,-6
9,11,34,3,40,0,40
9,11,34,13,46,0,46
9,11,34,17,54,27,27
9,11,34,23,50,52,-2
9,11,34,25,25,0,25
9,11,36,5,104,56,48
9,11,36,27,0,23,-23
9,11,36,47,303,229,74
9,11,36,55,45,32,13
9,11,36,59,40,30,10
9,11,36,61,229,164,65
9,11,36,67,29,0,29
9,11,36,81,237,172,65
9,11,36,91,95,47,48
9,11,36,103,134,48,86
9,11,36,119,74,95,-21
9,11,37,63,0,25,-25
9,11,37,119,0,33,-33
9,11,37,133,42,40,2
9,11,37,183,0,80,-80
9,11,39,35,0,41,-41
9,11,39,49,32,0,32
9,11,42,3,0,46,-46
9,11,42,79,0,24,-24
9,11,42,91,0,30,-30
9,11,42,101,37,55,-18
9,11,44,3,137,84,53
9,11,44,5,76,63,13
9,11,44,7,203,245,-42
9,11,44,9,703,619,84
9,11,45,15,201,65,136
9,11,45,19,64,58,6
9,11,45,35,0,39,-39
9,11,45,51,0,36,-36
9,11,45,79,0,34,-34
9,11,47,37,0,25,-25
9,11,48,29,0,36,-36
9,11,48,201,34,77,-43
9,11,48,439,27,47,-20
9,11,48,453,0,33,-33
9,11,50,7,22,37,-15
9,11,51,59,60,72,-12
9,11,51,153,0,48,-48
9,11,51,550,101,91,10
9,11,51,650,35,57,-22
9,11,51,700,0,39,-39
9,11,51,710,118,141,-23
9,11,51,740,46,67,-21
9,11,51,800,43,0,43
9,11,51,810,138,214,-76
9,11,53,33,48,74,-26
9,11,53,35,251,618,-367
9,11,53,53,0,38,-38
9,13,4,13,49,57,-8
9,13,6,37,28,31,-3
9,13,6,73,22,22,0
9,13,6,85,0,27,-27
9,13,9,1,132,142,-10
9,13,9,3,5317,4238,1079
9,13,9,7,262,297,-35
9,13,9,9,373,280,93
9,13,9,11,436,399,37
9,13,9,15,892,900,-8
9,13,12,11,37,0,37
9,13,12,57,0,45,-45
9,13,12,71,21,0,21
9,13,12,99,28,37,-9
9,13,12,101,0,32,-32
9,13,12,103,0,31,-31
9,13,17,31,0,27,-27
9,13,23,5,0,39,-39
9,13,25,1,0,50,-50
9,13,25,5,26,0,26
9,13,25,13,329,221,108
9,13,25,15,43,55,-12
9,13,25,17,123,113,10
9,13,25,21,40,46,-6
9,13,25,25,50,84,-34
9,13,25,27,141,150,-9
9,13,33,11,37,0,37
9,13,33,15,0,33,-33
9,13,36,47,0,23,-23
9,13,36,61,24,68,-44
9,13,36,81,0,42,-42
9,13,36,103,33,0,33
9,13,37,183,0,31,-31
9,13,44,7,0,31,-31
9,13,51,59,0,21,-21
9,15,4,13,0,31,-31
9,15,6,73,31,0,31
9,15,9,1,86,67,19
9,15,9,3,498,545,-47
9,15,9,7,90,115,-25
9,15,9,9,144,132,12
9,15,9,11,1559,1532,27
9,15,9,13,900,892,8
9,15,12,9,0,31,-31
9,15,12,83,27,0,27
9,15,12,115,0,28,-28
9,15,12,127,0,23,-23
9,15,23,5,0,28,-28
9,15,25,5,57,39,18
9,15,25,13,38,39,-1
9,15,25,17,73,99,-26
9,15,25,21,38,35,3
9,15,25,25,0,51,-51
9,15,25,27,683,569,114
9,15,32,3,0,38,-38
9,15,33,11,0,41,-41
9,15,36,47,0,24,-24
9,15,36,61,0,30,-30
9,15,36,81,0,29,-29
9,15,37,119,0,26,-26
9,15,44,3,274,88,186
9,15,44,7,614,249,365
9,15,44,9,73,67,6
10,1,2,20,63,45,18
10,1,4,13,0,34,-34
10,1,6,37,36,25,11
10,1,6,73,29,33,-4
10,1,8,41,0,33,-33
10,1,10,3,2823,1769,1054
10,1,11,1,29,32,-3
10,1,12,31,0,27,-27
10,1,12,57,39,45,-6
10,1,12,71,0,41,-41
10,1,12,86,0,38,-38
10,1,12,91,30,0,30
10,1,12,99,33,0,33
10,1,12,103,0,26,-26
10,1,15,3,77,47,30
10,1,24,3,196,90,106
10,1,24,5,110,73,37
10,1,24,11,185,136,49
10,1,24,15,189,84,105
10,1,24,19,36,0,36
10,1,24,25,42,29,13
10,1,24,27,41,0,41
10,1,24,29,64,71,-7
10,1,24,31,44,27,17
10,1,24,33,163,69,94
10,1,24,35,92,72,20
10,1,24,41,42,34,8
10,1,24,45,77,50,27
10,1,24,47,40,28,12
10,1,24,510,57,33,24
10,1,28,87,34,0,34
10,1,32,3,0,76,-76
10,1,34,1,56,0,56
10,1,34,5,139,43,96
10,1,34,7,130,33,97
10,1,34,13,81,0,81
10,1,34,15,83,46,37
10,1,34,17,32,0,32
10,1,34,21,52,0,52
10,1,34,23,102,0,102
10,1,34,25,56,0,56
10,1,34,29,43,0,43
10,1,34,33,28,0,28
10,1,34,35,31,0,31
10,1,34,39,52,0,52
10,1,35,9,48,0,48
10,1,36,5,53,45,8
10,1,36,47,99,31,68
10,1,36,55,0,26,-26
10,1,36,59,40,0,40
10,1,36,61,28,0,28
10,1,36,81,126,25,101
10,1,36,85,36,0,36
10,1,36,103,74,49,25
10,1,36,119,77,0,77
10,1,37,51,57,24,33
10,1,37,81,0,61,-61
10,1,37,119,0,39,-39
10,1,37,133,26,0,26
10,1,37,183,0,40,-40
10,1,40,65,59,0,59
10,1,42,3,29,38,-9
10,1,42,11,46,0,46
10,1,42,17,55,0,55
10,1,42,29,82,57,25
10,1,42,43,29,0,29
10,1,42,45,203,78,125
10,1,42,71,60,30,30
10,1,42,77,25,0,25
10,1,42,91,82,33,49
10,1,42,101,413,178,235
10,1,42,133,49,32,17
10,1,45,19,43,0,43
10,1,48,29,39,98,-59
10,1,48,201,0,39,-39
10,1,48,465,26,0,26
10,1,51,1,0,35,-35
10,1,51,13,0,27,-27
10,1,51,59,47,45,2
10,1,51,650,0,31,-31
10,1,51,810,54,31,23
10,1,53,53,118,0,118
10,3,4,13,82,200,-118
10,3,4,19,34,38,-4
10,3,6,1,28,59,-31
10,3,6,13,0,42,-42
10,3,6,37,132,208,-76
10,3,6,59,42,88,-46
10,3,6,65,36,0,36
10,3,6,67,0,35,-35
10,3,6,73,79,112,-33
10,3,6,75,0,43,-43
10,3,6,85,43,78,-35
10,3,8,5,0,33,-33
10,3,8,41,0,40,-40
10,3,9,1,73,69,4
10,3,9,3,63,49,14
10,3,9,9,38,53,-15
10,3,9,11,32,0,32
10,3,10,1,1769,2823,-1054
10,3,11,1,87,114,-27
10,3,12,1,0,25,-25
10,3,12,9,28,55,-27
10,3,12,11,73,101,-28
10,3,12,31,56,89,-33
10,3,12,57,62,127,-65
10,3,12,71,31,57,-26
10,3,12,81,0,39,-39
10,3,12,83,0,28,-28
10,3,12,86,48,62,-14
10,3,12,95,72,76,-4
10,3,12,99,115,104,11
10,3,12,101,0,38,-38
10,3,12,103,67,82,-15
10,3,12,105,34,40,-6
10,3,12,109,0,35,-35
10,3,12,111,0,32,-32
10,3,12,115,0,38,-38
10,3,12,117,0,37,-37
10,3,12,119,0,50,-50
10,3,12,127,54,43,11
10,3,13,67,74,89,-15
10,3,13,89,54,73,-19
10,3,13,121,71,141,-70
10,3,13,135,45,69,-24
10,3,15,3,46,46,0
10,3,17,31,177,184,-7
10,3,17,43,39,36,3
10,3,17,97,0,43,-43
10,3,18,97,0,38,-38
10,3,21,111,0,34,-34
10,3,22,71,0,33,-33
10,3,24,3,154,115,39
10,3,24,5,231,195,36
10,3,24,11,28,42,-14
10,3,24,15,1582,1500,82
10,3,24,21,0,46,-46
10,3,24,25,165,151,14
10,3,24,27,59,98,-39
10,3,24,29,37,109,-72
10,3,24,31,173,196,-23
10,3,24,33,167,127,40
10,3,24,35,37,47,-10
10,3,24,37,26,0,26
10,3,24,41,0,28,-28
10,3,24,45,58,34,24
10,3,24,47,32,64,-32
10,3,24,510,168,138,30
10,3,25,9,39,0,39
10,3,25,17,63,132,-69
10,3,25,21,52,37,15
10,3,25,25,55,44,11
10,3,25,27,56,34,22
10,3,26,125,68,65,3
10,3,26,163,32,0,32
10,3,27,53,49,37,12
10,3,29,189,35,28,7
10,3,32,3,82,124,-42
10,3,33,11,43,0,43
10,3,34,1,97,61,36
10,3,34,3,90,56,34
10,3,34,5,294,169,125
10,3,34,7,378,239,139
10,3,34,9,28,58,-30
10,3,34,11,139,53,86
10,3,34,13,182,107,75
10,3,34,15,381,228,153
10,3,34,17,120,136,-16
10,3,34,21,125,88,37
10,3,34,23,207,214,-7
10,3,34,25,106,35,71
10,3,34,27,93,68,25
10,3,34,29,65,39,26
10,3,34,31,34,0,34
10,3,34,33,443,317,126
10,3,34,35,83,32,51
10,3,34,39,96,33,63
10,3,36,5,215,102,113
10,3,36,29,73,60,13
10,3,36,47,278,189,89
10,3,36,55,27,57,-30
10,3,36,59,132,68,64
10,3,36,61,200,271,-71
10,3,36,67,41,44,-3
10,3,36,81,196,142,54
10,3,36,85,70,0,70
10,3,36,87,32,24,8
10,3,36,91,33,0,33
10,3,36,103,111,75,36
10,3,36,109,27,0,27
10,3,36,119,90,60,30
10,3,37,51,0,44,-44
10,3,37,63,34,39,-5
10,3,37,67,0,28,-28
10,3,37,81,36,51,-15
10,3,37,119,104,184,-80
10,3,37,133,54,42,12
10,3,37,179,0,42,-42
10,3,37,183,69,202,-133
10,3,39,35,47,0,47
10,3,39,49,108,143,-35
10,3,39,113,28,0,28
10,3,41,51,0,29,-29
10,3,42,3,85,92,-7
10,3,42,11,77,104,-27
10,3,42,17,333,226,107
10,3,42,27,41,0,41
10,3,42,29,1786,2178,-392
10,3,42,41,44,41,3
10,3,42,43,54,46,8
10,3,42,45,2601,1856,745
10,3,42,69,0,29,-29
10,3,42,71,194,228,-34
10,3,42,75,20,0,20
10,3,42,77,58,54,4
10,3,42,79,51,40,11
10,3,42,89,36,29,7
10,3,42,91,540,416,124
10,3,42,95,48,29,19
10,3,42,101,2012,1315,697
10,3,42,129,0,28,-28
10,3,42,133,58,77,-19
10,3,44,7,28,21,7
10,3,45,13,0,42,-42
10,3,45,19,0,43,-43
10,3,45,45,0,34,-34
10,3,45,51,28,42,-14
10,3,45,79,0,58,-58
10,3,47,37,0,57,-57
10,3,47,65,37,0,37
10,3,47,157,31,0,31
10,3,48,29,48,48,0
10,3,48,85,41,51,-10
10,3,48,113,96,95,1
10,3,48,157,0,52,-52
10,3,48,201,85,158,-73
10,3,48,439,39,75,-36
10,3,48,453,0,53,-53
10,3,51,13,59,78,-19
10,3,51,41,44,66,-22
10,3,51,59,119,173,-54
10,3,51,87,61,63,-2
10,3,51,107,29,49,-20
10,3,51,153,30,52,-22
10,3,51,510,31,55,-24
10,3,51,700,34,0,34
10,3,51,710,74,27,47
10,3,51,760,0,35,-35
10,3,51,810,58,68,-10
10,3,53,33,48,99,-51
10,3,55,25,25,0,25
10,5,4,13,49,38,11
10,5,6,37,0,35,-35
10,5,6,73,0,29,-29
10,5,10,1,1818,1664,154
10,5,11,1,89,55,34
10,5,12,9,0,29,-29
10,5,12,11,55,38,17
10,5,12,57,29,0,29
10,5,12,71,31,43,-12
10,5,12,86,31,26,5
10,5,12,95,29,31,-2
10,5,12,99,55,49,6
10,5,12,103,0,71,-71
10,5,12,115,0,29,-29
10,5,13,57,28,0,28
10,5,15,3,0,34,-34
10,5,24,3,385,142,243
10,5,24,5,296,77,219
10,5,24,9,55,0,55
10,5,24,11,216,122,94
10,5,24,13,71,26,45
10,5,24,15,79,51,28
10,5,24,17,53,0,53
10,5,24,19,175,96,79
10,5,24,21,91,35,56
10,5,24,25,142,44,98
10,5,24,27,141,51,90
10,5,24,31,315,83,232
10,5,24,33,160,44,116
10,5,24,35,70,41,29
10,5,24,39,49,55,-6
10,5,24,41,47,52,-5
10,5,24,45,830,788,42
10,5,24,47,373,279,94
10,5,24,510,97,59,38
10,5,25,27,23,0,23
10,5,32,3,29,27,2
10,5,34,1,44,0,44
10,5,34,3,66,0,66
10,5,34,5,92,0,92
10,5,34,7,100,26,74
10,5,34,9,33,0,33
10,5,34,13,41,0,41
10,5,34,15,67,0,67
10,5,34,17,32,0,32
10,5,34,19,29,0,29
10,5,34,23,95,0,95
10,5,34,25,69,0,69
10,5,34,27,53,0,53
10,5,34,29,58,0,58
10,5,34,31,38,0,38
10,5,34,33,38,0,38
10,5,34,35,44,0,44
10,5,34,39,54,0,54
10,5,36,5,45,0,45
10,5,36,47,48,0,48
10,5,36,59,47,0,47
10,5,36,61,42,40,2
10,5,36,85,31,0,31
10,5,36,103,68,25,43
10,5,36,119,49,0,49
10,5,37,119,0,32,-32
10,5,42,3,33,0,33
10,5,42,11,77,50,27
10,5,42,17,100,32,68
10,5,42,29,180,105,75
10,5,42,41,28,0,28
10,5,42,43,57,0,57
10,5,42,45,278,80,198
10,5,42,71,155,48,107
10,5,42,75,33,0,33
10,5,42,77,51,25,26
10,5,42,91,147,78,69
10,5,42,101,146,84,62
10,5,42,133,139,71,68
10,5,45,51,26,0,26
10,5,51,1,51,52,-1
10,5,51,13,38,23,15
10,5,51,59,193,51,142
10,5,51,107,61,32,29
10,5,51,153,34,0,34
10,5,51,510,67,0,67
11,1,1,73,65,57,8
11,1,1,97,26,0,26
11,1,1,101,34,36,-2
11,1,2,20,34,38,-4
11,1,4,13,204,216,-12
11,1,4,19,104,82,22
11,1,5,119,57,23,34
11,1,6,1,231,278,-47
11,1,6,13,99,80,19
11,1,6,37,781,912,-131
11,1,6,41,35,31,4
11,1,6,53,56,36,20
11,1,6,59,229,99,130
11,1,6,65,62,48,14
11,1,6,67,101,69,32
11,1,6,71,42,64,-22
11,1,6,73,452,385,67
11,1,6,75,375,549,-174
11,1,6,81,93,90,3
11,1,6,83,24,38,-14
11,1,6,85,186,223,-37
11,1,6,87,34,0,34
11,1,6,95,0,20,-20
11,1,6,97,0,26,-26
11,1,6,111,49,28,21
11,1,8,5,52,43,9
11,1,8,13,52,68,-16
11,1,8,31,164,271,-107
11,1,8,41,85,49,36
11,1,8,59,29,26,3
11,1,8,69,35,0,35
11,1,9,1,191,136,55
11,1,9,3,155,76,79
11,1,9,7,31,0,31
11,1,9,9,222,167,55
11,1,9,11,33,25,8
11,1,10,1,32,29,3
11,1,10,3,114,87,27
11,1,10,5,55,89,-34
11,1,12,1,65,24,41
11,1,12,9,49,28,21
11,1,12,11,198,188,10
11,1,12,21,21,27,-6
11,1,12,31,71,93,-22
11,1,12,33,30,0,30
11,1,12,57,140,135,5
11,1,12,61,0,26,-26
11,1,12,69,23,0,23
11,1,12,71,32,0,32
11,1,12,73,47,21,26
11,1,12,81,26,0,26
11,1,12,86,303,341,-38
11,1,12,95,108,93,15
11,1,12,99,159,78,81
11,1,12,103,55,59,-4
11,1,12,105,0,24,-24
11,1,12,115,28,30,-2
11,1,12,117,44,24,20
11,1,12,127,34,0,34
11,1,13,51,35,0,35
11,1,13,59,39,0,39
11,1,13,63,0,35,-35
11,1,13,67,120,66,54
11,1,13,89,170,235,-65
11,1,13,121,333,368,-35
11,1,13,135,71,70,1
11,1,13,151,25,0,25
11,1,15,3,125,139,-14
11,1,16,1,32,0,32
11,1,17,19,49,24,25
11,1,17,31,869,940,-71
11,1,17,43,86,58,28
11,1,17,89,31,24,7
11,1,17,97,57,28,29
11,1,17,111,20,0,20
11,1,17,163,42,0,42
11,1,17,197,34,0,34
11,1,17,201,21,0,21
11,1,18,35,28,0,28
11,1,18,57,23,0,23
11,1,18,97,93,67,26
11,1,18,105,63,38,25
11,1,18,141,48,26,22
11,1,19,103,29,0,29
11,1,19,153,41,0,41
11,1,20,45,25,0,25
11,1,20,91,63,36,27
11,1,21,67,48,33,15
11,1,21,111,70,50,20
11,1,22,33,43,45,-2
11,1,22,51,25,30,-5
11,1,22,71,120,139,-19
11,1,23,5,60,77,-17
11,1,23,19,21,0,21
11,1,24,3,632,656,-24
11,1,24,5,404,315,89
11,1,24,9,51,88,-37
11,1,24,13,25,37,-12
11,1,24,15,25,0,25
11,1,24,17,318,598,-280
11,1,24,21,135,167,-32
11,1,24,25,64,58,6
11,1,24,27,348,341,7
11,1,24,31,5882,7349,-1467
11,1,24,33,10859,15586,-4727
11,1,24,37,53,72,-19
11,1,24,43,41,40,1
11,1,24,510,752,826,-74
11,1,25,1,31,40,-9
11,1,25,3,25,0,25
11,1,25,5,27,0,27
11,1,25,9,102,47,55
11,1,25,13,45,0,45
11,1,25,15,55,21,34
11,1,25,17,619,534,85
11,1,25,21,222,134,88
11,1,25,23,52,26,26
11,1,25,25,435,405,30
11,1,25,27,82,23,59
11,1,26,65,76,36,40
11,1,26,77,28,0,28
11,1,26,81,51,0,51
11,1,26,99,26,0,26
11,1,26,125,170,49,121
11,1,26,161,181,142,39
11,1,26,163,104,77,27
11,1,27,37,40,0,40
11,1,27,53,219,186,33
11,1,27,123,80,62,18
11,1,28,47,26,31,-5
11,1,29,19,29,0,29
11,1,29,95,70,43,27
11,1,29,189,130,73,57
11,1,29,510,86,47,39
11,1,30,49,22,0,22
11,1,30,63,23,0,23
11,1,31,55,51,50,1
11,1,31,109,28,0,28
11,1,32,3,103,129,-26
11,1,32,31,26,0,26
11,1,33,9,36,0,36
11,1,33,11,56,30,26
11,1,33,13,37,0,37
11,1,33,15,26,28,-2
11,1,34,1,26,0,26
11,1,34,3,110,83,27
11,1,34,5,52,34,18
11,1,34,7,71,45,26
11,1,34,13,140,89,51
11,1,34,17,103,153,-50
11,1,34,21,139,75,64
11,1,34,23,115,41,74
11,1,34,25,78,51,27
11,1,34,27,117,57,60
11,1,34,29,47,24,23
11,1,34,31,27,0,27
11,1,34,35,40,27,13
11,1,34,39,51,26,25
11,1,35,1,59,87,-28
11,1,35,49,28,36,-8
11,1,36,1,73,28,45
11,1,36,5,129,77,52
11,1,36,7,25,0,25
11,1,36,27,31,30,1
11,1,36,29,97,51,46
11,1,36,47,487,671,-184
11,1,36,55,139,69,70
11,1,36,59,140,121,19
11,1,36,61,1263,2031,-768
11,1,36,67,137,43,94
11,1,36,71,56,0,56
11,1,36,81,206,213,-7
11,1,36,83,23,0,23
11,1,36,93,22,0,22
11,1,36,103,132,82,50
11,1,36,109,57,58,-1
11,1,36,119,197,159,38
11,1,37,21,29,29,0
11,1,37,49,0,32,-32
11,1,37,51,93,63,30
11,1,37,63,178,168,10
11,1,37,67,83,64,19
11,1,37,81,71,100,-29
11,1,37,83,0,38,-38
11,1,37,101,25,0,25
11,1,37,119,226,240,-14
11,1,37,127,27,30,-3
11,1,37,129,20,26,-6
11,1,37,133,46,72,-26
11,1,37,135,113,102,11
11,1,37,147,36,0,36
11,1,37,183,227,216,11
11,1,37,191,0,39,-39
11,1,37,195,0,26,-26
11,1,39,17,23,0,23
11,1,39,35,204,87,117
11,1,39,49,162,118,44
11,1,39,57,33,0,33
11,1,39,61,142,60,82
11,1,39,85,24,0,24
11,1,39,93,23,0,23
11,1,39,95,26,0,26
11,1,39,99,21,0,21
11,1,39,113,48,36,12
11,1,39,153,31,0,31
11,1,40,27,27,0,27
11,1,40,109,53,30,23
11,1,41,5,22,0,22
11,1,41,39,0,29,-29
11,1,41,51,140,169,-29
11,1,41,67,27,23,4
11,1,42,3,339,223,116
11,1,42,11,24,30,-6
11,1,42,17,99,63,36
11,1,42,27,40,26,14
11,1,42,29,134,56,78
11,1,42,41,49,27,22
11,1,42,43,54,32,22
11,1,42,45,113,52,61
11,1,42,55,0,29,-29
11,1,42,71,45,33,12
11,1,42,77,41,0,41
11,1,42,79,29,0,29
11,1,42,91,163,111,52
11,1,42,95,36,0,36
11,1,42,101,488,547,-59
11,1,42,125,32,0,32
11,1,42,129,29,0,29
11,1,42,133,47,39,8
11,1,44,1,20,0,20
11,1,44,3,30,0,30
11,1,44,5,20,31,-11
11,1,44,7,116,59,57
11,1,45,19,129,90,39
11,1,45,41,0,25,-25
11,1,45,45,32,26,6
11,1,45,51,0,26,-26
11,1,45,63,25,0,25
11,1,45,79,107,64,43
11,1,47,37,111,123,-12
11,1,47,65,33,0,33
11,1,47,93,38,39,-1
11,1,47,157,99,74,25
11,1,47,187,20,0,20
11,1,48,27,30,25,5
11,1,48,29,129,147,-18
11,1,48,85,30,28,2
11,1,48,113,239,220,19
11,1,48,121,31,0,31
11,1,48,141,41,42,-1
11,1,48,157,23,28,-5
11,1,48,201,315,275,40
11,1,48,439,50,100,-50
11,1,48,453,213,273,-60
11,1,49,35,66,44,22
11,1,49,49,31,0,31
11,1,50,7,81,38,43
11,1,50,25,20,0,20
11,1,50,27,24,20,4
11,1,51,3,74,86,-12
11,1,51,13,4012,3792,220
11,1,51,41,72,53,19
11,1,51,59,2857,2860,-3
11,1,51,61,39,0,39
11,1,51,69,0,29,-29
11,1,51,87,112,73,39
11,1,51,95,33,0,33
11,1,51,107,434,545,-111
11,1,51,121,0,30,-30
11,1,51,153,437,596,-159
11,1,51,177,32,68,-36
11,1,51,179,66,72,-6
11,1,51,510,1547,1752,-205
11,1,51,540,141,55,86
11,1,51,550,36,0,36
11,1,51,600,87,63,24
11,1,51,610,66,78,-12
11,1,51,630,35,27,8
11,1,51,650,43,41,2
11,1,51,660,29,0,29
11,1,51,683,23,0,23
11,1,51,700,48,0,48
11,1,51,710,106,112,-6
11,1,51,740,29,25,4
11,1,51,760,144,106,38
11,1,51,810,95,129,-34
11,1,53,33,329,410,-81
11,1,53,35,32,0,32
11,1,53,53,49,39,10
11,1,53,61,21,28,-7
11,1,53,63,25,0,25
11,1,54,3,0,72,-72
11,1,54,37,25,47,-22
11,1,54,39,38,0,38
11,1,55,25,153,64,89
11,1,55,79,84,56,28
11,1,55,133,21,0,21
12,1,1,73,51,74,-23
12,1,1,89,0,31,-31
12,1,4,13,59,104,-45
12,1,4,19,36,44,-8
12,1,6,1,0,57,-57
12,1,6,37,101,119,-18
12,1,6,59,0,45,-45
12,1,6,65,26,0,26
12,1,6,71,0,25,-25
12,1,6,73,100,95,5
12,1,6,75,0,39,-39
12,1,6,85,0,119,-119
12,1,8,31,0,30,-30
12,1,8,41,0,37,-37
12,1,9,9,31,35,-4
12,1,10,3,25,0,25
12,1,11,1,24,65,-41
12,1,12,3,28,0,28
12,1,12,5,91,86,5
12,1,12,7,316,343,-27
12,1,12,9,303,328,-25
12,1,12,11,753,617,136
12,1,12,15,92,57,35
12,1,12,17,150,138,12
12,1,12,19,383,421,-38
12,1,12,21,115,95,20
12,1,12,23,549,573,-24
12,1,12,29,69,54,15
12,1,12,31,834,960,-126
12,1,12,33,114,130,-16
12,1,12,35,41,102,-61
12,1,12,41,354,350,4
12,1,12,53,51,56,-5
12,1,12,55,51,31,20
12,1,12,57,616,813,-197
12,1,12,61,89,77,12
12,1,12,63,0,34,-34
12,1,12,69,173,218,-45
12,1,12,71,206,221,-15
12,1,12,73,340,376,-36
12,1,12,75,556,756,-200
12,1,12,81,122,152,-30
12,1,12,83,904,1038,-134
12,1,12,85,96,79,17
12,1,12,86,775,523,252
12,1,12,87,58,42,16
12,1,12,89,60,37,23
12,1,12,91,104,78,26
12,1,12,95,619,787,-168
12,1,12,97,110,102,8
12,1,12,99,486,429,57
12,1,12,101,147,192,-45
12,1,12,103,333,503,-170
12,1,12,105,297,244,53
12,1,12,107,406,366,40
12,1,12,109,200,294,-94
12,1,12,111,108,135,-27
12,1,12,113,47,54,-7
12,1,12,115,161,172,-11
12,1,12,117,224,321,-97
12,1,12,119,45,31,14
12,1,12,121,150,92,58
12,1,12,125,163,222,-59
12,1,12,127,302,280,22
12,1,12,131,0,31,-31
12,1,13,51,23,40,-17
12,1,13,59,26,39,-13
12,1,13,67,55,86,-31
12,1,13,89,70,136,-66
12,1,13,121,91,206,-115
12,1,13,135,95,77,18
12,1,13,153,0,26,-26
12,1,13,185,34,37,-3
12,1,15,3,28,34,-6
12,1,17,31,63,124,-61
12,1,17,97,30,0,30
12,1,18,97,52,25,27
12,1,19,103,31,0,31
12,1,21,111,36,46,-10
12,1,22,33,0,30,-30
12,1,22,71,0,41,-41
12,1,24,3,42,0,42
12,1,24,27,29,0,29
12,1,24,31,70,83,-13
12,1,24,33,21,0,21
12,1,25,17,53,101,-48
12,1,25,25,31,28,3
12,1,25,27,0,29,-29
12,1,26,125,34,0,34
12,1,26,161,0,23,-23
12,1,26,163,39,0,39
12,1,27,53,0,29,-29
12,1,29,95,0,23,-23
12,1,29,189,34,43,-9
12,1,32,3,35,46,-11
12,1,34,3,35,0,35
12,1,34,17,0,21,-21
12,1,36,5,45,0,45
12,1,36,47,37,84,-47
12,1,36,55,0,32,-32
12,1,36,61,75,133,-58
12,1,36,81,41,47,-6
12,1,36,119,0,24,-24
12,1,37,21,26,52,-26
12,1,37,51,33,32,1
12,1,37,63,39,69,-30
12,1,37,81,0,33,-33
12,1,37,119,38,94,-56
12,1,37,183,39,111,-72
12,1,39,35,45,33,12
12,1,39,49,50,43,7
12,1,39,61,0,46,-46
12,1,40,143,21,0,21
12,1,41,51,0,28,-28
12,1,41,67,0,37,-37
12,1,42,3,62,46,16
12,1,42,91,0,44,-44
12,1,42,101,0,32,-32
12,1,45,19,0,51,-51
12,1,45,45,0,39,-39
12,1,45,79,0,51,-51
12,1,47,37,33,46,-13
12,1,47,93,33,82,-49
12,1,47,125,0,30,-30
12,1,47,157,35,0,35
12,1,48,29,51,45,6
12,1,48,41,35,0,35
12,1,48,85,0,38,-38
12,1,48,113,49,52,-3
12,1,48,201,63,138,-75
12,1,48,439,37,63,-26
12,1,48,453,24,94,-70
12,1,49,35,58,37,21
12,1,51,13,0,33,-33
12,1,51,59,62,73,-11
12,1,51,510,0,34,-34
12,1,51,760,0,25,-25
12,1,53,33,27,84,-57
12,1,53,61,0,27,-27
12,1,55,25,27,27,0
12,1,55,79,36,0,36
12,3,12,1,0,28,-28
12,3,12,7,0,50,-50
12,3,12,19,118,110,8
12,3,12,23,79,94,-15
12,3,12,31,911,613,298
12,3,12,89,47,58,-11
12,3,12,109,30,0,30
12,3,12,125,48,74,-26
12,3,13,49,43,43,0
12,5,1,3,76,62,14
12,5,1,15,33,28,5
12,5,1,31,55,63,-8
12,5,1,39,32,0,32
12,5,1,45,44,48,-4
12,5,1,61,0,46,-46
12,5,1,69,205,219,-14
12,5,1,73,119,145,-26
12,5,1,81,33,28,5
12,5,1,89,0,61,-61
12,5,1,97,96,99,-3
12,5,1,101,62,64,-2
12,5,1,113,30,0,30
12,5,1,117,46,60,-14
12,5,1,125,27,46,-19
12,5,2,20,150,106,44
12,5,2,90,41,0,41
12,5,4,13,82,118,-36
12,5,4,19,0,34,-34
12,5,6,37,49,52,-3
12,5,6,59,34,0,34
12,5,6,71,0,23,-23
12,5,6,73,92,74,18
12,5,6,95,33,0,33
12,5,6,111,35,0,35
12,5,8,41,65,63,2
12,5,12,1,86,91,-5
12,5,12,9,49,102,-53
12,5,12,11,82,77,5
12,5,12,13,161,103,58
12,5,12,19,0,32,-32
12,5,12,23,32,0,32
12,5,12,31,169,161,8
12,5,12,33,189,223,-34
12,5,12,37,65,64,1
12,5,12,39,0,35,-35
12,5,12,45,365,324,41
12,5,12,57,103,195,-92
12,5,12,59,70,108,-38
12,5,12,63,282,244,38
12,5,12,69,46,40,6
12,5,12,71,68,54,14
12,5,12,73,384,359,25
12,5,12,81,30,0,30
12,5,12,83,70,77,-7
12,5,12,86,108,93,15
12,5,12,87,0,28,-28
12,5,12,91,368,294,74
12,5,12,95,113,158,-45
12,5,12,97,51,47,4
12,5,12,99,97,64,33
12,5,12,101,49,34,15
12,5,12,103,145,128,17
12,5,12,105,73,69,4
12,5,12,109,34,39,-5
12,5,12,113,139,127,12
12,5,12,115,25,39,-14
12,5,12,117,49,48,1
12,5,12,127,48,60,-12
12,5,12,129,44,52,-8
12,5,12,131,308,296,12
12,5,12,133,480,697,-217
12,5,13,57,0,33,-33
12,5,13,63,43,38,5
12,5,13,67,72,111,-39
12,5,13,77,0,33,-33
12,5,13,89,34,49,-15
12,5,13,95,34,0,34
12,5,13,97,0,33,-33
12,5,13,121,44,73,-29
12,5,13,135,80,84,-4
12,5,13,139,32,0,32
12,5,13,151,58,0,58
12,5,13,153,0,117,-117
12,5,13,185,61,61,0
12,5,13,215,44,47,-3
12,5,13,223,32,0,32
12,5,15,3,65,89,-24
12,5,17,31,39,56,-17
12,5,18,97,0,38,-38
12,5,21,111,27,0,27
12,5,22,51,0,23,-23
12,5,22,103,35,0,35
12,5,26,125,50,0,50
12,5,26,163,28,0,28
12,5,28,47,53,120,-67
12,5,28,59,43,56,-13
12,5,29,189,29,0,29
12,5,32,3,87,137,-50
12,5,35,1,34,0,34
12,5,37,51,31,42,-11
12,5,37,119,0,43,-43
12,5,37,133,0,35,-35
12,5,37,183,0,47,-47
12,5,37,191,42,0,42
12,5,39,35,28,0,28
12,5,39,49,36,0,36
12,5,39,113,27,57,-30
12,5,40,27,0,87,-87
12,5,40,109,32,144,-112
12,5,40,143,0,44,-44
12,5,45,45,0,35,-35
12,5,47,37,0,66,-66
12,5,47,65,22,0,22
12,5,47,93,42,53,-11
12,5,47,125,32,30,2
12,5,47,157,42,40,2
12,5,48,27,0,55,-55
12,5,48,29,106,114,-8
12,5,48,113,0,81,-81
12,5,48,201,59,141,-82
12,5,48,439,33,75,-42
12,5,48,453,0,42,-42
12,5,48,485,67,0,67
12,5,51,59,39,60,-21
12,5,51,153,0,35,-35
12,5,51,650,56,0,56
12,5,51,700,40,54,-14
12,5,51,710,31,0,31
12,5,51,810,106,67,39
12,5,53,33,0,41,-41
12,5,53,35,0,31,-31
12,5,53,53,40,0,40
12,7,12,1,343,316,27
12,7,12,3,50,0,50
12,7,12,19,361,271,90
12,7,12,23,70,0,70
12,7,12,31,263,148,115
12,7,12,83,40,32,8
12,7,12,107,77,74,3
12,7,12,125,173,209,-36
12,9,1,73,38,0,38
12,9,1,83,0,36,-36
12,9,1,89,74,220,-146
12,9,1,97,38,48,-10
12,9,1,101,48,0,48
12,9,1,103,0,29,-29
12,9,1,117,0,38,-38
12,9,4,13,155,246,-91
12,9,4,19,63,62,1
12,9,4,21,0,34,-34
12,9,5,119,0,28,-28
12,9,6,1,38,43,-5
12,9,6,29,34,0,34
12,9,6,37,183,254,-71
12,9,6,53,0,24,-24
12,9,6,59,88,114,-26
12,9,6,65,42,58,-16
12,9,6,67,36,0,36
12,9,6,71,41,41,0
12,9,6,73,178,124,54
12,9,6,75,0,29,-29
12,9,6,83,79,0,79
12,9,6,85,43,54,-11
12,9,8,5,51,46,5
12,9,8,31,31,26,5
12,9,8,35,48,63,-15
12,9,8,41,119,156,-37
12,9,8,59,27,41,-14
12,9,8,69,35,0,35
12,9,9,1,71,50,21
12,9,9,3,143,91,52
12,9,9,5,0,23,-23
12,9,9,7,45,0,45
12,9,9,9,125,70,55
12,9,9,11,68,57,11
12,9,9,15,31,0,31
12,9,10,3,55,28,27
12,9,10,5,29,0,29
12,9,11,1,28,49,-21
12,9,12,1,328,303,25
12,9,12,5,102,49,53
12,9,12,11,1721,778,943
12,9,12,15,49,60,-11
12,9,12,17,50,81,-31
12,9,12,19,100,120,-20
12,9,12,21,92,90,2
12,9,12,23,29,79,-50
12,9,12,31,469,554,-85
12,9,12,33,103,82,21
12,9,12,35,110,109,1
12,9,12,53,39,47,-8
12,9,12,55,81,59,22
12,9,12,57,619,588,31
12,9,12,61,980,805,175
12,9,12,69,278,234,44
12,9,12,71,245,202,43
12,9,12,73,262,269,-7
12,9,12,75,0,31,-31
12,9,12,81,107,112,-5
12,9,12,83,191,195,-4
12,9,12,85,167,149,18
12,9,12,86,1061,561,500
12,9,12,87,140,103,37
12,9,12,89,0,41,-41
12,9,12,91,124,128,-4
12,9,12,93,35,43,-8
12,9,12,95,2738,2332,406
12,9,12,97,466,476,-10
12,9,12,99,1039,636,403
12,9,12,101,172,163,9
12,9,12,103,436,337,99
12,9,12,105,361,364,-3
12,9,12,107,56,68,-12
12,9,12,109,144,229,-85
12,9,12,111,385,353,32
12,9,12,113,59,68,-9
12,9,12,115,123,86,37
12,9,12,117,824,671,153
12,9,12,119,0,48,-48
12,9,12,121,0,53,-53
12,9,12,127,645,618,27
12,9,13,39,59,37,22
12,9,13,51,54,71,-17
12,9,13,57,0,50,-50
12,9,13,63,0,28,-28
12,9,13,67,110,133,-23
12,9,13,77,35,35,0
12,9,13,89,85,130,-45
12,9,13,121,111,124,-13
12,9,13,127,0,39,-39
12,9,13,135,93,92,1
12,9,13,153,78,59,19
12,9,13,179,37,0,37
12,9,13,185,48,0,48
12,9,13,245,0,31,-31
12,9,15,3,95,70,25
12,9,17,31,126,107,19
12,9,17,43,41,38,3
12,9,17,163,44,0,44
12,9,18,3,40,0,40
12,9,18,97,53,29,24
12,9,18,157,0,26,-26
12,9,19,113,50,0,50
12,9,20,91,44,0,44
12,9,20,173,45,34,11
12,9,21,67,0,45,-45
12,9,21,111,40,49,-9
12,9,22,71,0,42,-42
12,9,22,103,35,46,-11
12,9,23,1,0,29,-29
12,9,23,5,41,38,3
12,9,23,19,23,0,23
12,9,23,31,44,26,18
12,9,24,3,141,87,54
12,9,24,5,68,45,23
12,9,24,13,40,0,40
12,9,24,17,0,34,-34
12,9,24,21,55,41,14
12,9,24,27,50,43,7
12,9,24,31,98,76,22
12,9,24,33,49,0,49
12,9,24,37,33,28,5
12,9,24,510,0,24,-24
12,9,25,1,49,49,0
12,9,25,5,78,55,23
12,9,25,9,88,84,4
12,9,25,13,78,41,37
12,9,25,17,111,88,23
12,9,25,21,50,44,6
12,9,25,23,67,68,-1
12,9,25,25,46,45,1
12,9,25,27,138,70,68
12,9,26,49,30,26,4
12,9,26,81,44,38,6
12,9,26,99,74,31,43
12,9,26,125,79,43,36
12,9,26,161,28,0,28
12,9,26,163,93,61,32
12,9,27,53,56,63,-7
12,9,27,123,28,0,28
12,9,28,47,40,64,-24
12,9,28,59,0,39,-39
12,9,29,95,27,0,27
12,9,29,189,38,38,0
12,9,31,55,38,0,38
12,9,31,153,0,39,-39
12,9,32,3,176,157,19
12,9,32,31,29,0,29
12,9,33,11,79,66,13
12,9,33,13,0,39,-39
12,9,33,15,71,54,17
12,9,33,17,24,0,24
12,9,34,1,37,31,6
12,9,34,3,87,41,46
12,9,34,5,55,32,23
12,9,34,7,71,57,14
12,9,34,9,41,0,41
12,9,34,13,102,0,102
12,9,34,15,26,0,26
12,9,34,17,60,40,20
12,9,34,21,31,0,31
12,9,34,23,89,37,52
12,9,34,25,79,46,33
12,9,34,27,50,0,50
12,9,34,29,109,57,52
12,9,34,31,67,27,40
12,9,34,37,36,0,36
12,9,34,39,43,0,43
12,9,35,1,56,47,9
12,9,36,1,33,0,33
12,9,36,5,141,92,49
12,9,36,7,28,22,6
12,9,36,27,45,0,45
12,9,36,29,65,46,19
12,9,36,45,51,0,51
12,9,36,47,261,116,145
12,9,36,55,98,65,33
12,9,36,59,182,73,109
12,9,36,61,44,96,-52
12,9,36,63,41,0,41
12,9,36,65,68,35,33
12,9,36,67,47,39,8
12,9,36,71,48,32,16
12,9,36,81,203,124,79
12,9,36,91,36,0,36
12,9,36,93,28,0,28
12,9,36,103,354,147,207
12,9,36,111,32,0,32
12,9,36,119,75,42,33
12,9,37,21,37,56,-19
12,9,37,25,0,50,-50
12,9,37,35,0,38,-38
12,9,37,51,81,103,-22
12,9,37,63,34,34,0
12,9,37,67,0,38,-38
12,9,37,81,44,72,-28
12,9,37,87,0,32,-32
12,9,37,89,31,55,-24
12,9,37,97,0,31,-31
12,9,37,113,0,34,-34
12,9,37,119,71,148,-77
12,9,37,129,45,0,45
12,9,37,133,89,90,-1
12,9,37,183,146,148,-2
12,9,39,17,42,0,42
12,9,39,35,95,41,54
12,9,39,49,91,58,33
12,9,39,57,0,27,-27
12,9,39,61,50,0,50
12,9,39,93,34,0,34
12,9,39,95,49,32,17
12,9,39,113,94,69,25
12,9,39,151,54,0,54
12,9,39,153,61,24,37
12,9,40,109,0,47,-47
12,9,40,143,24,0,24
12,9,41,5,0,33,-33
12,9,41,51,0,30,-30
12,9,42,3,104,81,23
12,9,42,7,33,0,33
12,9,42,11,32,29,3
12,9,42,17,75,40,35
12,9,42,19,29,0,29
12,9,42,29,47,0,47
12,9,42,41,29,0,29
12,9,42,71,28,38,-10
12,9,42,77,54,41,13
12,9,42,79,57,0,57
12,9,42,91,42,43,-1
12,9,42,95,31,0,31
12,9,42,101,60,43,17
12,9,42,129,32,0,32
12,9,42,133,69,35,34
12,9,44,3,31,0,31
12,9,44,7,72,37,35
12,9,44,9,33,0,33
12,9,45,3,0,39,-39
12,9,45,7,0,36,-36
12,9,45,13,35,53,-18
12,9,45,15,37,44,-7
12,9,45,19,37,56,-19
12,9,45,45,34,78,-44
12,9,45,51,57,43,14
12,9,45,63,0,58,-58
12,9,45,73,0,31,-31
12,9,45,77,0,36,-36
12,9,45,79,37,46,-9
12,9,45,83,0,41,-41
12,9,45,91,0,32,-32
12,9,47,11,0,27,-27
12,9,47,35,0,29,-29
12,9,47,37,52,54,-2
12,9,47,59,0,36,-36
12,9,47,65,0,65,-65
12,9,47,93,59,101,-42
12,9,47,125,0,41,-41
12,9,47,149,24,35,-11
12,9,47,155,0,43,-43
12,9,47,157,25,38,-13
12,9,47,165,0,46,-46
12,9,47,179,0,38,-38
12,9,47,185,0,44,-44
12,9,48,27,28,68,-40
12,9,48,29,122,206,-84
12,9,48,85,40,70,-30
12,9,48,113,72,62,10
12,9,48,121,44,51,-7
12,9,48,141,40,0,40
12,9,48,167,0,48,-48
12,9,48,201,95,191,-96
12,9,48,339,0,35,-35
12,9,48,439,95,123,-28
12,9,48,451,56,0,56
12,9,48,453,0,68,-68
12,9,48,491,0,27,-27
12,9,49,35,63,48,15
12,9,50,7,33,0,33
12,9,51,13,37,57,-20
12,9,51,41,28,30,-2
12,9,51,59,186,212,-26
12,9,51,107,53,69,-16
12,9,51,153,29,82,-53
12,9,51,177,34,0,34
12,9,51,179,0,41,-41
12,9,51,199,0,38,-38
12,9,51,510,26,26,0
12,9,51,550,48,29,19
12,9,51,700,40,37,3
12,9,51,710,60,54,6
12,9,51,810,116,57,59
12,9,53,33,57,87,-30
12,9,53,35,77,45,32
12,9,53,53,57,55,2
12,9,53,61,41,24,17
12,9,54,39,0,25,-25
12,9,55,79,26,0,26
12,11,1,3,29,63,-34
12,11,1,45,0,31,-31
12,11,1,69,0,71,-71
12,11,1,73,72,119,-47
12,11,1,77,0,28,-28
12,11,1,81,0,32,-32
12,11,1,89,30,122,-92
12,11,1,97,39,74,-35
12,11,1,101,44,37,7
12,11,1,117,0,61,-61
12,11,2,20,49,37,12
12,11,4,3,0,43,-43
12,11,4,13,440,647,-207
12,11,4,19,93,148,-55
12,11,4,25,0,40,-40
12,11,4,27,0,29,-29
12,11,5,7,0,48,-48
12,11,5,119,23,47,-24
12,11,5,143,0,32,-32
12,11,6,1,102,126,-24
12,11,6,13,72,128,-56
12,11,6,29,0,38,-38
12,11,6,37,770,844,-74
12,11,6,41,32,35,-3
12,11,6,53,0,56,-56
12,11,6,59,265,266,-1
12,11,6,65,175,189,-14
12,11,6,67,104,85,19
12,11,6,71,108,168,-60
12,11,6,73,312,431,-119
12,11,6,75,120,113,7
12,11,6,77,0,33,-33
12,11,6,81,37,100,-63
12,11,6,85,94,129,-35
12,11,6,95,48,30,18
12,11,6,97,28,0,28
12,11,6,111,70,53,17
12,11,8,1,0,73,-73
12,11,8,5,74,149,-75
12,11,8,13,43,62,-19
12,11,8,31,111,138,-27
12,11,8,35,70,125,-55
12,11,8,41,95,120,-25
12,11,8,59,47,100,-53
12,11,8,69,33,57,-24
12,11,9,1,367,277,90
12,11,9,3,290,257,33
12,11,9,5,21,0,21
12,11,9,7,0,37,-37
12,11,9,9,256,204,52
12,11,9,11,70,67,3
12,11,9,13,0,37,-37
12,11,10,3,101,73,28
12,11,10,5,38,55,-17
12,11,11,1,188,198,-10
12,11,12,1,617,753,-136
12,11,12,5,77,82,-5
12,11,12,9,778,1721,-943
12,11,12,15,171,268,-97
12,11,12,17,105,328,-223
12,11,12,19,156,367,-211
12,11,12,21,622,735,-113
12,11,12,23,64,130,-66
12,11,12,29,0,31,-31
12,11,12,31,936,1270,-334
12,11,12,33,127,185,-58
12,11,12,35,106,358,-252
12,11,12,39,0,43,-43
12,11,12,41,0,40,-40
12,11,12,43,32,56,-24
12,11,12,51,117,122,-5
12,11,12,53,87,343,-256
12,11,12,55,197,474,-277
12,11,12,57,1449,1880,-431
12,11,12,61,241,692,-451
12,11,12,63,0,60,-60
12,11,12,69,248,933,-685
12,11,12,71,1243,1944,-701
12,11,12,73,763,879,-116
12,11,12,75,0,115,-115
12,11,12,81,251,436,-185
12,11,12,83,459,1399,-940
12,11,12,85,270,525,-255
12,11,12,86,38794,23529,15265
12,11,12,87,383,336,47
12,11,12,89,0,52,-52
12,11,12,91,95,114,-19
12,11,12,93,34,100,-66
12,11,12,95,2357,3378,-1021
12,11,12,97,606,913,-307
12,11,12,99,11359,16731,-5372
12,11,12,101,283,569,-286
12,11,12,103,760,693,67
12,11,12,105,661,1390,-729
12,11,12,107,47,106,-59
12,11,12,109,158,400,-242
12,11,12,111,1318,4065,-2747
12,11,12,113,64,80,-16
12,11,12,115,320,466,-146
12,11,12,117,593,907,-314
12,11,12,119,39,196,-157
12,11,12,121,38,109,-71
12,11,12,127,531,812,-281
12,11,12,131,0,42,-42
12,11,13,13,0,95,-95
12,11,13,15,0,56,-56
12,11,13,21,40,64,-24
12,11,13,31,0,31,-31
12,11,13,33,0,25,-25
12,11,13,39,0,61,-61
12,11,13,45,0,71,-71
12,11,13,51,88,202,-114
12,11,13,57,90,337,-247
12,11,13,59,0,63,-63
12,11,13,63,143,346,-203
12,11,13,67,368,878,-510
12,11,13,73,0,74,-74
12,11,13,77,47,182,-135
12,11,13,87,0,27,-27
12,11,13,89,316,751,-435
12,11,13,95,46,74,-28
12,11,13,97,98,262,-164
12,11,13,103,0,26,-26
12,11,13,113,46,129,-83
12,11,13,117,78,396,-318
12,11,13,121,540,1282,-742
12,11,13,123,0,41,-41
12,11,13,127,33,99,-66
12,11,13,135,437,1512,-1075
12,11,13,137,0,33,-33
12,11,13,139,40,144,-104
12,11,13,151,102,526,-424
12,11,13,153,28,133,-105
12,11,13,157,0,66,-66
12,11,13,179,57,40,17
12,11,13,185,55,112,-57
12,11,13,215,49,103,-54
12,11,13,217,41,217,-176
12,11,13,223,71,306,-235
12,11,13,245,50,156,-106
12,11,13,247,67,256,-189
12,11,13,255,0,37,-37
12,11,13,275,27,32,-5
12,11,13,297,0,87,-87
12,11,15,3,162,163,-1
12,11,17,31,839,901,-62
12,11,17,43,131,153,-22
12,11,17,89,61,53,8
12,11,17,97,147,186,-39
12,11,17,111,27,97,-70
12,11,17,113,31,0,31
12,11,17,161,25,0,25
12,11,17,163,36,0,36
12,11,17,197,88,63,25
12,11,18,3,58,28,30
12,11,18,57,34,60,-26
12,11,18,89,0,56,-56
12,11,18,97,112,181,-69
12,11,18,105,0,28,-28
12,11,18,141,33,63,-30
12,11,19,153,42,0,42
12,11,19,163,0,56,-56
12,11,20,61,0,28,-28
12,11,20,91,73,120,-47
12,11,20,173,35,46,-11
12,11,21,67,71,64,7
12,11,21,111,127,170,-43
12,11,21,117,0,41,-41
12,11,22,17,26,0,26
12,11,22,33,82,61,21
12,11,22,51,80,102,-22
12,11,22,55,0,34,-34
12,11,22,71,27,83,-56
12,11,22,103,41,43,-2
12,11,23,1,0,25,-25
12,11,23,5,41,52,-11
12,11,23,31,45,42,3
12,11,24,3,132,160,-28
12,11,24,5,207,165,42
12,11,24,21,39,37,2
12,11,24,25,50,33,17
12,11,24,27,70,99,-29
12,11,24,31,382,372,10
12,11,24,33,218,161,57
12,11,24,510,133,103,30
12,11,25,1,148,73,75
12,11,25,3,22,31,-9
12,11,25,5,124,88,36
12,11,25,9,217,174,43
12,11,25,13,146,70,76
12,11,25,15,28,0,28
12,11,25,17,479,342,137
12,11,25,19,31,0,31
12,11,25,21,234,179,55
12,11,25,23,170,101,69
12,11,25,25,374,328,46
12,11,25,27,171,122,49
12,11,26,49,74,0,74
12,11,26,55,32,0,32
12,11,26,65,52,36,16
12,11,26,75,39,0,39
12,11,26,77,31,0,31
12,11,26,81,81,64,17
12,11,26,99,183,59,124
12,11,26,125,376,159,217
12,11,26,139,31,26,5
12,11,26,147,25,0,25
12,11,26,161,103,58,45
12,11,26,163,325,165,160
12,11,27,3,31,0,31
12,11,27,37,42,0,42
12,11,27,53,125,147,-22
12,11,27,123,54,53,1
12,11,28,33,0,42,-42
12,11,28,47,38,49,-11
12,11,28,59,0,24,-24
12,11,29,47,22,0,22
12,11,29,77,23,36,-13
12,11,29,95,77,69,8
12,11,29,183,48,33,15
12,11,29,189,170,153,17
12,11,29,510,0,40,-40
12,11,31,55,32,54,-22
12,11,32,3,436,508,-72
12,11,32,31,0,51,-51
12,11,33,11,87,90,-3
12,11,33,13,20,0,20
12,11,33,15,73,75,-2
12,11,34,1,162,87,75
12,11,34,3,432,278,154
12,11,34,5,104,77,27
12,11,34,7,156,113,43
12,11,34,9,52,51,1
12,11,34,13,396,217,179
12,11,34,15,63,29,34
12,11,34,17,397,324,73
12,11,34,19,0,44,-44
12,11,34,21,103,98,5
12,11,34,23,324,170,154
12,11,34,25,228,235,-7
12,11,34,27,175,136,39
12,11,34,29,190,138,52
12,11,34,31,251,116,135
12,11,34,35,105,83,22
12,11,34,37,0,28,-28
12,11,34,39,260,184,76
12,11,34,41,38,0,38
12,11,35,1,52,78,-26
12,11,35,43,0,40,-40
12,11,35,49,0,37,-37
12,11,36,1,86,42,44
12,11,36,5,916,535,381
12,11,36,7,30,31,-1
12,11,36,27,64,65,-1
12,11,36,29,210,180,30
12,11,36,45,40,29,11
12,11,36,47,1369,977,392
12,11,36,55,193,160,33
12,11,36,57,0,32,-32
12,11,36,59,785,525,260
12,11,36,61,859,867,-8
12,11,36,63,24,30,-6
12,11,36,65,36,31,5
12,11,36,67,92,71,21
12,11,36,71,128,87,41
12,11,36,81,1595,1114,481
12,11,36,85,217,157,60
12,11,36,87,137,117,20
12,11,36,91,0,52,-52
12,11,36,93,36,0,36
12,11,36,103,588,518,70
12,11,36,105,25,0,25
12,11,36,111,24,0,24
12,11,36,119,408,356,52
12,11,37,1,0,56,-56
12,11,37,21,56,213,-157
12,11,37,25,27,157,-130
12,11,37,27,0,34,-34
12,11,37,31,0,29,-29
12,11,37,35,0,65,-65
12,11,37,39,0,31,-31
12,11,37,49,26,47,-21
12,11,37,51,105,194,-89
12,11,37,63,31,130,-99
12,11,37,67,61,156,-95
12,11,37,71,0,123,-123
12,11,37,81,114,320,-206
12,11,37,87,0,43,-43
12,11,37,89,0,86,-86
12,11,37,97,0,122,-122
12,11,37,101,0,97,-97
12,11,37,109,0,54,-54
12,11,37,113,0,49,-49
12,11,37,119,317,1233,-916
12,11,37,125,0,51,-51
12,11,37,129,60,77,-17
12,11,37,133,178,137,41
12,11,37,135,0,35,-35
12,11,37,147,0,47,-47
12,11,37,151,0,76,-76
12,11,37,159,0,55,-55
12,11,37,161,0,49,-49
12,11,37,179,55,350,-295
12,11,37,183,196,896,-700
12,11,37,191,23,0,23
12,11,39,17,37,46,-9
12,11,39,35,254,221,33
12,11,39,41,0,32,-32
12,11,39,49,198,201,-3
12,11,39,57,0,26,-26
12,11,39,61,86,83,3
12,11,39,85,53,0,53
12,11,39,93,40,29,11
12,11,39,95,83,40,43
12,11,39,99,28,28,0
12,11,39,113,67,76,-9
12,11,39,139,0,34,-34
12,11,39,151,44,36,8
12,11,39,153,86,39,47
12,11,39,165,42,0,42
12,11,39,173,32,0,32
12,11,40,27,0,33,-33
12,11,40,109,70,64,6
12,11,40,143,46,76,-30
12,11,41,51,64,76,-12
12,11,41,67,0,57,-57
12,11,42,3,213,271,-58
12,11,42,7,34,0,34
12,11,42,11,59,68,-9
12,11,42,17,136,174,-38
12,11,42,19,32,28,4
12,11,42,29,67,90,-23
12,11,42,41,0,52,-52
12,11,42,43,47,40,7
12,11,42,45,99,68,31
12,11,42,49,24,0,24
12,11,42,69,47,28,19
12,11,42,71,83,47,36
12,11,42,77,100,91,9
12,11,42,79,51,26,25
12,11,42,89,63,48,15
12,11,42,91,187,220,-33
12,11,42,95,58,81,-23
12,11,42,101,406,311,95
12,11,42,103,28,0,28
12,11,42,125,0,39,-39
12,11,42,129,24,39,-15
12,11,42,133,43,49,-6
12,11,44,3,40,33,7
12,11,44,5,33,28,5
12,11,44,7,247,163,84
12,11,44,9,42,31,11
12,11,45,3,0,42,-42
12,11,45,7,0,134,-134
12,11,45,13,62,87,-25
12,11,45,15,36,89,-53
12,11,45,19,82,141,-59
12,11,45,35,0,75,-75
12,11,45,41,0,54,-54
12,11,45,45,58,469,-411
12,11,45,51,77,117,-40
12,11,45,63,0,141,-141
12,11,45,77,0,55,-55
12,11,45,79,108,183,-75
12,11,45,83,23,120,-97
12,11,45,85,0,33,-33
12,11,45,91,36,288,-252
12,11,47,9,0,82,-82
12,11,47,11,0,39,-39
12,11,47,35,0,26,-26
12,11,47,37,127,310,-183
12,11,47,65,36,156,-120
12,11,47,93,86,289,-203
12,11,47,119,0,61,-61
12,11,47,125,31,81,-50
12,11,47,141,0,45,-45
12,11,47,149,64,125,-61
12,11,47,155,0,59,-59
12,11,47,157,141,189,-48
12,11,47,165,0,60,-60
12,11,47,179,0,44,-44
12,11,47,187,39,134,-95
12,11,47,189,0,60,-60
12,11,48,27,122,144,-22
12,11,48,29,156,285,-129
12,11,48,39,0,72,-72
12,11,48,41,0,30,-30
12,11,48,61,0,53,-53
12,11,48,85,149,316,-167
12,11,48,113,304,506,-202
12,11,48,121,103,184,-81
12,11,48,141,49,95,-46
12,11,48,157,50,304,-254
12,11,48,167,0,55,-55
12,11,48,201,401,870,-469
12,11,48,215,38,44,-6
12,11,48,245,0,28,-28
12,11,48,339,42,165,-123
12,11,48,355,0,46,-46
12,11,48,423,0,38,-38
12,11,48,439,222,461,-239
12,11,48,453,95,277,-182
12,11,48,491,68,171,-103
12,11,49,35,59,128,-69
12,11,49,49,38,0,38
12,11,50,7,30,0,30
12,11,51,13,94,124,-30
12,11,51,41,56,80,-24
12,11,51,59,375,394,-19
12,11,51,87,57,47,10
12,11,51,95,0,32,-32
12,11,51,107,124,164,-40
12,11,51,153,98,138,-40
12,11,51,177,0,38,-38
12,11,51,179,40,65,-25
12,11,51,510,96,88,8
12,11,51,550,45,62,-17
12,11,51,650,0,32,-32
12,11,51,700,56,63,-7
12,11,51,710,91,63,28
12,11,51,760,26,46,-20
12,11,51,810,134,158,-24
12,11,53,11,30,0,30
12,11,53,33,177,248,-71
12,11,53,35,0,28,-28
12,11,53,53,84,57,27
12,11,53,61,30,52,-22
12,11,53,63,0,43,-43
12,11,53,67,0,41,-41
12,11,54,39,0,27,-27
12,11,55,25,57,56,1
12,11,55,79,133,76,57
12,11,55,133,54,37,17
12,13,12,5,103,161,-58
12,13,12,39,46,0,46
12,13,12,45,49,42,7
12,13,12,63,163,183,-20
12,13,12,73,74,48,26
12,13,12,77,147,118,29
12,15,4,13,38,74,-36
12,15,6,37,44,44,0
12,15,6,73,30,32,-2
12,15,8,41,0,23,-23
12,15,9,1,48,0,48
12,15,9,3,61,0,61
12,15,9,9,47,40,7
12,15,12,1,57,92,-35
12,15,12,9,60,49,11
12,15,12,11,268,171,97
12,15,12,17,0,38,-38
12,15,12,21,244,124,120
12,15,12,27,478,380,98
12,15,12,31,80,83,-3
12,15,12,33,27,0,27
12,15,12,49,40,0,40
12,15,12,53,25,32,-7
12,15,12,55,35,51,-16
12,15,12,57,273,281,-8
12,15,12,69,44,76,-32
12,15,12,71,1162,833,329
12,15,12,73,0,50,-50
12,15,12,81,317,178,139
12,15,12,83,32,78,-46
12,15,12,86,325,194,131
12,15,12,87,45,0,45
12,15,12,95,157,200,-43
12,15,12,97,27,0,27
12,15,12,99,153,91,62
12,15,12,101,62,118,-56
12,15,12,103,161,141,20
12,15,12,105,104,127,-23
12,15,12,111,40,35,5
12,15,12,115,3054,3055,-1
12,15,12,117,70,74,-4
12,15,12,127,54,48,6
12,15,13,67,30,30,0
12,15,13,135,0,36,-36
12,15,17,31,58,44,14
12,15,17,43,41,0,41
12,15,17,97,40,0,40
12,15,18,3,29,0,29
12,15,18,97,49,56,-7
12,15,24,3,37,50,-13
12,15,24,31,30,0,30
12,15,25,1,71,0,71
12,15,25,5,58,38,20
12,15,25,9,65,39,26
12,15,25,13,45,0,45
12,15,25,17,51,31,20
12,15,25,21,43,0,43
12,15,25,23,68,38,30
12,15,25,25,0,39,-39
12,15,25,27,38,0,38
12,15,26,49,48,40,8
12,15,26,81,33,30,3
12,15,26,99,46,0,46
12,15,26,125,65,48,17
12,15,26,147,32,0,32
12,15,26,161,28,0,28
12,15,26,163,71,0,71
12,15,32,3,36,38,-2
12,15,33,11,37,0,37
12,15,33,15,42,36,6
12,15,34,3,30,0,30
12,15,34,5,25,0,25
12,15,34,7,35,0,35
12,15,34,15,32,0,32
12,15,34,27,28,0,28
12,15,34,29,98,43,55
12,15,36,1,22,0,22
12,15,36,5,38,0,38
12,15,36,29,50,28,22
12,15,36,47,44,25,19
12,15,36,55,45,25,20
12,15,36,59,59,0,59
12,15,36,81,64,30,34
12,15,36,85,34,0,34
12,15,36,103,95,43,52
12,15,37,51,0,30,-30
12,15,37,119,41,37,4
12,15,37,133,0,27,-27
12,15,39,35,52,27,25
12,15,39,49,82,0,82
12,15,42,3,37,0,37
12,15,42,17,29,0,29
12,15,42,45,0,30,-30
12,15,42,91,36,0,36
12,15,44,7,67,53,14
12,15,45,7,0,28,-28
12,15,45,45,0,62,-62
12,15,47,9,0,40,-40
12,15,47,157,27,0,27
12,15,48,113,0,30,-30
12,15,48,201,0,43,-43
12,15,51,59,35,0,35
12,17,4,13,29,0,29
12,17,6,73,0,29,-29
12,17,9,3,43,0,43
12,17,9,9,45,28,17
12,17,12,1,138,150,-12
12,17,12,9,81,50,31
12,17,12,11,328,105,223
12,17,12,15,38,0,38
12,17,12,19,0,28,-28
12,17,12,21,98,43,55
12,17,12,31,117,70,47
12,17,12,33,0,46,-46
12,17,12,53,529,473,56
12,17,12,55,26,26,0
12,17,12,57,420,344,76
12,17,12,61,28,0,28
12,17,12,69,164,199,-35
12,17,12,71,131,80,51
12,17,12,73,39,74,-35
12,17,12,75,225,186,39
12,17,12,81,74,0,74
12,17,12,83,1079,919,160
12,17,12,86,256,71,185
12,17,12,87,42,27,15
12,17,12,95,232,208,24
12,17,12,97,46,38,8
12,17,12,99,189,88,101
12,17,12,101,492,262,230
12,17,12,103,643,354,289
12,17,12,105,178,131,47
12,17,12,109,0,24,-24
12,17,12,111,57,0,57
12,17,12,115,33,38,-5
12,17,12,117,74,59,15
12,17,12,119,212,166,46
12,17,12,127,105,80,25
12,17,17,31,53,0,53
12,17,17,43,31,0,31
12,17,24,3,30,0,30
12,17,25,5,32,0,32
12,17,25,9,41,0,41
12,17,25,17,41,0,41
12,17,25,23,28,0,28
12,17,25,27,44,0,44
12,17,26,99,25,0,25
12,17,26,125,46,0,46
12,17,26,163,49,37,12
12,17,32,3,35,0,35
12,17,33,11,48,0,48
12,17,33,15,35,0,35
12,17,34,29,35,0,35
12,17,36,5,28,0,28
12,17,36,27,34,0,34
12,17,36,47,61,0,61
12,17,36,59,68,0,68
12,17,36,81,40,0,40
12,17,36,103,171,72,99
12,17,36,119,29,0,29
12,17,37,183,0,39,-39
12,17,39,35,34,0,34
12,17,39,49,0,32,-32
12,17,45,51,29,0,29
12,17,47,93,0,29,-29
12,19,1,73,37,43,-6
12,19,1,97,31,0,31
12,19,4,13,44,65,-21
12,19,6,31,0,38,-38
12,19,6,37,59,37,22
12,19,6,71,34,0,34
12,19,6,73,217,126,91
12,19,6,111,33,0,33
12,19,8,41,40,0,40
12,19,9,1,31,0,31
12,19,9,9,46,0,46
12,19,12,1,421,383,38
12,19,12,3,110,118,-8
12,19,12,5,32,0,32
12,19,12,7,271,361,-90
12,19,12,9,120,100,20
12,19,12,11,367,156,211
12,19,12,17,28,0,28
12,19,12,21,27,0,27
12,19,12,23,89,55,34
12,19,12,31,8801,7616,1185
12,19,12,33,173,114,59
12,19,12,35,90,143,-53
12,19,12,57,195,178,17
12,19,12,61,27,0,27
12,19,12,69,45,41,4
12,19,12,71,76,37,39
12,19,12,73,118,115,3
12,19,12,81,33,26,7
12,19,12,83,143,133,10
12,19,12,86,266,116,150
12,19,12,87,34,52,-18
12,19,12,89,122,196,-74
12,19,12,91,52,0,52
12,19,12,95,207,274,-67
12,19,12,97,71,47,24
12,19,12,99,225,104,121
12,19,12,101,72,59,13
12,19,12,103,120,70,50
12,19,12,105,116,96,20
12,19,12,107,445,449,-4
12,19,12,109,508,747,-239
12,19,12,111,42,53,-11
12,19,12,113,42,55,-13
12,19,12,115,43,0,43
12,19,12,117,69,92,-23
12,19,12,121,37,0,37
12,19,12,125,54,43,11
12,19,12,127,159,86,73
12,19,13,39,66,51,15
12,19,13,51,51,66,-15
12,19,13,67,61,52,9
12,19,13,89,34,32,2
12,19,13,121,0,48,-48
12,19,13,127,34,0,34
12,19,13,135,38,61,-23
12,19,13,179,38,0,38
12,19,15,3,105,144,-39
12,19,17,31,68,54,14
12,19,21,111,0,32,-32
12,19,22,51,0,26,-26
12,19,23,5,0,79,-79
12,19,24,3,69,34,35
12,19,24,31,51,0,51
12,19,24,37,87,76,11
12,19,26,99,55,0,55
12,19,26,163,36,0,36
12,19,32,3,29,52,-23
12,19,36,47,0,31,-31
12,19,36,81,48,0,48
12,19,36,103,48,0,48
12,19,37,51,30,31,-1
12,19,37,119,34,50,-16
12,19,37,133,64,76,-12
12,19,37,183,40,41,-1
12,19,39,49,28,0,28
12,19,42,3,44,0,44
12,19,42,91,37,0,37
12,19,42,101,36,0,36
12,19,45,13,39,38,1
12,19,45,15,36,0,36
12,19,45,19,54,0,54
12,19,45,45,0,52,-52
12,19,45,91,0,37,-37
12,19,47,157,70,54,16
12,19,48,27,0,51,-51
12,19,48,29,0,57,-57
12,19,48,85,0,40,-40
12,19,48,113,33,27,6
12,19,48,201,61,65,-4
12,19,48,355,36,50,-14
12,19,48,439,62,70,-8
12,19,51,59,46,54,-8
12,19,51,153,30,0,30
12,19,51,550,100,50,50
12,19,51,650,39,0,39
12,19,51,700,34,30,4
12,19,51,710,117,53,64
12,19,51,800,50,0,50
12,19,51,810,265,216,49
12,19,53,29,44,137,-93
12,19,53,33,0,28,-28
12,19,53,53,37,0,37
12,21,4,13,105,100,5
12,21,4,19,30,36,-6
12,21,6,37,105,92,13
12,21,6,59,45,0,45
12,21,6,71,24,0,24
12,21,6,73,44,71,-27
12,21,6,85,0,30,-30
12,21,8,31,25,0,25
12,21,8,35,0,26,-26
12,21,9,1,116,74,42
12,21,9,3,96,52,44
12,21,9,7,27,0,27
12,21,9,9,98,45,53
12,21,9,11,42,0,42
12,21,11,1,27,21,6
12,21,12,1,95,115,-20
12,21,12,9,90,92,-2
12,21,12,11,735,622,113
12,21,12,15,124,244,-120
12,21,12,17,43,98,-55
12,21,12,19,0,27,-27
12,21,12,27,0,31,-31
12,21,12,31,106,142,-36
12,21,12,33,34,43,-9
12,21,12,51,157,248,-91
12,21,12,53,0,66,-66
12,21,12,55,79,84,-5
12,21,12,57,291,505,-214
12,21,12,61,36,37,-1
12,21,12,69,61,125,-64
12,21,12,71,4601,6738,-2137
12,21,12,73,65,96,-31
12,21,12,75,0,45,-45
12,21,12,81,111,152,-41
12,21,12,83,109,148,-39
12,21,12,85,38,25,13
12,21,12,86,1392,1576,-184
12,21,12,87,76,59,17
12,21,12,91,26,47,-21
12,21,12,95,319,378,-59
12,21,12,97,64,70,-6
12,21,12,99,320,359,-39
12,21,12,101,66,152,-86
12,21,12,103,182,171,11
12,21,12,105,120,137,-17
12,21,12,109,25,53,-28
12,21,12,111,63,93,-30
12,21,12,115,147,303,-156
12,21,12,117,68,93,-25
12,21,12,119,0,81,-81
12,21,12,127,58,76,-18
12,21,13,51,30,24,6
12,21,13,67,37,72,-35
12,21,13,89,25,42,-17
12,21,13,111,0,53,-53
12,21,13,121,70,89,-19
12,21,13,135,56,120,-64
12,21,17,31,295,201,94
12,21,17,43,138,88,50
12,21,17,89,39,48,-9
12,21,17,97,85,39,46
12,21,17,167,31,0,31
12,21,17,197,62,30,32
12,21,17,201,42,0,42
12,21,18,3,35,0,35
12,21,18,57,51,35,16
12,21,18,85,35,0,35
12,21,18,89,35,0,35
12,21,18,97,81,56,25
12,21,18,141,30,0,30
12,21,20,91,48,40,8
12,21,21,111,46,34,12
12,21,23,5,59,37,22
12,21,23,31,38,27,11
12,21,24,3,31,28,3
12,21,24,5,58,0,58
12,21,24,31,69,57,12
12,21,25,1,144,76,68
12,21,25,5,63,0,63
12,21,25,9,141,62,79
12,21,25,13,42,24,18
12,21,25,17,138,87,51
12,21,25,21,82,36,46
12,21,25,23,98,35,63
12,21,25,25,67,48,19
12,21,25,27,77,57,20
12,21,26,49,57,0,57
12,21,26,65,24,0,24
12,21,26,81,45,55,-10
12,21,26,99,107,32,75
12,21,26,125,215,66,149
12,21,26,161,49,0,49
12,21,26,163,138,50,88
12,21,27,53,137,67,70
12,21,27,123,38,0,38
12,21,27,163,34,0,34
12,21,29,95,0,45,-45
12,21,29,189,105,29,76
12,21,32,3,67,111,-44
12,21,33,11,54,0,54
12,21,33,15,52,27,25
12,21,34,3,128,42,86
12,21,34,5,40,0,40
12,21,34,9,69,0,69
12,21,34,13,50,0,50
12,21,34,17,54,36,18
12,21,34,23,69,0,69
12,21,34,25,75,35,40
12,21,34,27,85,0,85
12,21,34,29,102,39,63
12,21,34,31,46,0,46
12,21,34,35,45,0,45
12,21,34,39,40,0,40
12,21,36,5,54,46,8
12,21,36,27,25,0,25
12,21,36,29,77,25,52
12,21,36,47,66,83,-17
12,21,36,55,61,44,17
12,21,36,59,116,53,63
12,21,36,61,106,82,24
12,21,36,67,36,0,36
12,21,36,81,104,76,28
12,21,36,85,36,0,36
12,21,36,103,157,93,64
12,21,36,119,130,43,87
12,21,37,21,31,81,-50
12,21,37,67,0,33,-33
12,21,37,81,0,33,-33
12,21,37,89,0,43,-43
12,21,37,119,57,101,-44
12,21,37,133,0,41,-41
12,21,37,183,0,92,-92
12,21,39,17,28,0,28
12,21,39,35,118,84,34
12,21,39,49,99,80,19
12,21,39,61,88,43,45
12,21,39,85,25,0,25
12,21,39,93,37,25,12
12,21,39,95,53,0,53
12,21,39,99,32,0,32
12,21,39,103,25,0,25
12,21,39,113,50,41,9
12,21,39,151,43,31,12
12,21,39,153,86,39,47
12,21,39,165,23,0,23
12,21,40,143,0,28,-28
12,21,42,3,110,31,79
12,21,42,17,71,31,40
12,21,42,29,45,34,11
12,21,42,45,30,0,30
12,21,42,91,105,0,105
12,21,42,101,0,29,-29
12,21,44,3,27,0,27
12,21,44,5,0,25,-25
12,21,44,7,77,33,44
12,21,44,9,41,25,16
12,21,45,3,0,27,-27
12,21,45,13,33,0,33
12,21,45,19,0,43,-43
12,21,45,45,39,43,-4
12,21,45,51,25,0,25
12,21,47,37,39,55,-16
12,21,47,65,0,27,-27
12,21,47,93,0,38,-38
12,21,47,105,0,34,-34
12,21,47,155,0,47,-47
12,21,47,157,34,0,34
12,21,47,187,0,36,-36
12,21,48,29,0,61,-61
12,21,48,61,67,136,-69
12,21,48,85,0,46,-46
12,21,48,113,73,125,-52
12,21,48,121,0,28,-28
12,21,48,201,81,228,-147
12,21,48,215,0,103,-103
12,21,48,339,0,44,-44
12,21,48,439,38,84,-46
12,21,48,453,0,42,-42
12,21,48,491,0,38,-38
12,21,50,7,28,0,28
12,21,51,59,79,63,16
12,21,51,107,29,0,29
12,21,51,810,33,25,8
12,21,53,33,26,51,-25
12,21,55,9,32,0,32
12,21,55,25,34,27,7
12,21,55,79,38,31,7
12,21,55,89,35,0,35
12,21,55,133,55,30,25
12,23,12,1,573,549,24
12,23,12,3,94,79,15
12,23,12,5,0,32,-32
12,23,12,7,0,70,-70
12,23,12,9,79,29,50
12,23,12,11,130,64,66
12,23,12,19,55,89,-34
12,23,12,29,0,35,-35
12,23,12,31,268,214,54
12,23,12,41,75,57,18
12,23,12,47,118,149,-31
12,23,12,57,96,92,4
12,23,12,67,30,0,30
12,23,12,69,40,23,17
12,23,12,71,60,32,28
12,23,12,73,72,65,7
12,23,12,75,32,29,3
12,23,12,83,92,66,26
12,23,12,86,92,51,41
12,23,12,87,33,0,33
12,23,12,89,38,0,38
12,23,12,95,86,60,26
12,23,12,97,31,0,31
12,23,12,99,201,86,115
12,23,12,101,35,61,-26
12,23,12,103,58,60,-2
12,23,12,105,81,26,55
12,23,12,107,34,0,34
12,23,12,109,0,46,-46
12,23,12,111,53,0,53
12,23,12,115,34,0,34
12,23,12,117,49,0,49
12,23,12,121,618,609,9
12,23,12,125,142,140,2
12,23,12,127,42,0,42
12,23,13,185,43,35,8
12,27,12,15,380,478,-98
12,27,12,21,31,0,31
12,27,12,49,88,95,-7
12,27,12,55,43,99,-56
12,27,12,57,39,70,-31
12,27,12,71,133,105,28
12,27,12,73,0,27,-27
12,27,12,81,59,47,12
12,27,12,86,43,0,43
12,27,12,95,0,35,-35
12,27,12,103,24,35,-11
12,27,12,105,46,52,-6
12,27,12,115,120,170,-50
12,29,12,1,54,69,-15
12,29,12,11,31,0,31
12,29,12,23,35,0,35
12,29,12,41,69,139,-70
12,29,12,57,33,0,33
12,29,12,71,25,0,25
12,29,12,75,155,190,-35
12,29,12,83,0,28,-28
12,29,12,95,27,0,27
12,29,12,101,38,0,38
12,29,12,103,63,34,29
12,29,12,123,0,40,-40
12,31,1,3,40,61,-21
12,31,1,15,0,41,-41
12,31,1,45,0,32,-32
12,31,1,69,45,66,-21
12,31,1,73,126,107,19
12,31,1,81,32,34,-2
12,31,1,89,58,46,12
12,31,1,97,126,113,13
12,31,1,101,108,77,31
12,31,1,117,67,50,17
12,31,1,125,61,57,4
12,31,2,20,0,49,-49
12,31,4,3,0,25,-25
12,31,4,13,233,343,-110
12,31,4,19,70,58,12
12,31,5,7,26,0,26
12,31,5,119,67,75,-8
12,31,6,1,34,86,-52
12,31,6,13,49,51,-2
12,31,6,29,0,42,-42
12,31,6,31,57,101,-44
12,31,6,37,360,353,7
12,31,6,53,35,90,-55
12,31,6,59,115,154,-39
12,31,6,65,116,93,23
12,31,6,67,70,74,-4
12,31,6,71,78,114,-36
12,31,6,73,622,941,-319
12,31,6,75,44,33,11
12,31,6,85,51,68,-17
12,31,6,111,81,70,11
12,31,8,1,34,63,-29
12,31,8,5,69,102,-33
12,31,8,13,0,33,-33
12,31,8,31,63,74,-11
12,31,8,35,38,29,9
12,31,8,41,76,103,-27
12,31,8,59,39,48,-9
12,31,8,69,0,27,-27
12,31,9,1,87,74,13
12,31,9,3,94,68,26
12,31,9,9,96,40,56
12,31,9,11,106,114,-8
12,31,10,1,27,0,27
12,31,10,3,89,56,33
12,31,11,1,93,71,22
12,31,12,1,960,834,126
12,31,12,3,613,911,-298
12,31,12,5,161,169,-8
12,31,12,7,148,263,-115
12,31,12,9,554,469,85
12,31,12,11,1270,936,334
12,31,12,15,83,80,3
12,31,12,17,70,117,-47
12,31,12,19,7616,8801,-1185
12,31,12,21,142,106,36
12,31,12,23,214,268,-54
12,31,12,33,717,537,180
12,31,12,35,431,411,20
12,31,12,39,61,51,10
12,31,12,47,44,51,-7
12,31,12,53,85,60,25
12,31,12,55,54,51,3
12,31,12,57,864,1052,-188
12,31,12,61,95,79,16
12,31,12,63,30,27,3
12,31,12,65,35,0,35
12,31,12,69,192,224,-32
12,31,12,71,304,268,36
12,31,12,73,949,675,274
12,31,12,75,36,46,-10
12,31,12,79,59,35,24
12,31,12,81,209,114,95
12,31,12,83,347,358,-11
12,31,12,85,97,60,37
12,31,12,86,1273,826,447
12,31,12,87,167,127,40
12,31,12,89,1971,2562,-591
12,31,12,91,158,153,5
12,31,12,95,1236,1343,-107
12,31,12,97,233,231,2
12,31,12,99,821,573,248
12,31,12,101,191,264,-73
12,31,12,103,568,529,39
12,31,12,105,365,361,4
12,31,12,107,371,354,17
12,31,12,109,4150,5791,-1641
12,31,12,111,187,143,44
12,31,12,113,208,193,15
12,31,12,115,184,151,33
12,31,12,117,539,533,6
12,31,12,119,31,61,-30
12,31,12,121,94,115,-21
12,31,12,123,57,36,21
12,31,12,125,54,59,-5
12,31,12,127,846,666,180
12,31,12,129,31,34,-3
12,31,12,131,0,50,-50
12,31,12,133,0,57,-57
12,31,13,13,27,0,27
12,31,13,15,0,44,-44
12,31,13,21,81,80,1
12,31,13,25,0,53,-53
12,31,13,31,64,43,21
12,31,13,39,564,557,7
12,31,13,45,0,33,-33
12,31,13,49,103,128,-25
12,31,13,51,326,361,-35
12,31,13,57,48,68,-20
12,31,13,59,49,63,-14
12,31,13,63,105,153,-48
12,31,13,67,304,285,19
12,31,13,69,47,69,-22
12,31,13,71,0,33,-33
12,31,13,73,38,59,-21
12,31,13,77,34,55,-21
12,31,13,89,269,380,-111
12,31,13,95,103,71,32
12,31,13,97,0,99,-99
12,31,13,103,0,31,-31
12,31,13,113,0,39,-39
12,31,13,117,59,68,-9
12,31,13,121,383,485,-102
12,31,13,127,207,216,-9
12,31,13,135,231,311,-80
12,31,13,139,56,38,18
12,31,13,151,56,105,-49
12,31,13,153,62,84,-22
12,31,13,177,36,0,36
12,31,13,179,136,92,44
12,31,13,185,183,142,41
12,31,13,191,26,25,1
12,31,13,215,122,80,42
12,31,13,217,43,0,43
12,31,13,223,50,56,-6
12,31,13,229,38,50,-12
12,31,13,245,75,106,-31
12,31,13,247,0,35,-35
12,31,13,275,45,55,-10
12,31,13,277,38,35,3
12,31,13,299,102,79,23
12,31,13,305,47,40,7
12,31,15,3,298,453,-155
12,31,16,1,29,29,0
12,31,17,31,268,416,-148
12,31,17,43,59,92,-33
12,31,17,97,206,205,1
12,31,17,113,29,0,29
12,31,17,119,35,29,6
12,31,17,143,33,0,33
12,31,17,163,27,46,-19
12,31,17,167,30,0,30
12,31,17,197,40,32,8
12,31,17,201,48,0,48
12,31,18,3,34,32,2
12,31,18,57,0,38,-38
12,31,18,89,54,43,11
12,31,18,97,145,122,23
12,31,18,141,31,0,31
12,31,18,157,37,0,37
12,31,19,153,38,34,4
12,31,19,163,0,86,-86
12,31,20,61,0,23,-23
12,31,20,91,68,50,18
12,31,20,173,32,52,-20
12,31,21,15,35,0,35
12,31,21,47,35,0,35
12,31,21,67,35,55,-20
12,31,21,111,180,111,69
12,31,21,227,0,34,-34
12,31,22,15,29,0,29
12,31,22,17,27,42,-15
12,31,22,33,68,84,-16
12,31,22,51,30,157,-127
12,31,22,55,46,49,-3
12,31,22,71,59,117,-58
12,31,22,73,0,32,-32
12,31,22,75,0,43,-43
12,31,22,103,44,63,-19
12,31,23,5,108,176,-68
12,31,23,23,0,44,-44
12,31,24,3,182,180,2
12,31,24,5,132,61,71
12,31,24,17,41,43,-2
12,31,24,21,51,0,51
12,31,24,25,27,0,27
12,31,24,27,30,27,3
12,31,24,31,197,153,44
12,31,24,33,111,159,-48
12,31,24,37,164,245,-81
12,31,24,510,52,48,4
12,31,25,5,41,47,-6
12,31,25,9,78,28,50
12,31,25,13,57,33,24
12,31,25,17,77,125,-48
12,31,25,21,37,51,-14
12,31,25,23,29,28,1
12,31,25,25,97,71,26
12,31,25,27,84,36,48
12,31,26,49,49,29,20
12,31,26,65,35,0,35
12,31,26,75,27,0,27
12,31,26,77,33,0,33
12,31,26,81,79,38,41
12,31,26,99,106,43,63
12,31,26,125,199,68,131
12,31,26,161,31,0,31
12,31,26,163,201,142,59
12,31,27,37,30,0,30
12,31,27,53,114,66,48
12,31,27,109,32,0,32
12,31,27,123,29,0,29
12,31,28,33,0,34,-34
12,31,28,47,124,146,-22
12,31,28,49,27,0,27
12,31,28,59,67,49,18
12,31,28,75,36,0,36
12,31,29,95,75,73,2
12,31,29,183,26,37,-11
12,31,29,189,120,94,26
12,31,29,510,61,26,35
12,31,31,55,45,43,2
12,31,31,109,37,29,8
12,31,31,153,41,0,41
12,31,32,3,183,266,-83
12,31,32,31,28,35,-7
12,31,33,11,62,62,0
12,31,33,15,28,0,28
12,31,34,1,27,0,27
12,31,34,3,49,45,4
12,31,34,5,59,39,20
12,31,34,7,59,32,27
12,31,34,13,130,52,78
12,31,34,15,27,0,27
12,31,34,17,97,69,28
12,31,34,21,73,38,35
12,31,34,23,130,59,71
12,31,34,25,101,0,101
12,31,34,27,76,33,43
12,31,34,29,67,39,28
12,31,34,31,49,0,49
12,31,34,35,48,35,13
12,31,34,39,61,29,32
12,31,35,1,49,64,-15
12,31,36,1,32,33,-1
12,31,36,5,206,128,78
12,31,36,29,96,91,5
12,31,36,45,46,39,7
12,31,36,47,286,223,63
12,31,36,55,94,85,9
12,31,36,59,137,75,62
12,31,36,61,194,174,20
12,31,36,65,44,28,16
12,31,36,67,66,49,17
12,31,36,71,66,30,36
12,31,36,81,225,154,71
12,31,36,85,31,0,31
12,31,36,91,49,0,49
12,31,36,93,24,0,24
12,31,36,103,160,50,110
12,31,36,119,111,33,78
12,31,37,21,50,85,-35
12,31,37,25,182,0,182
12,31,37,35,0,37,-37
12,31,37,49,35,38,-3
12,31,37,51,118,150,-32
12,31,37,63,70,46,24
12,31,37,67,87,63,24
12,31,37,71,38,0,38
12,31,37,81,144,98,46
12,31,37,87,0,32,-32
12,31,37,97,29,0,29
12,31,37,119,350,354,-4
12,31,37,129,26,42,-16
12,31,37,133,200,174,26
12,31,37,135,0,28,-28
12,31,37,147,33,38,-5
12,31,37,179,44,61,-17
12,31,37,183,211,261,-50
12,31,37,191,0,34,-34
12,31,39,17,35,33,2
12,31,39,25,38,0,38
12,31,39,35,145,105,40
12,31,39,49,233,154,79
12,31,39,61,119,120,-1
12,31,39,89,28,0,28
12,31,39,93,32,36,-4
12,31,39,95,44,0,44
12,31,39,99,31,0,31
12,31,39,113,74,37,37
12,31,39,151,27,33,-6
12,31,39,153,120,41,79
12,31,40,27,40,42,-2
12,31,40,109,97,89,8
12,31,40,143,63,78,-15
12,31,41,5,0,32,-32
12,31,41,51,31,67,-36
12,31,42,3,181,91,90
12,31,42,7,28,0,28
12,31,42,11,43,36,7
12,31,42,17,92,107,-15
12,31,42,29,36,0,36
12,31,42,41,0,28,-28
12,31,42,43,30,28,2
12,31,42,45,46,49,-3
12,31,42,49,38,0,38
12,31,42,69,41,0,41
12,31,42,71,43,37,6
12,31,42,77,32,26,6
12,31,42,89,33,0,33
12,31,42,91,90,79,11
12,31,42,95,27,0,27
12,31,42,101,175,176,-1
12,31,44,3,23,0,23
12,31,44,5,108,87,21
12,31,44,7,71,46,25
12,31,45,3,43,42,1
12,31,45,7,28,52,-24
12,31,45,13,186,150,36
12,31,45,15,135,130,5
12,31,45,19,191,152,39
12,31,45,29,29,27,2
12,31,45,35,44,61,-17
12,31,45,41,35,81,-46
12,31,45,45,100,162,-62
12,31,45,51,71,62,9
12,31,45,63,55,79,-24
12,31,45,75,34,0,34
12,31,45,77,0,57,-57
12,31,45,79,162,148,14
12,31,45,83,62,98,-36
12,31,45,91,32,76,-44
12,31,46,99,0,24,-24
12,31,47,9,0,35,-35
12,31,47,37,141,109,32
12,31,47,65,89,137,-48
12,31,47,93,96,92,4
12,31,47,113,0,34,-34
12,31,47,125,44,81,-37
12,31,47,149,44,51,-7
12,31,47,155,0,35,-35
12,31,47,157,288,256,32
12,31,47,165,0,31,-31
12,31,47,167,0,42,-42
12,31,47,179,0,28,-28
12,31,47,187,25,46,-21
12,31,48,27,84,101,-17
12,31,48,29,188,278,-90
12,31,48,39,0,40,-40
12,31,48,61,0,38,-38
12,31,48,85,84,99,-15
12,31,48,113,181,289,-108
12,31,48,121,57,95,-38
12,31,48,141,86,88,-2
12,31,48,157,0,44,-44
12,31,48,201,286,462,-176
12,31,48,245,0,26,-26
12,31,48,339,36,63,-27
12,31,48,355,159,96,63
12,31,48,409,72,56,16
12,31,48,439,184,203,-19
12,31,48,453,91,128,-37
12,31,48,491,0,69,-69
12,31,49,35,57,31,26
12,31,50,7,40,0,40
12,31,51,13,63,63,0
12,31,51,41,44,67,-23
12,31,51,59,238,247,-9
12,31,51,87,61,47,14
12,31,51,107,57,43,14
12,31,51,153,77,122,-45
12,31,51,179,32,58,-26
12,31,51,199,30,0,30
12,31,51,510,54,54,0
12,31,51,550,159,203,-44
12,31,51,650,127,191,-64
12,31,51,700,152,207,-55
12,31,51,710,372,531,-159
12,31,51,740,84,108,-24
12,31,51,760,0,25,-25
12,31,51,800,63,62,1
12,31,51,810,552,938,-386
12,31,53,11,30,33,-3
12,31,53,29,90,231,-141
12,31,53,33,131,152,-21
12,31,53,35,70,147,-77
12,31,53,53,104,115,-11
12,31,53,57,0,32,-32
12,31,53,61,55,117,-62
12,31,53,63,31,0,31
12,31,55,25,45,38,7
12,31,55,79,113,57,56
12,31,55,133,38,0,38
12,33,1,1,33,0,33
12,33,1,3,653,1016,-363
12,33,1,15,0,35,-35
12,33,1,25,34,0,34
12,33,1,35,49,0,49
12,33,1,39,51,52,-1
12,33,1,45,0,37,-37
12,33,1,51,28,37,-9
12,33,1,53,388,464,-76
12,33,1,69,68,45,23
12,33,1,73,149,207,-58
12,33,1,81,57,25,32
12,33,1,89,53,44,9
12,33,1,97,381,315,66
12,33,1,99,47,46,1
12,33,1,101,88,84,4
12,33,1,103,0,30,-30
12,33,1,117,32,81,-49
12,33,1,125,0,43,-43
12,33,2,20,53,42,11
12,33,4,13,109,127,-18
12,33,4,19,56,86,-30
12,33,4,25,29,0,29
12,33,4,27,64,101,-37
12,33,5,119,30,0,30
12,33,6,1,29,0,29
12,33,6,29,0,50,-50
12,33,6,31,0,116,-116
12,33,6,37,142,106,36
12,33,6,53,0,31,-31
12,33,6,59,41,35,6
12,33,6,65,57,60,-3
12,33,6,67,38,40,-2
12,33,6,71,87,81,6
12,33,6,73,428,1002,-574
12,33,6,85,0,34,-34
12,33,6,111,38,69,-31
12,33,8,1,37,0,37
12,33,8,5,0,42,-42
12,33,8,31,23,0,23
12,33,8,41,95,98,-3
12,33,9,3,33,0,33
12,33,9,9,25,0,25
12,33,9,11,53,0,53
12,33,11,1,0,30,-30
12,33,12,1,130,114,16
12,33,12,5,223,189,34
12,33,12,9,82,103,-21
12,33,12,11,185,127,58
12,33,12,15,0,27,-27
12,33,12,17,46,0,46
12,33,12,19,114,173,-59
12,33,12,21,43,34,9
12,33,12,31,537,717,-180
12,33,12,39,0,34,-34
12,33,12,57,225,273,-48
12,33,12,59,22,0,22
12,33,12,63,26,45,-19
12,33,12,69,61,57,4
12,33,12,71,81,85,-4
12,33,12,73,363,283,80
12,33,12,81,46,47,-1
12,33,12,83,63,63,0
12,33,12,86,152,156,-4
12,33,12,87,61,29,32
12,33,12,91,715,509,206
12,33,12,95,229,233,-4
12,33,12,97,0,68,-68
12,33,12,99,113,79,34
12,33,12,101,66,80,-14
12,33,12,103,94,155,-61
12,33,12,105,91,97,-6
12,33,12,109,39,31,8
12,33,12,111,35,39,-4
12,33,12,113,3139,3965,-826
12,33,12,115,56,59,-3
12,33,12,117,89,86,3
12,33,12,127,95,66,29
12,33,12,131,95,129,-34
12,33,12,133,0,33,-33
12,33,13,39,0,39,-39
12,33,13,51,47,40,7
12,33,13,57,28,0,28
12,33,13,59,0,26,-26
12,33,13,63,33,58,-25
12,33,13,67,117,117,0
12,33,13,73,0,47,-47
12,33,13,89,78,79,-1
12,33,13,97,0,54,-54
12,33,13,121,99,151,-52
12,33,13,135,102,88,14
12,33,13,153,0,46,-46
12,33,13,215,57,74,-17
12,33,13,245,40,43,-3
12,33,15,3,213,311,-98
12,33,17,31,82,81,1
12,33,17,97,30,47,-17
12,33,17,163,0,28,-28
12,33,18,97,35,34,1
12,33,21,67,28,24,4
12,33,21,111,37,33,4
12,33,22,33,38,76,-38
12,33,22,51,70,94,-24
12,33,22,71,58,101,-43
12,33,22,103,57,83,-26
12,33,23,5,60,62,-2
12,33,24,3,219,117,102
12,33,24,5,0,41,-41
12,33,24,31,53,32,21
12,33,24,33,36,53,-17
12,33,24,37,34,56,-22
12,33,26,81,38,0,38
12,33,26,125,36,0,36
12,33,26,163,51,33,18
12,33,28,35,39,40,-1
12,33,28,47,97,165,-68
12,33,28,49,27,0,27
12,33,28,59,78,111,-33
12,33,28,73,24,0,24
12,33,28,75,0,153,-153
12,33,28,121,0,29,-29
12,33,29,189,23,24,-1
12,33,31,55,0,29,-29
12,33,32,3,47,118,-71
12,33,35,1,29,24,5
12,33,36,47,0,23,-23
12,33,36,61,30,25,5
12,33,36,81,28,0,28
12,33,37,21,26,31,-5
12,33,37,49,90,192,-102
12,33,37,51,56,55,1
12,33,37,119,38,60,-22
12,33,37,133,166,362,-196
12,33,37,141,0,36,-36
12,33,37,183,26,49,-23
12,33,37,191,0,96,-96
12,33,39,49,40,30,10
12,33,39,61,35,0,35
12,33,39,153,30,0,30
12,33,40,27,37,0,37
12,33,40,47,0,83,-83
12,33,40,109,42,87,-45
12,33,40,143,0,27,-27
12,33,41,51,0,25,-25
12,33,42,3,30,49,-19
12,33,42,17,0,32,-32
12,33,42,71,21,0,21
12,33,42,91,27,28,-1
12,33,42,101,41,32,9
12,33,42,133,28,0,28
12,33,45,13,120,147,-27
12,33,45,15,51,0,51
12,33,45,19,50,32,18
12,33,45,45,47,40,7
12,33,45,51,0,27,-27
12,33,45,79,30,0,30
12,33,47,37,59,66,-7
12,33,47,65,52,48,4
12,33,47,93,24,51,-27
12,33,47,125,0,41,-41
12,33,47,157,88,116,-28
12,33,47,179,0,28,-28
12,33,48,27,29,30,-1
12,33,48,29,94,236,-142
12,33,48,41,0,31,-31
12,33,48,85,33,43,-10
12,33,48,113,100,86,14
12,33,48,121,29,69,-40
12,33,48,141,28,29,-1
12,33,48,157,26,48,-22
12,33,48,167,0,31,-31
12,33,48,201,133,228,-95
12,33,48,273,0,98,-98
12,33,48,355,80,196,-116
12,33,48,439,128,133,-5
12,33,48,441,0,42,-42
12,33,48,453,41,61,-20
12,33,48,491,0,40,-40
12,33,51,13,30,39,-9
12,33,51,59,95,70,25
12,33,51,107,30,0,30
12,33,51,153,58,69,-11
12,33,51,177,35,0,35
12,33,51,179,71,0,71
12,33,51,550,66,121,-55
12,33,51,650,71,45,26
12,33,51,700,40,57,-17
12,33,51,710,154,266,-112
12,33,51,740,59,48,11
12,33,51,800,49,0,49
12,33,51,810,312,523,-211
12,33,53,29,103,216,-113
12,33,53,33,84,49,35
12,33,53,35,56,48,8
12,33,53,53,38,65,-27
12,33,53,57,0,51,-51
12,33,53,61,48,52,-4
12,33,53,63,30,0,30
12,33,55,9,0,30,-30
12,35,4,13,33,38,-5
12,35,6,37,46,0,46
12,35,6,73,29,26,3
12,35,9,1,59,33,26
12,35,9,3,27,0,27
12,35,9,9,32,0,32
12,35,12,1,102,41,61
12,35,12,9,109,110,-1
12,35,12,11,358,106,252
12,35,12,19,143,90,53
12,35,12,31,411,431,-20
12,35,12,57,94,96,-2
12,35,12,69,77,48,29
12,35,12,71,55,34,21
12,35,12,73,39,41,-2
12,35,12,83,84,47,37
12,35,12,86,211,135,76
12,35,12,95,191,232,-41
12,35,12,97,47,0,47
12,35,12,99,203,115,88
12,35,12,101,0,31,-31
12,35,12,103,68,90,-22
12,35,12,105,34,44,-10
12,35,12,107,175,120,55
12,35,12,109,762,580,182
12,35,12,111,52,0,52
12,35,12,115,32,35,-3
12,35,12,117,165,123,42
12,35,12,127,2792,1842,950
12,35,13,51,30,0,30
12,35,13,67,46,0,46
12,35,13,121,0,27,-27
12,35,13,135,33,0,33
12,35,17,31,59,46,13
12,35,24,5,32,0,32
12,35,24,33,36,0,36
12,35,25,5,42,0,42
12,35,25,13,33,0,33
12,35,25,23,35,0,35
12,35,25,27,40,0,40
12,35,26,125,39,0,39
12,35,32,3,43,33,10
12,35,34,3,42,0,42
12,35,34,13,38,0,38
12,35,34,17,43,0,43
12,35,34,21,28,0,28
12,35,34,23,62,36,26
12,35,34,25,35,0,35
12,35,34,27,31,0,31
12,35,34,29,78,29,49
12,35,34,39,86,0,86
12,35,36,5,47,33,14
12,35,36,27,31,0,31
12,35,36,47,103,98,5
12,35,36,59,98,23,75
12,35,36,61,38,22,16
12,35,36,71,52,0,52
12,35,36,81,133,58,75
12,35,36,85,51,0,51
12,35,36,103,214,66,148
12,35,36,119,67,0,67
12,35,39,35,26,0,26
12,35,42,3,47,0,47
12,35,42,17,61,0,61
12,35,42,101,40,0,40
12,35,42,133,25,0,25
12,35,44,7,45,0,45
12,35,45,19,0,31,-31
12,35,45,45,0,29,-29
12,35,48,201,25,0,25
12,35,51,153,24,0,24
12,37,12,5,64,65,-1
12,37,12,45,0,60,-60
12,37,12,73,108,80,28
12,37,12,129,35,79,-44
12,39,12,5,35,0,35
12,39,12,11,43,0,43
12,39,12,13,0,46,-46
12,39,12,31,51,61,-10
12,39,12,33,34,0,34
12,39,12,57,31,80,-49
12,39,12,63,159,131,28
12,39,12,65,0,32,-32
12,39,12,73,1975,1722,253
12,39,12,77,31,62,-31
12,39,12,86,25,0,25
12,39,12,95,50,49,1
12,39,12,99,37,28,9
12,39,12,103,31,0,31
12,39,12,105,26,0,26
12,39,12,129,0,98,-98
12,39,13,87,51,133,-82
12,39,13,131,50,52,-2
12,41,12,1,350,354,-4
12,41,12,11,40,0,40
12,41,12,23,57,75,-18
12,41,12,29,139,69,70
12,41,12,57,49,29,20
12,41,12,75,172,220,-48
12,41,12,83,0,25,-25
12,41,12,99,35,0,35
12,41,12,103,39,0,39
12,41,12,121,62,61,1
12,43,12,11,56,32,24
12,43,12,51,258,235,23
12,43,12,55,0,58,-58
12,43,12,71,101,144,-43
12,43,12,86,33,37,-4
12,43,12,93,82,91,-9
12,43,12,99,47,39,8
12,45,12,5,324,365,-41
12,45,12,13,42,49,-7
12,45,12,37,60,0,60
12,45,12,63,0,32,-32
12,45,12,73,0,48,-48
12,47,12,23,149,118,31
12,47,12,31,51,44,7
12,47,12,57,0,32,-32
12,47,12,73,0,21,-21
12,47,12,79,36,0,36
12,47,12,86,27,0,27
12,47,12,121,160,152,8
12,47,13,185,86,96,-10
12,49,12,15,0,40,-40
12,49,12,27,95,88,7
12,49,12,55,153,226,-73
12,49,12,57,104,82,22
12,49,12,81,57,101,-44
12,49,12,86,0,45,-45
12,49,12,105,272,342,-70
12,51,12,11,122,117,5
12,51,12,21,248,157,91
12,51,12,43,235,258,-23
12,51,12,55,33,66,-33
12,51,12,57,0,62,-62
12,51,12,71,358,616,-258
12,51,12,73,0,32,-32
12,51,12,83,0,26,-26
12,51,12,86,214,166,48
12,51,12,93,0,55,-55
12,51,12,95,37,60,-23
12,51,12,99,322,263,59
12,51,12,105,85,53,32
12,51,48,215,0,79,-79
12,53,4,13,0,52,-52
12,53,6,37,47,33,14
12,53,6,59,0,34,-34
12,53,6,73,28,31,-3
12,53,8,41,0,33,-33
12,53,9,1,40,0,40
12,53,9,3,46,0,46
12,53,9,9,79,34,45
12,53,12,1,56,51,5
12,53,12,9,47,39,8
12,53,12,11,343,87,256
12,53,12,15,32,25,7
12,53,12,17,473,529,-56
12,53,12,21,66,0,66
12,53,12,31,60,85,-25
12,53,12,57,1888,1251,637
12,53,12,69,128,144,-16
12,53,12,71,89,108,-19
12,53,12,73,58,29,29
12,53,12,81,46,56,-10
12,53,12,83,133,163,-30
12,53,12,86,226,149,77
12,53,12,87,48,53,-5
12,53,12,95,230,195,35
12,53,12,97,58,63,-5
12,53,12,99,107,103,4
12,53,12,101,3437,2254,1183
12,53,12,103,1121,651,470
12,53,12,105,145,167,-22
12,53,12,111,60,24,36
12,53,12,115,64,62,2
12,53,12,117,103,84,19
12,53,12,119,192,201,-9
12,53,12,127,78,86,-8
12,53,13,121,0,28,-28
12,53,13,135,0,39,-39
12,53,15,3,32,0,32
12,53,17,31,44,50,-6
12,53,25,5,109,34,75
12,53,25,9,44,0,44
12,53,25,17,39,0,39
12,53,25,27,36,0,36
12,53,26,49,34,0,34
12,53,26,99,37,0,37
12,53,26,125,40,34,6
12,53,26,163,55,28,27
12,53,32,3,26,59,-33
12,53,33,11,44,0,44
12,53,34,3,29,0,29
12,53,34,23,53,0,53
12,53,34,25,53,0,53
12,53,34,27,31,0,31
12,53,34,29,60,30,30
12,53,36,5,75,33,42
12,53,36,29,53,0,53
12,53,36,47,114,48,66
12,53,36,55,23,0,23
12,53,36,59,117,44,73
12,53,36,61,49,0,49
12,53,36,67,0,38,-38
12,53,36,71,37,0,37
12,53,36,81,111,48,63
12,53,36,85,69,0,69
12,53,36,103,281,188,93
12,53,36,119,54,0,54
12,53,37,119,30,35,-5
12,53,39,35,32,0,32
12,53,42,17,39,0,39
12,53,44,7,35,0,35
12,53,47,155,0,59,-59
12,53,48,29,0,30,-30
12,53,48,201,37,0,37
12,53,51,810,31,0,31
12,55,12,1,31,51,-20
12,55,12,9,59,81,-22
12,55,12,11,474,197,277
12,55,12,15,51,35,16
12,55,12,17,26,26,0
12,55,12,21,84,79,5
12,55,12,27,99,43,56
12,55,12,31,51,54,-3
12,55,12,43,58,0,58
12,55,12,49,226,153,73
12,55,12,51,66,33,33
12,55,12,57,154,178,-24
12,55,12,61,40,28,12
12,55,12,69,40,78,-38
12,55,12,71,186,149,37
12,55,12,73,29,29,0
12,55,12,81,71,70,1
12,55,12,83,45,61,-16
12,55,12,85,39,0,39
12,55,12,86,384,185,199
12,55,12,87,54,34,20
12,55,12,93,258,111,147
12,55,12,95,186,219,-33
12,55,12,97,57,102,-45
12,55,12,99,224,149,75
12,55,12,101,31,45,-14
12,55,12,103,47,66,-19
12,55,12,105,601,605,-4
12,55,12,109,0,30,-30
12,55,12,111,56,80,-24
12,55,12,115,56,58,-2
12,55,12,117,54,57,-3
12,55,12,127,42,52,-10
12,55,17,31,43,0,43
12,55,26,49,29,0,29
12,55,26,81,30,0,30
12,55,48,201,0,26,-26
12,57,1,3,52,63,-11
12,57,1,5,0,40,-40
12,57,1,31,0,34,-34
12,57,1,51,0,47,-47
12,57,1,69,52,62,-10
12,57,1,73,143,98,45
12,57,1,81,0,40,-40
12,57,1,89,52,67,-15
12,57,1,95,0,29,-29
12,57,1,97,103,124,-21
12,57,1,101,125,77,48
12,57,1,103,0,32,-32
12,57,1,117,0,76,-76
12,57,2,20,78,35,43
12,57,2,90,47,0,47
12,57,4,3,54,34,20
12,57,4,13,321,381,-60
12,57,4,19,122,167,-45
12,57,4,21,0,66,-66
12,57,5,7,35,0,35
12,57,5,119,73,54,19
12,57,5,143,26,39,-13
12,57,6,1,91,74,17
12,57,6,13,54,65,-11
12,57,6,19,0,34,-34
12,57,6,29,41,0,41
12,57,6,37,469,423,46
12,57,6,53,72,50,22
12,57,6,59,168,191,-23
12,57,6,65,101,70,31
12,57,6,67,107,81,26
12,57,6,71,95,102,-7
12,57,6,73,434,384,50
12,57,6,75,175,92,83
12,57,6,81,40,41,-1
12,57,6,83,47,35,12
12,57,6,85,79,91,-12
12,57,6,95,33,50,-17
12,57,6,111,72,39,33
12,57,8,1,37,53,-16
12,57,8,5,98,102,-4
12,57,8,13,0,72,-72
12,57,8,31,125,152,-27
12,57,8,35,53,89,-36
12,57,8,41,257,204,53
12,57,8,59,40,70,-30
12,57,8,69,34,30,4
12,57,9,1,265,141,124
12,57,9,3,242,122,120
12,57,9,5,26,0,26
12,57,9,7,38,0,38
12,57,9,9,208,147,61
12,57,9,11,64,49,15
12,57,9,13,45,0,45
12,57,10,1,45,39,6
12,57,10,3,127,62,65
12,57,10,5,0,29,-29
12,57,11,1,135,140,-5
12,57,12,1,813,616,197
12,57,12,5,195,103,92
12,57,12,9,588,619,-31
12,57,12,11,1880,1449,431
12,57,12,15,281,273,8
12,57,12,17,344,420,-76
12,57,12,19,178,195,-17
12,57,12,21,505,291,214
12,57,12,23,92,96,-4
12,57,12,27,70,39,31
12,57,12,29,0,33,-33
12,57,12,31,1052,864,188
12,57,12,33,273,225,48
12,57,12,35,96,94,2
12,57,12,39,80,31,49
12,57,12,41,29,49,-20
12,57,12,47,32,0,32
12,57,12,49,82,104,-22
12,57,12,51,62,0,62
12,57,12,53,1251,1888,-637
12,57,12,55,178,154,24
12,57,12,61,130,101,29
12,57,12,63,0,57,-57
12,57,12,69,407,367,40
12,57,12,71,1191,898,293
12,57,12,73,816,639,177
12,57,12,75,84,75,9
12,57,12,81,1750,1694,56
12,57,12,83,584,694,-110
12,57,12,85,101,87,14
12,57,12,86,2893,2014,879
12,57,12,87,152,186,-34
12,57,12,89,27,28,-1
12,57,12,91,268,197,71
12,57,12,93,30,0,30
12,57,12,95,2415,2034,381
12,57,12,97,476,447,29
12,57,12,99,1192,968,224
12,57,12,101,7847,14128,-6281
12,57,12,103,8872,9019,-147
12,57,12,105,4154,5101,-947
12,57,12,107,95,59,36
12,57,12,109,173,195,-22
12,57,12,111,317,220,97
12,57,12,113,122,108,14
12,57,12,115,1057,805,252
12,57,12,117,700,535,165
12,57,12,119,147,184,-37
12,57,12,121,51,79,-28
12,57,12,123,0,73,-73
12,57,12,127,537,405,132
12,57,12,129,0,27,-27
12,57,12,131,26,31,-5
12,57,13,21,41,44,-3
12,57,13,45,0,32,-32
12,57,13,51,127,121,6
12,57,13,57,51,79,-28
12,57,13,59,44,36,8
12,57,13,63,69,153,-84
12,57,13,67,334,425,-91
12,57,13,71,0,52,-52
12,57,13,73,35,53,-18
12,57,13,75,0,31,-31
12,57,13,77,0,53,-53
12,57,13,89,191,309,-118
12,57,13,95,37,39,-2
12,57,13,97,0,64,-64
12,57,13,113,49,34,15
12,57,13,117,49,109,-60
12,57,13,121,392,595,-203
12,57,13,135,303,399,-96
12,57,13,139,47,60,-13
12,57,13,151,79,133,-54
12,57,13,153,64,106,-42
12,57,13,179,71,61,10
12,57,13,185,103,107,-4
12,57,13,215,96,99,-3
12,57,13,217,0,41,-41
12,57,13,223,59,75,-16
12,57,13,245,94,117,-23
12,57,13,291,0,33,-33
12,57,13,297,0,27,-27
12,57,15,3,245,176,69
12,57,17,19,32,0,32
12,57,17,31,727,602,125
12,57,17,43,178,135,43
12,57,17,89,42,70,-28
12,57,17,93,31,0,31
12,57,17,97,117,107,10
12,57,17,111,57,0,57
12,57,17,113,0,26,-26
12,57,17,115,29,0,29
12,57,17,143,0,24,-24
12,57,17,163,62,68,-6
12,57,17,197,59,44,15
12,57,17,201,34,0,34
12,57,18,3,72,51,21
12,57,18,35,31,0,31
12,57,18,39,38,0,38
12,57,18,57,72,75,-3
12,57,18,63,26,0,26
12,57,18,89,66,37,29
12,57,18,95,30,34,-4
12,57,18,97,199,131,68
12,57,18,127,30,0,30
12,57,18,141,53,50,3
12,57,18,157,29,41,-12
12,57,18,163,24,30,-6
12,57,19,153,41,69,-28
12,57,20,61,0,39,-39
12,57,20,91,113,91,22
12,57,20,103,46,0,46
12,57,20,173,57,58,-1
12,57,21,15,0,35,-35
12,57,21,47,48,27,21
12,57,21,67,63,86,-23
12,57,21,93,39,33,6
12,57,21,111,211,166,45
12,57,21,117,25,0,25
12,57,22,15,30,0,30
12,57,22,17,35,30,5
12,57,22,33,48,56,-8
12,57,22,51,56,115,-59
12,57,22,55,26,27,-1
12,57,22,71,42,74,-32
12,57,22,103,54,68,-14
12,57,22,115,40,0,40
12,57,23,1,25,0,25
12,57,23,5,82,55,27
12,57,23,31,34,0,34
12,57,24,3,247,126,121
12,57,24,5,176,113,63
12,57,24,17,42,32,10
12,57,24,21,51,32,19
12,57,24,25,35,44,-9
12,57,24,27,80,65,15
12,57,24,31,190,214,-24
12,57,24,33,186,175,11
12,57,24,510,64,54,10
12,57,25,1,56,32,24
12,57,25,5,143,88,55
12,57,25,9,176,158,18
12,57,25,13,137,135,2
12,57,25,15,26,0,26
12,57,25,17,281,250,31
12,57,25,21,103,99,4
12,57,25,23,58,57,1
12,57,25,25,152,177,-25
12,57,25,27,167,102,65
12,57,26,45,26,0,26
12,57,26,49,84,28,56
12,57,26,65,84,34,50
12,57,26,75,23,33,-10
12,57,26,77,44,0,44
12,57,26,81,108,67,41
12,57,26,93,54,26,28
12,57,26,99,147,59,88
12,57,26,125,230,120,110
12,57,26,139,0,27,-27
12,57,26,145,34,0,34
12,57,26,147,33,0,33
12,57,26,159,26,0,26
12,57,26,161,66,53,13
12,57,26,163,277,103,174
12,57,27,3,0,31,-31
12,57,27,37,60,70,-10
12,57,27,53,129,149,-20
12,57,27,123,60,39,21
12,57,28,47,79,88,-9
12,57,28,49,0,25,-25
12,57,28,59,88,64,24
12,57,28,87,41,0,41
12,57,29,19,0,40,-40
12,57,29,47,54,0,54
12,57,29,77,39,28,11
12,57,29,95,63,58,5
12,57,29,101,38,0,38
12,57,29,169,50,0,50
12,57,29,183,58,48,10
12,57,29,189,151,145,6
12,57,29,510,50,39,11
12,57,31,55,83,57,26
12,57,31,153,72,0,72
12,57,32,3,317,400,-83
12,57,32,31,0,44,-44
12,57,33,11,155,80,75
12,57,33,15,51,67,-16
12,57,34,1,65,43,22
12,57,34,3,194,159,35
12,57,34,5,148,64,84
12,57,34,7,145,52,93
12,57,34,9,50,0,50
12,57,34,11,49,32,17
12,57,34,13,222,93,129
12,57,34,15,57,31,26
12,57,34,17,267,164,103
12,57,34,21,69,38,31
12,57,34,23,215,161,54
12,57,34,25,143,82,61
12,57,34,27,127,87,40
12,57,34,29,145,60,85
12,57,34,31,208,194,14
12,57,34,35,116,57,59
12,57,34,39,135,92,43
12,57,35,1,80,104,-24
12,57,36,1,75,39,36
12,57,36,5,621,388,233
12,57,36,7,38,0,38
12,57,36,13,36,29,7
12,57,36,15,28,0,28
12,57,36,27,73,48,25
12,57,36,29,221,160,61
12,57,36,45,94,57,37
12,57,36,47,550,400,150
12,57,36,55,265,206,59
12,57,36,59,339,154,185
12,57,36,61,462,443,19
12,57,36,63,58,24,34
12,57,36,65,58,25,33
12,57,36,67,202,78,124
12,57,36,71,119,77,42
12,57,36,81,676,368,308
12,57,36,83,30,0,30
12,57,36,85,125,65,60
12,57,36,87,61,39,22
12,57,36,91,51,43,8
12,57,36,103,522,227,295
12,57,36,111,34,0,34
12,57,36,119,218,90,128
12,57,37,1,0,34,-34
12,57,37,21,63,133,-70
12,57,37,25,0,92,-92
12,57,37,39,0,32,-32
12,57,37,49,49,30,19
12,57,37,51,369,276,93
12,57,37,63,54,57,-3
12,57,37,67,59,84,-25
12,57,37,71,0,48,-48
12,57,37,81,62,121,-59
12,57,37,85,37,52,-15
12,57,37,87,0,51,-51
12,57,37,89,45,43,2
12,57,37,97,43,40,3
12,57,37,101,0,82,-82
12,57,37,113,0,31,-31
12,57,37,119,298,514,-216
12,57,37,129,70,28,42
12,57,37,133,163,167,-4
12,57,37,135,0,44,-44
12,57,37,147,34,40,-6
12,57,37,159,0,42,-42
12,57,37,179,0,56,-56
12,57,37,183,244,328,-84
12,57,37,191,40,0,40
12,57,39,17,84,53,31
12,57,39,23,0,31,-31
12,57,39,25,51,0,51
12,57,39,35,307,128,179
12,57,39,41,0,31,-31
12,57,39,45,26,0,26
12,57,39,49,271,254,17
12,57,39,57,71,60,11
12,57,39,61,171,107,64
12,57,39,63,36,0,36
12,57,39,85,57,31,26
12,57,39,87,0,33,-33
12,57,39,89,35,0,35
12,57,39,93,52,59,-7
12,57,39,95,96,37,59
12,57,39,99,51,37,14
12,57,39,103,32,0,32
12,57,39,113,131,74,57
12,57,39,151,48,36,12
12,57,39,153,107,57,50
12,57,39,165,51,46,5
12,57,40,27,43,0,43
12,57,40,31,59,35,24
12,57,40,109,72,80,-8
12,57,40,143,60,92,-32
12,57,41,51,35,81,-46
12,57,41,67,45,39,6
12,57,42,3,181,185,-4
12,57,42,7,31,0,31
12,57,42,11,89,38,51
12,57,42,17,91,104,-13
12,57,42,29,70,84,-14
12,57,42,41,64,0,64
12,57,42,43,48,28,20
12,57,42,45,58,45,13
12,57,42,49,43,0,43
12,57,42,69,49,33,16
12,57,42,71,116,76,40
12,57,42,77,160,103,57
12,57,42,79,48,33,15
12,57,42,89,43,0,43
12,57,42,91,142,92,50
12,57,42,95,56,48,8
12,57,42,101,254,190,64
12,57,42,125,29,0,29
12,57,42,129,0,51,-51
12,57,42,133,48,49,-1
12,57,44,3,31,28,3
12,57,44,5,67,0,67
12,57,44,7,205,150,55
12,57,44,9,39,0,39
12,57,45,3,0,62,-62
12,57,45,7,0,48,-48
12,57,45,13,87,77,10
12,57,45,15,62,67,-5
12,57,45,19,90,125,-35
12,57,45,35,60,59,1
12,57,45,41,26,0,26
12,57,45,45,47,263,-216
12,57,45,51,36,50,-14
12,57,45,63,36,53,-17
12,57,45,77,0,33,-33
12,57,45,79,114,112,2
12,57,45,83,39,92,-53
12,57,45,85,53,34,19
12,57,45,91,56,92,-36
12,57,47,9,0,25,-25
12,57,47,37,178,228,-50
12,57,47,59,0,49,-49
12,57,47,65,68,139,-71
12,57,47,73,0,29,-29
12,57,47,93,127,179,-52
12,57,47,125,99,59,40
12,57,47,149,68,100,-32
12,57,47,155,0,58,-58
12,57,47,157,183,121,62
12,57,47,163,0,30,-30
12,57,47,165,0,35,-35
12,57,47,179,0,38,-38
12,57,47,187,33,100,-67
12,57,47,189,31,0,31
12,57,48,27,131,170,-39
12,57,48,29,286,396,-110
12,57,48,61,92,296,-204
12,57,48,85,178,219,-41
12,57,48,113,328,379,-51
12,57,48,121,90,167,-77
12,57,48,141,98,139,-41
12,57,48,157,27,90,-63
12,57,48,201,341,609,-268
12,57,48,215,52,148,-96
12,57,48,245,0,52,-52
12,57,48,339,0,109,-109
12,57,48,355,0,37,-37
12,57,48,409,0,31,-31
12,57,48,423,0,44,-44
12,57,48,439,210,328,-118
12,57,48,441,28,0,28
12,57,48,451,0,43,-43
12,57,48,453,97,200,-103
12,57,48,485,44,43,1
12,57,48,491,65,85,-20
12,57,49,35,82,69,13
12,57,50,7,33,23,10
12,57,51,3,0,27,-27
12,57,51,13,83,134,-51
12,57,51,41,79,70,9
12,57,51,59,454,332,122
12,57,51,87,57,82,-25
12,57,51,107,101,131,-30
12,57,51,153,190,130,60
12,57,51,161,0,26,-26
12,57,51,179,74,54,20
12,57,51,199,48,0,48
12,57,51,510,54,57,-3
12,57,51,550,92,67,25
12,57,51,650,55,35,20
12,57,51,700,79,59,20
12,57,51,710,110,76,34
12,57,51,760,41,0,41
12,57,51,770,0,57,-57
12,57,51,810,299,140,159
12,57,53,11,39,0,39
12,57,53,29,38,0,38
12,57,53,33,146,263,-117
12,57,53,53,128,102,26
12,57,53,61,48,48,0
12,57,53,63,42,37,5
12,57,55,9,0,30,-30
12,57,55,25,81,29,52
12,57,55,79,169,84,85
12,57,55,101,0,27,-27
12,57,55,133,60,33,27
12,57,55,139,28,0,28
12,59,1,61,67,171,-104
12,59,1,69,53,68,-15
12,59,12,5,108,70,38
12,59,12,33,0,22,-22
12,59,12,63,100,102,-2
12,59,12,73,0,23,-23
12,59,12,91,53,46,7
12,59,12,131,187,204,-17
12,59,12,133,314,312,2
12,61,4,13,29,40,-11
12,61,6,37,30,39,-9
12,61,6,73,49,0,49
12,61,8,13,0,27,-27
12,61,9,1,95,27,68
12,61,9,3,38,0,38
12,61,9,9,48,0,48
12,61,11,1,26,0,26
12,61,12,1,77,89,-12
12,61,12,9,805,980,-175
12,61,12,11,692,241,451
12,61,12,17,0,28,-28
12,61,12,19,0,27,-27
12,61,12,21,37,36,1
12,61,12,31,79,95,-16
12,61,12,55,28,40,-12
12,61,12,57,101,130,-29
12,61,12,69,36,52,-16
12,61,12,71,57,61,-4
12,61,12,73,39,90,-51
12,61,12,83,57,49,8
12,61,12,85,241,210,31
12,61,12,86,382,203,179
12,61,12,87,41,49,-8
12,61,12,93,45,47,-2
12,61,12,95,278,318,-40
12,61,12,97,65,100,-35
12,61,12,99,647,394,253
12,61,12,101,37,0,37
12,61,12,103,34,66,-32
12,61,12,105,129,109,20
12,61,12,109,26,29,-3
12,61,12,111,1827,1124,703
12,61,12,115,36,35,1
12,61,12,117,82,72,10
12,61,12,119,0,24,-24
12,61,12,127,95,46,49
12,61,13,57,29,32,-3
12,61,13,67,0,28,-28
12,61,13,89,0,36,-36
12,61,13,121,0,26,-26
12,61,13,135,0,26,-26
12,61,24,3,49,0,49
12,61,24,31,31,0,31
12,61,25,1,49,0,49
12,61,25,5,25,0,25
12,61,25,9,47,0,47
12,61,25,17,36,34,2
12,61,25,27,26,25,1
12,61,26,125,30,0,30
12,61,26,163,40,0,40
12,61,32,3,0,48,-48
12,61,34,3,37,0,37
12,61,34,5,37,0,37
12,61,34,13,44,0,44
12,61,34,25,54,0,54
12,61,34,29,68,31,37
12,61,36,47,25,0,25
12,61,36,59,62,0,62
12,61,36,61,37,23,14
12,61,36,71,31,0,31
12,61,36,81,38,0,38
12,61,36,103,137,55,82
12,61,36,119,41,0,41
12,61,37,119,36,42,-6
12,61,39,35,0,26,-26
12,61,39,49,27,25,2
12,61,42,3,0,25,-25
12,61,42,17,25,0,25
12,61,42,91,31,0,31
12,61,44,7,35,0,35
12,61,45,45,0,26,-26
12,61,47,93,0,26,-26
12,61,48,201,26,48,-22
12,61,48,439,0,36,-36
12,61,48,453,0,29,-29
12,61,51,59,28,0,28
12,63,1,45,34,0,34
12,63,1,61,0,34,-34
12,63,1,69,144,168,-24
12,63,12,1,34,0,34
12,63,12,5,244,282,-38
12,63,12,11,60,0,60
12,63,12,13,183,163,20
12,63,12,31,27,30,-3
12,63,12,33,45,26,19
12,63,12,39,131,159,-28
12,63,12,45,32,0,32
12,63,12,57,57,0,57
12,63,12,59,102,100,2
12,63,12,71,35,0,35
12,63,12,73,151,216,-65
12,63,12,77,31,0,31
12,63,12,83,26,0,26
12,63,12,86,44,0,44
12,63,12,91,50,0,50
12,63,12,95,29,0,29
12,63,12,99,77,0,77
12,63,12,105,34,40,-6
12,63,12,131,0,35,-35
12,63,12,133,222,289,-67
12,65,12,31,0,35,-35
12,65,12,39,32,0,32
12,65,12,73,572,535,37
12,65,12,79,40,37,3
12,65,12,123,32,0,32
12,65,12,129,0,55,-55
12,65,13,275,0,53,-53
12,67,12,23,0,30,-30
12,67,12,121,79,135,-56
12,69,1,97,0,41,-41
12,69,4,13,38,81,-43
12,69,6,37,70,44,26
12,69,6,73,58,43,15
12,69,8,41,33,44,-11
12,69,9,1,55,0,55
12,69,9,3,76,0,76
12,69,9,7,30,0,30
12,69,9,9,60,34,26
12,69,11,1,0,23,-23
12,69,12,1,218,173,45
12,69,12,5,40,46,-6
12,69,12,9,234,278,-44
12,69,12,11,933,248,685
12,69,12,15,76,44,32
12,69,12,17,199,164,35
12,69,12,19,41,45,-4
12,69,12,21,125,61,64
12,69,12,23,23,40,-17
12,69,12,31,224,192,32
12,69,12,33,57,61,-4
12,69,12,35,48,77,-29
12,69,12,53,144,128,16
12,69,12,55,78,40,38
12,69,12,57,367,407,-40
12,69,12,61,52,36,16
12,69,12,71,156,101,55
12,69,12,73,95,113,-18
12,69,12,75,0,42,-42
12,69,12,81,108,104,4
12,69,12,83,1209,1552,-343
12,69,12,85,45,44,1
12,69,12,86,584,232,352
12,69,12,87,52,37,15
12,69,12,91,41,36,5
12,69,12,95,7068,4704,2364
12,69,12,97,1116,889,227
12,69,12,99,425,244,181
12,69,12,101,196,175,21
12,69,12,103,245,229,16
12,69,12,105,1167,1464,-297
12,69,12,107,30,53,-23
12,69,12,109,57,71,-14
12,69,12,111,119,95,24
12,69,12,115,80,97,-17
12,69,12,117,1763,1116,647
12,69,12,119,857,1108,-251
12,69,12,127,1117,884,233
12,69,13,67,59,56,3
12,69,13,89,0,30,-30
12,69,13,121,29,76,-47
12,69,13,135,88,64,24
12,69,13,151,24,35,-11
12,69,13,185,0,30,-30
12,69,15,3,36,39,-3
12,69,17,31,112,73,39
12,69,17,43,47,35,12
12,69,17,97,44,0,44
12,69,17,197,33,0,33
12,69,18,3,25,0,25
12,69,18,89,36,0,36
12,69,18,97,38,34,4
12,69,20,91,28,0,28
12,69,21,67,27,0,27
12,69,23,5,23,26,-3
12,69,24,3,56,35,21
12,69,24,5,53,0,53
12,69,24,31,30,0,30
12,69,25,1,38,0,38
12,69,25,5,51,0,51
12,69,25,9,62,35,27
12,69,25,13,37,28,9
12,69,25,17,47,32,15
12,69,25,21,0,39,-39
12,69,25,23,55,0,55
12,69,25,25,24,31,-7
12,69,25,27,44,36,8
12,69,26,49,57,0,57
12,69,26,81,44,0,44
12,69,26,93,34,0,34
12,69,26,99,52,40,12
12,69,26,125,86,30,56
12,69,26,147,35,0,35
12,69,26,163,101,27,74
12,69,32,3,44,64,-20
12,69,33,11,45,35,10
12,69,33,15,26,0,26
12,69,34,3,49,0,49
12,69,34,7,40,0,40
12,69,34,13,31,0,31
12,69,34,17,74,0,74
12,69,34,23,65,27,38
12,69,34,29,83,0,83
12,69,34,31,49,0,49
12,69,34,39,45,0,45
12,69,36,5,180,62,118
12,69,36,29,78,42,36
12,69,36,47,134,92,42
12,69,36,55,74,46,28
12,69,36,59,150,47,103
12,69,36,61,60,29,31
12,69,36,67,56,29,27
12,69,36,71,52,0,52
12,69,36,81,274,163,111
12,69,36,85,33,0,33
12,69,36,103,155,50,105
12,69,36,119,57,0,57
12,69,37,21,0,69,-69
12,69,37,35,0,42,-42
12,69,37,81,0,37,-37
12,69,37,113,0,35,-35
12,69,37,119,63,54,9
12,69,37,133,39,0,39
12,69,37,183,0,74,-74
12,69,39,35,70,0,70
12,69,39,49,65,45,20
12,69,39,61,0,28,-28
12,69,39,93,22,0,22
12,69,39,95,41,0,41
12,69,39,113,34,0,34
12,69,39,155,42,0,42
12,69,42,3,33,36,-3
12,69,42,29,40,0,40
12,69,42,77,53,0,53
12,69,42,89,33,0,33
12,69,42,91,27,0,27
12,69,42,101,66,30,36
12,69,44,7,53,0,53
12,69,45,19,0,24,-24
12,69,45,45,0,56,-56
12,69,45,63,0,37,-37
12,69,45,83,0,41,-41
12,69,47,9,0,40,-40
12,69,47,35,0,30,-30
12,69,47,37,0,43,-43
12,69,47,65,0,38,-38
12,69,47,93,0,49,-49
12,69,47,155,0,32,-32
12,69,48,29,42,62,-20
12,69,48,113,28,51,-23
12,69,48,121,0,41,-41
12,69,48,201,84,102,-18
12,69,48,215,0,43,-43
12,69,48,439,44,59,-15
12,69,48,453,0,38,-38
12,69,48,491,32,0,32
12,69,49,35,33,0,33
12,69,51,59,84,0,84
12,69,51,153,34,25,9
12,69,51,810,58,45,13
12,69,55,79,30,0,30
12,71,1,3,0,35,-35
12,71,1,69,0,44,-44
12,71,1,73,28,65,-37
12,71,1,89,0,67,-67
12,71,1,95,0,49,-49
12,71,1,97,0,39,-39
12,71,4,13,183,234,-51
12,71,4,19,47,89,-42
12,71,5,7,0,38,-38
12,71,6,1,0,30,-30
12,71,6,37,170,205,-35
12,71,6,59,107,70,37
12,71,6,65,44,67,-23
12,71,6,67,36,46,-10
12,71,6,71,24,54,-30
12,71,6,73,120,123,-3
12,71,6,81,31,0,31
12,71,6,85,29,36,-7
12,71,8,1,38,33,5
12,71,8,5,49,52,-3
12,71,8,13,35,0,35
12,71,8,31,36,62,-26
12,71,8,35,55,31,24
12,71,8,41,97,107,-10
12,71,8,59,33,27,6
12,71,8,69,0,30,-30
12,71,9,1,181,91,90
12,71,9,3,198,43,155
12,71,9,5,34,22,12
12,71,9,7,47,0,47
12,71,9,9,158,101,57
12,71,9,11,65,39,26
12,71,9,13,0,21,-21
12,71,10,1,41,0,41
12,71,10,3,57,31,26
12,71,10,5,43,31,12
12,71,11,1,0,32,-32
12,71,12,1,221,206,15
12,71,12,5,54,68,-14
12,71,12,9,202,245,-43
12,71,12,11,1944,1243,701
12,71,12,15,833,1162,-329
12,71,12,17,80,131,-51
12,71,12,19,37,76,-39
12,71,12,21,6738,4601,2137
12,71,12,23,32,60,-28
12,71,12,27,105,133,-28
12,71,12,29,0,25,-25
12,71,12,31,268,304,-36
12,71,12,33,85,81,4
12,71,12,35,34,55,-21
12,71,12,43,144,101,43
12,71,12,51,616,358,258
12,71,12,53,108,89,19
12,71,12,55,149,186,-37
12,71,12,57,898,1191,-293
12,71,12,61,61,57,4
12,71,12,63,0,35,-35
12,71,12,69,101,156,-55
12,71,12,73,146,214,-68
12,71,12,81,324,302,22
12,71,12,83,218,306,-88
12,71,12,85,37,76,-39
12,71,12,86,2926,3618,-692
12,71,12,87,160,277,-117
12,71,12,89,0,42,-42
12,71,12,91,47,51,-4
12,71,12,93,38,54,-16
12,71,12,95,769,917,-148
12,71,12,97,122,176,-54
12,71,12,99,838,962,-124
12,71,12,101,240,254,-14
12,71,12,103,420,575,-155
12,71,12,105,339,424,-85
12,71,12,109,63,74,-11
12,71,12,111,140,160,-20
12,71,12,113,40,43,-3
12,71,12,115,486,639,-153
12,71,12,117,240,229,11
12,71,12,119,0,137,-137
12,71,12,121,0,57,-57
12,71,12,127,237,201,36
12,71,13,51,35,84,-49
12,71,13,57,37,79,-42
12,71,13,63,38,46,-8
12,71,13,67,107,107,0
12,71,13,73,0,29,-29
12,71,13,77,0,48,-48
12,71,13,89,59,100,-41
12,71,13,117,0,44,-44
12,71,13,121,93,114,-21
12,71,13,123,0,49,-49
12,71,13,135,106,200,-94
12,71,13,139,0,67,-67
12,71,13,153,0,37,-37
12,71,13,215,36,26,10
12,71,13,223,0,31,-31
12,71,13,291,0,45,-45
12,71,15,3,77,29,48
12,71,17,19,0,32,-32
12,71,17,31,477,322,155
12,71,17,43,171,91,80
12,71,17,89,112,84,28
12,71,17,91,32,0,32
12,71,17,97,110,69,41
12,71,17,111,90,41,49
12,71,17,113,33,0,33
12,71,17,115,27,0,27
12,71,17,143,30,0,30
12,71,17,197,126,68,58
12,71,17,201,33,42,-9
12,71,18,3,87,52,35
12,71,18,11,27,0,27
12,71,18,19,0,26,-26
12,71,18,35,0,27,-27
12,71,18,39,52,36,16
12,71,18,57,96,56,40
12,71,18,63,37,53,-16
12,71,18,81,43,0,43
12,71,18,85,33,26,7
12,71,18,89,78,49,29
12,71,18,91,27,0,27
12,71,18,95,32,0,32
12,71,18,97,182,140,42
12,71,18,105,0,39,-39
12,71,18,109,27,0,27
12,71,18,127,30,24,6
12,71,18,141,34,47,-13
12,71,18,157,40,27,13
12,71,19,113,33,0,33
12,71,19,153,49,35,14
12,71,19,163,36,0,36
12,71,20,91,54,64,-10
12,71,21,15,0,27,-27
12,71,21,67,82,51,31
12,71,21,111,111,117,-6
12,71,21,117,26,27,-1
12,71,22,33,0,34,-34
12,71,22,51,0,34,-34
12,71,23,5,56,51,5
12,71,23,19,33,0,33
12,71,23,31,60,34,26
12,71,24,3,100,76,24
12,71,24,5,100,69,31
12,71,24,31,106,88,18
12,71,24,33,44,29,15
12,71,24,510,0,38,-38
12,71,25,1,152,86,66
12,71,25,3,44,26,18
12,71,25,5,149,65,84
12,71,25,9,196,146,50
12,71,25,13,102,41,61
12,71,25,17,242,167,75
12,71,25,21,130,57,73
12,71,25,23,143,80,63
12,71,25,25,87,82,5
12,71,25,27,173,135,38
12,71,26,45,53,0,53
12,71,26,49,108,45,63
12,71,26,55,0,41,-41
12,71,26,65,61,48,13
12,71,26,73,27,0,27
12,71,26,75,47,26,21
12,71,26,77,64,46,18
12,71,26,81,121,89,32
12,71,26,87,50,0,50
12,71,26,91,45,0,45
12,71,26,93,83,0,83
12,71,26,99,269,100,169
12,71,26,115,65,0,65
12,71,26,121,26,0,26
12,71,26,125,329,128,201
12,71,26,139,38,39,-1
12,71,26,143,31,0,31
12,71,26,145,32,32,0
12,71,26,147,41,0,41
12,71,26,161,95,47,48
12,71,26,163,307,127,180
12,71,27,3,46,0,46
12,71,27,37,75,50,25
12,71,27,53,198,120,78
12,71,27,123,56,25,31
12,71,27,139,35,0,35
12,71,27,163,49,42,7
12,71,28,33,0,28,-28
12,71,28,47,0,37,-37
12,71,29,47,34,0,34
12,71,29,77,0,36,-36
12,71,29,95,31,66,-35
12,71,29,183,48,42,6
12,71,29,189,134,64,70
12,71,31,55,33,28,5
12,71,32,3,128,207,-79
12,71,33,1,41,0,41
12,71,33,11,99,44,55
12,71,33,13,48,0,48
12,71,33,15,120,39,81
12,71,33,17,29,0,29
12,71,34,1,74,56,18
12,71,34,3,134,67,67
12,71,34,5,95,30,65
12,71,34,7,73,39,34
12,71,34,9,63,0,63
12,71,34,11,29,0,29
12,71,34,13,96,70,26
12,71,34,15,65,0,65
12,71,34,17,173,101,72
12,71,34,19,25,0,25
12,71,34,21,34,23,11
12,71,34,23,164,32,132
12,71,34,25,158,72,86
12,71,34,27,95,43,52
12,71,34,29,193,97,96
12,71,34,31,124,98,26
12,71,34,35,71,0,71
12,71,34,37,43,0,43
12,71,34,39,120,69,51
12,71,35,1,0,24,-24
12,71,36,1,52,0,52
12,71,36,5,135,112,23
12,71,36,7,42,24,18
12,71,36,13,35,26,9
12,71,36,27,47,36,11
12,71,36,29,164,80,84
12,71,36,45,27,36,-9
12,71,36,47,214,139,75
12,71,36,55,126,114,12
12,71,36,59,205,62,143
12,71,36,61,140,118,22
12,71,36,63,64,0,64
12,71,36,65,46,27,19
12,71,36,67,108,43,65
12,71,36,71,85,26,59
12,71,36,81,297,162,135
12,71,36,85,99,75,24
12,71,36,87,28,0,28
12,71,36,91,26,0,26
12,71,36,103,436,183,253
12,71,36,111,40,0,40
12,71,36,119,148,65,83
12,71,37,21,47,144,-97
12,71,37,25,0,43,-43
12,71,37,35,0,62,-62
12,71,37,39,0,58,-58
12,71,37,45,0,25,-25
12,71,37,51,42,70,-28
12,71,37,63,0,46,-46
12,71,37,67,45,48,-3
12,71,37,81,38,83,-45
12,71,37,87,0,56,-56
12,71,37,89,0,75,-75
12,71,37,97,0,49,-49
12,71,37,101,0,56,-56
12,71,37,113,0,51,-51
12,71,37,119,92,260,-168
12,71,37,129,0,27,-27
12,71,37,133,50,33,17
12,71,37,183,61,243,-182
12,71,37,189,0,33,-33
12,71,39,17,60,67,-7
12,71,39,25,49,34,15
12,71,39,29,34,0,34
12,71,39,35,255,160,95
12,71,39,41,51,33,18
12,71,39,43,35,0,35
12,71,39,45,0,29,-29
12,71,39,49,277,173,104
12,71,39,55,37,0,37
12,71,39,57,41,0,41
12,71,39,61,163,52,111
12,71,39,85,75,37,38
12,71,39,89,54,0,54
12,71,39,93,88,62,26
12,71,39,95,149,52,97
12,71,39,99,73,39,34
12,71,39,103,47,25,22
12,71,39,109,29,26,3
12,71,39,113,99,55,44
12,71,39,123,36,0,36
12,71,39,133,0,52,-52
12,71,39,151,75,67,8
12,71,39,153,159,109,50
12,71,39,155,45,36,9
12,71,39,165,50,0,50
12,71,39,173,24,0,24
12,71,40,143,50,37,13
12,71,41,51,0,30,-30
12,71,41,67,29,0,29
12,71,42,3,158,160,-2
12,71,42,7,27,0,27
12,71,42,11,63,36,27
12,71,42,17,117,51,66
12,71,42,19,33,37,-4
12,71,42,29,66,29,37
12,71,42,39,30,0,30
12,71,42,43,0,35,-35
12,71,42,45,57,42,15
12,71,42,49,46,38,8
12,71,42,69,33,0,33
12,71,42,71,51,39,12
12,71,42,73,27,0,27
12,71,42,77,52,30,22
12,71,42,79,31,0,31
12,71,42,85,0,29,-29
12,71,42,89,26,0,26
12,71,42,91,99,68,31
12,71,42,95,40,0,40
12,71,42,101,101,101,0
12,71,42,125,0,29,-29
12,71,42,129,30,54,-24
12,71,42,133,28,50,-22
12,71,44,3,47,0,47
12,71,44,5,38,0,38
12,71,44,7,164,74,90
12,71,44,9,63,27,36
12,71,45,3,0,37,-37
12,71,45,7,0,62,-62
12,71,45,13,51,28,23
12,71,45,19,35,48,-13
12,71,45,45,52,98,-46
12,71,45,51,53,48,5
12,71,45,63,0,36,-36
12,71,45,79,0,57,-57
12,71,45,83,0,44,-44
12,71,45,91,0,37,-37
12,71,47,9,0,54,-54
12,71,47,11,29,65,-36
12,71,47,35,0,44,-44
12,71,47,37,43,152,-109
12,71,47,59,0,40,-40
12,71,47,65,0,66,-66
12,71,47,89,0,37,-37
12,71,47,93,78,172,-94
12,71,47,119,0,42,-42
12,71,47,123,0,40,-40
12,71,47,125,33,42,-9
12,71,47,149,0,90,-90
12,71,47,155,0,106,-106
12,71,47,157,63,49,14
12,71,47,187,0,41,-41
12,71,48,27,43,51,-8
12,71,48,29,50,103,-53
12,71,48,61,60,137,-77
12,71,48,85,0,108,-108
12,71,48,113,61,209,-148
12,71,48,121,51,56,-5
12,71,48,157,0,52,-52
12,71,48,201,113,436,-323
12,71,48,215,0,86,-86
12,71,48,339,0,43,-43
12,71,48,355,0,37,-37
12,71,48,439,64,131,-67
12,71,48,453,42,133,-91
12,71,48,491,0,38,-38
12,71,49,35,41,71,-30
12,71,49,49,0,50,-50
12,71,50,7,33,36,-3
12,71,51,13,0,28,-28
12,71,51,59,126,84,42
12,71,51,87,39,27,12
12,71,51,107,44,43,1
12,71,51,153,52,52,0
12,71,51,510,28,30,-2
12,71,51,550,31,0,31
12,71,51,710,32,0,32
12,71,51,810,62,49,13
12,71,53,33,89,123,-34
12,71,53,53,43,30,13
12,71,54,39,33,0,33
12,71,55,9,23,0,23
12,71,55,25,45,50,-5
12,71,55,29,27,0,27
12,71,55,59,41,0,41
12,71,55,79,60,55,5
12,71,55,89,46,0,46
12,71,55,127,29,0,29
12,71,55,133,68,36,32
12,73,1,69,0,57,-57
12,73,1,73,57,88,-31
12,73,1,81,29,0,29
12,73,1,89,26,46,-20
12,73,1,97,57,75,-18
12,73,1,101,33,29,4
12,73,4,13,35,66,-31
12,73,4,19,0,25,-25
12,73,5,119,0,30,-30
12,73,6,1,0,34,-34
12,73,6,37,73,145,-72
12,73,6,59,38,0,38
12,73,6,65,29,0,29
12,73,6,73,37,79,-42
12,73,6,75,0,20,-20
12,73,6,85,31,52,-21
12,73,8,5,0,37,-37
12,73,8,31,0,58,-58
12,73,8,41,40,0,40
12,73,8,59,0,34,-34
12,73,11,1,21,47,-26
12,73,12,1,376,340,36
12,73,12,5,359,384,-25
12,73,12,9,269,262,7
12,73,12,11,879,763,116
12,73,12,13,48,74,-26
12,73,12,15,50,0,50
12,73,12,17,74,39,35
12,73,12,19,115,118,-3
12,73,12,21,96,65,31
12,73,12,23,65,72,-7
12,73,12,27,27,0,27
12,73,12,31,675,949,-274
12,73,12,33,283,363,-80
12,73,12,35,41,39,2
12,73,12,37,80,108,-28
12,73,12,39,1722,1975,-253
12,73,12,45,48,0,48
12,73,12,47,21,0,21
12,73,12,51,32,0,32
12,73,12,53,29,58,-29
12,73,12,55,29,29,0
12,73,12,57,639,816,-177
12,73,12,59,23,0,23
12,73,12,61,90,39,51
12,73,12,63,216,151,65
12,73,12,65,535,572,-37
12,73,12,69,113,95,18
12,73,12,71,214,146,68
12,73,12,77,79,125,-46
12,73,12,79,74,89,-15
12,73,12,81,135,136,-1
12,73,12,83,170,135,35
12,73,12,85,49,54,-5
12,73,12,86,884,744,140
12,73,12,87,44,37,7
12,73,12,89,0,39,-39
12,73,12,91,236,185,51
12,73,12,95,629,878,-249
12,73,12,97,73,104,-31
12,73,12,99,633,534,99
12,73,12,101,132,167,-35
12,73,12,103,369,429,-60
12,73,12,105,204,208,-4
12,73,12,107,26,0,26
12,73,12,109,99,107,-8
12,73,12,111,98,102,-4
12,73,12,113,130,106,24
12,73,12,115,194,138,56
12,73,12,117,224,300,-76
12,73,12,119,23,0,23
12,73,12,121,51,39,12
12,73,12,123,163,69,94
12,73,12,127,233,199,34
12,73,12,129,1035,1665,-630
12,73,12,131,96,80,16
12,73,12,133,40,39,1
12,73,13,21,37,25,12
12,73,13,51,29,64,-35
12,73,13,57,40,26,14
12,73,13,59,0,28,-28
12,73,13,63,34,65,-31
12,73,13,67,66,180,-114
12,73,13,71,33,29,4
12,73,13,87,117,154,-37
12,73,13,89,113,230,-117
12,73,13,95,75,49,26
12,73,13,97,0,40,-40
12,73,13,121,150,284,-134
12,73,13,131,125,120,5
12,73,13,135,62,166,-104
12,73,13,139,0,32,-32
12,73,13,151,33,76,-43
12,73,13,185,133,85,48
12,73,13,215,39,59,-20
12,73,13,247,0,26,-26
12,73,13,275,193,199,-6
12,73,15,3,0,43,-43
12,73,17,19,24,0,24
12,73,17,31,98,180,-82
12,73,18,97,25,35,-10
12,73,20,91,0,30,-30
12,73,21,111,26,26,0
12,73,22,33,30,59,-29
12,73,22,51,0,30,-30
12,73,22,71,34,51,-17
12,73,22,103,0,43,-43
12,73,24,3,0,22,-22
12,73,24,5,0,47,-47
12,73,24,31,0,63,-63
12,73,24,33,25,64,-39
12,73,25,17,34,0,34
12,73,25,25,0,33,-33
12,73,26,77,0,20,-20
12,73,26,125,47,0,47
12,73,26,163,70,37,33
12,73,27,53,0,23,-23
12,73,29,189,0,25,-25
12,73,32,3,35,45,-10
12,73,34,13,0,39,-39
12,73,34,17,0,22,-22
12,73,36,47,26,81,-55
12,73,36,59,26,0,26
12,73,36,61,39,114,-75
12,73,36,81,31,49,-18
12,73,36,103,28,0,28
12,73,37,21,0,48,-48
12,73,37,51,0,39,-39
12,73,37,63,40,44,-4
12,73,37,119,46,132,-86
12,73,37,133,0,27,-27
12,73,37,135,0,35,-35
12,73,37,183,50,113,-63
12,73,39,35,59,35,24
12,73,39,49,55,47,8
12,73,41,51,0,27,-27
12,73,42,3,0,36,-36
12,73,42,91,0,29,-29
12,73,42,101,28,0,28
12,73,45,13,27,0,27
12,73,45,19,33,53,-20
12,73,45,45,28,0,28
12,73,45,63,0,34,-34
12,73,45,79,51,48,3
12,73,47,37,44,82,-38
12,73,47,93,36,31,5
12,73,47,157,34,41,-7
12,73,48,29,27,52,-25
12,73,48,113,31,94,-63
12,73,48,121,0,38,-38
12,73,48,201,48,175,-127
12,73,48,439,63,52,11
12,73,48,453,0,86,-86
12,73,49,35,0,26,-26
12,73,51,13,0,46,-46
12,73,51,59,44,84,-40
12,73,51,153,0,26,-26
12,73,51,510,24,22,2
12,73,51,710,0,28,-28
12,73,53,33,0,47,-47
12,73,55,25,28,0,28
12,75,12,1,756,556,200
12,75,12,9,31,0,31
12,75,12,11,115,0,115
12,75,12,17,186,225,-39
12,75,12,21,45,0,45
12,75,12,23,29,32,-3
12,75,12,29,190,155,35
12,75,12,31,46,36,10
12,75,12,41,220,172,48
12,75,12,57,75,84,-9
12,75,12,69,42,0,42
12,75,12,83,390,478,-88
12,75,12,86,48,0,48
12,75,12,95,54,55,-1
12,75,12,99,132,24,108
12,75,12,101,58,36,22
12,75,12,103,117,45,72
12,75,12,105,48,0,48
12,75,12,127,0,31,-31
12,77,12,13,118,147,-29
12,77,12,39,62,31,31
12,77,12,63,0,31,-31
12,77,12,73,125,79,46
12,79,12,31,35,59,-24
12,79,12,47,0,36,-36
12,79,12,65,37,40,-3
12,79,12,73,89,74,15
12,79,12,95,34,0,34
12,79,12,99,34,0,34
12,79,12,121,44,88,-44
12,79,12,123,63,50,13
12,79,13,185,99,127,-28
12,81,1,3,0,39,-39
12,81,1,89,0,29,-29
12,81,4,13,89,96,-7
12,81,4,19,35,28,7
12,81,6,37,105,76,29
12,81,6,59,70,29,41
12,81,6,65,36,0,36
12,81,6,73,100,116,-16
12,81,8,31,30,35,-5
12,81,8,41,0,56,-56
12,81,9,1,96,47,49
12,81,9,3,68,32,36
12,81,9,5,23,0,23
12,81,9,9,53,37,16
12,81,9,11,32,0,32
12,81,10,3,39,0,39
12,81,11,1,0,26,-26
12,81,12,1,152,122,30
12,81,12,5,0,30,-30
12,81,12,9,112,107,5
12,81,12,11,436,251,185
12,81,12,15,178,317,-139
12,81,12,17,0,74,-74
12,81,12,19,26,33,-7
12,81,12,21,152,111,41
12,81,12,27,47,59,-12
12,81,12,31,114,209,-95
12,81,12,33,47,46,1
12,81,12,49,101,57,44
12,81,12,53,56,46,10
12,81,12,55,70,71,-1
12,81,12,57,1694,1750,-56
12,81,12,69,104,108,-4
12,81,12,71,302,324,-22
12,81,12,73,136,135,1
12,81,12,83,132,176,-44
12,81,12,85,30,33,-3
12,81,12,86,316,290,26
12,81,12,87,78,35,43
12,81,12,91,0,26,-26
12,81,12,95,365,413,-48
12,81,12,97,66,73,-7
12,81,12,99,256,205,51
12,81,12,101,236,213,23
12,81,12,103,1290,836,454
12,81,12,105,220,296,-76
12,81,12,109,50,55,-5
12,81,12,111,49,63,-14
12,81,12,115,5794,5754,40
12,81,12,117,119,111,8
12,81,12,119,0,29,-29
12,81,12,121,0,33,-33
12,81,12,127,102,90,12
12,81,13,51,28,0,28
12,81,13,63,0,37,-37
12,81,13,67,63,79,-16
12,81,13,89,0,34,-34
12,81,13,121,64,102,-38
12,81,13,135,55,83,-28
12,81,13,291,0,30,-30
12,81,15,3,0,37,-37
12,81,17,31,158,94,64
12,81,17,43,61,51,10
12,81,17,89,56,0,56
12,81,17,97,41,31,10
12,81,17,111,28,0,28
12,81,17,197,35,0,35
12,81,18,3,32,31,1
12,81,18,57,0,36,-36
12,81,18,89,28,0,28
12,81,18,97,51,31,20
12,81,20,91,38,0,38
12,81,21,111,75,37,38
12,81,22,51,0,36,-36
12,81,23,5,62,36,26
12,81,23,31,25,0,25
12,81,24,3,87,40,47
12,81,24,5,62,0,62
12,81,24,31,37,35,2
12,81,25,1,38,33,5
12,81,25,3,32,0,32
12,81,25,5,47,0,47
12,81,25,9,55,51,4
12,81,25,13,35,37,-2
12,81,25,17,90,51,39
12,81,25,21,27,0,27
12,81,25,23,58,30,28
12,81,25,25,0,27,-27
12,81,25,27,67,38,29
12,81,26,45,32,0,32
12,81,26,49,50,33,17
12,81,26,65,54,0,54
12,81,26,81,97,0,97
12,81,26,99,57,26,31
12,81,26,125,123,52,71
12,81,26,163,134,48,86
12,81,27,53,54,0,54
12,81,29,189,53,0,53
12,81,32,3,72,108,-36
12,81,33,11,34,59,-25
12,81,33,15,37,30,7
12,81,34,3,93,34,59
12,81,34,5,32,0,32
12,81,34,7,39,0,39
12,81,34,17,40,0,40
12,81,34,21,32,0,32
12,81,34,23,43,33,10
12,81,34,25,44,0,44
12,81,34,27,51,0,51
12,81,34,29,70,26,44
12,81,34,31,44,0,44
12,81,34,39,32,0,32
12,81,36,1,33,0,33
12,81,36,5,31,34,-3
12,81,36,13,25,0,25
12,81,36,29,69,61,8
12,81,36,47,35,37,-2
12,81,36,55,66,43,23
12,81,36,59,78,26,52
12,81,36,61,52,60,-8
12,81,36,67,52,0,52
12,81,36,81,63,34,29
12,81,36,85,35,0,35
12,81,36,91,29,0,29
12,81,36,103,153,57,96
12,81,36,119,44,25,19
12,81,37,21,0,53,-53
12,81,37,45,0,64,-64
12,81,37,51,0,31,-31
12,81,37,63,0,27,-27
12,81,37,71,0,37,-37
12,81,37,81,28,46,-18
12,81,37,89,0,49,-49
12,81,37,97,0,38,-38
12,81,37,119,54,99,-45
12,81,37,179,0,34,-34
12,81,37,183,46,109,-63
12,81,39,17,0,28,-28
12,81,39,23,29,0,29
12,81,39,35,58,50,8
12,81,39,49,60,50,10
12,81,39,61,75,32,43
12,81,39,93,35,0,35
12,81,39,95,59,0,59
12,81,39,99,31,0,31
12,81,39,113,64,41,23
12,81,39,151,53,57,-4
12,81,39,153,46,39,7
12,81,42,3,94,76,18
12,81,42,17,43,38,5
12,81,42,49,32,0,32
12,81,42,71,0,29,-29
12,81,42,91,56,0,56
12,81,42,101,41,26,15
12,81,42,133,0,32,-32
12,81,44,3,37,0,37
12,81,44,7,70,0,70
12,81,45,45,35,66,-31
12,81,45,51,32,31,1
12,81,45,79,0,28,-28
12,81,45,83,0,40,-40
12,81,45,91,0,45,-45
12,81,47,9,0,51,-51
12,81,47,37,27,49,-22
12,81,47,65,0,39,-39
12,81,47,93,0,52,-52
12,81,47,125,0,43,-43
12,81,47,155,0,29,-29
12,81,47,165,0,34,-34
12,81,48,29,27,77,-50
12,81,48,61,74,184,-110
12,81,48,85,0,37,-37
12,81,48,113,69,61,8
12,81,48,121,0,37,-37
12,81,48,201,54,119,-65
12,81,48,215,45,81,-36
12,81,48,339,0,40,-40
12,81,48,439,54,68,-14
12,81,48,453,0,86,-86
12,81,49,35,0,46,-46
12,81,51,59,114,56,58
12,81,51,87,0,29,-29
12,81,51,107,37,0,37
12,81,51,153,0,37,-37
12,81,51,810,33,0,33
12,81,53,33,36,55,-19
12,81,55,25,33,0,33
12,83,1,73,31,34,-3
12,83,4,13,88,66,22
12,83,6,37,46,71,-25
12,83,6,65,38,0,38
12,83,6,73,62,48,14
12,83,8,5,0,34,-34
12,83,9,1,86,0,86
12,83,9,3,88,40,48
12,83,9,5,43,0,43
12,83,9,9,83,0,83
12,83,9,11,49,39,10
12,83,9,15,0,27,-27
12,83,10,3,28,0,28
12,83,12,1,1038,904,134
12,83,12,5,77,70,7
12,83,12,7,32,40,-8
12,83,12,9,195,191,4
12,83,12,11,1399,459,940
12,83,12,15,78,32,46
12,83,12,17,919,1079,-160
12,83,12,19,133,143,-10
12,83,12,21,148,109,39
12,83,12,23,66,92,-26
12,83,12,29,28,0,28
12,83,12,31,358,347,11
12,83,12,33,63,63,0
12,83,12,35,47,84,-37
12,83,12,41,25,0,25
12,83,12,51,26,0,26
12,83,12,53,163,133,30
12,83,12,55,61,45,16
12,83,12,57,694,584,110
12,83,12,61,49,57,-8
12,83,12,63,0,26,-26
12,83,12,69,1552,1209,343
12,83,12,71,306,218,88
12,83,12,73,135,170,-35
12,83,12,75,478,390,88
12,83,12,81,176,132,44
12,83,12,85,78,34,44
12,83,12,86,1003,445,558
12,83,12,87,124,52,72
12,83,12,91,46,55,-9
12,83,12,95,861,667,194
12,83,12,97,176,106,70
12,83,12,99,720,357,363
12,83,12,101,252,186,66
12,83,12,103,430,344,86
12,83,12,105,253,259,-6
12,83,12,107,197,151,46
12,83,12,109,110,132,-22
12,83,12,111,157,125,32
12,83,12,113,33,0,33
12,83,12,115,133,121,12
12,83,12,117,310,220,90
12,83,12,119,622,470,152
12,83,12,121,42,46,-4
12,83,12,127,364,303,61
12,83,13,51,40,27,13
12,83,13,67,42,59,-17
12,83,13,89,49,51,-2
12,83,13,121,29,59,-30
12,83,13,135,45,67,-22
12,83,13,185,32,31,1
12,83,15,3,29,36,-7
12,83,17,31,82,62,20
12,83,17,43,28,0,28
12,83,17,97,40,0,40
12,83,17,111,25,0,25
12,83,18,97,44,32,12
12,83,21,67,0,30,-30
12,83,21,111,42,0,42
12,83,23,5,32,0,32
12,83,23,31,0,24,-24
12,83,24,3,28,0,28
12,83,24,5,42,0,42
12,83,24,31,32,0,32
12,83,24,33,45,0,45
12,83,25,1,34,0,34
12,83,25,5,47,31,16
12,83,25,9,32,0,32
12,83,25,13,33,30,3
12,83,25,17,50,32,18
12,83,25,23,40,0,40
12,83,25,25,26,0,26
12,83,25,27,69,47,22
12,83,26,49,39,0,39
12,83,26,99,43,31,12
12,83,26,125,76,32,44
12,83,26,163,78,38,40
12,83,27,53,39,0,39
12,83,29,77,0,24,-24
12,83,32,3,84,87,-3
12,83,33,11,50,30,20
12,83,33,13,33,0,33
12,83,33,15,58,0,58
12,83,34,3,46,0,46
12,83,34,5,56,0,56
12,83,34,7,69,0,69
12,83,34,13,24,0,24
12,83,34,17,29,0,29
12,83,34,23,68,39,29
12,83,34,25,36,0,36
12,83,34,29,70,38,32
12,83,34,31,41,0,41
12,83,36,5,153,38,115
12,83,36,27,55,0,55
12,83,36,29,40,48,-8
12,83,36,47,173,107,66
12,83,36,55,57,31,26
12,83,36,59,144,32,112
12,83,36,61,55,25,30
12,83,36,67,52,0,52
12,83,36,71,58,0,58
12,83,36,81,251,140,111
12,83,36,85,45,0,45
12,83,36,87,43,0,43
12,83,36,91,44,0,44
12,83,36,103,231,78,153
12,83,36,119,46,0,46
12,83,37,21,0,25,-25
12,83,37,51,35,36,-1
12,83,37,67,0,28,-28
12,83,37,119,64,68,-4
12,83,37,133,54,37,17
12,83,37,183,31,76,-45
12,83,39,35,46,30,16
12,83,39,49,55,41,14
12,83,39,113,55,0,55
12,83,39,151,23,0,23
12,83,39,153,30,0,30
12,83,39,165,29,0,29
12,83,42,3,73,40,33
12,83,42,11,32,0,32
12,83,42,17,44,0,44
12,83,42,45,33,0,33
12,83,42,71,30,35,-5
12,83,42,79,37,0,37
12,83,42,91,34,0,34
12,83,42,95,35,0,35
12,83,42,101,60,47,13
12,83,42,129,31,0,31
12,83,44,3,29,0,29
12,83,44,7,72,35,37
12,83,45,13,0,29,-29
12,83,45,15,0,39,-39
12,83,45,45,0,50,-50
12,83,45,83,0,42,-42
12,83,47,37,24,52,-28
12,83,47,65,0,28,-28
12,83,47,93,0,49,-49
12,83,47,125,0,31,-31
12,83,47,157,28,0,28
12,83,47,179,0,50,-50
12,83,48,29,37,40,-3
12,83,48,113,0,35,-35
12,83,48,201,38,83,-45
12,83,48,439,41,73,-32
12,83,48,453,0,65,-65
12,83,51,59,33,0,33
12,83,51,710,39,0,39
12,83,51,810,33,0,33
12,83,53,53,0,27,-27
12,83,54,39,0,28,-28
12,83,55,79,22,0,22
12,85,4,13,46,46,0
12,85,6,37,32,51,-19
12,85,6,73,35,31,4
12,85,9,1,47,34,13
12,85,9,3,82,33,49
12,85,9,9,40,0,40
12,85,12,1,79,96,-17
12,85,12,9,149,167,-18
12,85,12,11,525,270,255
12,85,12,21,25,38,-13
12,85,12,31,60,97,-37
12,85,12,55,0,39,-39
12,85,12,57,87,101,-14
12,85,12,61,210,241,-31
12,85,12,69,44,45,-1
12,85,12,71,76,37,39
12,85,12,73,54,49,5
12,85,12,81,33,30,3
12,85,12,83,34,78,-44
12,85,12,86,243,179,64
12,85,12,87,49,26,23
12,85,12,93,91,133,-42
12,85,12,95,157,197,-40
12,85,12,99,2527,1528,999
12,85,12,101,46,36,10
12,85,12,103,56,56,0
12,85,12,105,43,81,-38
12,85,12,109,0,55,-55
12,85,12,111,2556,3226,-670
12,85,12,115,21,27,-6
12,85,12,117,60,73,-13
12,85,12,127,67,68,-1
12,85,13,67,0,30,-30
12,85,13,121,0,44,-44
12,85,13,135,0,71,-71
12,85,15,3,0,23,-23
12,85,17,31,43,37,6
12,85,24,3,36,0,36
12,85,25,1,42,26,16
12,85,25,9,29,0,29
12,85,25,17,28,35,-7
12,85,25,23,31,0,31
12,85,26,99,27,0,27
12,85,26,163,25,0,25
12,85,32,3,36,30,6
12,85,33,15,27,0,27
12,85,34,1,27,0,27
12,85,34,3,39,0,39
12,85,34,25,60,0,60
12,85,34,27,29,0,29
12,85,34,29,65,47,18
12,85,36,59,94,55,39
12,85,36,61,31,29,2
12,85,36,67,36,0,36
12,85,36,71,29,0,29
12,85,36,81,52,26,26
12,85,36,103,157,69,88
12,85,36,119,44,0,44
12,85,37,21,28,32,-4
12,85,37,119,0,52,-52
12,85,37,183,27,47,-20
12,85,39,35,28,0,28
12,85,39,153,32,0,32
12,85,42,3,35,0,35
12,85,42,91,0,26,-26
12,85,45,13,0,29,-29
12,85,45,45,0,60,-60
12,85,48,113,0,44,-44
12,85,48,201,0,35,-35
12,85,48,439,31,0,31
12,85,51,59,34,0,34
12,86,1,3,0,44,-44
12,86,1,45,0,35,-35
12,86,1,69,0,84,-84
12,86,1,73,87,140,-53
12,86,1,89,24,90,-66
12,86,1,97,45,127,-82
12,86,1,101,42,63,-21
12,86,1,117,36,71,-35
12,86,1,125,33,45,-12
12,86,2,20,43,67,-24
12,86,4,3,34,0,34
12,86,4,13,331,423,-92
12,86,4,19,85,108,-23
12,86,4,25,0,23,-23
12,86,5,7,0,54,-54
12,86,5,119,28,42,-14
12,86,6,1,104,160,-56
12,86,6,13,78,113,-35
12,86,6,19,32,46,-14
12,86,6,37,1127,1377,-250
12,86,6,41,45,58,-13
12,86,6,53,39,33,6
12,86,6,59,237,239,-2
12,86,6,61,0,27,-27
12,86,6,65,123,144,-21
12,86,6,67,72,61,11
12,86,6,71,113,124,-11
12,86,6,73,447,478,-31
12,86,6,75,181,237,-56
12,86,6,77,0,33,-33
12,86,6,81,99,115,-16
12,86,6,83,44,32,12
12,86,6,85,117,177,-60
12,86,6,95,0,27,-27
12,86,6,97,30,45,-15
12,86,6,111,61,50,11
12,86,8,1,36,37,-1
12,86,8,5,57,97,-40
12,86,8,13,54,133,-79
12,86,8,31,90,131,-41
12,86,8,35,24,33,-9
12,86,8,41,121,195,-74
12,86,8,59,42,37,5
12,86,9,1,267,215,52
12,86,9,3,200,138,62
12,86,9,9,188,168,20
12,86,9,11,85,22,63
12,86,10,1,38,0,38
12,86,10,3,62,48,14
12,86,10,5,26,31,-5
12,86,11,1,341,303,38
12,86,12,1,523,775,-252
12,86,12,5,93,108,-15
12,86,12,9,561,1061,-500
12,86,12,11,23529,38794,-15265
12,86,12,15,194,325,-131
12,86,12,17,71,256,-185
12,86,12,19,116,266,-150
12,86,12,21,1576,1392,184
12,86,12,23,51,92,-41
12,86,12,27,0,43,-43
12,86,12,31,826,1273,-447
12,86,12,33,156,152,4
12,86,12,35,135,211,-76
12,86,12,39,0,25,-25
12,86,12,43,37,33,4
12,86,12,47,0,27,-27
12,86,12,49,45,0,45
12,86,12,51,166,214,-48
12,86,12,53,149,226,-77
12,86,12,55,185,384,-199
12,86,12,57,2014,2893,-879
12,86,12,61,203,382,-179
12,86,12,63,0,44,-44
12,86,12,69,232,584,-352
12,86,12,71,3618,2926,692
12,86,12,73,744,884,-140
12,86,12,75,0,48,-48
12,86,12,81,290,316,-26
12,86,12,83,445,1003,-558
12,86,12,85,179,243,-64
12,86,12,87,1032,871,161
12,86,12,89,26,82,-56
12,86,12,91,131,53,78
12,86,12,93,38,92,-54
12,86,12,95,2389,3250,-861
12,86,12,97,643,1170,-527
12,86,12,99,3573,4853,-1280
12,86,12,101,249,475,-226
12,86,12,103,591,703,-112
12,86,12,105,713,1426,-713
12,86,12,107,34,69,-35
12,86,12,109,76,216,-140
12,86,12,111,648,1467,-819
12,86,12,113,73,49,24
12,86,12,115,417,439,-22
12,86,12,117,493,712,-219
12,86,12,119,29,74,-45
12,86,12,121,59,93,-34
12,86,12,127,445,645,-200
12,86,12,131,29,0,29
12,86,13,13,0,41,-41
12,86,13,15,0,39,-39
12,86,13,21,34,95,-61
12,86,13,39,0,37,-37
12,86,13,45,0,77,-77
12,86,13,51,137,221,-84
12,86,13,57,74,163,-89
12,86,13,59,26,66,-40
12,86,13,63,145,499,-354
12,86,13,67,329,774,-445
12,86,13,69,0,39,-39
12,86,13,71,0,57,-57
12,86,13,73,0,47,-47
12,86,13,77,0,129,-129
12,86,13,89,442,748,-306
12,86,13,95,0,80,-80
12,86,13,97,75,283,-208
12,86,13,113,31,116,-85
12,86,13,117,31,140,-109
12,86,13,121,538,1076,-538
12,86,13,127,0,88,-88
12,86,13,131,0,36,-36
12,86,13,135,482,1232,-750
12,86,13,139,41,116,-75
12,86,13,145,0,51,-51
12,86,13,151,131,655,-524
12,86,13,153,39,135,-96
12,86,13,175,0,77,-77
12,86,13,179,105,90,15
12,86,13,185,58,167,-109
12,86,13,215,54,106,-52
12,86,13,217,71,181,-110
12,86,13,223,0,195,-195
12,86,13,245,78,140,-62
12,86,13,247,47,173,-126
12,86,13,255,0,36,-36
12,86,13,275,0,44,-44
12,86,13,297,0,52,-52
12,86,13,313,0,32,-32
12,86,15,3,172,178,-6
12,86,15,9,31,0,31
12,86,17,31,935,911,24
12,86,17,43,122,98,24
12,86,17,89,31,51,-20
12,86,17,97,94,117,-23
12,86,17,143,21,0,21
12,86,17,163,0,35,-35
12,86,17,197,34,37,-3
12,86,17,201,0,31,-31
12,86,18,57,49,31,18
12,86,18,89,28,0,28
12,86,18,97,131,155,-24
12,86,18,105,35,0,35
12,86,18,141,35,46,-11
12,86,19,113,0,22,-22
12,86,20,61,0,42,-42
12,86,20,91,45,95,-50
12,86,20,161,0,46,-46
12,86,21,47,0,32,-32
12,86,21,67,58,81,-23
12,86,21,111,186,271,-85
12,86,21,117,27,0,27
12,86,22,33,39,52,-13
12,86,22,51,153,221,-68
12,86,22,55,0,28,-28
12,86,22,71,91,105,-14
12,86,22,103,28,0,28
12,86,22,115,40,0,40
12,86,23,5,27,55,-28
12,86,23,31,30,27,3
12,86,24,3,83,111,-28
12,86,24,5,129,100,29
12,86,24,21,33,31,2
12,86,24,27,44,93,-49
12,86,24,31,327,461,-134
12,86,24,33,194,210,-16
12,86,24,43,0,29,-29
12,86,24,510,142,97,45
12,86,25,1,37,28,9
12,86,25,5,63,62,1
12,86,25,9,227,193,34
12,86,25,13,69,50,19
12,86,25,15,27,0,27
12,86,25,17,361,303,58
12,86,25,21,108,65,43
12,86,25,23,69,47,22
12,86,25,25,389,355,34
12,86,25,27,81,73,8
12,86,26,65,73,28,45
12,86,26,77,21,0,21
12,86,26,81,141,58,83
12,86,26,97,46,0,46
12,86,26,99,91,40,51
12,86,26,125,203,95,108
12,86,26,161,75,35,40
12,86,26,163,200,103,97
12,86,27,37,0,30,-30
12,86,27,53,152,107,45
12,86,27,123,30,0,30
12,86,28,47,152,112,40
12,86,28,59,26,0,26
12,86,29,95,66,55,11
12,86,29,169,0,36,-36
12,86,29,183,23,46,-23
12,86,29,189,92,86,6
12,86,29,510,51,39,12
12,86,31,55,37,52,-15
12,86,32,3,602,733,-131
12,86,32,31,30,29,1
12,86,33,11,62,51,11
12,86,33,15,44,0,44
12,86,34,1,103,60,43
12,86,34,3,380,306,74
12,86,34,5,57,31,26
12,86,34,7,77,35,42
12,86,34,9,0,36,-36
12,86,34,13,305,234,71
12,86,34,17,768,451,317
12,86,34,21,90,56,34
12,86,34,23,233,159,74
12,86,34,25,92,108,-16
12,86,34,27,125,91,34
12,86,34,29,102,34,68
12,86,34,31,237,159,78
12,86,34,35,70,68,2
12,86,34,39,352,226,126
12,86,35,1,92,69,23
12,86,35,43,0,33,-33
12,86,35,49,0,43,-43
12,86,36,1,43,32,11
12,86,36,5,998,773,225
12,86,36,27,0,27,-27
12,86,36,29,122,75,47
12,86,36,45,0,60,-60
12,86,36,47,999,924,75
12,86,36,55,139,114,25
12,86,36,59,402,254,148
12,86,36,61,1638,1662,-24
12,86,36,67,79,38,41
12,86,36,71,94,37,57
12,86,36,81,1217,1039,178
12,86,36,85,94,84,10
12,86,36,87,67,80,-13
12,86,36,91,37,25,12
12,86,36,103,417,283,134
12,86,36,109,27,29,-2
12,86,36,111,24,0,24
12,86,36,119,334,289,45
12,86,37,1,0,40,-40
12,86,37,5,0,31,-31
12,86,37,19,0,38,-38
12,86,37,21,31,210,-179
12,86,37,25,0,133,-133
12,86,37,39,0,32,-32
12,86,37,49,25,33,-8
12,86,37,51,173,223,-50
12,86,37,57,0,32,-32
12,86,37,63,117,181,-64
12,86,37,67,46,149,-103
12,86,37,71,38,108,-70
12,86,37,81,77,233,-156
12,86,37,89,0,51,-51
12,86,37,97,0,73,-73
12,86,37,101,0,106,-106
12,86,37,119,322,1178,-856
12,86,37,129,29,56,-27
12,86,37,133,178,211,-33
12,86,37,135,38,40,-2
12,86,37,147,0,30,-30
12,86,37,159,0,55,-55
12,86,37,179,23,147,-124
12,86,37,183,211,687,-476
12,86,39,17,52,36,16
12,86,39,35,167,176,-9
12,86,39,49,151,152,-1
12,86,39,61,105,91,14
12,86,39,95,45,0,45
12,86,39,99,32,0,32
12,86,39,113,45,0,45
12,86,39,153,43,35,8
12,86,40,31,34,0,34
12,86,40,109,30,96,-66
12,86,40,143,44,59,-15
12,86,41,51,79,110,-31
12,86,41,67,53,33,20
12,86,42,3,138,78,60
12,86,42,11,68,51,17
12,86,42,17,57,46,11
12,86,42,29,74,52,22
12,86,42,41,0,45,-45
12,86,42,43,46,43,3
12,86,42,45,59,70,-11
12,86,42,69,31,0,31
12,86,42,71,89,70,19
12,86,42,77,80,65,15
12,86,42,79,32,31,1
12,86,42,89,40,0,40
12,86,42,91,146,100,46
12,86,42,95,27,0,27
12,86,42,101,326,355,-29
12,86,42,129,24,0,24
12,86,42,133,29,33,-4
12,86,44,5,23,0,23
12,86,44,7,184,176,8
12,86,45,7,0,47,-47
12,86,45,13,212,143,69
12,86,45,15,0,74,-74
12,86,45,19,123,115,8
12,86,45,35,43,71,-28
12,86,45,45,107,403,-296
12,86,45,51,73,88,-15
12,86,45,63,0,101,-101
12,86,45,77,0,45,-45
12,86,45,79,72,196,-124
12,86,45,83,0,102,-102
12,86,45,91,25,100,-75
12,86,47,37,146,190,-44
12,86,47,65,0,74,-74
12,86,47,93,65,90,-25
12,86,47,119,0,35,-35
12,86,47,125,54,83,-29
12,86,47,141,0,33,-33
12,86,47,149,34,67,-33
12,86,47,155,0,59,-59
12,86,47,157,138,150,-12
12,86,47,179,0,37,-37
12,86,47,187,0,62,-62
12,86,48,27,122,143,-21
12,86,48,29,243,421,-178
12,86,48,39,0,62,-62
12,86,48,61,51,133,-82
12,86,48,85,68,242,-174
12,86,48,113,351,511,-160
12,86,48,121,108,163,-55
12,86,48,141,126,112,14
12,86,48,157,81,237,-156
12,86,48,167,25,77,-52
12,86,48,201,630,1663,-1033
12,86,48,209,0,30,-30
12,86,48,215,41,189,-148
12,86,48,245,0,44,-44
12,86,48,339,70,173,-103
12,86,48,355,28,34,-6
12,86,48,439,210,497,-287
12,86,48,453,188,340,-152
12,86,48,479,0,34,-34
12,86,48,491,41,144,-103
12,86,49,35,106,116,-10
12,86,49,49,0,52,-52
12,86,50,7,29,38,-9
12,86,51,3,0,29,-29
12,86,51,13,131,183,-52
12,86,51,17,22,0,22
12,86,51,41,0,79,-79
12,86,51,59,442,456,-14
12,86,51,87,42,73,-31
12,86,51,107,121,125,-4
12,86,51,153,100,113,-13
12,86,51,179,0,35,-35
12,86,51,510,90,112,-22
12,86,51,550,45,34,11
12,86,51,650,54,25,29
12,86,51,700,54,51,3
12,86,51,710,83,79,4
12,86,51,740,32,24,8
12,86,51,760,38,34,4
12,86,51,770,0,34,-34
12,86,51,810,123,146,-23
12,86,53,33,204,326,-122
12,86,53,53,76,110,-34
12,86,53,61,39,78,-39
12,86,53,67,0,35,-35
12,86,53,73,0,29,-29
12,86,55,25,38,49,-11
12,86,55,79,81,75,6
12,87,4,13,0,31,-31
12,87,6,37,44,23,21
12,87,6,73,59,56,3
12,87,8,41,0,33,-33
12,87,9,1,25,0,25
12,87,12,1,42,58,-16
12,87,12,5,28,0,28
12,87,12,9,103,140,-37
12,87,12,11,336,383,-47
12,87,12,15,0,45,-45
12,87,12,17,27,42,-15
12,87,12,19,52,34,18
12,87,12,21,59,76,-17
12,87,12,23,0,33,-33
12,87,12,31,127,167,-40
12,87,12,33,29,61,-32
12,87,12,53,53,48,5
12,87,12,55,34,54,-20
12,87,12,57,186,152,34
12,87,12,61,49,41,8
12,87,12,69,37,52,-15
12,87,12,71,277,160,117
12,87,12,73,37,44,-7
12,87,12,81,35,78,-43
12,87,12,83,52,124,-72
12,87,12,85,26,49,-23
12,87,12,86,871,1032,-161
12,87,12,91,0,31,-31
12,87,12,95,129,164,-35
12,87,12,97,42,35,7
12,87,12,99,201,226,-25
12,87,12,101,48,74,-26
12,87,12,103,85,153,-68
12,87,12,105,48,87,-39
12,87,12,109,34,49,-15
12,87,12,111,37,83,-46
12,87,12,115,44,65,-21
12,87,12,117,37,44,-7
12,87,12,127,64,121,-57
12,87,13,51,0,33,-33
12,87,13,121,0,29,-29
12,87,15,3,0,31,-31
12,87,17,31,52,75,-23
12,87,22,71,0,30,-30
12,87,23,5,27,0,27
12,87,24,3,45,0,45
12,87,24,5,25,0,25
12,87,24,31,26,0,26
12,87,25,1,38,0,38
12,87,25,9,22,0,22
12,87,26,81,32,0,32
12,87,26,125,32,0,32
12,87,27,53,27,0,27
12,87,28,47,0,37,-37
12,87,32,3,27,33,-6
12,87,34,1,33,0,33
12,87,34,29,47,0,47
12,87,36,29,26,0,26
12,87,36,59,28,0,28
12,87,36,61,0,24,-24
12,87,36,103,46,0,46
12,87,37,21,0,34,-34
12,87,37,51,33,0,33
12,87,42,3,31,30,1
12,87,42,17,28,0,28
12,87,45,19,26,32,-6
12,87,45,51,0,33,-33
12,87,48,201,36,34,2
12,87,48,453,0,24,-24
12,87,51,59,0,54,-54
12,87,51,710,42,42,0
12,87,51,810,90,89,1
12,87,53,33,0,25,-25
12,89,6,73,0,32,-32
12,89,12,1,37,60,-23
12,89,12,3,58,47,11
12,89,12,9,41,0,41
12,89,12,11,52,0,52
12,89,12,19,196,122,74
12,89,12,23,0,38,-38
12,89,12,31,2562,1971,591
12,89,12,57,28,27,1
12,89,12,71,42,0,42
12,89,12,73,39,0,39
12,89,12,86,82,26,56
12,89,12,95,66,73,-7
12,89,12,99,59,36,23
12,89,12,103,36,27,9
12,89,12,105,46,0,46
12,89,12,107,0,36,-36
12,89,12,109,95,106,-11
12,89,12,117,27,0,27
12,89,12,127,51,0,51
12,89,13,39,322,339,-17
12,89,13,49,76,141,-65
12,89,13,51,0,27,-27
12,89,13,67,0,29,-29
12,89,13,89,34,0,34
12,89,13,121,59,35,24
12,89,13,127,55,30,25
12,89,13,135,39,0,39
12,89,13,299,41,46,-5
12,89,24,31,35,0,35
12,89,45,19,0,33,-33
12,89,51,810,34,0,34
12,91,1,1,0,44,-44
12,91,1,3,82,70,12
12,91,1,31,37,38,-1
12,91,1,39,167,171,-4
12,91,1,45,0,32,-32
12,91,1,51,0,42,-42
12,91,1,53,29,0,29
12,91,1,69,37,58,-21
12,91,1,73,74,108,-34
12,91,1,81,36,36,0
12,91,1,89,65,196,-131
12,91,1,95,0,38,-38
12,91,1,97,115,180,-65
12,91,1,101,158,95,63
12,91,1,103,0,32,-32
12,91,1,117,0,86,-86
12,91,1,125,29,0,29
12,91,2,20,161,148,13
12,91,2,90,85,61,24
12,91,4,13,132,161,-29
12,91,4,19,72,103,-31
12,91,5,119,52,78,-26
12,91,6,29,70,52,18
12,91,6,37,87,123,-36
12,91,6,53,36,65,-29
12,91,6,59,42,38,4
12,91,6,65,56,0,56
12,91,6,67,29,0,29
12,91,6,71,61,53,8
12,91,6,73,153,181,-28
12,91,6,83,41,0,41
12,91,6,95,63,44,19
12,91,8,5,0,64,-64
12,91,8,31,0,32,-32
12,91,8,41,208,172,36
12,91,8,59,0,32,-32
12,91,10,1,0,30,-30
12,91,12,1,78,104,-26
12,91,12,5,294,368,-74
12,91,12,9,128,124,4
12,91,12,11,114,95,19
12,91,12,19,0,52,-52
12,91,12,21,47,26,21
12,91,12,31,153,158,-5
12,91,12,33,509,715,-206
12,91,12,57,197,268,-71
12,91,12,59,46,53,-7
12,91,12,63,0,50,-50
12,91,12,69,36,41,-5
12,91,12,71,51,47,4
12,91,12,73,185,236,-51
12,91,12,81,26,0,26
12,91,12,83,55,46,9
12,91,12,86,53,131,-78
12,91,12,87,31,0,31
12,91,12,95,187,212,-25
12,91,12,97,0,33,-33
12,91,12,99,61,60,1
12,91,12,101,55,60,-5
12,91,12,103,95,92,3
12,91,12,105,63,45,18
12,91,12,109,0,38,-38
12,91,12,111,42,43,-1
12,91,12,113,1568,2571,-1003
12,91,12,115,0,34,-34
12,91,12,117,81,56,25
12,91,12,127,67,51,16
12,91,12,131,1159,1829,-670
12,91,12,133,0,51,-51
12,91,13,51,0,50,-50
12,91,13,57,38,0,38
12,91,13,63,0,31,-31
12,91,13,67,76,58,18
12,91,13,77,0,41,-41
12,91,13,89,38,65,-27
12,91,13,121,72,123,-51
12,91,13,135,64,95,-31
12,91,13,153,136,103,33
12,91,13,179,50,55,-5
12,91,13,185,50,37,13
12,91,13,215,55,55,0
12,91,15,3,190,125,65
12,91,16,39,35,38,-3
12,91,17,31,33,64,-31
12,91,17,163,52,84,-32
12,91,18,97,46,38,8
12,91,20,61,0,38,-38
12,91,20,173,0,43,-43
12,91,21,47,68,44,24
12,91,21,67,0,35,-35
12,91,22,15,0,61,-61
12,91,22,17,31,0,31
12,91,22,33,31,49,-18
12,91,22,51,48,28,20
12,91,22,71,0,44,-44
12,91,22,103,37,57,-20
12,91,24,3,48,0,48
12,91,24,33,37,47,-10
12,91,25,17,0,47,-47
12,91,26,125,42,0,42
12,91,26,163,0,29,-29
12,91,28,47,67,106,-39
12,91,28,59,60,81,-21
12,91,28,87,0,39,-39
12,91,28,121,0,31,-31
12,91,29,189,0,28,-28
12,91,30,13,42,0,42
12,91,31,153,55,36,19
12,91,32,3,157,232,-75
12,91,34,5,48,33,15
12,91,35,1,165,117,48
12,91,35,9,135,113,22
12,91,35,35,39,0,39
12,91,36,45,33,59,-26
12,91,37,51,150,164,-14
12,91,37,85,57,40,17
12,91,37,119,37,43,-6
12,91,37,133,67,97,-30
12,91,37,183,0,26,-26
12,91,37,191,59,32,27
12,91,39,35,32,0,32
12,91,39,49,33,21,12
12,91,39,57,104,89,15
12,91,39,61,27,0,27
12,91,39,113,83,79,4
12,91,39,151,29,0,29
12,91,40,27,0,30,-30
12,91,40,47,0,29,-29
12,91,40,109,41,67,-26
12,91,40,143,38,40,-2
12,91,42,3,24,26,-2
12,91,42,41,41,0,41
12,91,45,15,0,36,-36
12,91,45,19,0,50,-50
12,91,45,35,40,0,40
12,91,45,45,0,30,-30
12,91,45,79,0,49,-49
12,91,45,85,48,33,15
12,91,47,37,35,86,-51
12,91,47,65,31,33,-2
12,91,47,93,0,38,-38
12,91,47,125,117,51,66
12,91,47,149,0,35,-35
12,91,47,157,54,58,-4
12,91,48,27,83,100,-17
12,91,48,29,274,253,21
12,91,48,85,0,39,-39
12,91,48,113,55,60,-5
12,91,48,121,0,37,-37
12,91,48,141,38,34,4
12,91,48,167,0,22,-22
12,91,48,201,71,153,-82
12,91,48,355,32,46,-14
12,91,48,409,30,0,30
12,91,48,439,97,89,8
12,91,48,441,50,0,50
12,91,48,451,54,0,54
12,91,48,453,28,34,-6
12,91,48,485,140,55,85
12,91,49,11,31,92,-61
12,91,51,13,0,30,-30
12,91,51,59,112,122,-10
12,91,51,107,0,43,-43
12,91,51,153,63,61,2
12,91,51,199,51,0,51
12,91,51,650,42,51,-9
12,91,51,700,40,52,-12
12,91,51,710,0,25,-25
12,91,51,810,74,54,20
12,91,53,33,0,36,-36
12,91,53,53,60,99,-39
12,91,53,63,0,44,-44
12,93,12,9,43,35,8
12,93,12,11,100,34,66
12,93,12,43,91,82,9
12,93,12,51,55,0,55
12,93,12,55,111,258,-147
12,93,12,57,0,30,-30
12,93,12,61,47,45,2
12,93,12,71,54,38,16
12,93,12,85,133,91,42
12,93,12,86,92,38,54
12,93,12,95,35,31,4
12,93,12,99,346,229,117
12,93,12,105,52,43,9
12,93,12,111,244,235,9
12,95,1,3,25,57,-32
12,95,1,31,0,31,-31
12,95,1,69,0,47,-47
12,95,1,73,106,102,4
12,95,1,81,29,30,-1
12,95,1,89,74,138,-64
12,95,1,97,68,57,11
12,95,1,101,41,33,8
12,95,1,117,60,72,-12
12,95,2,20,92,48,44
12,95,4,3,0,25,-25
12,95,4,13,337,416,-79
12,95,4,19,56,99,-43
12,95,4,21,0,62,-62
12,95,5,7,0,31,-31
12,95,5,119,44,0,44
12,95,5,143,32,0,32
12,95,6,1,67,83,-16
12,95,6,13,54,69,-15
12,95,6,19,0,32,-32
12,95,6,29,42,0,42
12,95,6,37,541,936,-395
12,95,6,53,0,33,-33
12,95,6,59,237,279,-42
12,95,6,61,0,35,-35
12,95,6,65,109,107,2
12,95,6,67,67,103,-36
12,95,6,71,104,106,-2
12,95,6,73,327,266,61
12,95,6,75,24,137,-113
12,95,6,81,37,77,-40
12,95,6,83,43,32,11
12,95,6,85,73,133,-60
12,95,6,95,34,34,0
12,95,6,111,28,70,-42
12,95,8,1,31,60,-29
12,95,8,5,78,129,-51
12,95,8,13,35,65,-30
12,95,8,14,0,25,-25
12,95,8,31,82,104,-22
12,95,8,35,36,96,-60
12,95,8,41,78,130,-52
12,95,8,59,50,48,2
12,95,8,69,25,43,-18
12,95,9,1,206,163,43
12,95,9,3,327,244,83
12,95,9,5,29,0,29
12,95,9,7,35,27,8
12,95,9,9,268,177,91
12,95,9,11,53,57,-4
12,95,10,3,76,72,4
12,95,10,5,31,29,2
12,95,11,1,93,108,-15
12,95,12,1,787,619,168
12,95,12,5,158,113,45
12,95,12,9,2332,2738,-406
12,95,12,11,3378,2357,1021
12,95,12,15,200,157,43
12,95,12,17,208,232,-24
12,95,12,19,274,207,67
12,95,12,21,378,319,59
12,95,12,23,60,86,-26
12,95,12,27,35,0,35
12,95,12,29,0,27,-27
12,95,12,31,1343,1236,107
12,95,12,33,233,229,4
12,95,12,35,232,191,41
12,95,12,39,49,50,-1
12,95,12,51,60,37,23
12,95,12,53,195,230,-35
12,95,12,55,219,186,33
12,95,12,57,2034,2415,-381
12,95,12,61,318,278,40
12,95,12,63,0,29,-29
12,95,12,69,4704,7068,-2364
12,95,12,71,917,769,148
12,95,12,73,878,629,249
12,95,12,75,55,54,1
12,95,12,79,0,34,-34
12,95,12,81,413,365,48
12,95,12,83,667,861,-194
12,95,12,85,197,157,40
12,95,12,86,3250,2389,861
12,95,12,87,164,129,35
12,95,12,89,73,66,7
12,95,12,91,212,187,25
12,95,12,93,31,35,-4
12,95,12,97,10765,13023,-2258
12,95,12,99,2025,1522,503
12,95,12,101,431,532,-101
12,95,12,103,1234,1160,74
12,95,12,105,3729,5023,-1294
12,95,12,107,126,140,-14
12,95,12,109,216,303,-87
12,95,12,111,629,402,227
12,95,12,113,149,107,42
12,95,12,115,440,448,-8
12,95,12,117,15861,18201,-2340
12,95,12,119,115,220,-105
12,95,12,121,37,70,-33
12,95,12,123,30,0,30
12,95,12,127,2417,2958,-541
12,95,12,129,0,35,-35
12,95,12,131,44,51,-7
12,95,13,13,0,36,-36
12,95,13,15,0,60,-60
12,95,13,21,45,39,6
12,95,13,39,45,0,45
12,95,13,45,26,0,26
12,95,13,51,121,172,-51
12,95,13,57,70,172,-102
12,95,13,59,44,33,11
12,95,13,63,90,193,-103
12,95,13,67,379,509,-130
12,95,13,73,28,41,-13
12,95,13,77,45,49,-4
12,95,13,89,259,487,-228
12,95,13,95,32,0,32
12,95,13,97,37,152,-115
12,95,13,113,38,48,-10
12,95,13,117,47,134,-87
12,95,13,121,432,698,-266
12,95,13,127,32,51,-19
12,95,13,135,287,545,-258
12,95,13,139,33,84,-51
12,95,13,151,100,168,-68
12,95,13,153,53,78,-25
12,95,13,179,79,59,20
12,95,13,185,102,78,24
12,95,13,215,67,88,-21
12,95,13,217,0,50,-50
12,95,13,223,58,116,-58
12,95,13,245,79,87,-8
12,95,13,247,0,29,-29
12,95,13,275,0,30,-30
12,95,13,291,0,41,-41
12,95,13,313,43,0,43
12,95,15,1,27,0,27
12,95,15,3,163,127,36
12,95,15,9,34,36,-2
12,95,16,1,24,50,-26
12,95,17,19,0,36,-36
12,95,17,31,631,803,-172
12,95,17,43,162,201,-39
12,95,17,89,84,46,38
12,95,17,97,86,72,14
12,95,17,111,31,0,31
12,95,17,115,0,36,-36
12,95,17,161,25,0,25
12,95,17,167,0,30,-30
12,95,17,197,73,56,17
12,95,17,201,31,25,6
12,95,18,3,50,31,19
12,95,18,57,83,52,31
12,95,18,89,56,55,1
12,95,18,91,0,32,-32
12,95,18,97,161,140,21
12,95,18,141,41,38,3
12,95,18,157,32,0,32
12,95,19,153,40,33,7
12,95,19,163,32,30,2
12,95,20,91,83,91,-8
12,95,20,173,61,41,20
12,95,21,15,41,30,11
12,95,21,67,91,51,40
12,95,21,111,117,153,-36
12,95,22,33,51,59,-8
12,95,22,51,83,133,-50
12,95,22,71,35,114,-79
12,95,22,103,0,85,-85
12,95,23,5,45,43,2
12,95,23,19,29,29,0
12,95,23,31,37,0,37
12,95,24,3,106,105,1
12,95,24,5,119,120,-1
12,95,24,17,31,35,-4
12,95,24,21,42,44,-2
12,95,24,25,31,49,-18
12,95,24,27,69,44,25
12,95,24,31,247,233,14
12,95,24,33,155,131,24
12,95,24,37,26,0,26
12,95,24,43,0,27,-27
12,95,24,47,25,0,25
12,95,24,510,74,46,28
12,95,25,1,38,47,-9
12,95,25,5,129,86,43
12,95,25,9,277,233,44
12,95,25,13,199,187,12
12,95,25,17,261,286,-25
12,95,25,21,74,94,-20
12,95,25,23,97,50,47
12,95,25,25,262,193,69
12,95,25,27,185,158,27
12,95,26,21,46,47,-1
12,95,26,45,30,0,30
12,95,26,49,80,0,80
12,95,26,65,66,52,14
12,95,26,77,46,0,46
12,95,26,81,81,71,10
12,95,26,93,53,0,53
12,95,26,99,148,81,67
12,95,26,125,252,133,119
12,95,26,139,21,0,21
12,95,26,145,39,0,39
12,95,26,147,20,0,20
12,95,26,161,78,32,46
12,95,26,163,331,129,202
12,95,27,3,0,31,-31
12,95,27,37,52,22,30
12,95,27,53,127,169,-42
12,95,27,123,44,41,3
12,95,28,33,27,0,27
12,95,28,47,42,75,-33
12,95,28,59,31,54,-23
12,95,28,67,0,29,-29
12,95,29,19,25,0,25
12,95,29,77,67,42,25
12,95,29,95,74,63,11
12,95,29,183,52,36,16
12,95,29,189,171,100,71
12,95,29,213,0,31,-31
12,95,29,510,34,40,-6
12,95,31,55,72,34,38
12,95,31,109,39,24,15
12,95,32,3,414,678,-264
12,95,32,31,46,34,12
12,95,33,11,137,70,67
12,95,33,13,30,0,30
12,95,33,15,49,47,2
12,95,33,17,0,25,-25
12,95,34,1,114,67,47
12,95,34,3,238,166,72
12,95,34,5,88,47,41
12,95,34,7,157,121,36
12,95,34,9,23,0,23
12,95,34,11,31,36,-5
12,95,34,13,323,207,116
12,95,34,15,51,0,51
12,95,34,17,310,235,75
12,95,34,21,59,32,27
12,95,34,23,263,179,84
12,95,34,25,157,80,77
12,95,34,27,128,57,71
12,95,34,29,123,57,66
12,95,34,31,233,163,70
12,95,34,33,28,0,28
12,95,34,35,55,35,20
12,95,34,39,210,132,78
12,95,35,1,77,73,4
12,95,36,1,71,57,14
12,95,36,5,1158,730,428
12,95,36,7,43,26,17
12,95,36,13,28,36,-8
12,95,36,15,0,36,-36
12,95,36,27,52,48,4
12,95,36,29,199,197,2
12,95,36,45,55,53,2
12,95,36,47,835,593,242
12,95,36,55,173,178,-5
12,95,36,57,24,0,24
12,95,36,59,326,226,100
12,95,36,61,519,623,-104
12,95,36,63,35,31,4
12,95,36,65,26,34,-8
12,95,36,67,95,98,-3
12,95,36,69,28,0,28
12,95,36,71,89,79,10
12,95,36,81,1273,852,421
12,95,36,83,29,0,29
12,95,36,85,110,64,46
12,95,36,87,67,36,31
12,95,36,91,37,45,-8
12,95,36,93,38,31,7
12,95,36,103,411,373,38
12,95,36,105,39,0,39
12,95,36,111,37,46,-9
12,95,36,119,309,147,162
12,95,37,1,0,55,-55
12,95,37,21,49,136,-87
12,95,37,25,0,64,-64
12,95,37,35,0,31,-31
12,95,37,49,33,32,1
12,95,37,51,98,156,-58
12,95,37,63,73,78,-5
12,95,37,67,55,127,-72
12,95,37,71,0,101,-101
12,95,37,81,99,148,-49
12,95,37,85,0,36,-36
12,95,37,87,0,60,-60
12,95,37,89,22,69,-47
12,95,37,97,0,56,-56
12,95,37,101,0,67,-67
12,95,37,109,0,43,-43
12,95,37,113,29,36,-7
12,95,37,119,329,689,-360
12,95,37,125,0,31,-31
12,95,37,129,37,52,-15
12,95,37,133,127,100,27
12,95,37,135,0,32,-32
12,95,37,147,0,38,-38
12,95,37,179,59,94,-35
12,95,37,183,287,456,-169
12,95,39,17,68,53,15
12,95,39,35,319,191,128
12,95,39,41,33,33,0
12,95,39,43,30,0,30
12,95,39,45,0,37,-37
12,95,39,49,219,182,37
12,95,39,57,0,34,-34
12,95,39,61,98,85,13
12,95,39,89,0,23,-23
12,95,39,93,48,53,-5
12,95,39,95,45,25,20
12,95,39,99,44,43,1
12,95,39,113,98,88,10
12,95,39,151,45,31,14
12,95,39,153,103,47,56
12,95,39,155,37,0,37
12,95,39,165,34,0,34
12,95,40,27,27,24,3
12,95,40,31,47,0,47
12,95,40,109,55,49,6
12,95,40,143,66,86,-20
12,95,41,5,0,58,-58
12,95,41,51,47,102,-55
12,95,41,67,35,60,-25
12,95,42,3,215,139,76
12,95,42,11,118,94,24
12,95,42,17,107,80,27
12,95,42,19,23,0,23
12,95,42,29,67,60,7
12,95,42,41,35,38,-3
12,95,42,43,53,75,-22
12,95,42,45,74,44,30
12,95,42,49,61,36,25
12,95,42,71,66,65,1
12,95,42,77,118,82,36
12,95,42,79,51,40,11
12,95,42,89,58,41,17
12,95,42,91,94,88,6
12,95,42,95,66,42,24
12,95,42,101,292,295,-3
12,95,42,129,37,40,-3
12,95,42,133,73,55,18
12,95,44,3,30,0,30
12,95,44,5,0,31,-31
12,95,44,7,210,162,48
12,95,45,3,44,0,44
12,95,45,7,0,79,-79
12,95,45,13,67,77,-10
12,95,45,15,53,65,-12
12,95,45,19,65,129,-64
12,95,45,35,32,50,-18
12,95,45,45,94,232,-138
12,95,45,51,87,115,-28
12,95,45,63,47,63,-16
12,95,45,77,0,31,-31
12,95,45,79,83,117,-34
12,95,45,83,58,73,-15
12,95,45,91,50,127,-77
12,95,46,99,22,0,22
12,95,47,9,0,79,-79
12,95,47,35,0,32,-32
12,95,47,37,209,241,-32
12,95,47,59,0,38,-38
12,95,47,65,59,172,-113
12,95,47,93,77,127,-50
12,95,47,125,31,45,-14
12,95,47,149,42,84,-42
12,95,47,155,26,64,-38
12,95,47,157,189,183,6
12,95,47,163,0,33,-33
12,95,47,165,31,35,-4
12,95,47,179,31,39,-8
12,95,47,187,53,93,-40
12,95,48,27,96,126,-30
12,95,48,29,162,278,-116
12,95,48,39,0,50,-50
12,95,48,41,0,34,-34
12,95,48,61,29,35,-6
12,95,48,85,87,238,-151
12,95,48,99,0,28,-28
12,95,48,113,253,367,-114
12,95,48,121,94,140,-46
12,95,48,141,82,57,25
12,95,48,157,43,113,-70
12,95,48,167,34,28,6
12,95,48,201,330,674,-344
12,95,48,215,40,71,-31
12,95,48,245,26,35,-9
12,95,48,339,31,88,-57
12,95,48,355,0,33,-33
12,95,48,439,177,338,-161
12,95,48,453,86,275,-189
12,95,48,491,37,106,-69
12,95,49,11,0,60,-60
12,95,49,35,81,169,-88
12,95,49,49,42,38,4
12,95,50,7,33,0,33
12,95,51,13,68,74,-6
12,95,51,41,57,48,9
12,95,51,59,243,386,-143
12,95,51,87,67,69,-2
12,95,51,95,0,40,-40
12,95,51,107,111,130,-19
12,95,51,121,23,0,23
12,95,51,153,116,138,-22
12,95,51,177,0,33,-33
12,95,51,179,27,31,-4
12,95,51,510,52,66,-14
12,95,51,550,48,0,48
12,95,51,650,43,26,17
12,95,51,680,27,0,27
12,95,51,700,80,69,11
12,95,51,710,50,76,-26
12,95,51,760,40,31,9
12,95,51,810,168,142,26
12,95,53,11,28,38,-10
12,95,53,33,217,277,-60
12,95,53,53,104,81,23
12,95,53,61,48,60,-12
12,95,53,63,23,0,23
12,95,53,67,0,25,-25
12,95,54,39,29,40,-11
12,95,55,9,25,34,-9
12,95,55,25,72,57,15
12,95,55,79,137,93,44
12,95,55,133,39,41,-2
12,97,1,73,0,28,-28
12,97,4,13,71,97,-26
12,97,4,19,0,27,-27
12,97,6,37,100,123,-23
12,97,6,59,47,56,-9
12,97,6,65,34,34,0
12,97,6,71,0,37,-37
12,97,6,73,71,64,7
12,97,6,85,29,0,29
12,97,8,41,0,37,-37
12,97,9,1,95,64,31
12,97,9,3,143,107,36
12,97,9,9,95,56,39
12,97,9,11,49,0,49
12,97,12,1,102,110,-8
12,97,12,5,47,51,-4
12,97,12,9,476,466,10
12,97,12,11,913,606,307
12,97,12,15,0,27,-27
12,97,12,17,38,46,-8
12,97,12,19,47,71,-24
12,97,12,21,70,64,6
12,97,12,23,0,31,-31
12,97,12,31,231,233,-2
12,97,12,33,68,0,68
12,97,12,35,0,47,-47
12,97,12,53,63,58,5
12,97,12,55,102,57,45
12,97,12,57,447,476,-29
12,97,12,61,100,65,35
12,97,12,69,889,1116,-227
12,97,12,71,176,122,54
12,97,12,73,104,73,31
12,97,12,81,73,66,7
12,97,12,83,106,176,-70
12,97,12,86,1170,643,527
12,97,12,87,35,42,-7
12,97,12,91,33,0,33
12,97,12,95,13023,10765,2258
12,97,12,99,396,287,109
12,97,12,101,134,150,-16
12,97,12,103,194,222,-28
12,97,12,105,3358,3625,-267
12,97,12,107,0,28,-28
12,97,12,109,46,43,3
12,97,12,111,133,67,66
12,97,12,113,0,36,-36
12,97,12,115,96,82,14
12,97,12,117,854,878,-24
12,97,12,119,26,43,-17
12,97,12,121,0,25,-25
12,97,12,127,303,314,-11
12,97,13,51,0,32,-32
12,97,13,57,0,41,-41
12,97,13,67,31,53,-22
12,97,13,89,57,34,23
12,97,13,121,45,64,-19
12,97,13,135,69,84,-15
12,97,15,3,58,25,33
12,97,17,31,192,166,26
12,97,17,43,38,0,38
12,97,17,197,0,28,-28
12,97,18,89,34,0,34
12,97,24,3,36,26,10
12,97,24,5,43,0,43
12,97,24,31,90,0,90
12,97,24,33,52,29,23
12,97,25,5,64,49,15
12,97,25,9,121,132,-11
12,97,25,13,76,81,-5
12,97,25,17,68,43,25
12,97,25,21,32,0,32
12,97,25,23,57,49,8
12,97,25,25,86,90,-4
12,97,25,27,104,34,70
12,97,26,81,36,36,0
12,97,26,99,35,0,35
12,97,26,125,56,0,56
12,97,26,163,87,27,60
12,97,32,3,113,109,4
12,97,33,11,44,0,44
12,97,33,15,37,0,37
12,97,34,1,33,33,0
12,97,34,3,72,68,4
12,97,34,7,67,0,67
12,97,34,13,115,41,74
12,97,34,15,29,0,29
12,97,34,17,142,100,42
12,97,34,21,45,0,45
12,97,34,23,159,72,87
12,97,34,25,58,0,58
12,97,34,27,47,25,22
12,97,34,29,36,0,36
12,97,34,31,126,85,41
12,97,34,39,131,69,62
12,97,36,5,646,353,293
12,97,36,29,38,52,-14
12,97,36,47,544,281,263
12,97,36,55,44,35,9
12,97,36,59,176,54,122
12,97,36,61,271,170,101
12,97,36,67,53,35,18
12,97,36,71,73,42,31
12,97,36,81,811,369,442
12,97,36,85,79,0,79
12,97,36,87,26,0,26
12,97,36,103,211,121,90
12,97,36,111,38,0,38
12,97,36,119,111,57,54
12,97,37,1,0,30,-30
12,97,37,51,49,0,49
12,97,37,67,0,49,-49
12,97,37,81,0,35,-35
12,97,37,119,84,162,-78
12,97,37,133,38,37,1
12,97,37,183,51,57,-6
12,97,39,35,116,53,63
12,97,39,49,59,38,21
12,97,39,93,0,45,-45
12,97,39,113,0,32,-32
12,97,39,153,32,0,32
12,97,42,3,74,0,74
12,97,42,11,33,58,-25
12,97,42,17,24,0,24
12,97,42,49,30,0,30
12,97,42,71,59,41,18
12,97,42,77,65,0,65
12,97,42,91,48,0,48
12,97,42,95,43,0,43
12,97,42,101,238,93,145
12,97,42,133,76,0,76
12,97,44,7,139,89,50
12,97,45,7,0,44,-44
12,97,45,13,41,0,41
12,97,45,45,0,49,-49
12,97,45,51,0,24,-24
12,97,45,79,0,31,-31
12,97,45,91,0,41,-41
12,97,47,37,0,37,-37
12,97,47,93,0,67,-67
12,97,47,123,0,39,-39
12,97,47,157,43,0,43
12,97,48,27,0,69,-69
12,97,48,29,0,95,-95
12,97,48,85,0,41,-41
12,97,48,113,52,88,-36
12,97,48,121,0,37,-37
12,97,48,141,39,38,1
12,97,48,157,0,32,-32
12,97,48,201,59,206,-147
12,97,48,439,46,99,-53
12,97,48,453,0,39,-39
12,97,48,491,0,39,-39
12,97,51,59,64,56,8
12,97,51,153,43,0,43
12,97,51,810,39,37,2
12,97,53,33,29,0,29
12,97,53,53,31,34,-3
12,99,1,3,29,40,-11
12,99,1,49,0,36,-36
12,99,1,73,65,100,-35
12,99,1,81,0,26,-26
12,99,1,89,48,124,-76
12,99,1,97,0,61,-61
12,99,1,101,0,48,-48
12,99,1,117,0,54,-54
12,99,2,20,0,37,-37
12,99,4,5,0,23,-23
12,99,4,13,216,438,-222
12,99,4,19,101,110,-9
12,99,4,21,0,42,-42
12,99,4,25,0,37,-37
12,99,5,7,0,47,-47
12,99,5,119,21,26,-5
12,99,6,1,95,97,-2
12,99,6,13,45,66,-21
12,99,6,19,0,24,-24
12,99,6,37,475,594,-119
12,99,6,41,28,25,3
12,99,6,59,140,224,-84
12,99,6,65,79,107,-28
12,99,6,67,53,72,-19
12,99,6,71,46,59,-13
12,99,6,73,261,337,-76
12,99,6,75,38,79,-41
12,99,6,81,36,34,2
12,99,6,85,77,151,-74
12,99,6,97,0,33,-33
12,99,6,111,0,51,-51
12,99,8,5,89,67,22
12,99,8,13,28,49,-21
12,99,8,31,53,123,-70
12,99,8,35,0,75,-75
12,99,8,41,85,105,-20
12,99,8,59,40,70,-30
12,99,8,69,31,44,-13
12,99,8,97,0,22,-22
12,99,9,1,468,315,153
12,99,9,3,362,180,182
12,99,9,5,47,34,13
12,99,9,7,45,30,15
12,99,9,9,375,141,234
12,99,9,11,100,42,58
12,99,9,13,37,28,9
12,99,10,1,0,33,-33
12,99,10,3,104,115,-11
12,99,10,5,49,55,-6
12,99,11,1,78,159,-81
12,99,12,1,429,486,-57
12,99,12,5,64,97,-33
12,99,12,9,636,1039,-403
12,99,12,11,16731,11359,5372
12,99,12,15,91,153,-62
12,99,12,17,88,189,-101
12,99,12,19,104,225,-121
12,99,12,21,359,320,39
12,99,12,23,86,201,-115
12,99,12,31,573,821,-248
12,99,12,33,79,113,-34
12,99,12,35,115,203,-88
12,99,12,39,28,37,-9
12,99,12,41,0,35,-35
12,99,12,43,39,47,-8
12,99,12,51,263,322,-59
12,99,12,53,103,107,-4
12,99,12,55,149,224,-75
12,99,12,57,968,1192,-224
12,99,12,61,394,647,-253
12,99,12,63,0,77,-77
12,99,12,69,244,425,-181
12,99,12,71,962,838,124
12,99,12,73,534,633,-99
12,99,12,75,24,132,-108
12,99,12,79,0,34,-34
12,99,12,81,205,256,-51
12,99,12,83,357,720,-363
12,99,12,85,1528,2527,-999
12,99,12,86,4853,3573,1280
12,99,12,87,226,201,25
12,99,12,89,36,59,-23
12,99,12,91,60,61,-1
12,99,12,93,229,346,-117
12,99,12,95,1522,2025,-503
12,99,12,97,287,396,-109
12,99,12,101,230,353,-123
12,99,12,103,517,451,66
12,99,12,105,395,729,-334
12,99,12,107,44,70,-26
12,99,12,109,161,338,-177
12,99,12,111,2462,4779,-2317
12,99,12,113,50,57,-7
12,99,12,115,303,300,3
12,99,12,117,498,560,-62
12,99,12,119,36,178,-142
12,99,12,121,0,39,-39
12,99,12,127,387,489,-102
12,99,13,13,0,35,-35
12,99,13,21,37,31,6
12,99,13,31,0,27,-27
12,99,13,51,74,139,-65
12,99,13,57,86,230,-144
12,99,13,59,27,30,-3
12,99,13,63,76,127,-51
12,99,13,67,252,454,-202
12,99,13,71,0,48,-48
12,99,13,77,0,72,-72
12,99,13,89,200,363,-163
12,99,13,95,0,32,-32
12,99,13,97,47,83,-36
12,99,13,113,34,39,-5
12,99,13,117,66,212,-146
12,99,13,121,384,680,-296
12,99,13,123,0,47,-47
12,99,13,127,0,49,-49
12,99,13,135,221,519,-298
12,99,13,139,0,70,-70
12,99,13,151,53,197,-144
12,99,13,153,35,73,-38
12,99,13,179,0,30,-30
12,99,13,185,33,55,-22
12,99,13,215,0,37,-37
12,99,13,217,0,73,-73
12,99,13,223,57,127,-70
12,99,13,245,50,76,-26
12,99,13,247,0,70,-70
12,99,13,277,0,25,-25
12,99,13,291,0,53,-53
12,99,13,311,0,30,-30
12,99,15,3,73,107,-34
12,99,15,9,0,21,-21
12,99,17,19,34,0,34
12,99,17,31,689,578,111
12,99,17,43,129,105,24
12,99,17,89,54,63,-9
12,99,17,97,190,68,122
12,99,17,111,27,0,27
12,99,17,197,57,31,26
12,99,17,201,23,0,23
12,99,18,3,43,29,14
12,99,18,57,49,45,4
12,99,18,89,62,26,36
12,99,18,97,106,106,0
12,99,18,127,0,39,-39
12,99,18,141,25,65,-40
12,99,18,163,21,0,21
12,99,19,153,0,39,-39
12,99,19,163,0,34,-34
12,99,20,91,80,68,12
12,99,21,67,48,73,-25
12,99,21,111,116,107,9
12,99,22,33,30,32,-2
12,99,22,51,33,47,-14
12,99,22,55,30,0,30
12,99,22,71,0,69,-69
12,99,22,103,30,0,30
12,99,23,5,50,41,9
12,99,23,11,24,0,24
12,99,23,19,40,0,40
12,99,23,31,78,38,40
12,99,24,3,121,135,-14
12,99,24,5,214,122,92
12,99,24,13,36,0,36
12,99,24,21,30,32,-2
12,99,24,25,48,0,48
12,99,24,27,71,53,18
12,99,24,31,391,263,128
12,99,24,33,133,48,85
12,99,24,510,77,56,21
12,99,25,1,174,84,90
12,99,25,3,54,57,-3
12,99,25,5,121,95,26
12,99,25,9,237,263,-26
12,99,25,13,109,108,1
12,99,25,15,28,0,28
12,99,25,17,465,377,88
12,99,25,21,219,180,39
12,99,25,23,107,142,-35
12,99,25,25,223,161,62
12,99,25,27,221,110,111
12,99,26,49,75,26,49
12,99,26,77,40,0,40
12,99,26,81,61,49,12
12,99,26,93,23,0,23
12,99,26,99,146,55,91
12,99,26,125,365,163,202
12,99,26,139,30,0,30
12,99,26,147,30,0,30
12,99,26,161,75,64,11
12,99,26,163,226,73,153
12,99,27,37,25,29,-4
12,99,27,53,97,104,-7
12,99,27,123,26,30,-4
12,99,28,35,0,31,-31
12,99,29,95,47,30,17
12,99,29,183,49,0,49
12,99,29,189,121,77,44
12,99,29,510,22,28,-6
12,99,31,55,33,44,-11
12,99,32,3,243,377,-134
12,99,32,31,31,36,-5
12,99,33,9,27,0,27
12,99,33,11,78,94,-16
12,99,33,13,33,0,33
12,99,33,15,97,57,40
12,99,34,1,228,86,142
12,99,34,3,550,271,279
12,99,34,5,120,110,10
12,99,34,7,178,82,96
12,99,34,9,53,29,24
12,99,34,11,39,31,8
12,99,34,13,415,207,208
12,99,34,15,61,33,28
12,99,34,17,220,132,88
12,99,34,19,35,0,35
12,99,34,21,136,93,43
12,99,34,23,393,197,196
12,99,34,25,430,240,190
12,99,34,27,209,127,82
12,99,34,29,293,165,128
12,99,34,31,259,92,167
12,99,34,35,132,53,79
12,99,34,37,60,28,32
12,99,34,39,242,146,96
12,99,34,41,0,22,-22
12,99,35,1,38,56,-18
12,99,36,1,90,64,26
12,99,36,5,432,265,167
12,99,36,7,21,34,-13
12,99,36,19,34,0,34
12,99,36,27,116,74,42
12,99,36,29,205,141,64
12,99,36,45,0,47,-47
12,99,36,47,815,559,256
12,99,36,55,172,140,32
12,99,36,59,1440,520,920
12,99,36,61,820,743,77
12,99,36,63,33,0,33
12,99,36,65,48,45,3
12,99,36,67,136,112,24
12,99,36,69,0,35,-35
12,99,36,71,159,98,61
12,99,36,75,0,28,-28
12,99,36,79,36,0,36
12,99,36,81,926,611,315
12,99,36,83,27,0,27
12,99,36,85,209,115,94
12,99,36,87,259,110,149
12,99,36,91,61,63,-2
12,99,36,93,25,24,1
12,99,36,103,1107,552,555
12,99,36,105,62,27,35
12,99,36,111,56,28,28
12,99,36,119,631,333,298
12,99,37,1,0,35,-35
12,99,37,21,47,158,-111
12,99,37,25,0,64,-64
12,99,37,35,0,52,-52
12,99,37,37,0,31,-31
12,99,37,39,0,59,-59
12,99,37,51,80,99,-19
12,99,37,57,0,35,-35
12,99,37,63,66,86,-20
12,99,37,67,31,82,-51
12,99,37,71,0,46,-46
12,99,37,81,71,181,-110
12,99,37,87,0,38,-38
12,99,37,89,43,105,-62
12,99,37,97,0,92,-92
12,99,37,101,0,55,-55
12,99,37,109,0,59,-59
12,99,37,113,0,36,-36
12,99,37,119,323,726,-403
12,99,37,125,0,53,-53
12,99,37,129,42,68,-26
12,99,37,133,92,98,-6
12,99,37,135,0,35,-35
12,99,37,161,0,42,-42
12,99,37,175,0,34,-34
12,99,37,179,0,219,-219
12,99,37,183,144,550,-406
12,99,37,189,0,48,-48
12,99,39,17,0,46,-46
12,99,39,25,30,31,-1
12,99,39,35,316,150,166
12,99,39,45,0,26,-26
12,99,39,49,184,171,13
12,99,39,57,25,0,25
12,99,39,61,105,77,28
12,99,39,85,40,31,9
12,99,39,93,36,27,9
12,99,39,95,72,40,32
12,99,39,99,33,26,7
12,99,39,113,98,58,40
12,99,39,151,69,32,37
12,99,39,153,109,69,40
12,99,39,155,31,0,31
12,99,40,109,26,31,-5
12,99,40,143,22,39,-17
12,99,41,39,0,31,-31
12,99,41,51,28,43,-15
12,99,41,67,49,50,-1
12,99,42,3,241,185,56
12,99,42,11,74,35,39
12,99,42,17,142,105,37
12,99,42,29,135,111,24
12,99,42,41,34,0,34
12,99,42,43,39,33,6
12,99,42,45,108,79,29
12,99,42,49,47,23,24
12,99,42,69,39,46,-7
12,99,42,71,65,49,16
12,99,42,77,98,90,8
12,99,42,79,40,34,6
12,99,42,89,48,0,48
12,99,42,91,359,158,201
12,99,42,95,69,50,19
12,99,42,101,301,232,69
12,99,42,103,31,0,31
12,99,42,125,24,0,24
12,99,42,129,51,31,20
12,99,42,133,36,60,-24
12,99,44,3,71,30,41
12,99,44,5,29,40,-11
12,99,44,7,210,119,91
12,99,44,9,64,0,64
12,99,45,3,0,73,-73
12,99,45,7,0,132,-132
12,99,45,13,83,131,-48
12,99,45,15,0,35,-35
12,99,45,19,96,96,0
12,99,45,35,0,45,-45
12,99,45,45,77,399,-322
12,99,45,51,65,69,-4
12,99,45,63,0,57,-57
12,99,45,73,0,36,-36
12,99,45,79,57,134,-77
12,99,45,83,0,133,-133
12,99,45,91,36,192,-156
12,99,47,9,0,55,-55
12,99,47,11,0,56,-56
12,99,47,35,0,43,-43
12,99,47,37,98,179,-81
12,99,47,65,63,102,-39
12,99,47,93,57,126,-69
12,99,47,119,0,32,-32
12,99,47,125,0,46,-46
12,99,47,149,32,92,-60
12,99,47,155,0,37,-37
12,99,47,157,102,106,-4
12,99,47,165,0,40,-40
12,99,47,187,0,84,-84
12,99,47,189,0,31,-31
12,99,48,27,56,90,-34
12,99,48,29,133,164,-31
12,99,48,39,0,37,-37
12,99,48,61,41,126,-85
12,99,48,85,105,178,-73
12,99,48,113,221,343,-122
12,99,48,121,80,196,-116
12,99,48,141,34,51,-17
12,99,48,157,50,86,-36
12,99,48,167,0,33,-33
12,99,48,201,249,575,-326
12,99,48,215,59,128,-69
12,99,48,339,50,87,-37
12,99,48,439,128,204,-76
12,99,48,453,90,256,-166
12,99,48,491,0,106,-106
12,99,49,35,58,35,23
12,99,50,7,34,0,34
12,99,51,13,71,64,7
12,99,51,41,44,75,-31
12,99,51,59,225,194,31
12,99,51,87,49,63,-14
12,99,51,107,89,114,-25
12,99,51,153,83,71,12
12,99,51,510,65,59,6
12,99,51,550,0,34,-34
12,99,51,700,0,40,-40
12,99,51,710,54,57,-3
12,99,51,760,21,31,-10
12,99,51,810,115,113,2
12,99,53,33,116,157,-41
12,99,53,53,47,54,-7
12,99,53,61,0,28,-28
12,99,54,39,0,26,-26
12,99,55,25,32,27,5
12,99,55,79,79,57,22
12,99,55,133,34,43,-9
12,101,1,3,0,30,-30
12,101,1,89,0,36,-36
12,101,1,97,28,0,28
12,101,2,20,0,31,-31
12,101,4,13,121,158,-37
12,101,4,19,0,27,-27
12,101,6,1,0,23,-23
12,101,6,13,29,0,29
12,101,6,37,122,121,1
12,101,6,59,0,61,-61
12,101,6,71,42,41,1
12,101,6,73,98,73,25
12,101,8,1,0,41,-41
12,101,8,5,28,33,-5
12,101,8,41,49,78,-29
12,101,8,59,0,26,-26
12,101,9,1,100,56,44
12,101,9,3,89,88,1
12,101,9,9,103,41,62
12,101,9,11,26,0,26
12,101,9,13,32,0,32
12,101,10,3,38,0,38
12,101,12,1,192,147,45
12,101,12,5,34,49,-15
12,101,12,9,163,172,-9
12,101,12,11,569,283,286
12,101,12,15,118,62,56
12,101,12,17,262,492,-230
12,101,12,19,59,72,-13
12,101,12,21,152,66,86
12,101,12,23,61,35,26
12,101,12,29,0,38,-38
12,101,12,31,264,191,73
12,101,12,33,80,66,14
12,101,12,35,31,0,31
12,101,12,53,2254,3437,-1183
12,101,12,55,45,31,14
12,101,12,57,14128,7847,6281
12,101,12,61,0,37,-37
12,101,12,69,175,196,-21
12,101,12,71,254,240,14
12,101,12,73,167,132,35
12,101,12,75,36,58,-22
12,101,12,81,213,236,-23
12,101,12,83,186,252,-66
12,101,12,85,36,46,-10
12,101,12,86,475,249,226
12,101,12,87,74,48,26
12,101,12,91,60,55,5
12,101,12,95,532,431,101
12,101,12,97,150,134,16
12,101,12,99,353,230,123
12,101,12,103,7287,4933,2354
12,101,12,105,726,734,-8
12,101,12,107,45,0,45
12,101,12,109,46,59,-13
12,101,12,111,92,70,22
12,101,12,113,44,47,-3
12,101,12,115,132,215,-83
12,101,12,117,151,156,-5
12,101,12,119,153,205,-52
12,101,12,121,0,33,-33
12,101,12,127,236,127,109
12,101,13,51,24,33,-9
12,101,13,57,0,65,-65
12,101,13,67,60,91,-31
12,101,13,89,36,45,-9
12,101,13,117,0,30,-30
12,101,13,121,52,71,-19
12,101,13,135,105,141,-36
12,101,13,151,0,45,-45
12,101,13,153,0,57,-57
12,101,13,179,34,0,34
12,101,15,3,81,63,18
12,101,17,31,195,135,60
12,101,17,43,51,40,11
12,101,17,97,32,26,6
12,101,17,111,32,0,32
12,101,17,197,71,0,71
12,101,18,57,0,43,-43
12,101,18,89,30,0,30
12,101,18,97,73,68,5
12,101,18,141,29,0,29
12,101,21,15,29,0,29
12,101,21,67,0,35,-35
12,101,21,111,27,64,-37
12,101,22,51,0,33,-33
12,101,23,5,51,0,51
12,101,23,11,0,30,-30
12,101,23,19,30,52,-22
12,101,23,31,35,0,35
12,101,24,3,87,58,29
12,101,24,5,67,0,67
12,101,24,27,35,0,35
12,101,24,31,45,51,-6
12,101,24,33,44,0,44
12,101,25,1,34,0,34
12,101,25,5,82,45,37
12,101,25,9,67,45,22
12,101,25,13,50,42,8
12,101,25,17,116,56,60
12,101,25,21,43,44,-1
12,101,25,23,52,42,10
12,101,25,25,44,39,5
12,101,25,27,100,69,31
12,101,26,49,109,36,73
12,101,26,81,77,33,44
12,101,26,93,0,31,-31
12,101,26,99,101,48,53
12,101,26,115,26,0,26
12,101,26,125,130,111,19
12,101,26,147,50,0,50
12,101,26,161,32,0,32
12,101,26,163,186,92,94
12,101,29,189,58,0,58
12,101,32,3,137,125,12
12,101,33,5,27,0,27
12,101,33,11,68,52,16
12,101,33,15,56,59,-3
12,101,34,1,56,0,56
12,101,34,3,92,55,37
12,101,34,5,43,33,10
12,101,34,7,57,49,8
12,101,34,13,75,0,75
12,101,34,17,67,31,36
12,101,34,21,31,0,31
12,101,34,23,106,40,66
12,101,34,25,93,0,93
12,101,34,27,66,29,37
12,101,34,29,109,47,62
12,101,34,31,80,0,80
12,101,34,39,51,0,51
12,101,35,1,0,28,-28
12,101,36,1,33,30,3
12,101,36,5,154,46,108
12,101,36,7,34,0,34
12,101,36,11,32,0,32
12,101,36,13,0,31,-31
12,101,36,15,26,0,26
12,101,36,27,70,0,70
12,101,36,29,108,96,12
12,101,36,45,58,36,22
12,101,36,47,144,64,80
12,101,36,55,71,55,16
12,101,36,59,235,97,138
12,101,36,61,67,43,24
12,101,36,63,33,0,33
12,101,36,65,35,31,4
12,101,36,67,85,54,31
12,101,36,71,70,35,35
12,101,36,75,39,27,12
12,101,36,81,221,86,135
12,101,36,83,40,0,40
12,101,36,85,65,65,0
12,101,36,87,28,0,28
12,101,36,91,37,31,6
12,101,36,103,405,166,239
12,101,36,111,30,0,30
12,101,36,119,88,39,49
12,101,37,21,34,55,-21
12,101,37,35,0,33,-33
12,101,37,51,61,43,18
12,101,37,67,0,35,-35
12,101,37,71,0,33,-33
12,101,37,81,0,36,-36
12,101,37,89,0,39,-39
12,101,37,101,0,31,-31
12,101,37,119,74,143,-69
12,101,37,133,48,64,-16
12,101,37,179,0,41,-41
12,101,37,183,56,148,-92
12,101,39,17,39,37,2
12,101,39,35,101,46,55
12,101,39,49,59,88,-29
12,101,39,61,50,28,22
12,101,39,93,41,0,41
12,101,39,95,56,0,56
12,101,39,99,28,0,28
12,101,39,113,67,31,36
12,101,39,151,34,34,0
12,101,39,153,56,34,22
12,101,39,155,34,35,-1
12,101,40,109,47,44,3
12,101,42,3,74,74,0
12,101,42,11,33,0,33
12,101,42,13,33,0,33
12,101,42,17,51,36,15
12,101,42,29,40,0,40
12,101,42,43,31,0,31
12,101,42,45,29,0,29
12,101,42,71,30,0,30
12,101,42,77,51,0,51
12,101,42,89,46,0,46
12,101,42,91,68,0,68
12,101,42,95,39,0,39
12,101,42,101,48,35,13
12,101,42,129,0,48,-48
12,101,42,133,32,0,32
12,101,44,7,125,27,98
12,101,45,7,0,31,-31
12,101,45,13,33,34,-1
12,101,45,19,0,30,-30
12,101,45,45,0,80,-80
12,101,45,51,0,45,-45
12,101,45,63,0,46,-46
12,101,45,79,39,0,39
12,101,45,91,0,38,-38
12,101,47,9,0,42,-42
12,101,47,11,0,44,-44
12,101,47,35,0,41,-41
12,101,47,37,40,62,-22
12,101,47,65,0,55,-55
12,101,47,93,0,87,-87
12,101,47,125,54,0,54
12,101,47,149,49,56,-7
12,101,47,157,68,0,68
12,101,47,179,0,37,-37
12,101,48,27,0,52,-52
12,101,48,29,41,88,-47
12,101,48,85,72,71,1
12,101,48,113,35,78,-43
12,101,48,121,0,66,-66
12,101,48,141,0,33,-33
12,101,48,201,70,157,-87
12,101,48,439,33,96,-63
12,101,48,453,45,40,5
12,101,51,41,46,30,16
12,101,51,59,107,58,49
12,101,51,107,35,0,35
12,101,51,153,50,0,50
12,101,51,700,0,27,-27
12,101,51,810,62,0,62
12,101,53,33,78,51,27
12,101,53,53,35,34,1
12,101,55,25,0,27,-27
12,101,55,79,0,22,-22
12,101,55,101,35,0,35
12,103,1,3,0,65,-65
12,103,1,69,0,42,-42
12,103,1,73,82,79,3
12,103,1,89,53,111,-58
12,103,1,97,47,56,-9
12,103,1,101,27,0,27
12,103,1,117,26,66,-40
12,103,2,20,50,57,-7
12,103,2,150,40,0,40
12,103,4,13,244,364,-120
12,103,4,19,96,97,-1
12,103,4,21,0,39,-39
12,103,5,7,0,41,-41
12,103,5,119,54,39,15
12,103,6,1,67,60,7
12,103,6,13,28,0,28
12,103,6,37,271,307,-36
12,103,6,59,137,111,26
12,103,6,65,55,60,-5
12,103,6,67,48,67,-19
12,103,6,71,65,45,20
12,103,6,73,208,236,-28
12,103,6,75,34,48,-14
12,103,6,83,28,22,6
12,103,6,85,56,67,-11
12,103,6,97,23,35,-12
12,103,6,111,0,38,-38
12,103,8,1,45,34,11
12,103,8,5,50,51,-1
12,103,8,13,24,57,-33
12,103,8,31,71,104,-33
12,103,8,35,38,51,-13
12,103,8,41,97,83,14
12,103,8,59,50,51,-1
12,103,8,69,0,64,-64
12,103,9,1,211,80,131
12,103,9,3,215,124,91
12,103,9,5,28,33,-5
12,103,9,7,39,0,39
12,103,9,9,192,79,113
12,103,9,11,81,53,28
12,103,9,13,31,0,31
12,103,10,1,26,0,26
12,103,10,3,82,67,15
12,103,10,5,71,0,71
12,103,11,1,59,55,4
12,103,12,1,503,333,170
12,103,12,5,128,145,-17
12,103,12,9,337,436,-99
12,103,12,11,693,760,-67
12,103,12,15,141,161,-20
12,103,12,17,354,643,-289
12,103,12,19,70,120,-50
12,103,12,21,171,182,-11
12,103,12,23,60,58,2
12,103,12,27,35,24,11
12,103,12,29,34,63,-29
12,103,12,31,529,568,-39
12,103,12,33,155,94,61
12,103,12,35,90,68,22
12,103,12,39,0,31,-31
12,103,12,41,0,39,-39
12,103,12,53,651,1121,-470
12,103,12,55,66,47,19
12,103,12,57,9019,8872,147
12,103,12,61,66,34,32
12,103,12,69,229,245,-16
12,103,12,71,575,420,155
12,103,12,73,429,369,60
12,103,12,75,45,117,-72
12,103,12,81,836,1290,-454
12,103,12,83,344,430,-86
12,103,12,85,56,56,0
12,103,12,86,703,591,112
12,103,12,87,153,85,68
12,103,12,89,27,36,-9
12,103,12,91,92,95,-3
12,103,12,95,1160,1234,-74
12,103,12,97,222,194,28
12,103,12,99,451,517,-66
12,103,12,101,4933,7287,-2354
12,103,12,105,816,849,-33
12,103,12,107,37,33,4
12,103,12,109,74,115,-41
12,103,12,111,92,140,-48
12,103,12,113,85,101,-16
12,103,12,115,604,625,-21
12,103,12,117,447,317,130
12,103,12,119,69,174,-105
12,103,12,121,26,106,-80
12,103,12,127,364,331,33
12,103,12,129,0,31,-31
12,103,12,131,24,0,24
12,103,13,39,0,29,-29
12,103,13,47,0,27,-27
12,103,13,51,61,78,-17
12,103,13,57,47,93,-46
12,103,13,63,41,29,12
12,103,13,67,165,187,-22
12,103,13,77,0,36,-36
12,103,13,89,162,164,-2
12,103,13,95,0,24,-24
12,103,13,97,0,35,-35
12,103,13,117,0,74,-74
12,103,13,121,225,279,-54
12,103,13,123,0,27,-27
12,103,13,127,0,35,-35
12,103,13,135,163,281,-118
12,103,13,139,28,72,-44
12,103,13,151,47,44,3
12,103,13,153,0,74,-74
12,103,13,179,46,0,46
12,103,13,185,39,66,-27
12,103,13,215,30,43,-13
12,103,13,223,0,52,-52
12,103,13,245,47,72,-25
12,103,13,247,0,35,-35
12,103,13,291,0,32,-32
12,103,13,295,0,28,-28
12,103,15,3,155,105,50
12,103,15,9,0,26,-26
12,103,17,19,26,32,-6
12,103,17,31,532,453,79
12,103,17,43,159,102,57
12,103,17,89,62,51,11
12,103,17,91,0,26,-26
12,103,17,97,106,116,-10
12,103,17,111,52,41,11
12,103,17,119,30,0,30
12,103,17,163,33,0,33
12,103,17,167,27,57,-30
12,103,17,197,75,91,-16
12,103,17,201,40,0,40
12,103,18,3,62,74,-12
12,103,18,35,30,30,0
12,103,18,57,73,96,-23
12,103,18,59,0,29,-29
12,103,18,63,42,41,1
12,103,18,81,41,29,12
12,103,18,89,71,41,30
12,103,18,95,32,31,1
12,103,18,97,180,160,20
12,103,18,105,0,29,-29
12,103,18,127,28,0,28
12,103,18,141,75,43,32
12,103,18,163,39,33,6
12,103,19,153,43,64,-21
12,103,20,91,34,78,-44
12,103,20,173,28,41,-13
12,103,21,15,36,0,36
12,103,21,67,63,55,8
12,103,21,111,152,115,37
12,103,21,117,49,43,6
12,103,21,227,0,27,-27
12,103,22,17,0,26,-26
12,103,22,51,26,44,-18
12,103,22,71,44,60,-16
12,103,22,103,0,35,-35
12,103,23,5,62,85,-23
12,103,23,11,28,39,-11
12,103,23,19,25,26,-1
12,103,23,31,58,42,16
12,103,24,3,108,97,11
12,103,24,5,101,80,21
12,103,24,21,0,25,-25
12,103,24,25,69,34,35
12,103,24,27,38,42,-4
12,103,24,31,160,119,41
12,103,24,33,84,70,14
12,103,24,43,30,0,30
12,103,24,45,21,0,21
12,103,24,510,78,0,78
12,103,25,1,80,90,-10
12,103,25,3,34,26,8
12,103,25,5,116,87,29
12,103,25,9,175,126,49
12,103,25,13,134,67,67
12,103,25,15,28,31,-3
12,103,25,17,244,202,42
12,103,25,21,113,68,45
12,103,25,23,93,82,11
12,103,25,25,137,99,38
12,103,25,27,198,145,53
12,103,26,25,32,0,32
12,103,26,45,27,0,27
12,103,26,49,110,61,49
12,103,26,55,35,0,35
12,103,26,65,90,0,90
12,103,26,75,30,0,30
12,103,26,77,53,0,53
12,103,26,81,67,62,5
12,103,26,93,22,0,22
12,103,26,99,212,88,124
12,103,26,121,21,0,21
12,103,26,125,260,152,108
12,103,26,139,48,0,48
12,103,26,145,32,0,32
12,103,26,147,45,0,45
12,103,26,161,90,36,54
12,103,26,163,281,134,147
12,103,27,3,25,0,25
12,103,27,37,51,0,51
12,103,27,53,132,95,37
12,103,27,123,50,30,20
12,103,27,163,0,24,-24
12,103,28,47,0,51,-51
12,103,29,19,25,0,25
12,103,29,77,41,31,10
12,103,29,95,70,51,19
12,103,29,183,60,62,-2
12,103,29,189,127,143,-16
12,103,29,510,48,30,18
12,103,31,55,37,40,-3
12,103,32,3,190,280,-90
12,103,32,31,27,30,-3
12,103,33,11,118,81,37
12,103,33,13,39,43,-4
12,103,33,15,120,55,65
12,103,33,17,32,34,-2
12,103,34,1,52,0,52
12,103,34,3,119,66,53
12,103,34,5,94,43,51
12,103,34,7,78,52,26
12,103,34,9,54,33,21
12,103,34,13,99,54,45
12,103,34,15,37,52,-15
12,103,34,17,121,66,55
12,103,34,21,52,31,21
12,103,34,23,102,69,33
12,103,34,25,95,41,54
12,103,34,27,80,28,52
12,103,34,29,117,82,35
12,103,34,31,63,0,63
12,103,34,35,62,0,62
12,103,34,37,25,0,25
12,103,34,39,68,28,40
12,103,35,1,62,49,13
12,103,36,1,71,48,23
12,103,36,5,144,112,32
12,103,36,7,25,29,-4
12,103,36,9,24,0,24
12,103,36,13,47,34,13
12,103,36,15,25,0,25
12,103,36,27,51,31,20
12,103,36,29,218,178,40
12,103,36,45,41,45,-4
12,103,36,47,220,138,82
12,103,36,55,201,86,115
12,103,36,57,28,0,28
12,103,36,59,194,72,122
12,103,36,61,187,211,-24
12,103,36,63,71,28,43
12,103,36,65,62,33,29
12,103,36,67,75,83,-8
12,103,36,69,0,38,-38
12,103,36,71,86,59,27
12,103,36,81,262,151,111
12,103,36,83,38,23,15
12,103,36,85,62,40,22
12,103,36,87,29,0,29
12,103,36,89,23,0,23
12,103,36,91,64,38,26
12,103,36,93,52,24,28
12,103,36,103,262,184,78
12,103,36,109,28,0,28
12,103,36,111,50,0,50
12,103,36,117,0,25,-25
12,103,36,119,121,38,83
12,103,37,21,70,164,-94
12,103,37,25,0,44,-44
12,103,37,35,0,50,-50
12,103,37,49,31,0,31
12,103,37,51,96,98,-2
12,103,37,63,0,38,-38
12,103,37,67,24,86,-62
12,103,37,71,0,50,-50
12,103,37,81,35,106,-71
12,103,37,87,31,46,-15
12,103,37,89,0,87,-87
12,103,37,97,37,79,-42
12,103,37,99,0,29,-29
12,103,37,113,0,57,-57
12,103,37,119,144,268,-124
12,103,37,129,33,0,33
12,103,37,133,82,79,3
12,103,37,139,30,0,30
12,103,37,147,22,0,22
12,103,37,183,115,249,-134
12,103,38,17,31,0,31
12,103,39,17,87,39,48
12,103,39,23,0,25,-25
12,103,39,25,41,0,41
12,103,39,29,30,0,30
12,103,39,35,222,142,80
12,103,39,41,0,25,-25
12,103,39,45,26,34,-8
12,103,39,49,253,222,31
12,103,39,57,36,50,-14
12,103,39,61,111,82,29
12,103,39,85,61,39,22
12,103,39,89,37,32,5
12,103,39,93,88,42,46
12,103,39,95,133,76,57
12,103,39,99,51,40,11
12,103,39,103,37,0,37
12,103,39,113,117,81,36
12,103,39,151,69,59,10
12,103,39,153,96,102,-6
12,103,39,155,58,42,16
12,103,39,165,41,36,5
12,103,39,173,31,0,31
12,103,40,109,26,42,-16
12,103,40,143,25,46,-21
12,103,41,51,23,73,-50
12,103,41,67,43,50,-7
12,103,42,3,240,196,44
12,103,42,7,37,28,9
12,103,42,11,65,75,-10
12,103,42,17,114,45,69
12,103,42,19,28,22,6
12,103,42,21,0,24,-24
12,103,42,27,31,0,31
12,103,42,29,92,52,40
12,103,42,41,36,51,-15
12,103,42,43,55,38,17
12,103,42,45,113,44,69
12,103,42,49,64,61,3
12,103,42,69,43,0,43
12,103,42,71,41,53,-12
12,103,42,77,61,33,28
12,103,42,79,34,0,34
12,103,42,85,20,0,20
12,103,42,89,41,34,7
12,103,42,91,87,94,-7
12,103,42,95,32,24,8
12,103,42,101,142,113,29
12,103,42,125,24,27,-3
12,103,42,129,39,71,-32
12,103,42,133,68,42,26
12,103,44,3,52,25,27
12,103,44,5,39,28,11
12,103,44,7,127,82,45
12,103,44,9,26,0,26
12,103,45,7,0,38,-38
12,103,45,13,41,38,3
12,103,45,15,55,36,19
12,103,45,19,56,75,-19
12,103,45,35,0,39,-39
12,103,45,45,54,159,-105
12,103,45,51,51,69,-18
12,103,45,63,0,89,-89
12,103,45,73,0,34,-34
12,103,45,79,69,47,22
12,103,45,83,0,76,-76
12,103,45,91,0,75,-75
12,103,46,99,40,0,40
12,103,47,1,0,38,-38
12,103,47,9,0,77,-77
12,103,47,11,0,25,-25
12,103,47,31,0,34,-34
12,103,47,35,0,31,-31
12,103,47,37,123,197,-74
12,103,47,65,42,62,-20
12,103,47,93,97,146,-49
12,103,47,119,0,52,-52
12,103,47,125,41,38,3
12,103,47,149,47,86,-39
12,103,47,155,36,84,-48
12,103,47,157,94,100,-6
12,103,47,163,0,44,-44
12,103,47,165,0,87,-87
12,103,47,179,32,60,-28
12,103,47,187,30,72,-42
12,103,47,189,0,37,-37
12,103,48,27,77,74,3
12,103,48,29,108,138,-30
12,103,48,85,65,80,-15
12,103,48,113,139,131,8
12,103,48,121,37,133,-96
12,103,48,141,46,55,-9
12,103,48,157,0,45,-45
12,103,48,201,157,286,-129
12,103,48,245,0,44,-44
12,103,48,339,34,65,-31
12,103,48,355,0,25,-25
12,103,48,439,106,190,-84
12,103,48,453,68,148,-80
12,103,48,491,46,63,-17
12,103,49,35,51,67,-16
12,103,50,7,43,25,18
12,103,50,25,0,24,-24
12,103,51,13,24,65,-41
12,103,51,41,51,40,11
12,103,51,59,194,174,20
12,103,51,87,0,62,-62
12,103,51,107,58,44,14
12,103,51,153,60,34,26
12,103,51,177,25,0,25
12,103,51,179,34,0,34
12,103,51,510,32,0,32
12,103,51,550,28,42,-14
12,103,51,650,34,0,34
12,103,51,680,0,32,-32
12,103,51,700,48,34,14
12,103,51,710,37,49,-12
12,103,51,760,23,28,-5
12,103,51,810,111,90,21
12,103,53,11,0,26,-26
12,103,53,33,151,193,-42
12,103,53,53,41,111,-70
12,103,53,61,56,68,-12
12,103,53,63,42,27,15
12,103,54,39,0,40,-40
12,103,55,25,57,45,12
12,103,55,59,28,0,28
12,103,55,79,78,95,-17
12,103,55,133,93,51,42
12,105,1,3,0,35,-35
12,105,1,45,0,31,-31
12,105,1,69,0,75,-75
12,105,1,73,56,35,21
12,105,1,89,0,50,-50
12,105,1,95,0,32,-32
12,105,1,97,40,33,7
12,105,1,101,0,27,-27
12,105,1,117,0,50,-50
12,105,4,13,111,137,-26
12,105,4,21,0,37,-37
12,105,5,7,0,27,-27
12,105,6,13,32,0,32
12,105,6,37,124,144,-20
12,105,6,59,45,27,18
12,105,6,65,0,44,-44
12,105,6,67,26,0,26
12,105,6,71,38,43,-5
12,105,6,73,72,94,-22
12,105,6,85,0,33,-33
12,105,8,5,0,37,-37
12,105,8,41,45,79,-34
12,105,8,59,0,34,-34
12,105,9,1,57,31,26
12,105,9,3,119,62,57
12,105,9,9,112,61,51
12,105,9,11,42,0,42
12,105,10,3,40,34,6
12,105,11,1,24,0,24
12,105,12,1,244,297,-53
12,105,12,5,69,73,-4
12,105,12,9,364,361,3
12,105,12,11,1390,661,729
12,105,12,15,127,104,23
12,105,12,17,131,178,-47
12,105,12,19,96,116,-20
12,105,12,21,137,120,17
12,105,12,23,26,81,-55
12,105,12,27,52,46,6
12,105,12,31,361,365,-4
12,105,12,33,97,91,6
12,105,12,35,44,34,10
12,105,12,39,0,26,-26
12,105,12,49,342,272,70
12,105,12,51,53,85,-32
12,105,12,53,167,145,22
12,105,12,55,605,601,4
12,105,12,57,5101,4154,947
12,105,12,61,109,129,-20
12,105,12,63,40,34,6
12,105,12,69,1464,1167,297
12,105,12,71,424,339,85
12,105,12,73,208,204,4
12,105,12,75,0,48,-48
12,105,12,81,296,220,76
12,105,12,83,259,253,6
12,105,12,85,81,43,38
12,105,12,86,1426,713,713
12,105,12,87,87,48,39
12,105,12,89,0,46,-46
12,105,12,91,45,63,-18
12,105,12,93,43,52,-9
12,105,12,95,5023,3729,1294
12,105,12,97,3625,3358,267
12,105,12,99,729,395,334
12,105,12,101,734,726,8
12,105,12,103,849,816,33
12,105,12,107,48,53,-5
12,105,12,109,37,97,-60
12,105,12,111,211,146,65
12,105,12,113,0,41,-41
12,105,12,115,214,202,12
12,105,12,117,674,489,185
12,105,12,119,84,116,-32
12,105,12,121,0,72,-72
12,105,12,127,349,350,-1
12,105,12,131,25,48,-23
12,105,13,51,38,57,-19
12,105,13,57,0,65,-65
12,105,13,63,41,52,-11
12,105,13,67,74,145,-71
12,105,13,89,53,69,-16
12,105,13,95,0,37,-37
12,105,13,117,0,38,-38
12,105,13,121,104,143,-39
12,105,13,135,135,126,9
12,105,13,139,0,42,-42
12,105,13,151,28,65,-37
12,105,13,153,38,0,38
12,105,13,185,57,53,4
12,105,13,215,36,0,36
12,105,13,245,30,43,-13
12,105,15,3,46,47,-1
12,105,17,31,170,180,-10
12,105,17,43,57,0,57
12,105,17,89,42,32,10
12,105,17,97,30,0,30
12,105,17,113,40,0,40
12,105,17,197,35,0,35
12,105,17,201,29,0,29
12,105,18,3,45,34,11
12,105,18,89,58,0,58
12,105,18,95,0,29,-29
12,105,18,97,89,55,34
12,105,18,167,24,0,24
12,105,19,163,0,26,-26
12,105,20,173,0,27,-27
12,105,21,67,0,28,-28
12,105,21,111,52,35,17
12,105,22,51,26,40,-14
12,105,23,1,0,34,-34
12,105,23,5,25,41,-16
12,105,23,19,43,37,6
12,105,24,3,52,63,-11
12,105,24,5,77,37,40
12,105,24,31,72,52,20
12,105,24,33,64,50,14
12,105,24,510,38,0,38
12,105,25,5,77,41,36
12,105,25,9,87,53,34
12,105,25,13,80,61,19
12,105,25,17,98,36,62
12,105,25,21,34,0,34
12,105,25,23,74,35,39
12,105,25,25,48,34,14
12,105,25,27,145,89,56
12,105,26,49,86,0,86
12,105,26,65,48,0,48
12,105,26,75,42,0,42
12,105,26,77,0,31,-31
12,105,26,81,72,51,21
12,105,26,93,28,0,28
12,105,26,99,101,0,101
12,105,26,121,23,0,23
12,105,26,125,174,56,118
12,105,26,147,36,0,36
12,105,26,159,0,42,-42
12,105,26,161,41,0,41
12,105,26,163,142,60,82
12,105,27,53,38,43,-5
12,105,28,47,25,0,25
12,105,29,95,33,37,-4
12,105,29,183,34,0,34
12,105,29,189,50,0,50
12,105,32,3,74,92,-18
12,105,33,11,73,39,34
12,105,33,15,26,0,26
12,105,34,1,49,29,20
12,105,34,3,67,0,67
12,105,34,5,53,29,24
12,105,34,7,66,48,18
12,105,34,13,88,29,59
12,105,34,15,38,0,38
12,105,34,17,134,0,134
12,105,34,21,37,0,37
12,105,34,23,90,48,42
12,105,34,25,69,29,40
12,105,34,27,41,0,41
12,105,34,29,72,38,34
12,105,34,31,83,42,41
12,105,34,35,27,0,27
12,105,34,39,67,0,67
12,105,36,1,31,0,31
12,105,36,5,367,134,233
12,105,36,27,29,0,29
12,105,36,29,88,66,22
12,105,36,45,52,29,23
12,105,36,47,280,125,155
12,105,36,55,129,61,68
12,105,36,59,135,50,85
12,105,36,61,85,74,11
12,105,36,63,29,0,29
12,105,36,67,64,26,38
12,105,36,71,42,0,42
12,105,36,75,27,0,27
12,105,36,81,381,111,270
12,105,36,85,40,0,40
12,105,36,89,45,0,45
12,105,36,101,38,0,38
12,105,36,103,172,89,83
12,105,36,111,29,0,29
12,105,36,119,77,0,77
12,105,37,21,0,38,-38
12,105,37,27,0,28,-28
12,105,37,51,64,89,-25
12,105,37,67,0,45,-45
12,105,37,81,27,66,-39
12,105,37,85,0,32,-32
12,105,37,89,0,56,-56
12,105,37,99,0,32,-32
12,105,37,119,88,144,-56
12,105,37,133,72,59,13
12,105,37,179,0,35,-35
12,105,37,183,76,111,-35
12,105,39,7,32,0,32
12,105,39,23,36,0,36
12,105,39,35,110,66,44
12,105,39,45,0,25,-25
12,105,39,49,109,85,24
12,105,39,61,48,42,6
12,105,39,89,28,0,28
12,105,39,93,57,53,4
12,105,39,95,58,51,7
12,105,39,113,57,43,14
12,105,39,139,34,0,34
12,105,39,151,52,33,19
12,105,39,153,40,35,5
12,105,39,155,23,0,23
12,105,39,173,23,0,23
12,105,40,109,40,35,5
12,105,40,143,0,28,-28
12,105,41,51,29,45,-16
12,105,42,3,64,58,6
12,105,42,11,77,38,39
12,105,42,17,81,36,45
12,105,42,29,22,0,22
12,105,42,43,0,34,-34
12,105,42,45,37,0,37
12,105,42,49,58,0,58
12,105,42,69,34,0,34
12,105,42,71,53,37,16
12,105,42,77,73,25,48
12,105,42,79,0,39,-39
12,105,42,89,37,0,37
12,105,42,91,54,31,23
12,105,42,95,31,0,31
12,105,42,101,162,72,90
12,105,42,133,31,30,1
12,105,44,3,41,0,41
12,105,44,7,109,56,53
12,105,45,13,0,28,-28
12,105,45,19,30,0,30
12,105,45,45,0,85,-85
12,105,45,51,39,57,-18
12,105,45,63,38,44,-6
12,105,45,79,0,27,-27
12,105,45,83,0,47,-47
12,105,47,9,0,60,-60
12,105,47,11,0,69,-69
12,105,47,37,64,57,7
12,105,47,65,29,66,-37
12,105,47,93,37,69,-32
12,105,47,125,43,0,43
12,105,47,149,32,42,-10
12,105,47,155,0,77,-77
12,105,47,157,77,44,33
12,105,47,163,0,31,-31
12,105,47,165,0,29,-29
12,105,47,179,0,33,-33
12,105,47,189,0,37,-37
12,105,48,27,37,63,-26
12,105,48,29,26,72,-46
12,105,48,61,0,37,-37
12,105,48,85,37,59,-22
12,105,48,113,78,99,-21
12,105,48,121,0,31,-31
12,105,48,141,0,42,-42
12,105,48,201,110,297,-187
12,105,48,215,0,63,-63
12,105,48,309,0,27,-27
12,105,48,339,0,30,-30
12,105,48,423,0,33,-33
12,105,48,439,95,90,5
12,105,48,453,0,69,-69
12,105,48,491,0,34,-34
12,105,49,35,0,37,-37
12,105,51,41,37,0,37
12,105,51,59,61,63,-2
12,105,51,153,49,39,10
12,105,51,700,0,25,-25
12,105,51,710,44,0,44
12,105,51,810,81,44,37
12,105,53,33,44,54,-10
12,105,53,53,44,44,0
12,105,55,25,41,0,41
12,105,55,79,66,42,24
12,105,55,133,29,0,29
12,107,12,1,366,406,-40
12,107,12,7,74,77,-3
12,107,12,9,68,56,12
12,107,12,11,106,47,59
12,107,12,19,449,445,4
12,107,12,23,0,34,-34
12,107,12,31,354,371,-17
12,107,12,35,120,175,-55
12,107,12,57,59,95,-36
12,107,12,69,53,30,23
12,107,12,73,0,26,-26
12,107,12,83,151,197,-46
12,107,12,86,69,34,35
12,107,12,89,36,0,36
12,107,12,95,140,126,14
12,107,12,97,28,0,28
12,107,12,99,70,44,26
12,107,12,101,0,45,-45
12,107,12,103,33,37,-4
12,107,12,105,53,48,5
12,107,12,109,427,569,-142
12,107,12,111,48,0,48
12,107,12,117,58,35,23
12,107,12,127,325,306,19
12,107,13,185,0,29,-29
12,109,1,117,35,0,35
12,109,4,13,53,53,0
12,109,6,37,44,45,-1
12,109,6,59,81,51,30
12,109,6,73,66,74,-8
12,109,8,41,36,0,36
12,109,9,1,87,0,87
12,109,9,3,33,0,33
12,109,9,9,44,0,44
12,109,10,3,35,0,35
12,109,12,1,294,200,94
12,109,12,3,0,30,-30
12,109,12,5,39,34,5
12,109,12,9,229,144,85
12,109,12,11,400,158,242
12,109,12,17,24,0,24
12,109,12,19,747,508,239
12,109,12,21,53,25,28
12,109,12,23,46,0,46
12,109,12,31,5791,4150,1641
12,109,12,33,31,39,-8
12,109,12,35,580,762,-182
12,109,12,55,30,0,30
12,109,12,57,195,173,22
12,109,12,61,29,26,3
12,109,12,69,71,57,14
12,109,12,71,74,63,11
12,109,12,73,107,99,8
12,109,12,81,55,50,5
12,109,12,83,132,110,22
12,109,12,85,55,0,55
12,109,12,86,216,76,140
12,109,12,87,49,34,15
12,109,12,89,106,95,11
12,109,12,91,38,0,38
12,109,12,95,303,216,87
12,109,12,97,43,46,-3
12,109,12,99,338,161,177
12,109,12,101,59,46,13
12,109,12,103,115,74,41
12,109,12,105,97,37,60
12,109,12,107,569,427,142
12,109,12,111,53,0,53
12,109,12,113,35,0,35
12,109,12,115,68,35,33
12,109,12,117,159,65,94
12,109,12,121,27,0,27
12,109,12,127,244,226,18
12,109,13,39,33,0,33
12,109,13,51,54,45,9
12,109,13,57,47,0,47
12,109,13,67,85,48,37
12,109,13,89,51,24,27
12,109,13,117,0,47,-47
12,109,13,121,138,93,45
12,109,13,135,84,51,33
12,109,13,185,27,0,27
12,109,13,245,28,0,28
12,109,15,3,48,43,5
12,109,17,31,70,51,19
12,109,17,43,33,0,33
12,109,17,197,47,0,47
12,109,20,91,37,0,37
12,109,21,111,24,0,24
12,109,23,5,37,0,37
12,109,24,3,65,0,65
12,109,24,5,34,0,34
12,109,24,31,64,33,31
12,109,24,37,38,0,38
12,109,25,9,36,0,36
12,109,25,17,34,39,-5
12,109,26,125,72,27,45
12,109,26,163,56,0,56
12,109,29,189,50,0,50
12,109,32,3,57,56,1
12,109,33,11,38,0,38
12,109,34,3,68,0,68
12,109,34,5,35,0,35
12,109,34,23,64,0,64
12,109,34,25,70,0,70
12,109,34,27,37,0,37
12,109,34,29,46,0,46
12,109,36,47,47,25,22
12,109,36,59,60,0,60
12,109,36,61,43,32,11
12,109,36,71,35,0,35
12,109,36,81,66,0,66
12,109,36,103,167,29,138
12,109,36,119,63,0,63
12,109,37,21,46,60,-14
12,109,37,119,63,98,-35
12,109,37,133,34,43,-9
12,109,37,183,36,40,-4
12,109,39,35,27,0,27
12,109,39,49,28,0,28
12,109,39,153,27,0,27
12,109,42,3,58,24,34
12,109,42,17,67,0,67
12,109,42,29,36,0,36
12,109,42,91,57,0,57
12,109,45,13,30,0,30
12,109,45,19,37,38,-1
12,109,47,37,0,36,-36
12,109,47,93,35,0,35
12,109,47,157,36,0,36
12,109,48,29,0,38,-38
12,109,48,113,33,0,33
12,109,48,121,0,58,-58
12,109,48,201,52,42,10
12,109,48,439,0,43,-43
12,109,51,59,107,44,63
12,109,51,153,37,0,37
12,109,51,710,31,0,31
12,109,51,810,56,36,20
12,109,53,33,39,0,39
12,111,4,13,63,89,-26
12,111,6,37,65,81,-16
12,111,6,59,34,0,34
12,111,6,65,43,0,43
12,111,6,73,53,61,-8
12,111,9,1,99,32,67
12,111,9,3,83,59,24
12,111,9,9,93,49,44
12,111,9,11,37,0,37
12,111,10,3,32,0,32
12,111,12,1,135,108,27
12,111,12,9,353,385,-32
12,111,12,11,4065,1318,2747
12,111,12,15,35,40,-5
12,111,12,17,0,57,-57
12,111,12,19,53,42,11
12,111,12,21,93,63,30
12,111,12,23,0,53,-53
12,111,12,31,143,187,-44
12,111,12,33,39,35,4
12,111,12,35,0,52,-52
12,111,12,53,24,60,-36
12,111,12,55,80,56,24
12,111,12,57,220,317,-97
12,111,12,61,1124,1827,-703
12,111,12,69,95,119,-24
12,111,12,71,160,140,20
12,111,12,73,102,98,4
12,111,12,81,63,49,14
12,111,12,83,125,157,-32
12,111,12,85,3226,2556,670
12,111,12,86,1467,648,819
12,111,12,87,83,37,46
12,111,12,91,43,42,1
12,111,12,93,235,244,-9
12,111,12,95,402,629,-227
12,111,12,97,67,133,-66
12,111,12,99,4779,2462,2317
12,111,12,101,70,92,-22
12,111,12,103,140,92,48
12,111,12,105,146,211,-65
12,111,12,107,0,48,-48
12,111,12,109,0,53,-53
12,111,12,115,65,63,2
12,111,12,117,102,157,-55
12,111,12,119,0,47,-47
12,111,12,121,0,37,-37
12,111,12,127,139,161,-22
12,111,13,63,0,50,-50
12,111,13,67,0,56,-56
12,111,13,89,34,38,-4
12,111,13,121,40,96,-56
12,111,13,135,59,96,-37
12,111,13,151,0,61,-61
12,111,17,31,49,68,-19
12,111,18,97,34,0,34
12,111,21,111,0,40,-40
12,111,23,5,32,0,32
12,111,24,3,40,0,40
12,111,24,5,27,0,27
12,111,24,31,32,0,32
12,111,24,33,0,35,-35
12,111,25,1,56,54,2
12,111,25,5,31,48,-17
12,111,25,9,39,29,10
12,111,25,13,32,32,0
12,111,25,17,105,55,50
12,111,25,21,0,26,-26
12,111,25,23,33,0,33
12,111,25,25,45,38,7
12,111,25,27,80,61,19
12,111,26,81,33,0,33
12,111,26,93,26,0,26
12,111,26,99,0,30,-30
12,111,26,125,64,33,31
12,111,26,163,83,27,56
12,111,29,189,22,0,22
12,111,32,3,49,76,-27
12,111,33,11,56,0,56
12,111,33,15,33,26,7
12,111,34,1,40,0,40
12,111,34,3,114,36,78
12,111,34,7,30,28,2
12,111,34,9,25,0,25
12,111,34,13,84,33,51
12,111,34,17,55,34,21
12,111,34,23,58,34,24
12,111,34,25,79,38,41
12,111,34,27,40,0,40
12,111,34,29,124,72,52
12,111,34,31,61,0,61
12,111,34,35,26,0,26
12,111,34,39,79,0,79
12,111,36,5,174,63,111
12,111,36,27,28,0,28
12,111,36,29,45,29,16
12,111,36,47,185,102,83
12,111,36,55,42,0,42
12,111,36,59,164,83,81
12,111,36,61,106,33,73
12,111,36,67,44,0,44
12,111,36,71,57,36,21
12,111,36,81,244,92,152
12,111,36,85,78,0,78
12,111,36,87,50,0,50
12,111,36,103,390,199,191
12,111,36,119,115,57,58
12,111,37,21,0,23,-23
12,111,37,25,0,44,-44
12,111,37,71,0,40,-40
12,111,37,119,72,110,-38
12,111,37,133,32,37,-5
12,111,37,183,34,53,-19
12,111,39,35,48,0,48
12,111,39,49,42,34,8
12,111,42,3,29,31,-2
12,111,42,17,44,0,44
12,111,42,45,48,0,48
12,111,42,91,50,31,19
12,111,42,101,71,0,71
12,111,44,3,28,0,28
12,111,44,7,61,27,34
12,111,45,7,0,42,-42
12,111,45,13,0,49,-49
12,111,45,45,0,103,-103
12,111,45,63,0,36,-36
12,111,45,77,0,51,-51
12,111,47,65,0,46,-46
12,111,47,93,0,42,-42
12,111,48,27,0,34,-34
12,111,48,29,0,72,-72
12,111,48,113,0,59,-59
12,111,48,201,0,131,-131
12,111,48,439,35,64,-29
12,111,48,453,0,32,-32
12,111,51,59,40,0,40
12,111,51,810,43,0,43
12,113,1,3,140,170,-30
12,113,1,31,0,40,-40
12,113,1,39,50,29,21
12,113,1,51,32,0,32
12,113,1,53,127,126,1
12,113,1,73,86,69,17
12,113,1,89,36,54,-18
12,113,1,97,121,103,18
12,113,1,101,54,59,-5
12,113,1,117,50,62,-12
12,113,2,20,94,0,94
12,113,4,13,62,39,23
12,113,4,19,47,0,47
12,113,6,29,41,0,41
12,113,6,37,55,22,33
12,113,6,53,44,0,44
12,113,6,65,24,0,24
12,113,6,73,173,361,-188
12,113,8,41,95,71,24
12,113,9,11,40,0,40
12,113,12,1,54,47,7
12,113,12,5,127,139,-12
12,113,12,9,68,59,9
12,113,12,11,80,64,16
12,113,12,19,55,42,13
12,113,12,31,193,208,-15
12,113,12,33,3965,3139,826
12,113,12,57,108,122,-14
12,113,12,71,43,40,3
12,113,12,73,106,130,-24
12,113,12,83,0,33,-33
12,113,12,86,49,73,-24
12,113,12,91,2571,1568,1003
12,113,12,95,107,149,-42
12,113,12,97,36,0,36
12,113,12,99,57,50,7
12,113,12,101,47,44,3
12,113,12,103,101,85,16
12,113,12,105,41,0,41
12,113,12,109,0,35,-35
12,113,12,115,0,27,-27
12,113,12,117,30,42,-12
12,113,12,127,65,0,65
12,113,12,131,131,158,-27
12,113,13,67,48,28,20
12,113,13,89,25,0,25
12,113,13,121,51,30,21
12,113,13,135,0,55,-55
12,113,13,153,49,37,12
12,113,13,215,0,39,-39
12,113,15,3,157,66,91
12,113,17,31,34,0,34
12,113,21,111,29,0,29
12,113,22,33,36,0,36
12,113,22,51,38,0,38
12,113,22,103,36,26,10
12,113,24,3,89,0,89
12,113,27,53,23,0,23
12,113,28,47,32,49,-17
12,113,28,59,30,37,-7
12,113,28,75,0,84,-84
12,113,29,189,38,0,38
12,113,32,3,66,83,-17
12,113,34,5,46,0,46
12,113,35,1,80,38,42
12,113,35,9,0,87,-87
12,113,36,61,0,21,-21
12,113,37,49,53,31,22
12,113,37,51,52,0,52
12,113,37,85,48,0,48
12,113,37,119,0,28,-28
12,113,37,133,87,176,-89
12,113,39,57,40,0,40
12,113,39,113,39,0,39
12,113,40,47,30,84,-54
12,113,40,109,37,48,-11
12,113,45,13,46,0,46
12,113,45,85,33,0,33
12,113,47,37,30,0,30
12,113,47,93,30,40,-10
12,113,47,149,0,30,-30
12,113,47,157,58,39,19
12,113,48,29,94,85,9
12,113,48,113,36,0,36
12,113,48,201,39,66,-27
12,113,48,273,0,70,-70
12,113,48,355,173,121,52
12,113,48,439,41,45,-4
12,113,48,441,36,0,36
12,113,48,451,56,0,56
12,113,51,59,58,51,7
12,113,51,153,43,0,43
12,113,51,179,99,0,99
12,113,51,550,52,41,11
12,113,51,710,82,74,8
12,113,51,800,0,51,-51
12,113,51,810,115,105,10
12,113,53,53,0,50,-50
12,113,53,63,42,0,42
12,115,4,13,118,102,16
12,115,4,19,0,66,-66
12,115,6,1,0,29,-29
12,115,6,37,177,100,77
12,115,6,59,33,47,-14
12,115,6,65,0,28,-28
12,115,6,73,77,57,20
12,115,6,75,0,27,-27
12,115,8,5,34,45,-11
12,115,8,13,0,26,-26
12,115,8,31,27,54,-27
12,115,8,41,28,49,-21
12,115,8,59,29,0,29
12,115,8,69,0,44,-44
12,115,9,1,132,63,69
12,115,9,3,114,60,54
12,115,9,9,117,41,76
12,115,9,11,50,53,-3
12,115,9,15,28,0,28
12,115,10,3,38,0,38
12,115,10,5,29,0,29
12,115,11,1,30,28,2
12,115,12,1,172,161,11
12,115,12,5,39,25,14
12,115,12,9,86,123,-37
12,115,12,11,466,320,146
12,115,12,15,3055,3054,1
12,115,12,17,38,33,5
12,115,12,19,0,43,-43
12,115,12,21,303,147,156
12,115,12,23,0,34,-34
12,115,12,27,170,120,50
12,115,12,31,151,184,-33
12,115,12,33,59,56,3
12,115,12,35,35,32,3
12,115,12,53,62,64,-2
12,115,12,55,58,56,2
12,115,12,57,805,1057,-252
12,115,12,61,35,36,-1
12,115,12,69,97,80,17
12,115,12,71,639,486,153
12,115,12,73,138,194,-56
12,115,12,81,5754,5794,-40
12,115,12,83,121,133,-12
12,115,12,85,27,21,6
12,115,12,86,439,417,22
12,115,12,87,65,44,21
12,115,12,91,34,0,34
12,115,12,95,448,440,8
12,115,12,97,82,96,-14
12,115,12,99,300,303,-3
12,115,12,101,215,132,83
12,115,12,103,625,604,21
12,115,12,105,202,214,-12
12,115,12,109,35,68,-33
12,115,12,111,63,65,-2
12,115,12,113,27,0,27
12,115,12,117,150,151,-1
12,115,12,119,0,48,-48
12,115,12,127,147,60,87
12,115,13,51,46,42,4
12,115,13,57,31,30,1
12,115,13,67,63,66,-3
12,115,13,89,51,36,15
12,115,13,117,0,37,-37
12,115,13,121,70,142,-72
12,115,13,135,48,54,-6
12,115,13,151,34,0,34
12,115,15,3,0,28,-28
12,115,17,31,237,238,-1
12,115,17,43,103,0,103
12,115,17,89,37,45,-8
12,115,17,97,68,30,38
12,115,17,111,0,34,-34
12,115,17,113,24,0,24
12,115,17,197,79,0,79
12,115,17,201,42,0,42
12,115,18,3,55,27,28
12,115,18,39,32,40,-8
12,115,18,57,31,33,-2
12,115,18,97,123,80,43
12,115,20,91,39,42,-3
12,115,21,67,36,34,2
12,115,21,111,65,67,-2
12,115,23,5,90,40,50
12,115,23,31,49,0,49
12,115,24,3,66,49,17
12,115,24,5,77,33,44
12,115,24,25,26,0,26
12,115,24,27,39,27,12
12,115,24,31,110,65,45
12,115,24,33,49,0,49
12,115,25,1,111,58,53
12,115,25,5,69,55,14
12,115,25,9,116,75,41
12,115,25,13,55,0,55
12,115,25,17,218,83,135
12,115,25,21,66,22,44
12,115,25,23,104,49,55
12,115,25,25,23,26,-3
12,115,25,27,144,65,79
12,115,26,49,84,45,39
12,115,26,65,60,0,60
12,115,26,77,39,0,39
12,115,26,81,71,42,29
12,115,26,93,37,0,37
12,115,26,99,89,62,27
12,115,26,125,185,90,95
12,115,26,139,50,0,50
12,115,26,147,36,0,36
12,115,26,161,40,0,40
12,115,26,163,125,62,63
12,115,27,37,24,0,24
12,115,27,53,50,34,16
12,115,27,123,33,0,33
12,115,29,95,29,37,-8
12,115,29,189,83,28,55
12,115,32,3,132,133,-1
12,115,33,1,30,0,30
12,115,33,9,30,23,7
12,115,33,11,75,32,43
12,115,33,13,30,0,30
12,115,33,15,65,47,18
12,115,34,1,33,0,33
12,115,34,3,103,41,62
12,115,34,5,76,53,23
12,115,34,7,71,0,71
12,115,34,9,44,0,44
12,115,34,13,65,0,65
12,115,34,17,41,29,12
12,115,34,21,52,0,52
12,115,34,23,69,52,17
12,115,34,25,75,36,39
12,115,34,27,77,37,40
12,115,34,29,115,40,75
12,115,34,31,49,40,9
12,115,34,35,37,0,37
12,115,34,39,52,27,25
12,115,35,1,34,0,34
12,115,36,1,26,24,2
12,115,36,5,46,24,22
12,115,36,7,0,36,-36
12,115,36,29,167,81,86
12,115,36,47,100,124,-24
12,115,36,55,67,34,33
12,115,36,59,123,37,86
12,115,36,61,94,126,-32
12,115,36,67,83,27,56
12,115,36,71,51,0,51
12,115,36,81,128,57,71
12,115,36,83,27,0,27
12,115,36,85,48,0,48
12,115,36,91,29,0,29
12,115,36,103,187,95,92
12,115,36,111,27,0,27
12,115,36,119,118,35,83
12,115,37,21,0,98,-98
12,115,37,45,0,32,-32
12,115,37,51,0,43,-43
12,115,37,89,0,30,-30
12,115,37,97,0,29,-29
12,115,37,113,0,33,-33
12,115,37,119,61,120,-59
12,115,37,161,0,31,-31
12,115,37,179,33,0,33
12,115,37,183,65,133,-68
12,115,39,17,29,36,-7
12,115,39,25,31,34,-3
12,115,39,35,130,70,60
12,115,39,41,0,28,-28
12,115,39,49,130,78,52
12,115,39,57,0,31,-31
12,115,39,61,90,42,48
12,115,39,93,28,0,28
12,115,39,95,66,0,66
12,115,39,99,44,0,44
12,115,39,113,92,54,38
12,115,39,151,39,31,8
12,115,39,153,85,40,45
12,115,39,155,29,0,29
12,115,39,157,0,25,-25
12,115,40,143,0,31,-31
12,115,41,39,0,24,-24
12,115,41,51,0,37,-37
12,115,42,3,95,80,15
12,115,42,17,66,32,34
12,115,42,29,51,0,51
12,115,42,45,28,0,28
12,115,42,49,33,0,33
12,115,42,71,29,29,0
12,115,42,91,64,45,19
12,115,42,95,37,0,37
12,115,42,101,75,57,18
12,115,42,133,63,0,63
12,115,44,3,64,0,64
12,115,44,7,89,42,47
12,115,44,9,70,0,70
12,115,45,7,0,42,-42
12,115,45,13,0,43,-43
12,115,45,19,42,30,12
12,115,45,45,0,74,-74
12,115,45,51,38,28,10
12,115,45,91,0,60,-60
12,115,47,9,0,43,-43
12,115,47,35,0,39,-39
12,115,47,37,35,80,-45
12,115,47,65,0,30,-30
12,115,47,93,0,80,-80
12,115,47,155,0,58,-58
12,115,47,157,30,0,30
12,115,47,187,0,37,-37
12,115,48,29,0,86,-86
12,115,48,85,31,51,-20
12,115,48,113,36,71,-35
12,115,48,121,30,0,30
12,115,48,201,65,107,-42
12,115,48,439,56,36,20
12,115,48,453,0,45,-45
12,115,50,7,42,0,42
12,115,51,13,31,29,2
12,115,51,41,0,23,-23
12,115,51,59,113,65,48
12,115,51,87,32,0,32
12,115,51,810,48,32,16
12,115,53,11,0,65,-65
12,115,53,33,0,66,-66
12,115,53,53,0,46,-46
12,115,53,61,0,53,-53
12,115,55,25,41,0,41
12,115,55,79,26,0,26
12,115,55,101,30,0,30
12,115,55,127,29,0,29
12,115,55,133,39,0,39
12,117,1,73,44,80,-36
12,117,1,89,30,47,-17
12,117,1,97,35,29,6
12,117,1,117,34,0,34
12,117,2,20,0,40,-40
12,117,4,13,155,163,-8
12,117,4,19,0,42,-42
12,117,5,7,0,32,-32
12,117,5,119,29,0,29
12,117,6,1,32,41,-9
12,117,6,37,165,241,-76
12,117,6,59,49,49,0
12,117,6,65,29,0,29
12,117,6,67,34,0,34
12,117,6,71,37,29,8
12,117,6,73,87,136,-49
12,117,6,75,0,28,-28
12,117,6,85,0,25,-25
12,117,8,1,0,37,-37
12,117,8,5,29,44,-15
12,117,8,31,0,39,-39
12,117,8,35,0,63,-63
12,117,8,41,45,50,-5
12,117,8,69,0,20,-20
12,117,9,1,71,28,43
12,117,9,3,81,62,19
12,117,9,9,100,45,55
12,117,9,11,43,0,43
12,117,10,3,37,0,37
12,117,11,1,24,44,-20
12,117,12,1,321,224,97
12,117,12,5,48,49,-1
12,117,12,9,671,824,-153
12,117,12,11,907,593,314
12,117,12,15,74,70,4
12,117,12,17,59,74,-15
12,117,12,19,92,69,23
12,117,12,21,93,68,25
12,117,12,23,0,49,-49
12,117,12,31,533,539,-6
12,117,12,33,86,89,-3
12,117,12,35,123,165,-42
12,117,12,53,84,103,-19
12,117,12,55,57,54,3
12,117,12,57,535,700,-165
12,117,12,61,72,82,-10
12,117,12,69,1116,1763,-647
12,117,12,71,229,240,-11
12,117,12,73,300,224,76
12,117,12,81,111,119,-8
12,117,12,83,220,310,-90
12,117,12,85,73,60,13
12,117,12,86,712,493,219
12,117,12,87,44,37,7
12,117,12,89,0,27,-27
12,117,12,91,56,81,-25
12,117,12,95,18201,15861,2340
12,117,12,97,878,854,24
12,117,12,99,560,498,62
12,117,12,101,156,151,5
12,117,12,103,317,447,-130
12,117,12,105,489,674,-185
12,117,12,107,35,58,-23
12,117,12,109,65,159,-94
12,117,12,111,157,102,55
12,117,12,113,42,30,12
12,117,12,115,151,150,1
12,117,12,119,49,70,-21
12,117,12,127,3966,5048,-1082
12,117,13,51,69,70,-1
12,117,13,57,37,78,-41
12,117,13,63,0,28,-28
12,117,13,67,149,197,-48
12,117,13,89,73,119,-46
12,117,13,113,29,0,29
12,117,13,117,38,79,-41
12,117,13,121,120,240,-120
12,117,13,135,115,189,-74
12,117,13,139,32,0,32
12,117,13,151,0,81,-81
12,117,13,245,38,0,38
12,117,15,3,52,40,12
12,117,17,31,167,225,-58
12,117,17,43,65,52,13
12,117,17,89,0,38,-38
12,117,17,97,31,34,-3
12,117,18,57,52,53,-1
12,117,18,97,54,50,4
12,117,18,163,0,30,-30
12,117,20,91,0,42,-42
12,117,21,111,32,41,-9
12,117,22,33,0,38,-38
12,117,22,51,0,40,-40
12,117,24,3,51,31,20
12,117,24,5,43,33,10
12,117,24,27,33,0,33
12,117,24,31,58,62,-4
12,117,24,33,43,36,7
12,117,24,510,29,0,29
12,117,25,5,40,0,40
12,117,25,9,45,47,-2
12,117,25,13,47,64,-17
12,117,25,17,80,109,-29
12,117,25,21,30,0,30
12,117,25,23,34,0,34
12,117,25,25,51,41,10
12,117,25,27,49,61,-12
12,117,26,81,29,0,29
12,117,26,99,51,35,16
12,117,26,125,120,60,60
12,117,26,161,30,0,30
12,117,26,163,99,34,65
12,117,27,53,34,0,34
12,117,29,95,30,0,30
12,117,29,183,33,0,33
12,117,29,189,71,65,6
12,117,31,55,29,0,29
12,117,32,3,58,172,-114
12,117,33,11,49,50,-1
12,117,34,3,104,36,68
12,117,34,5,37,22,15
12,117,34,7,70,32,38
12,117,34,13,83,47,36
12,117,34,17,105,61,44
12,117,34,23,90,35,55
12,117,34,25,82,0,82
12,117,34,27,53,0,53
12,117,34,29,60,41,19
12,117,34,31,61,33,28
12,117,34,39,49,0,49
12,117,35,1,38,39,-1
12,117,36,1,20,0,20
12,117,36,5,294,131,163
12,117,36,7,36,0,36
12,117,36,27,0,34,-34
12,117,36,29,64,55,9
12,117,36,47,201,143,58
12,117,36,55,117,55,62
12,117,36,59,63,54,9
12,117,36,61,120,128,-8
12,117,36,67,44,55,-11
12,117,36,71,52,0,52
12,117,36,81,258,179,79
12,117,36,85,59,0,59
12,117,36,103,161,113,48
12,117,36,119,56,64,-8
12,117,37,21,30,71,-41
12,117,37,51,50,60,-10
12,117,37,63,0,29,-29
12,117,37,67,0,62,-62
12,117,37,81,0,27,-27
12,117,37,87,0,37,-37
12,117,37,119,103,275,-172
12,117,37,129,36,0,36
12,117,37,133,74,35,39
12,117,37,179,37,105,-68
12,117,37,183,74,184,-110
12,117,39,17,25,31,-6
12,117,39,35,86,49,37
12,117,39,49,108,97,11
12,117,39,61,46,33,13
12,117,39,99,0,28,-28
12,117,39,103,24,0,24
12,117,39,113,56,0,56
12,117,39,151,45,0,45
12,117,39,153,41,40,1
12,117,40,109,0,45,-45
12,117,41,51,0,27,-27
12,117,42,3,72,69,3
12,117,42,11,37,0,37
12,117,42,17,60,27,33
12,117,42,29,52,28,24
12,117,42,41,39,0,39
12,117,42,45,46,0,46
12,117,42,71,36,0,36
12,117,42,77,70,0,70
12,117,42,91,38,36,2
12,117,42,101,58,43,15
12,117,44,7,61,48,13
12,117,45,13,32,29,3
12,117,45,15,0,29,-29
12,117,45,19,0,41,-41
12,117,45,45,0,133,-133
12,117,45,51,0,43,-43
12,117,45,63,0,33,-33
12,117,45,79,42,46,-4
12,117,45,83,0,69,-69
12,117,45,91,0,49,-49
12,117,47,37,67,85,-18
12,117,47,65,54,57,-3
12,117,47,93,30,87,-57
12,117,47,125,0,38,-38
12,117,47,149,0,56,-56
12,117,47,155,0,33,-33
12,117,47,157,55,70,-15
12,117,47,179,0,33,-33
12,117,47,187,0,46,-46
12,117,48,27,32,60,-28
12,117,48,29,70,77,-7
12,117,48,85,51,89,-38
12,117,48,113,82,105,-23
12,117,48,121,37,73,-36
12,117,48,141,27,38,-11
12,117,48,157,35,0,35
12,117,48,167,0,33,-33
12,117,48,201,113,196,-83
12,117,48,339,0,52,-52
12,117,48,439,68,159,-91
12,117,48,453,39,77,-38
12,117,48,491,0,62,-62
12,117,49,35,37,40,-3
12,117,51,13,0,32,-32
12,117,51,41,36,0,36
12,117,51,59,83,115,-32
12,117,51,87,36,0,36
12,117,51,107,0,62,-62
12,117,51,153,63,37,26
12,117,51,510,0,38,-38
12,117,51,710,32,0,32
12,117,51,810,86,49,37
12,117,53,33,28,77,-49
12,117,53,53,0,57,-57
12,117,53,61,21,40,-19
12,117,55,79,34,29,5
12,117,55,133,0,55,-55
12,119,4,13,28,0,28
12,119,6,37,33,0,33
12,119,9,1,51,0,51
12,119,9,3,61,0,61
12,119,9,9,49,0,49
12,119,10,3,50,0,50
12,119,12,1,31,45,-14
12,119,12,9,48,0,48
12,119,12,11,196,39,157
12,119,12,17,166,212,-46
12,119,12,21,81,0,81
12,119,12,31,61,31,30
12,119,12,53,201,192,9
12,119,12,57,184,147,37
12,119,12,61,24,0,24
12,119,12,69,1108,857,251
12,119,12,71,137,0,137
12,119,12,73,0,23,-23
12,119,12,81,29,0,29
12,119,12,83,470,622,-152
12,119,12,86,74,29,45
12,119,12,95,220,115,105
12,119,12,97,43,26,17
12,119,12,99,178,36,142
12,119,12,101,205,153,52
12,119,12,103,174,69,105
12,119,12,105,116,84,32
12,119,12,111,47,0,47
12,119,12,115,48,0,48
12,119,12,117,70,49,21
12,119,12,127,61,36,25
12,119,13,135,39,0,39
12,119,17,31,74,0,74
12,119,17,43,33,0,33
12,119,17,97,31,0,31
12,119,23,5,31,0,31
12,119,24,3,41,0,41
12,119,24,5,46,0,46
12,119,24,31,29,0,29
12,119,25,1,42,0,42
12,119,25,5,31,0,31
12,119,25,9,49,0,49
12,119,25,17,48,0,48
12,119,25,21,28,0,28
12,119,25,25,25,0,25
12,119,25,27,38,0,38
12,119,26,99,34,0,34
12,119,26,125,64,0,64
12,119,26,163,36,0,36
12,119,33,11,46,0,46
12,119,33,15,30,0,30
12,119,34,5,27,0,27
12,119,34,25,29,0,29
12,119,34,27,41,0,41
12,119,34,29,41,0,41
12,119,36,29,37,0,37
12,119,36,55,46,0,46
12,119,36,59,83,0,83
12,119,36,67,37,0,37
12,119,36,71,28,0,28
12,119,36,81,39,0,39
12,119,36,85,31,0,31
12,119,36,91,27,0,27
12,119,36,103,176,0,176
12,119,36,119,26,0,26
12,119,39,61,42,0,42
12,119,42,3,57,0,57
12,119,42,11,39,0,39
12,119,42,17,24,0,24
12,119,44,7,56,0,56
12,119,51,59,70,0,70
12,119,55,79,32,0,32
12,121,12,1,92,150,-58
12,121,12,9,53,0,53
12,121,12,11,109,38,71
12,121,12,19,0,37,-37
12,121,12,23,609,618,-9
12,121,12,31,115,94,21
12,121,12,41,61,62,-1
12,121,12,47,152,160,-8
12,121,12,57,79,51,28
12,121,12,67,135,79,56
12,121,12,71,57,0,57
12,121,12,73,39,51,-12
12,121,12,79,88,44,44
12,121,12,81,33,0,33
12,121,12,83,46,42,4
12,121,12,86,93,59,34
12,121,12,95,70,37,33
12,121,12,97,25,0,25
12,121,12,99,39,0,39
12,121,12,101,33,0,33
12,121,12,103,106,26,80
12,121,12,105,72,0,72
12,121,12,109,0,27,-27
12,121,12,111,37,0,37
12,121,12,123,0,40,-40
12,121,12,125,33,0,33
12,121,12,127,33,0,33
12,121,13,185,39,39,0
12,123,12,29,40,0,40
12,123,12,31,36,57,-21
12,123,12,57,73,0,73
12,123,12,65,0,32,-32
12,123,12,73,69,163,-94
12,123,12,79,50,63,-13
12,123,12,95,0,30,-30
12,123,12,121,40,0,40
12,125,12,1,222,163,59
12,125,12,3,74,48,26
12,125,12,7,209,173,36
12,125,12,19,43,54,-11
12,125,12,23,140,142,-2
12,125,12,31,59,54,5
12,125,12,121,0,33,-33
12,127,1,73,31,51,-20
12,127,1,89,0,42,-42
12,127,1,117,0,31,-31
12,127,4,3,0,32,-32
12,127,4,13,134,162,-28
12,127,4,19,36,31,5
12,127,6,1,39,0,39
12,127,6,37,103,129,-26
12,127,6,59,60,40,20
12,127,6,65,35,0,35
12,127,6,71,40,30,10
12,127,6,73,114,145,-31
12,127,8,31,0,50,-50
12,127,8,41,72,77,-5
12,127,8,69,0,32,-32
12,127,9,1,61,67,-6
12,127,9,3,115,95,20
12,127,9,5,35,45,-10
12,127,9,7,30,0,30
12,127,9,9,123,88,35
12,127,9,11,52,42,10
12,127,9,15,23,0,23
12,127,10,3,43,54,-11
12,127,11,1,0,34,-34
12,127,12,1,280,302,-22
12,127,12,5,60,48,12
12,127,12,9,618,645,-27
12,127,12,11,812,531,281
12,127,12,15,48,54,-6
12,127,12,17,80,105,-25
12,127,12,19,86,159,-73
12,127,12,21,76,58,18
12,127,12,23,0,42,-42
12,127,12,31,666,846,-180
12,127,12,33,66,95,-29
12,127,12,35,1842,2792,-950
12,127,12,53,86,78,8
12,127,12,55,52,42,10
12,127,12,57,405,537,-132
12,127,12,61,46,95,-49
12,127,12,69,884,1117,-233
12,127,12,71,201,237,-36
12,127,12,73,199,233,-34
12,127,12,75,31,0,31
12,127,12,81,90,102,-12
12,127,12,83,303,364,-61
12,127,12,85,68,67,1
12,127,12,86,645,445,200
12,127,12,87,121,64,57
12,127,12,89,0,51,-51
12,127,12,91,51,67,-16
12,127,12,95,2958,2417,541
12,127,12,97,314,303,11
12,127,12,99,489,387,102
12,127,12,101,127,236,-109
12,127,12,103,331,364,-33
12,127,12,105,350,349,1
12,127,12,107,306,325,-19
12,127,12,109,226,244,-18
12,127,12,111,161,139,22
12,127,12,113,0,65,-65
12,127,12,115,60,147,-87
12,127,12,117,5048,3966,1082
12,127,12,119,36,61,-25
12,127,12,121,0,33,-33
12,127,13,51,46,80,-34
12,127,13,57,43,50,-7
12,127,13,59,0,24,-24
12,127,13,63,34,59,-25
12,127,13,67,98,131,-33
12,127,13,77,0,42,-42
12,127,13,89,81,111,-30
12,127,13,113,0,28,-28
12,127,13,117,0,60,-60
12,127,13,121,51,161,-110
12,127,13,135,77,119,-42
12,127,13,139,0,34,-34
12,127,13,151,40,35,5
12,127,13,153,36,50,-14
12,127,13,179,36,0,36
12,127,13,185,0,38,-38
12,127,13,245,34,32,2
12,127,13,291,0,40,-40
12,127,15,3,45,52,-7
12,127,17,31,109,129,-20
12,127,17,43,24,0,24
12,127,17,89,0,36,-36
12,127,17,97,38,0,38
12,127,17,111,30,0,30
12,127,17,197,50,42,8
12,127,18,3,36,0,36
12,127,18,89,30,0,30
12,127,18,97,67,57,10
12,127,19,113,0,26,-26
12,127,20,91,0,26,-26
12,127,20,173,0,31,-31
12,127,21,67,28,28,0
12,127,21,111,26,77,-51
12,127,22,71,0,27,-27
12,127,23,1,0,30,-30
12,127,23,5,35,39,-4
12,127,23,31,45,25,20
12,127,24,3,70,46,24
12,127,24,5,36,54,-18
12,127,24,21,25,0,25
12,127,24,25,46,0,46
12,127,24,27,33,0,33
12,127,24,31,65,50,15
12,127,24,33,71,0,71
12,127,24,510,0,20,-20
12,127,25,1,41,0,41
12,127,25,3,26,41,-15
12,127,25,5,53,41,12
12,127,25,9,122,79,43
12,127,25,13,70,78,-8
12,127,25,17,92,69,23
12,127,25,21,51,25,26
12,127,25,23,60,64,-4
12,127,25,25,45,42,3
12,127,25,27,140,95,45
12,127,26,49,34,0,34
12,127,26,99,40,0,40
12,127,26,125,82,56,26
12,127,26,139,23,0,23
12,127,26,161,24,0,24
12,127,26,163,85,47,38
12,127,27,53,39,40,-1
12,127,27,123,31,0,31
12,127,29,77,0,35,-35
12,127,29,189,32,32,0
12,127,31,55,30,0,30
12,127,32,3,115,160,-45
12,127,32,31,22,0,22
12,127,33,9,36,0,36
12,127,33,11,25,59,-34
12,127,33,15,61,45,16
12,127,34,1,54,0,54
12,127,34,3,79,43,36
12,127,34,5,56,0,56
12,127,34,7,67,29,38
12,127,34,13,83,27,56
12,127,34,15,39,0,39
12,127,34,17,64,39,25
12,127,34,23,67,48,19
12,127,34,25,93,0,93
12,127,34,27,58,0,58
12,127,34,29,130,51,79
12,127,34,31,66,35,31
12,127,34,35,31,0,31
12,127,34,39,39,0,39
12,127,36,1,46,0,46
12,127,36,5,184,106,78
12,127,36,7,33,25,8
12,127,36,15,0,26,-26
12,127,36,27,30,35,-5
12,127,36,29,70,85,-15
12,127,36,35,0,28,-28
12,127,36,45,35,28,7
12,127,36,47,133,107,26
12,127,36,55,93,61,32
12,127,36,59,91,53,38
12,127,36,61,111,76,35
12,127,36,63,36,0,36
12,127,36,65,51,33,18
12,127,36,67,51,82,-31
12,127,36,69,0,22,-22
12,127,36,71,110,39,71
12,127,36,75,0,30,-30
12,127,36,81,90,120,-30
12,127,36,85,57,41,16
12,127,36,91,34,43,-9
12,127,36,103,286,127,159
12,127,36,105,36,0,36
12,127,36,111,40,0,40
12,127,36,119,73,24,49
12,127,37,21,42,83,-41
12,127,37,25,0,65,-65
12,127,37,35,0,31,-31
12,127,37,51,54,73,-19
12,127,37,67,26,50,-24
12,127,37,71,0,44,-44
12,127,37,81,0,40,-40
12,127,37,87,0,42,-42
12,127,37,89,0,71,-71
12,127,37,97,0,73,-73
12,127,37,101,0,24,-24
12,127,37,109,0,38,-38
12,127,37,119,68,208,-140
12,127,37,129,0,33,-33
12,127,37,133,51,53,-2
12,127,37,175,0,27,-27
12,127,37,183,60,126,-66
12,127,39,35,67,42,25
12,127,39,49,82,84,-2
12,127,39,61,58,39,19
12,127,39,95,0,21,-21
12,127,39,113,37,63,-26
12,127,39,151,56,0,56
12,127,39,153,62,45,17
12,127,39,155,39,38,1
12,127,39,165,29,0,29
12,127,40,109,0,30,-30
12,127,40,143,27,30,-3
12,127,42,3,105,83,22
12,127,42,7,28,0,28
12,127,42,11,38,0,38
12,127,42,17,53,43,10
12,127,42,19,34,0,34
12,127,42,45,34,26,8
12,127,42,49,25,0,25
12,127,42,55,24,0,24
12,127,42,71,31,38,-7
12,127,42,77,38,40,-2
12,127,42,89,45,0,45
12,127,42,91,58,36,22
12,127,42,95,42,0,42
12,127,42,101,85,54,31
12,127,42,129,32,39,-7
12,127,42,133,37,31,6
12,127,44,7,99,75,24
12,127,45,3,0,34,-34
12,127,45,7,0,44,-44
12,127,45,13,0,75,-75
12,127,45,19,36,40,-4
12,127,45,45,28,129,-101
12,127,45,51,48,49,-1
12,127,45,63,0,34,-34
12,127,45,79,39,36,3
12,127,45,83,0,51,-51
12,127,45,91,0,63,-63
12,127,47,9,0,50,-50
12,127,47,37,44,74,-30
12,127,47,65,37,74,-37
12,127,47,89,0,26,-26
12,127,47,93,30,77,-47
12,127,47,123,0,49,-49
12,127,47,149,0,64,-64
12,127,47,155,0,43,-43
12,127,47,157,56,35,21
12,127,47,179,0,51,-51
12,127,48,27,33,28,5
12,127,48,29,71,75,-4
12,127,48,85,0,44,-44
12,127,48,113,56,65,-9
12,127,48,121,0,63,-63
12,127,48,141,34,34,0
12,127,48,201,96,151,-55
12,127,48,339,0,42,-42
12,127,48,439,35,125,-90
12,127,49,35,0,37,-37
12,127,50,21,0,25,-25
12,127,51,41,0,40,-40
12,127,51,59,72,66,6
12,127,51,107,0,37,-37
12,127,51,153,38,48,-10
12,127,51,550,0,30,-30
12,127,51,700,0,36,-36
12,127,51,710,34,0,34
12,127,51,810,74,45,29
12,127,53,33,28,61,-33
12,127,53,53,0,42,-42
12,127,53,61,0,35,-35
12,127,54,39,29,0,29
12,127,55,79,29,0,29
12,129,12,5,52,44,8
12,129,12,31,34,31,3
12,129,12,37,79,35,44
12,129,12,39,98,0,98
12,129,12,57,27,0,27
12,129,12,65,55,0,55
12,129,12,73,1665,1035,630
12,129,12,95,35,0,35
12,129,12,103,31,0,31
12,131,1,39,130,91,39
12,131,1,61,38,71,-33
12,131,1,69,32,42,-10
12,131,1,73,54,0,54
12,131,1,81,22,0,22
12,131,1,117,0,37,-37
12,131,12,1,31,0,31
12,131,12,5,296,308,-12
12,131,12,11,42,0,42
12,131,12,31,50,0,50
12,131,12,33,129,95,34
12,131,12,57,31,26,5
12,131,12,59,204,187,17
12,131,12,63,35,0,35
12,131,12,73,80,96,-16
12,131,12,86,0,29,-29
12,131,12,91,1829,1159,670
12,131,12,95,51,44,7
12,131,12,103,0,24,-24
12,131,12,105,48,25,23
12,131,12,113,158,131,27
12,131,12,133,56,39,17
12,131,13,67,32,29,3
12,131,13,89,46,0,46
12,131,13,121,31,42,-11
12,131,13,135,40,0,40
12,131,47,37,37,0,37
12,131,47,157,46,0,46
12,133,1,69,0,72,-72
12,133,12,5,697,480,217
12,133,12,31,57,0,57
12,133,12,33,33,0,33
12,133,12,59,312,314,-2
12,133,12,63,289,222,67
12,133,12,73,39,40,-1
12,133,12,91,51,0,51
12,133,12,131,39,56,-17
13,1,13,5,86,73,13
13,1,13,69,39,37,2
13,1,13,127,0,44,-44
13,1,13,161,182,187,-5
13,1,13,279,41,0,41
13,1,13,299,33,0,33
13,1,13,305,63,56,7
13,3,13,19,35,40,-5
13,3,13,69,187,217,-30
13,5,13,1,73,86,-13
13,5,13,69,98,121,-23
13,5,13,161,0,44,-44
13,5,13,229,29,38,-9
13,5,13,299,45,72,-27
13,7,13,95,51,53,-2
13,7,13,205,76,50,26
13,9,13,21,227,227,0
13,9,13,51,26,0,26
13,9,13,59,24,51,-27
13,9,13,63,0,39,-39
13,9,13,67,43,35,8
13,9,13,89,27,63,-36
13,9,13,121,43,104,-61
13,9,13,135,54,78,-24
13,9,13,141,250,142,108
13,9,13,151,0,31,-31
13,9,13,153,50,45,5
13,9,13,169,172,212,-40
13,9,13,175,48,57,-9
13,9,13,217,0,58,-58
13,9,13,237,276,236,40
13,9,13,245,0,31,-31
13,9,13,247,28,27,1
13,9,13,303,112,81,31
13,9,13,319,204,170,34
13,11,13,13,62,38,24
13,11,13,59,27,0,27
13,11,13,119,71,44,27
13,11,13,135,115,60,55
13,11,13,137,378,394,-16
13,11,13,139,290,234,56
13,11,13,157,369,342,27
13,11,13,195,62,73,-11
13,11,13,257,36,70,-34
13,11,13,311,50,32,18
13,13,6,77,48,0,48
13,13,12,11,95,0,95
13,13,12,31,0,27,-27
13,13,12,86,41,0,41
13,13,12,95,36,0,36
13,13,12,99,35,0,35
13,13,13,11,38,62,-24
13,13,13,57,31,0,31
13,13,13,59,476,281,195
13,13,13,63,61,29,32
13,13,13,67,85,59,26
13,13,13,89,227,151,76
13,13,13,117,57,75,-18
13,13,13,121,157,116,41
13,13,13,135,3588,1499,2089
13,13,13,139,361,340,21
13,13,13,147,0,35,-35
13,13,13,151,72,0,72
13,13,13,157,513,608,-95
13,13,13,195,58,77,-19
13,13,13,217,71,0,71
13,13,13,219,142,154,-12
13,13,13,221,47,60,-13
13,13,13,241,0,27,-27
13,13,13,247,31,40,-9
13,13,13,257,0,68,-68
13,13,13,297,549,489,60
13,13,13,311,0,25,-25
13,15,1,19,0,31,-31
13,15,4,13,0,39,-39
13,15,6,73,34,0,34
13,15,12,11,56,0,56
13,15,12,31,44,0,44
13,15,12,86,39,0,39
13,15,12,95,60,0,60
13,15,13,45,70,36,34
13,15,13,55,36,30,6
13,15,13,57,794,571,223
13,15,13,59,0,21,-21
13,15,13,63,37,41,-4
13,15,13,67,1801,1262,539
13,15,13,77,39,0,39
13,15,13,89,133,84,49
13,15,13,97,74,92,-18
13,15,13,115,697,575,122
13,15,13,117,63,52,11
13,15,13,121,250,165,85
13,15,13,123,37,41,-4
13,15,13,129,581,590,-9
13,15,13,135,113,113,0
13,15,13,139,39,46,-7
13,15,13,143,28,0,28
13,15,13,151,38,0,38
13,15,13,213,39,28,11
13,15,13,223,474,557,-83
13,15,13,227,92,42,50
13,15,13,233,296,250,46
13,15,13,295,0,62,-62
13,15,13,313,91,52,39
13,15,47,65,69,41,28
13,17,13,69,115,82,33
13,17,13,153,0,42,-42
13,17,13,155,234,269,-35
13,17,13,185,29,41,-12
13,17,13,277,87,84,3
13,17,13,287,33,0,33
13,17,13,315,70,38,32
13,19,13,3,40,35,5
13,19,13,75,88,164,-76
13,19,13,115,156,80,76
13,19,13,155,48,0,48
13,19,13,173,99,96,3
13,19,13,185,347,241,106
13,19,13,277,234,186,48
13,19,37,51,50,0,50
13,19,37,85,42,0,42
13,21,1,73,0,33,-33
13,21,1,89,30,0,30
13,21,1,101,30,0,30
13,21,6,37,31,31,0
13,21,6,73,0,33,-33
13,21,12,11,64,40,24
13,21,12,31,80,81,-1
13,21,12,57,44,41,3
13,21,12,73,25,37,-12
13,21,12,86,95,34,61
13,21,12,95,39,45,-6
13,21,12,99,31,37,-6
13,21,13,9,227,227,0
13,21,13,23,0,40,-40
13,21,13,31,37,29,8
13,21,13,35,36,50,-14
13,21,13,45,25,0,25
13,21,13,51,99,145,-46
13,21,13,57,32,34,-2
13,21,13,59,69,88,-19
13,21,13,63,174,206,-32
13,21,13,67,156,268,-112
13,21,13,77,25,40,-15
13,21,13,79,325,398,-73
13,21,13,81,35,0,35
13,21,13,89,226,272,-46
13,21,13,91,44,47,-3
13,21,13,95,105,58,47
13,21,13,97,0,33,-33
13,21,13,115,28,0,28
13,21,13,121,212,412,-200
13,21,13,127,43,43,0
13,21,13,135,186,199,-13
13,21,13,141,0,35,-35
13,21,13,151,121,227,-106
13,21,13,153,1222,1565,-343
13,21,13,169,826,1056,-230
13,21,13,171,38,0,38
13,21,13,175,132,98,34
13,21,13,179,46,0,46
13,21,13,185,71,43,28
13,21,13,207,482,618,-136
13,21,13,215,90,92,-2
13,21,13,217,30,27,3
13,21,13,219,0,38,-38
13,21,13,225,321,427,-106
13,21,13,235,51,0,51
13,21,13,237,58,69,-11
13,21,13,245,72,69,3
13,21,13,255,38,51,-13
13,21,13,261,26,0,26
13,21,13,269,27,0,27
13,21,13,277,48,0,48
13,21,13,289,291,268,23
13,21,13,293,45,31,14
13,21,13,303,48,0,48
13,21,13,319,130,82,48
13,21,17,31,60,35,25
13,21,26,163,46,0,46
13,21,32,3,0,36,-36
13,21,36,61,0,31,-31
13,21,37,67,0,64,-64
13,21,37,119,0,45,-45
13,21,39,35,57,0,57
13,21,45,19,0,30,-30
13,21,45,79,27,42,-15
13,21,47,65,0,46,-46
13,23,13,21,40,0,40
13,23,13,91,121,101,20
13,23,13,121,0,29,-29
13,23,13,153,144,109,35
13,23,13,175,34,48,-14
13,23,13,235,58,43,15
13,23,13,289,0,43,-43
13,25,12,31,53,0,53
13,25,13,39,76,47,29
13,25,13,127,396,301,95
13,25,13,229,77,108,-31
13,25,13,299,190,163,27
13,25,13,305,52,59,-7
13,27,13,71,153,66,87
13,27,13,75,0,65,-65
13,27,13,185,547,646,-99
13,27,13,275,139,154,-15
13,29,13,31,128,154,-26
13,29,13,51,1403,963,440
13,29,13,103,307,254,53
13,29,13,109,0,35,-35
13,29,13,121,0,31,-31
13,29,13,135,47,0,47
13,29,13,179,303,279,24
13,29,13,267,30,0,30
13,29,45,13,0,23,-23
13,31,12,11,31,0,31
13,31,12,31,43,64,-21
13,31,12,99,27,0,27
13,31,13,21,29,37,-8
13,31,13,29,154,128,26
13,31,13,33,50,26,24
13,31,13,39,24,0,24
13,31,13,43,205,168,37
13,31,13,51,453,450,3
13,31,13,57,0,27,-27
13,31,13,59,0,29,-29
13,31,13,63,33,46,-13
13,31,13,67,78,81,-3
13,31,13,73,35,0,35
13,31,13,89,87,116,-29
13,31,13,95,0,30,-30
13,31,13,103,300,212,88
13,31,13,107,111,105,6
13,31,13,109,118,156,-38
13,31,13,121,73,101,-28
13,31,13,127,51,35,16
13,31,13,135,68,90,-22
13,31,13,139,0,35,-35
13,31,13,153,50,48,2
13,31,13,165,123,100,23
13,31,13,175,30,0,30
13,31,13,179,84,79,5
13,31,13,183,0,37,-37
13,31,13,185,47,0,47
13,31,13,245,71,103,-32
13,31,13,251,300,217,83
13,31,13,267,80,90,-10
13,31,13,279,53,42,11
13,31,13,305,37,0,37
13,31,37,119,0,29,-29
13,31,45,13,41,46,-5
13,31,45,19,0,32,-32
13,31,45,79,37,0,37
13,33,12,11,25,0,25
13,33,13,31,26,50,-24
13,33,13,73,107,131,-24
13,33,13,107,65,45,20
13,33,13,163,78,74,4
13,33,13,165,64,54,10
13,33,13,245,707,758,-51
13,33,13,251,38,29,9
13,33,45,3,35,50,-15
13,35,13,21,50,36,14
13,35,13,63,274,106,168
13,35,13,67,35,34,1
13,35,13,77,38,0,38
13,35,13,89,62,35,27
13,35,13,113,50,0,50
13,35,13,121,71,67,4
13,35,13,135,40,41,-1
13,35,13,151,863,562,301
13,35,13,159,53,75,-22
13,35,13,171,41,0,41
13,35,13,207,67,104,-37
13,35,13,217,119,89,30
13,35,13,247,73,32,41
13,35,13,255,265,252,13
13,37,13,95,54,122,-68
13,37,13,99,52,41,11
13,37,13,243,32,0,32
13,39,6,71,33,30,3
13,39,6,73,72,140,-68
13,39,9,11,281,157,124
13,39,12,9,37,59,-22
13,39,12,11,61,0,61
13,39,12,19,51,66,-15
13,39,12,31,557,564,-7
13,39,12,33,39,0,39
13,39,12,86,37,0,37
13,39,12,89,339,322,17
13,39,12,95,0,45,-45
13,39,12,103,29,0,29
13,39,12,109,0,33,-33
13,39,13,25,47,76,-29
13,39,13,31,0,24,-24
13,39,13,49,120,135,-15
13,39,13,51,38,65,-27
13,39,13,59,41,0,41
13,39,13,67,30,32,-2
13,39,13,95,0,32,-32
13,39,13,121,0,47,-47
13,39,13,127,287,316,-29
13,39,13,135,51,0,51
13,39,13,179,29,0,29
13,39,13,185,33,43,-10
13,39,13,299,43,54,-11
13,39,15,3,114,93,21
13,39,28,47,0,47,-47
13,39,36,91,36,0,36
13,39,37,133,47,165,-118
13,39,45,15,179,83,96
13,39,45,19,55,53,2
13,39,45,35,45,36,9
13,39,48,201,0,29,-29
13,39,51,550,102,0,102
13,39,51,700,31,0,31
13,39,51,710,139,65,74
13,39,51,740,42,0,42
13,39,51,810,160,108,52
13,39,53,35,170,193,-23
13,43,13,31,168,205,-37
13,43,13,51,29,0,29
13,43,13,107,88,105,-17
13,43,13,267,70,72,-2
13,45,1,15,60,91,-31
13,45,1,29,133,132,1
13,45,1,73,52,51,1
13,45,1,111,97,93,4
13,45,12,11,71,0,71
13,45,12,31,33,0,33
13,45,12,57,32,0,32
13,45,12,86,77,0,77
13,45,12,95,0,26,-26
13,45,13,15,36,70,-34
13,45,13,21,0,25,-25
13,45,13,51,0,51,-51
13,45,13,57,96,78,18
13,45,13,59,0,29,-29
13,45,13,63,91,104,-13
13,45,13,67,664,541,123
13,45,13,77,318,300,18
13,45,13,89,189,155,34
13,45,13,97,1884,1201,683
13,45,13,113,96,48,48
13,45,13,115,61,54,7
13,45,13,121,336,386,-50
13,45,13,135,198,115,83
13,45,13,139,33,41,-8
13,45,13,143,870,1021,-151
13,45,13,149,269,224,45
13,45,13,151,107,84,23
13,45,13,215,50,46,4
13,45,13,217,0,46,-46
13,45,13,223,611,635,-24
13,45,13,233,69,83,-14
13,45,13,247,33,0,33
13,45,13,255,0,34,-34
13,45,13,285,74,46,28
13,45,47,65,0,35,-35
13,47,12,103,27,0,27
13,47,13,55,43,0,43
13,47,13,67,52,56,-4
13,47,13,83,96,93,3
13,47,13,115,35,0,35
13,47,13,121,0,21,-21
13,47,13,129,66,56,10
13,47,13,135,36,0,36
13,47,13,213,104,78,26
13,47,13,295,1253,1158,95
13,47,13,313,422,551,-129
13,47,47,11,95,103,-8
13,47,47,65,1971,1618,353
13,47,47,93,30,0,30
13,47,47,115,46,0,46
13,49,12,3,43,43,0
13,49,12,31,128,103,25
13,49,12,89,141,76,65
13,49,13,39,135,120,15
13,49,13,299,0,42,-42
13,51,1,45,57,0,57
13,51,1,73,44,51,-7
13,51,1,81,32,0,32
13,51,1,89,39,45,-6
13,51,1,97,0,36,-36
13,51,1,101,30,45,-15
13,51,1,117,0,36,-36
13,51,2,20,0,40,-40
13,51,2,90,61,0,61
13,51,4,3,33,53,-20
13,51,4,13,89,102,-13
13,51,4,19,26,0,26
13,51,5,119,0,29,-29
13,51,6,1,0,27,-27
13,51,6,37,134,187,-53
13,51,6,59,57,0,57
13,51,6,65,30,0,30
13,51,6,67,0,36,-36
13,51,6,71,63,36,27
13,51,6,73,76,63,13
13,51,6,75,0,24,-24
13,51,6,85,0,35,-35
13,51,8,31,0,41,-41
13,51,8,41,63,80,-17
13,51,9,1,46,27,19
13,51,9,3,24,0,24
13,51,11,1,0,35,-35
13,51,12,1,40,23,17
13,51,12,9,71,54,17
13,51,12,11,202,88,114
13,51,12,19,66,51,15
13,51,12,21,24,30,-6
13,51,12,31,361,326,35
13,51,12,33,40,47,-7
13,51,12,35,0,30,-30
13,51,12,57,121,127,-6
13,51,12,71,84,35,49
13,51,12,73,64,29,35
13,51,12,81,0,28,-28
13,51,12,83,27,40,-13
13,51,12,86,221,137,84
13,51,12,87,33,0,33
13,51,12,89,27,0,27
13,51,12,91,50,0,50
13,51,12,95,172,121,51
13,51,12,97,32,0,32
13,51,12,99,139,74,65
13,51,12,101,33,24,9
13,51,12,103,78,61,17
13,51,12,105,57,38,19
13,51,12,109,45,54,-9
13,51,12,115,42,46,-4
13,51,12,117,70,69,1
13,51,12,127,80,46,34
13,51,13,9,0,26,-26
13,51,13,21,145,99,46
13,51,13,29,963,1403,-440
13,51,13,31,450,453,-3
13,51,13,39,65,38,27
13,51,13,43,0,29,-29
13,51,13,45,51,0,51
13,51,13,57,64,54,10
13,51,13,59,114,94,20
13,51,13,63,122,181,-59
13,51,13,67,316,313,3
13,51,13,69,27,0,27
13,51,13,73,58,73,-15
13,51,13,77,46,25,21
13,51,13,89,334,379,-45
13,51,13,95,43,71,-28
13,51,13,97,65,0,65
13,51,13,103,1294,1972,-678
13,51,13,107,45,0,45
13,51,13,109,64,58,6
13,51,13,113,40,43,-3
13,51,13,117,38,56,-18
13,51,13,121,372,478,-106
13,51,13,127,209,207,2
13,51,13,135,235,261,-26
13,51,13,139,51,43,8
13,51,13,151,92,86,6
13,51,13,153,129,126,3
13,51,13,175,68,0,68
13,51,13,179,836,610,226
13,51,13,183,64,62,2
13,51,13,185,83,57,26
13,51,13,191,56,74,-18
13,51,13,215,121,139,-18
13,51,13,217,30,0,30
13,51,13,223,53,0,53
13,51,13,245,236,207,29
13,51,13,247,23,41,-18
13,51,13,251,46,74,-28
13,51,13,255,0,28,-28
13,51,13,267,62,78,-16
13,51,13,277,26,0,26
13,51,13,279,79,44,35
13,51,13,285,0,24,-24
13,51,13,299,66,42,24
13,51,13,305,33,36,-3
13,51,15,3,64,67,-3
13,51,17,31,95,105,-10
13,51,17,43,35,0,35
13,51,17,197,0,24,-24
13,51,18,97,43,0,43
13,51,20,173,38,0,38
13,51,21,47,63,0,63
13,51,21,93,39,0,39
13,51,21,111,43,39,4
13,51,22,71,0,50,-50
13,51,24,3,50,59,-9
13,51,24,5,47,37,10
13,51,24,21,27,0,27
13,51,24,31,40,61,-21
13,51,24,33,60,49,11
13,51,24,510,0,22,-22
13,51,25,17,46,28,18
13,51,26,99,25,0,25
13,51,26,125,39,37,2
13,51,26,163,93,0,93
13,51,29,189,41,0,41
13,51,32,3,51,78,-27
13,51,34,17,0,25,-25
13,51,36,5,37,37,0
13,51,36,45,71,48,23
13,51,36,47,99,62,37
13,51,36,55,25,0,25
13,51,36,59,24,25,-1
13,51,36,61,65,69,-4
13,51,36,67,44,32,12
13,51,36,71,30,0,30
13,51,36,81,51,36,15
13,51,36,103,74,31,43
13,51,36,119,33,0,33
13,51,37,21,30,32,-2
13,51,37,51,120,158,-38
13,51,37,67,31,41,-10
13,51,37,81,25,69,-44
13,51,37,119,143,143,0
13,51,37,129,0,41,-41
13,51,37,133,47,0,47
13,51,37,147,28,0,28
13,51,37,183,82,106,-24
13,51,39,35,66,0,66
13,51,39,49,65,55,10
13,51,39,61,60,20,40
13,51,39,113,28,0,28
13,51,40,31,0,45,-45
13,51,42,3,50,0,50
13,51,42,29,29,0,29
13,51,42,91,31,0,31
13,51,42,101,32,61,-29
13,51,44,7,34,0,34
13,51,45,3,24,51,-27
13,51,45,13,429,307,122
13,51,45,15,69,46,23
13,51,45,19,168,152,16
13,51,45,35,52,76,-24
13,51,45,45,76,74,2
13,51,45,49,34,59,-25
13,51,45,51,79,54,25
13,51,45,53,148,185,-37
13,51,45,63,34,35,-1
13,51,45,79,75,130,-55
13,51,45,83,35,29,6
13,51,45,85,35,0,35
13,51,45,91,29,0,29
13,51,47,37,47,73,-26
13,51,47,65,32,0,32
13,51,47,93,75,50,25
13,51,47,125,92,59,33
13,51,47,157,54,50,4
13,51,48,27,93,93,0
13,51,48,29,65,99,-34
13,51,48,85,0,48,-48
13,51,48,113,43,67,-24
13,51,48,121,0,44,-44
13,51,48,141,53,92,-39
13,51,48,201,93,134,-41
13,51,48,439,77,51,26
13,51,48,453,36,58,-22
13,51,49,35,0,28,-28
13,51,51,59,61,61,0
13,51,51,87,0,31,-31
13,51,51,153,0,42,-42
13,51,51,550,36,0,36
13,51,51,700,68,53,15
13,51,51,710,59,0,59
13,51,51,760,0,29,-29
13,51,51,810,47,46,1
13,51,53,33,52,30,22
13,51,53,53,52,74,-22
13,51,53,61,32,47,-15
13,51,55,79,28,0,28
13,53,1,81,0,157,-157
13,53,1,113,91,252,-161
13,53,2,90,41,0,41
13,53,4,3,0,30,-30
13,53,4,13,0,24,-24
13,53,6,37,0,30,-30
13,53,6,71,48,53,-5
13,53,8,41,88,70,18
13,53,13,145,0,35,-35
13,53,13,197,0,49,-49
13,53,13,215,719,964,-245
13,53,15,3,66,50,16
13,53,20,61,49,44,5
13,53,20,161,0,59,-59
13,53,21,47,66,47,19
13,53,22,115,53,0,53
13,53,29,169,61,0,61
13,53,36,45,138,95,43
13,53,36,71,100,0,100
13,53,37,51,109,165,-56
13,53,47,125,113,156,-43
13,53,48,27,149,171,-22
13,53,48,29,97,67,30
13,53,48,141,62,68,-6
13,53,53,53,92,106,-14
13,55,1,19,90,83,7
13,55,1,49,0,48,-48
13,55,13,15,30,36,-6
13,55,13,47,0,43,-43
13,55,13,115,242,264,-22
13,55,13,129,66,72,-6
13,55,13,233,0,43,-43
13,55,13,295,292,327,-35
13,55,13,313,45,0,45
13,57,1,3,0,41,-41
13,57,1,73,33,45,-12
13,57,1,89,0,38,-38
13,57,1,117,37,0,37
13,57,4,13,83,87,-4
13,57,6,37,132,83,49
13,57,6,59,79,37,42
13,57,6,65,41,50,-9
13,57,6,67,0,33,-33
13,57,6,71,36,0,36
13,57,6,73,66,46,20
13,57,10,5,0,28,-28
13,57,12,5,33,0,33
13,57,12,9,50,0,50
13,57,12,11,337,90,247
13,57,12,31,68,48,20
13,57,12,33,0,28,-28
13,57,12,57,79,51,28
13,57,12,61,32,29,3
13,57,12,71,79,37,42
13,57,12,73,26,40,-14
13,57,12,86,163,74,89
13,57,12,91,0,38,-38
13,57,12,95,172,70,102
13,57,12,97,41,0,41
13,57,12,99,230,86,144
13,57,12,101,65,0,65
13,57,12,103,93,47,46
13,57,12,105,65,0,65
13,57,12,109,0,47,-47
13,57,12,115,30,31,-1
13,57,12,117,78,37,41
13,57,12,127,50,43,7
13,57,13,13,0,31,-31
13,57,13,15,571,794,-223
13,57,13,21,34,32,2
13,57,13,31,27,0,27
13,57,13,45,78,96,-18
13,57,13,51,54,64,-10
13,57,13,59,56,62,-6
13,57,13,63,125,47,78
13,57,13,67,6101,3852,2249
13,57,13,77,81,65,16
13,57,13,85,53,72,-19
13,57,13,89,493,351,142
13,57,13,97,153,102,51
13,57,13,111,81,39,42
13,57,13,113,98,0,98
13,57,13,115,61,98,-37
13,57,13,117,635,638,-3
13,57,13,121,2909,1579,1330
13,57,13,123,164,172,-8
13,57,13,127,33,0,33
13,57,13,129,47,83,-36
13,57,13,135,747,864,-117
13,57,13,137,29,0,29
13,57,13,139,105,117,-12
13,57,13,151,129,80,49
13,57,13,153,29,39,-10
13,57,13,157,0,39,-39
13,57,13,185,47,32,15
13,57,13,187,51,62,-11
13,57,13,215,60,51,9
13,57,13,217,59,62,-3
13,57,13,223,366,498,-132
13,57,13,227,594,790,-196
13,57,13,233,43,51,-8
13,57,13,247,47,0,47
13,57,13,255,23,0,23
13,57,13,291,39,46,-7
13,57,13,297,64,43,21
13,57,13,313,0,35,-35
13,57,17,31,69,81,-12
13,57,17,43,0,25,-25
13,57,17,97,42,0,42
13,57,20,91,33,0,33
13,57,21,111,34,0,34
13,57,24,47,0,42,-42
13,57,26,125,35,0,35
13,57,29,189,35,0,35
13,57,32,3,73,0,73
13,57,34,9,0,30,-30
13,57,36,47,33,0,33
13,57,36,59,70,0,70
13,57,36,61,0,37,-37
13,57,36,81,35,0,35
13,57,36,103,69,0,69
13,57,37,119,87,74,13
13,57,37,133,35,0,35
13,57,37,183,50,77,-27
13,57,39,49,36,0,36
13,57,42,101,40,0,40
13,57,45,19,0,28,-28
13,57,45,45,0,78,-78
13,57,45,51,0,27,-27
13,57,47,37,35,47,-12
13,57,47,65,49,63,-14
13,57,47,93,0,82,-82
13,57,47,157,45,42,3
13,57,47,187,0,33,-33
13,57,48,29,0,48,-48
13,57,48,113,0,39,-39
13,57,48,121,51,0,51
13,57,48,201,63,70,-7
13,57,48,439,35,44,-9
13,57,48,453,38,43,-5
13,57,51,59,46,0,46
13,57,51,107,37,0,37
13,57,51,810,48,41,7
13,57,53,33,41,30,11
13,59,1,73,30,47,-17
13,59,6,1,0,20,-20
13,59,6,37,65,91,-26
13,59,6,73,32,57,-25
13,59,11,1,0,39,-39
13,59,12,1,39,26,13
13,59,12,11,63,0,63
13,59,12,31,63,49,14
13,59,12,33,26,0,26
13,59,12,57,36,44,-8
13,59,12,73,28,0,28
13,59,12,86,66,26,40
13,59,12,95,33,44,-11
13,59,12,99,30,27,3
13,59,12,127,24,0,24
13,59,13,9,51,24,27
13,59,13,11,0,27,-27
13,59,13,13,281,476,-195
13,59,13,15,21,0,21
13,59,13,21,88,69,19
13,59,13,31,29,0,29
13,59,13,39,0,41,-41
13,59,13,45,29,0,29
13,59,13,51,94,114,-20
13,59,13,57,62,56,6
13,59,13,63,63,32,31
13,59,13,67,324,282,42
13,59,13,73,58,36,22
13,59,13,77,0,31,-31
13,59,13,89,337,570,-233
13,59,13,95,58,0,58
13,59,13,97,26,36,-10
13,59,13,105,154,72,82
13,59,13,113,38,30,8
13,59,13,115,31,0,31
13,59,13,117,63,59,4
13,59,13,119,64,60,4
13,59,13,121,366,599,-233
13,59,13,127,41,43,-2
13,59,13,133,87,67,20
13,59,13,135,552,543,9
13,59,13,137,39,36,3
13,59,13,139,166,121,45
13,59,13,147,65,54,11
13,59,13,151,41,41,0
13,59,13,153,57,48,9
13,59,13,157,468,471,-3
13,59,13,175,26,0,26
13,59,13,185,52,29,23
13,59,13,187,22,0,22
13,59,13,195,631,803,-172
13,59,13,211,85,85,0
13,59,13,215,45,57,-12
13,59,13,217,84,49,35
13,59,13,219,708,1183,-475
13,59,13,221,391,485,-94
13,59,13,245,79,141,-62
13,59,13,247,97,37,60
13,59,13,255,25,0,25
13,59,13,257,44,0,44
13,59,13,277,27,28,-1
13,59,13,295,27,0,27
13,59,13,297,226,190,36
13,59,13,313,28,0,28
13,59,13,317,72,44,28
13,59,17,31,54,63,-9
13,59,18,105,25,0,25
13,59,22,71,0,34,-34
13,59,24,31,0,34,-34
13,59,25,17,0,34,-34
13,59,28,83,0,38,-38
13,59,32,3,0,30,-30
13,59,36,47,0,41,-41
13,59,36,61,27,41,-14
13,59,37,21,0,43,-43
13,59,37,49,0,23,-23
13,59,37,63,0,34,-34
13,59,37,119,30,71,-41
13,59,37,183,34,61,-27
13,59,45,13,29,31,-2
13,59,45,19,39,56,-17
13,59,45,45,24,28,-4
13,59,45,79,23,42,-19
13,59,47,37,22,70,-48
13,59,47,65,0,43,-43
13,59,47,93,0,23,-23
13,59,48,29,0,29,-29
13,59,48,113,26,42,-16
13,59,48,201,0,33,-33
13,59,48,453,0,36,-36
13,59,51,59,0,32,-32
13,59,53,33,0,31,-31
13,63,1,73,115,113,2
13,63,1,81,40,41,-1
13,63,1,89,54,51,3
13,63,1,97,64,71,-7
13,63,1,101,102,85,17
13,63,4,13,49,60,-11
13,63,4,19,0,30,-30
13,63,6,37,205,141,64
13,63,6,67,38,0,38
13,63,6,71,89,0,89
13,63,6,73,48,69,-21
13,63,9,3,51,0,51
13,63,11,1,35,0,35
13,63,12,5,38,43,-5
13,63,12,9,28,0,28
13,63,12,11,346,143,203
13,63,12,31,153,105,48
13,63,12,33,58,33,25
13,63,12,57,153,69,84
13,63,12,71,46,38,8
13,63,12,73,65,34,31
13,63,12,81,37,0,37
13,63,12,86,499,145,354
13,63,12,91,31,0,31
13,63,12,95,193,90,103
13,63,12,99,127,76,51
13,63,12,103,29,41,-12
13,63,12,105,52,41,11
13,63,12,111,50,0,50
13,63,12,117,28,0,28
13,63,12,127,59,34,25
13,63,13,9,39,0,39
13,63,13,13,29,61,-32
13,63,13,15,41,37,4
13,63,13,21,206,174,32
13,63,13,31,46,33,13
13,63,13,35,106,274,-168
13,63,13,45,104,91,13
13,63,13,51,181,122,59
13,63,13,57,47,125,-78
13,63,13,59,32,63,-31
13,63,13,67,1274,1413,-139
13,63,13,77,331,663,-332
13,63,13,89,5020,3660,1360
13,63,13,95,120,71,49
13,63,13,97,425,509,-84
13,63,13,113,969,1582,-613
13,63,13,117,0,81,-81
13,63,13,121,10480,9724,756
13,63,13,127,0,32,-32
13,63,13,135,1142,1213,-71
13,63,13,139,40,70,-30
13,63,13,151,3462,5789,-2327
13,63,13,153,69,83,-14
13,63,13,157,0,29,-29
13,63,13,159,0,34,-34
13,63,13,171,54,110,-56
13,63,13,175,49,0,49
13,63,13,179,91,58,33
13,63,13,185,49,56,-7
13,63,13,187,0,31,-31
13,63,13,199,46,65,-19
13,63,13,207,0,111,-111
13,63,13,215,200,126,74
13,63,13,217,175,263,-88
13,63,13,223,92,209,-117
13,63,13,231,57,136,-79
13,63,13,245,159,95,64
13,63,13,247,267,318,-51
13,63,13,255,487,828,-341
13,63,13,275,37,0,37
13,63,13,285,52,50,2
13,63,13,293,55,0,55
13,63,13,297,58,54,4
13,63,17,31,234,198,36
13,63,17,197,38,0,38
13,63,18,97,46,42,4
13,63,21,111,51,52,-1
13,63,22,33,44,37,7
13,63,22,51,50,81,-31
13,63,22,71,37,206,-169
13,63,24,5,102,42,60
13,63,24,31,0,44,-44
13,63,24,33,147,70,77
13,63,24,510,47,0,47
13,63,25,17,30,0,30
13,63,25,25,53,0,53
13,63,26,125,42,0,42
13,63,26,163,131,101,30
13,63,28,47,26,35,-9
13,63,28,49,42,0,42
13,63,29,189,38,38,0
13,63,32,3,59,73,-14
13,63,34,13,121,47,74
13,63,34,23,33,0,33
13,63,34,31,73,0,73
13,63,34,39,42,0,42
13,63,36,5,159,75,84
13,63,36,29,24,0,24
13,63,36,47,264,152,112
13,63,36,59,60,0,60
13,63,36,61,46,46,0
13,63,36,81,209,110,99
13,63,36,103,75,0,75
13,63,36,119,45,0,45
13,63,37,51,62,82,-20
13,63,37,81,35,57,-22
13,63,37,119,101,91,10
13,63,37,183,42,56,-14
13,63,39,35,88,56,32
13,63,39,49,80,32,48
13,63,39,61,77,34,43
13,63,39,99,29,0,29
13,63,40,109,27,0,27
13,63,42,3,45,55,-10
13,63,42,101,97,59,38
13,63,45,19,36,31,5
13,63,45,45,29,0,29
13,63,45,79,45,58,-13
13,63,45,83,0,41,-41
13,63,47,37,55,39,16
13,63,47,65,43,33,10
13,63,47,93,31,34,-3
13,63,47,125,31,0,31
13,63,47,149,0,36,-36
13,63,47,157,81,57,24
13,63,48,27,65,37,28
13,63,48,29,27,40,-13
13,63,48,113,79,74,5
13,63,48,201,92,164,-72
13,63,48,439,37,90,-53
13,63,51,59,46,31,15
13,63,51,153,49,0,49
13,63,51,650,33,0,33
13,63,51,700,62,34,28
13,63,51,710,50,27,23
13,63,51,740,32,0,32
13,63,51,810,49,0,49
13,63,53,33,0,58,-58
13,63,53,53,34,49,-15
13,63,55,79,46,35,11
13,65,13,185,55,34,21
13,65,13,299,53,53,0
13,67,1,3,55,89,-34
13,67,1,15,69,65,4
13,67,1,19,0,26,-26
13,67,1,47,33,0,33
13,67,1,69,40,35,5
13,67,1,73,357,282,75
13,67,1,81,136,109,27
13,67,1,89,100,110,-10
13,67,1,97,116,96,20
13,67,1,101,137,154,-17
13,67,1,103,0,30,-30
13,67,1,117,92,103,-11
13,67,1,125,63,56,7
13,67,2,20,32,0,32
13,67,4,13,248,283,-35
13,67,4,19,36,72,-36
13,67,5,7,34,44,-10
13,67,5,119,64,58,6
13,67,6,1,92,89,3
13,67,6,13,67,55,12
13,67,6,19,26,0,26
13,67,6,29,28,0,28
13,67,6,37,687,451,236
13,67,6,59,222,169,53
13,67,6,65,93,62,31
13,67,6,67,63,50,13
13,67,6,71,99,74,25
13,67,6,73,223,234,-11
13,67,6,75,31,44,-13
13,67,6,81,0,30,-30
13,67,6,85,98,136,-38
13,67,6,111,43,33,10
13,67,8,5,59,32,27
13,67,8,13,0,33,-33
13,67,8,31,71,77,-6
13,67,8,35,51,66,-15
13,67,8,41,71,73,-2
13,67,9,1,137,95,42
13,67,9,3,92,95,-3
13,67,9,9,84,27,57
13,67,10,3,89,74,15
13,67,11,1,66,120,-54
13,67,12,1,86,55,31
13,67,12,5,111,72,39
13,67,12,9,133,110,23
13,67,12,11,878,368,510
13,67,12,15,30,30,0
13,67,12,19,52,61,-9
13,67,12,21,72,37,35
13,67,12,31,285,304,-19
13,67,12,33,117,117,0
13,67,12,35,0,46,-46
13,67,12,57,425,334,91
13,67,12,61,28,0,28
13,67,12,69,56,59,-3
13,67,12,71,107,107,0
13,67,12,73,180,66,114
13,67,12,81,79,63,16
13,67,12,83,59,42,17
13,67,12,85,30,0,30
13,67,12,86,774,329,445
13,67,12,89,29,0,29
13,67,12,91,58,76,-18
13,67,12,95,509,379,130
13,67,12,97,53,31,22
13,67,12,99,454,252,202
13,67,12,101,91,60,31
13,67,12,103,187,165,22
13,67,12,105,145,74,71
13,67,12,109,48,85,-37
13,67,12,111,56,0,56
13,67,12,113,28,48,-20
13,67,12,115,66,63,3
13,67,12,117,197,149,48
13,67,12,127,131,98,33
13,67,12,131,29,32,-3
13,67,13,9,35,43,-8
13,67,13,13,59,85,-26
13,67,13,15,1262,1801,-539
13,67,13,21,268,156,112
13,67,13,31,81,78,3
13,67,13,35,34,35,-1
13,67,13,39,32,30,2
13,67,13,45,541,664,-123
13,67,13,47,56,52,4
13,67,13,51,313,316,-3
13,67,13,57,3852,6101,-2249
13,67,13,59,282,324,-42
13,67,13,63,1413,1274,139
13,67,13,73,100,60,40
13,67,13,77,283,302,-19
13,67,13,85,0,51,-51
13,67,13,89,4898,4581,317
13,67,13,95,146,57,89
13,67,13,97,2734,3902,-1168
13,67,13,111,67,40,27
13,67,13,113,395,258,137
13,67,13,115,214,214,0
13,67,13,117,355,689,-334
13,67,13,121,11910,11668,242
13,67,13,123,81,97,-16
13,67,13,127,42,85,-43
13,67,13,129,95,173,-78
13,67,13,133,0,48,-48
13,67,13,135,2851,2914,-63
13,67,13,137,30,0,30
13,67,13,139,171,234,-63
13,67,13,143,85,82,3
13,67,13,145,33,0,33
13,67,13,151,639,548,91
13,67,13,153,137,130,7
13,67,13,157,42,58,-16
13,67,13,169,36,0,36
13,67,13,171,0,31,-31
13,67,13,175,0,28,-28
13,67,13,177,56,0,56
13,67,13,179,49,43,6
13,67,13,185,137,61,76
13,67,13,187,0,46,-46
13,67,13,211,0,34,-34
13,67,13,213,0,36,-36
13,67,13,215,280,154,126
13,67,13,217,170,207,-37
13,67,13,219,30,0,30
13,67,13,223,3161,6035,-2874
13,67,13,227,127,200,-73
13,67,13,233,98,203,-105
13,67,13,245,193,192,1
13,67,13,247,247,192,55
13,67,13,255,48,83,-35
13,67,13,277,27,0,27
13,67,13,285,57,73,-16
13,67,13,291,28,38,-10
13,67,13,295,36,30,6
13,67,13,297,98,58,40
13,67,13,311,32,0,32
13,67,13,313,133,65,68
13,67,15,3,86,62,24
13,67,17,31,606,469,137
13,67,17,43,102,125,-23
13,67,17,89,0,33,-33
13,67,17,97,62,79,-17
13,67,17,143,60,0,60
13,67,17,161,24,0,24
13,67,17,163,38,0,38
13,67,17,197,81,61,20
13,67,18,3,54,36,18
13,67,18,57,65,0,65
13,67,18,89,86,26,60
13,67,18,97,134,116,18
13,67,18,141,52,0,52
13,67,19,163,0,43,-43
13,67,20,91,60,74,-14
13,67,20,173,38,61,-23
13,67,21,67,65,49,16
13,67,21,111,107,110,-3
13,67,22,17,29,0,29
13,67,22,33,91,79,12
13,67,22,51,91,195,-104
13,67,22,55,27,0,27
13,67,22,71,74,277,-203
13,67,22,103,77,46,31
13,67,23,5,0,30,-30
13,67,24,3,83,54,29
13,67,24,5,125,88,37
13,67,24,21,55,0,55
13,67,24,25,40,41,-1
13,67,24,27,37,50,-13
13,67,24,31,170,147,23
13,67,24,33,183,91,92
13,67,24,510,59,57,2
13,67,25,5,44,0,44
13,67,25,9,0,38,-38
13,67,25,13,47,0,47
13,67,25,17,194,109,85
13,67,25,21,73,45,28
13,67,25,23,42,0,42
13,67,25,25,104,63,41
13,67,25,27,60,0,60
13,67,26,49,61,0,61
13,67,26,65,58,0,58
13,67,26,77,49,0,49
13,67,26,81,70,0,70
13,67,26,99,104,33,71
13,67,26,125,223,77,146
13,67,26,145,31,0,31
13,67,26,161,67,23,44
13,67,26,163,435,128,307
13,67,27,37,0,27,-27
13,67,27,53,127,119,8
13,67,27,123,37,0,37
13,67,28,33,0,52,-52
13,67,28,47,58,47,11
13,67,28,49,75,54,21
13,67,28,59,32,0,32
13,67,28,89,0,35,-35
13,67,29,77,26,0,26
13,67,29,95,73,49,24
13,67,29,183,49,0,49
13,67,29,189,141,82,59
13,67,29,510,37,28,9
13,67,31,55,50,51,-1
13,67,32,3,191,215,-24
13,67,32,31,0,33,-33
13,67,33,11,40,0,40
13,67,34,1,38,0,38
13,67,34,3,74,0,74
13,67,34,5,43,0,43
13,67,34,7,49,39,10
13,67,34,13,172,71,101
13,67,34,17,75,60,15
13,67,34,21,49,41,8
13,67,34,23,103,105,-2
13,67,34,25,46,0,46
13,67,34,27,32,0,32
13,67,34,31,61,0,61
13,67,34,35,39,0,39
13,67,34,39,81,35,46
13,67,35,1,32,26,6
13,67,36,1,42,0,42
13,67,36,5,202,91,111
13,67,36,27,42,0,42
13,67,36,29,85,43,42
13,67,36,47,419,214,205
13,67,36,55,129,43,86
13,67,36,59,253,99,154
13,67,36,61,227,261,-34
13,67,36,67,49,36,13
13,67,36,71,48,40,8
13,67,36,81,403,181,222
13,67,36,87,61,0,61
13,67,36,93,34,0,34
13,67,36,103,180,84,96
13,67,36,119,158,91,67
13,67,37,21,33,69,-36
13,67,37,25,0,50,-50
13,67,37,35,0,41,-41
13,67,37,43,0,36,-36
13,67,37,49,0,31,-31
13,67,37,51,86,95,-9
13,67,37,63,80,80,0
13,67,37,67,68,58,10
13,67,37,71,25,0,25
13,67,37,81,93,75,18
13,67,37,89,34,0,34
13,67,37,119,330,384,-54
13,67,37,129,60,54,6
13,67,37,133,79,79,0
13,67,37,135,41,28,13
13,67,37,179,49,44,5
13,67,37,183,265,230,35
13,67,39,17,63,37,26
13,67,39,35,149,141,8
13,67,39,49,221,135,86
13,67,39,57,45,0,45
13,67,39,61,134,85,49
13,67,39,93,38,0,38
13,67,39,95,46,42,4
13,67,39,99,35,0,35
13,67,39,113,82,40,42
13,67,39,153,71,0,71
13,67,39,165,30,0,30
13,67,40,109,75,36,39
13,67,40,143,70,57,13
13,67,41,51,29,52,-23
13,67,41,67,43,41,2
13,67,42,3,106,72,34
13,67,42,17,65,35,30
13,67,42,29,69,70,-1
13,67,42,45,35,37,-2
13,67,42,71,43,33,10
13,67,42,91,95,59,36
13,67,42,95,35,0,35
13,67,42,101,134,116,18
13,67,44,7,105,31,74
13,67,45,3,37,27,10
13,67,45,7,56,48,8
13,67,45,13,100,149,-49
13,67,45,15,39,51,-12
13,67,45,19,155,144,11
13,67,45,35,32,0,32
13,67,45,45,163,173,-10
13,67,45,51,43,69,-26
13,67,45,63,30,70,-40
13,67,45,73,0,54,-54
13,67,45,79,144,105,39
13,67,45,83,40,55,-15
13,67,45,91,0,50,-50
13,67,47,11,36,38,-2
13,67,47,37,222,227,-5
13,67,47,65,220,186,34
13,67,47,93,144,130,14
13,67,47,113,29,0,29
13,67,47,125,69,0,69
13,67,47,149,48,73,-25
13,67,47,155,0,33,-33
13,67,47,157,269,168,101
13,67,47,187,59,104,-45
13,67,48,27,59,52,7
13,67,48,29,118,183,-65
13,67,48,61,0,42,-42
13,67,48,85,127,177,-50
13,67,48,113,266,264,2
13,67,48,121,77,112,-35
13,67,48,141,42,59,-17
13,67,48,157,63,65,-2
13,67,48,201,314,591,-277
13,67,48,339,47,31,16
13,67,48,439,243,267,-24
13,67,48,453,82,185,-103
13,67,48,491,43,37,6
13,67,49,35,34,79,-45
13,67,49,49,39,43,-4
13,67,51,13,53,58,-5
13,67,51,41,55,60,-5
13,67,51,59,234,203,31
13,67,51,87,56,70,-14
13,67,51,107,88,66,22
13,67,51,153,49,56,-7
13,67,51,510,0,61,-61
13,67,51,550,39,32,7
13,67,51,650,68,30,38
13,67,51,700,36,32,4
13,67,51,710,60,34,26
13,67,51,740,26,0,26
13,67,51,760,44,28,16
13,67,51,800,38,0,38
13,67,51,810,150,72,78
13,67,53,11,33,27,6
13,67,53,33,163,189,-26
13,67,53,53,59,50,9
13,67,53,61,0,52,-52
13,67,55,25,50,0,50
13,67,55,79,170,35,135
13,67,55,133,0,40,-40
13,69,12,31,69,47,22
13,69,12,86,39,0,39
13,69,13,1,37,39,-2
13,69,13,3,217,187,30
13,69,13,5,121,98,23
13,69,13,17,82,115,-33
13,69,13,51,0,27,-27
13,69,13,89,0,30,-30
13,69,13,95,0,38,-38
13,69,13,127,0,36,-36
13,69,13,153,0,30,-30
13,69,13,155,57,63,-6
13,69,13,161,95,78,17
13,69,13,185,44,110,-66
13,69,13,229,0,44,-44
13,69,13,271,48,0,48
13,69,13,277,37,31,6
13,69,13,299,78,66,12
13,71,12,31,33,0,33
13,71,12,57,52,0,52
13,71,12,73,29,33,-4
13,71,12,86,57,0,57
13,71,12,99,48,0,48
13,71,13,27,66,153,-87
13,71,13,75,66,81,-15
13,71,13,89,0,23,-23
13,71,13,95,102,95,7
13,71,13,121,0,29,-29
13,71,13,131,0,53,-53
13,71,13,153,32,34,-2
13,71,13,177,0,44,-44
13,71,13,185,86,106,-20
13,71,13,205,183,58,125
13,71,13,275,221,221,0
13,71,13,277,153,206,-53
13,71,13,321,136,115,21
13,73,1,81,31,0,31
13,73,4,3,65,37,28
13,73,4,13,58,0,58
13,73,6,53,87,0,87
13,73,6,73,33,0,33
13,73,8,41,61,96,-35
13,73,12,11,74,0,74
13,73,12,31,59,38,21
13,73,12,33,47,0,47
13,73,12,57,53,35,18
13,73,12,71,29,0,29
13,73,12,86,47,0,47
13,73,12,95,41,28,13
13,73,13,31,0,35,-35
13,73,13,33,131,107,24
13,73,13,51,73,58,15
13,73,13,59,36,58,-22
13,73,13,67,60,100,-40
13,73,13,89,59,80,-21
13,73,13,117,0,42,-42
13,73,13,121,96,179,-83
13,73,13,135,118,70,48
13,73,13,139,35,0,35
13,73,13,153,53,0,53
13,73,13,163,81,44,37
13,73,13,179,60,0,60
13,73,13,181,94,91,3
13,73,13,189,245,370,-125
13,73,13,215,51,44,7
13,73,13,245,4501,3279,1222
13,73,13,301,0,38,-38
13,73,13,317,39,0,39
13,73,15,3,92,97,-5
13,73,20,91,28,0,28
13,73,24,3,172,48,124
13,73,24,27,0,41,-41
13,73,24,31,62,35,27
13,73,24,33,31,26,5
13,73,36,45,40,0,40
13,73,37,21,0,40,-40
13,73,37,51,37,80,-43
13,73,37,119,42,58,-16
13,73,37,133,42,0,42
13,73,37,183,33,56,-23
13,73,40,31,41,0,41
13,73,45,3,563,490,73
13,73,45,13,0,49,-49
13,73,45,19,24,49,-25
13,73,45,37,36,101,-65
13,73,45,45,34,53,-19
13,73,45,63,38,79,-41
13,73,45,65,50,49,1
13,73,45,79,45,87,-42
13,73,45,83,35,0,35
13,73,47,125,67,48,19
13,73,47,157,43,0,43
13,73,48,27,61,103,-42
13,73,48,29,103,71,32
13,73,48,141,56,0,56
13,73,48,201,0,40,-40
13,73,51,59,0,108,-108
13,73,51,810,46,43,3
13,73,53,53,56,39,17
13,75,12,57,31,0,31
13,75,13,19,164,88,76
13,75,13,27,65,0,65
13,75,13,71,81,66,15
13,75,13,173,0,31,-31
13,75,13,185,327,371,-44
13,75,13,277,136,155,-19
13,77,1,3,0,25,-25
13,77,1,73,41,31,10
13,77,1,81,51,49,2
13,77,1,111,0,35,-35
13,77,4,13,44,32,12
13,77,6,37,73,34,39
13,77,12,5,33,0,33
13,77,12,9,35,35,0
13,77,12,11,182,47,135
13,77,12,31,55,34,21
13,77,12,57,53,0,53
13,77,12,71,48,0,48
13,77,12,86,129,0,129
13,77,12,91,41,0,41
13,77,12,95,49,45,4
13,77,12,99,72,0,72
13,77,12,103,36,0,36
13,77,12,127,42,0,42
13,77,13,15,0,39,-39
13,77,13,21,40,25,15
13,77,13,35,0,38,-38
13,77,13,45,300,318,-18
13,77,13,51,25,46,-21
13,77,13,57,65,81,-16
13,77,13,59,31,0,31
13,77,13,63,663,331,332
13,77,13,67,302,283,19
13,77,13,89,241,201,40
13,77,13,97,128,112,16
13,77,13,113,1850,723,1127
13,77,13,117,44,27,17
13,77,13,121,1253,1053,200
13,77,13,135,191,182,9
13,77,13,149,191,253,-62
13,77,13,151,524,264,260
13,77,13,153,51,0,51
13,77,13,199,402,359,43
13,77,13,215,135,63,72
13,77,13,217,40,0,40
13,77,13,223,56,72,-16
13,77,13,231,32,63,-31
13,77,13,245,0,28,-28
13,77,13,247,28,0,28
13,77,13,255,182,137,45
13,77,13,285,293,295,-2
13,77,13,293,43,0,43
13,77,15,3,0,32,-32
13,77,26,163,59,0,59
13,77,36,5,28,0,28
13,77,36,29,23,0,23
13,77,36,59,59,0,59
13,77,36,81,41,0,41
13,77,37,119,0,55,-55
13,77,37,183,41,0,41
13,77,39,49,43,0,43
13,77,45,45,37,0,37
13,77,47,157,39,0,39
13,77,48,201,39,36,3
13,77,48,439,89,59,30
13,79,13,21,398,325,73
13,79,13,153,215,240,-25
13,79,13,207,57,38,19
13,79,13,225,102,119,-17
13,79,13,269,0,29,-29
13,81,13,21,0,35,-35
13,81,13,89,30,0,30
13,81,13,93,220,160,60
13,81,13,95,44,69,-25
13,81,13,121,0,36,-36
13,81,13,153,41,82,-41
13,81,13,177,43,45,-2
13,81,13,261,55,70,-15
13,81,13,277,0,49,-49
13,81,13,287,93,60,33
13,81,13,315,73,53,20
13,81,13,321,64,51,13
13,83,1,49,50,93,-43
13,83,1,71,120,102,18
13,83,13,47,93,96,-3
13,83,13,295,122,154,-32
13,83,47,65,315,320,-5
13,83,47,115,70,60,10
13,85,13,57,72,53,19
13,85,13,67,51,0,51
13,85,13,89,27,34,-7
13,85,13,117,668,528,140
13,85,13,121,154,86,68
13,85,13,123,64,33,31
13,85,13,135,118,70,48
13,85,13,139,211,183,28
13,85,13,187,227,286,-59
13,85,13,227,38,0,38
13,85,13,311,30,29,1
13,87,12,11,27,0,27
13,87,12,39,133,51,82
13,87,12,73,154,117,37
13,87,13,95,54,0,54
13,87,13,99,33,32,1
13,87,13,131,134,133,1
13,87,13,185,0,27,-27
13,87,13,201,71,95,-24
13,87,13,205,0,49,-49
13,87,13,253,160,196,-36
13,87,13,275,45,60,-15
13,89,1,3,47,53,-6
13,89,1,15,45,37,8
13,89,1,55,31,40,-9
13,89,1,73,354,233,121
13,89,1,81,109,48,61
13,89,1,89,145,104,41
13,89,1,97,126,135,-9
13,89,1,101,166,150,16
13,89,1,113,40,0,40
13,89,1,117,52,55,-3
13,89,1,125,70,52,18
13,89,4,13,195,260,-65
13,89,4,19,30,59,-29
13,89,5,119,52,57,-5
13,89,6,1,131,123,8
13,89,6,13,42,76,-34
13,89,6,37,625,498,127
13,89,6,59,177,112,65
13,89,6,65,0,51,-51
13,89,6,67,31,54,-23
13,89,6,71,70,62,8
13,89,6,73,220,228,-8
13,89,6,75,79,94,-15
13,89,6,81,40,68,-28
13,89,6,85,76,139,-63
13,89,6,95,0,42,-42
13,89,8,5,46,66,-20
13,89,8,13,34,61,-27
13,89,8,31,92,114,-22
13,89,8,41,48,37,11
13,89,8,59,0,31,-31
13,89,8,69,0,22,-22
13,89,9,1,140,59,81
13,89,9,3,125,80,45
13,89,9,9,95,74,21
13,89,10,3,73,54,19
13,89,11,1,235,170,65
13,89,12,1,136,70,66
13,89,12,5,49,34,15
13,89,12,9,130,85,45
13,89,12,11,751,316,435
13,89,12,19,32,34,-2
13,89,12,21,42,25,17
13,89,12,31,380,269,111
13,89,12,33,79,78,1
13,89,12,57,309,191,118
13,89,12,61,36,0,36
13,89,12,69,30,0,30
13,89,12,71,100,59,41
13,89,12,73,230,113,117
13,89,12,81,34,0,34
13,89,12,83,51,49,2
13,89,12,86,748,442,306
13,89,12,89,0,34,-34
13,89,12,91,65,38,27
13,89,12,95,487,259,228
13,89,12,97,34,57,-23
13,89,12,99,363,200,163
13,89,12,101,45,36,9
13,89,12,103,164,162,2
13,89,12,105,69,53,16
13,89,12,109,24,51,-27
13,89,12,111,38,34,4
13,89,12,113,0,25,-25
13,89,12,115,36,51,-15
13,89,12,117,119,73,46
13,89,12,127,111,81,30
13,89,12,131,0,46,-46
13,89,13,9,63,27,36
13,89,13,13,151,227,-76
13,89,13,15,84,133,-49
13,89,13,21,272,226,46
13,89,13,31,116,87,29
13,89,13,35,35,62,-27
13,89,13,45,155,189,-34
13,89,13,51,379,334,45
13,89,13,57,351,493,-142
13,89,13,59,570,337,233
13,89,13,63,3660,5020,-1360
13,89,13,67,4581,4898,-317
13,89,13,69,30,0,30
13,89,13,71,23,0,23
13,89,13,73,80,59,21
13,89,13,77,201,241,-40
13,89,13,81,0,30,-30
13,89,13,85,34,27,7
13,89,13,95,215,195,20
13,89,13,97,589,742,-153
13,89,13,111,0,35,-35
13,89,13,113,314,313,1
13,89,13,115,90,77,13
13,89,13,117,319,641,-322
13,89,13,121,22078,21258,820
13,89,13,123,0,24,-24
13,89,13,127,72,80,-8
13,89,13,129,46,31,15
13,89,13,133,36,0,36
13,89,13,135,11447,16382,-4935
13,89,13,137,24,0,24
13,89,13,139,251,354,-103
13,89,13,151,1213,2003,-790
13,89,13,153,148,126,22
13,89,13,157,46,118,-72
13,89,13,159,37,0,37
13,89,13,175,44,32,12
13,89,13,179,70,43,27
13,89,13,185,141,74,67
13,89,13,187,29,52,-23
13,89,13,207,25,31,-6
13,89,13,211,47,64,-17
13,89,13,215,327,228,99
13,89,13,217,1200,2096,-896
13,89,13,219,0,35,-35
13,89,13,223,173,290,-117
13,89,13,225,27,0,27
13,89,13,227,0,38,-38
13,89,13,231,27,0,27
13,89,13,237,0,39,-39
13,89,13,241,0,48,-48
13,89,13,245,305,223,82
13,89,13,247,1538,2936,-1398
13,89,13,255,100,104,-4
13,89,13,257,22,0,22
13,89,13,261,48,0,48
13,89,13,275,46,0,46
13,89,13,277,26,35,-9
13,89,13,285,66,59,7
13,89,13,297,306,453,-147
13,89,13,311,0,38,-38
13,89,13,313,46,33,13
13,89,15,3,99,48,51
13,89,17,19,42,32,10
13,89,17,31,570,539,31
13,89,17,43,73,67,6
13,89,17,89,29,0,29
13,89,17,97,66,57,9
13,89,17,113,31,0,31
13,89,17,143,34,0,34
13,89,17,163,30,0,30
13,89,17,197,55,37,18
13,89,18,3,26,0,26
13,89,18,57,35,0,35
13,89,18,89,62,32,30
13,89,18,97,149,133,16
13,89,19,153,0,46,-46
13,89,19,163,0,48,-48
13,89,20,91,29,36,-7
13,89,21,67,45,35,10
13,89,21,111,94,119,-25
13,89,22,17,37,49,-12
13,89,22,33,114,133,-19
13,89,22,51,132,121,11
13,89,22,55,35,28,7
13,89,22,71,184,416,-232
13,89,22,73,0,46,-46
13,89,22,103,0,57,-57
13,89,23,1,0,32,-32
13,89,24,3,69,38,31
13,89,24,5,163,77,86
13,89,24,27,46,38,8
13,89,24,31,188,141,47
13,89,24,33,281,164,117
13,89,24,510,126,84,42
13,89,25,9,29,27,2
13,89,25,13,55,0,55
13,89,25,17,141,151,-10
13,89,25,21,72,51,21
13,89,25,23,35,0,35
13,89,25,25,121,147,-26
13,89,25,27,30,56,-26
13,89,26,49,97,26,71
13,89,26,65,37,0,37
13,89,26,77,26,0,26
13,89,26,81,49,0,49
13,89,26,99,56,0,56
13,89,26,125,199,52,147
13,89,26,161,69,55,14
13,89,26,163,392,119,273
13,89,27,53,131,154,-23
13,89,27,123,79,59,20
13,89,28,35,0,37,-37
13,89,28,47,0,42,-42
13,89,28,49,75,78,-3
13,89,28,59,29,0,29
13,89,28,89,25,0,25
13,89,28,105,35,0,35
13,89,29,95,72,44,28
13,89,29,189,134,84,50
13,89,29,510,78,90,-12
13,89,31,55,37,32,5
13,89,32,3,175,212,-37
13,89,34,3,110,55,55
13,89,34,5,32,29,3
13,89,34,7,34,32,2
13,89,34,13,168,105,63
13,89,34,17,78,84,-6
13,89,34,21,45,47,-2
13,89,34,23,141,58,83
13,89,34,25,47,0,47
13,89,34,27,0,32,-32
13,89,34,31,55,30,25
13,89,34,35,30,0,30
13,89,34,39,67,25,42
13,89,35,1,34,35,-1
13,89,36,1,30,38,-8
13,89,36,5,390,180,210
13,89,36,27,36,0,36
13,89,36,29,109,71,38
13,89,36,47,665,363,302
13,89,36,55,100,73,27
13,89,36,59,139,79,60
13,89,36,61,368,364,4
13,89,36,67,48,28,20
13,89,36,81,423,195,228
13,89,36,85,43,0,43
13,89,36,87,27,0,27
13,89,36,103,157,69,88
13,89,36,119,146,85,61
13,89,37,21,63,117,-54
13,89,37,51,93,98,-5
13,89,37,63,128,120,8
13,89,37,67,89,78,11
13,89,37,71,0,26,-26
13,89,37,81,120,106,14
13,89,37,119,372,390,-18
13,89,37,129,52,45,7
13,89,37,133,37,0,37
13,89,37,135,59,38,21
13,89,37,147,39,0,39
13,89,37,183,191,246,-55
13,89,39,35,220,139,81
13,89,39,49,226,218,8
13,89,39,61,202,126,76
13,89,39,95,0,45,-45
13,89,39,99,37,0,37
13,89,39,113,65,35,30
13,89,39,153,65,0,65
13,89,40,109,39,28,11
13,89,40,143,34,0,34
13,89,41,5,0,28,-28
13,89,41,39,0,24,-24
13,89,41,51,39,73,-34
13,89,41,67,0,28,-28
13,89,42,3,171,157,14
13,89,42,17,42,24,18
13,89,42,29,0,42,-42
13,89,42,43,35,0,35
13,89,42,45,57,61,-4
13,89,42,91,65,58,7
13,89,42,95,38,0,38
13,89,42,101,231,192,39
13,89,44,7,102,57,45
13,89,45,3,42,52,-10
13,89,45,7,47,37,10
13,89,45,13,49,54,-5
13,89,45,15,47,40,7
13,89,45,19,136,214,-78
13,89,45,35,35,44,-9
13,89,45,41,41,0,41
13,89,45,43,0,41,-41
13,89,45,45,103,135,-32
13,89,45,51,50,47,3
13,89,45,63,53,44,9
13,89,45,73,0,25,-25
13,89,45,75,37,0,37
13,89,45,79,206,156,50
13,89,45,83,62,45,17
13,89,45,85,36,41,-5
13,89,45,91,31,37,-6
13,89,47,37,292,308,-16
13,89,47,65,100,165,-65
13,89,47,93,130,121,9
13,89,47,113,30,0,30
13,89,47,125,56,40,16
13,89,47,149,40,32,8
13,89,47,157,283,221,62
13,89,47,163,28,0,28
13,89,47,179,26,0,26
13,89,47,187,52,58,-6
13,89,48,27,52,48,4
13,89,48,29,84,78,6
13,89,48,85,64,144,-80
13,89,48,113,235,277,-42
13,89,48,121,49,70,-21
13,89,48,141,0,43,-43
13,89,48,157,0,96,-96
13,89,48,201,315,337,-22
13,89,48,245,0,35,-35
13,89,48,439,101,164,-63
13,89,48,453,151,175,-24
13,89,48,491,0,34,-34
13,89,49,35,28,49,-21
13,89,51,13,84,84,0
13,89,51,41,37,32,5
13,89,51,59,203,178,25
13,89,51,87,77,70,7
13,89,51,107,28,78,-50
13,89,51,153,67,55,12
13,89,51,510,64,56,8
13,89,51,550,41,32,9
13,89,51,650,58,33,25
13,89,51,700,89,39,50
13,89,51,710,87,56,31
13,89,51,760,41,53,-12
13,89,51,810,90,28,62
13,89,53,33,165,308,-143
13,89,53,53,37,62,-25
13,89,54,61,27,0,27
13,89,55,25,27,0,27
13,89,55,79,111,96,15
13,91,13,21,47,44,3
13,91,13,23,101,121,-20
13,91,13,153,57,103,-46
13,91,13,175,77,110,-33
13,91,13,235,33,27,6
13,91,13,271,88,98,-10
13,93,13,81,160,220,-60
13,93,13,153,119,172,-53
13,93,13,193,55,0,55
13,93,13,261,30,30,0
13,95,6,73,62,50,12
13,95,12,5,0,34,-34
13,95,12,11,74,46,28
13,95,12,31,71,103,-32
13,95,12,57,39,37,2
13,95,12,73,49,75,-26
13,95,12,86,80,0,80
13,95,12,95,0,32,-32
13,95,12,99,32,0,32
13,95,12,103,24,0,24
13,95,12,105,37,0,37
13,95,13,7,53,51,2
13,95,13,21,58,105,-47
13,95,13,31,30,0,30
13,95,13,37,122,54,68
13,95,13,39,32,0,32
13,95,13,51,71,43,28
13,95,13,59,0,58,-58
13,95,13,63,71,120,-49
13,95,13,67,57,146,-89
13,95,13,69,38,0,38
13,95,13,71,95,102,-7
13,95,13,81,69,44,25
13,95,13,87,0,54,-54
13,95,13,89,195,215,-20
13,95,13,97,0,50,-50
13,95,13,99,73,41,32
13,95,13,121,131,162,-31
13,95,13,131,38,37,1
13,95,13,135,49,138,-89
13,95,13,139,0,33,-33
13,95,13,151,33,73,-40
13,95,13,153,44,97,-53
13,95,13,177,1124,1763,-639
13,95,13,185,63,99,-36
13,95,13,201,31,0,31
13,95,13,205,346,239,107
13,95,13,215,74,145,-71
13,95,13,243,82,43,39
13,95,13,245,25,35,-10
13,95,13,261,193,116,77
13,95,13,273,312,220,92
13,95,13,275,68,66,2
13,95,13,277,88,95,-7
13,95,13,321,482,482,0
13,95,37,133,64,69,-5
13,97,1,15,45,38,7
13,97,1,73,112,70,42
13,97,1,89,27,0,27
13,97,1,101,28,0,28
13,97,1,111,0,65,-65
13,97,1,125,0,28,-28
13,97,4,13,37,32,5
13,97,6,37,117,51,66
13,97,6,65,31,0,31
13,97,6,71,39,0,39
13,97,6,73,42,0,42
13,97,12,5,33,0,33
13,97,12,11,262,98,164
13,97,12,31,99,0,99
13,97,12,33,54,0,54
13,97,12,57,64,0,64
13,97,12,73,40,0,40
13,97,12,86,283,75,208
13,97,12,95,152,37,115
13,97,12,99,83,47,36
13,97,12,103,35,0,35
13,97,13,15,92,74,18
13,97,13,21,33,0,33
13,97,13,45,1201,1884,-683
13,97,13,51,0,65,-65
13,97,13,57,102,153,-51
13,97,13,59,36,26,10
13,97,13,63,509,425,84
13,97,13,67,3902,2734,1168
13,97,13,77,112,128,-16
13,97,13,89,742,589,153
13,97,13,95,50,0,50
13,97,13,113,55,82,-27
13,97,13,115,57,38,19
13,97,13,117,0,61,-61
13,97,13,121,2203,2021,182
13,97,13,135,442,359,83
13,97,13,139,42,30,12
13,97,13,143,115,159,-44
13,97,13,151,187,157,30
13,97,13,153,0,45,-45
13,97,13,179,35,0,35
13,97,13,185,39,0,39
13,97,13,215,59,63,-4
13,97,13,217,40,69,-29
13,97,13,223,1182,1325,-143
13,97,13,227,0,27,-27
13,97,13,233,48,82,-34
13,97,13,247,45,68,-23
13,97,13,255,0,38,-38
13,97,13,285,28,0,28
13,97,13,297,0,28,-28
13,97,17,31,75,74,1
13,97,21,111,0,34,-34
13,97,22,51,37,0,37
13,97,22,71,0,50,-50
13,97,22,103,0,42,-42
13,97,24,33,81,0,81
13,97,25,25,45,0,45
13,97,26,99,31,0,31
13,97,26,125,50,0,50
13,97,26,163,78,32,46
13,97,32,3,43,0,43
13,97,34,3,39,0,39
13,97,34,13,66,0,66
13,97,34,39,48,0,48
13,97,36,5,119,60,59
13,97,36,47,98,41,57
13,97,36,59,68,0,68
13,97,36,81,137,28,109
13,97,36,103,46,0,46
13,97,37,51,0,29,-29
13,97,37,119,53,46,7
13,97,39,35,28,0,28
13,97,39,49,0,35,-35
13,97,39,61,23,0,23
13,97,42,101,50,0,50
13,97,45,45,0,40,-40
13,97,47,65,26,0,26
13,97,47,93,29,0,29
13,97,47,157,43,0,43
13,97,48,113,53,0,53
13,97,48,201,43,71,-28
13,97,48,439,0,32,-32
13,97,51,59,53,0,53
13,97,51,550,32,0,32
13,97,51,810,50,0,50
13,99,1,69,57,74,-17
13,99,13,37,41,52,-11
13,99,13,87,32,33,-1
13,99,13,95,41,73,-32
13,99,13,201,36,63,-27
13,99,13,253,63,74,-11
13,101,13,185,110,159,-49
13,103,12,11,26,0,26
13,103,12,31,31,0,31
13,103,13,29,254,307,-53
13,103,13,31,212,300,-88
13,103,13,51,1972,1294,678
13,103,13,121,29,0,29
13,103,13,179,107,53,54
13,103,13,245,44,0,44
13,103,13,251,90,119,-29
13,103,13,267,31,0,31
13,103,45,13,96,66,30
13,103,45,53,83,44,39
13,105,13,59,72,154,-82
13,105,13,119,82,101,-19
13,105,13,147,132,191,-59
13,105,13,157,34,0,34
13,105,13,195,52,52,0
13,105,13,221,37,0,37
13,105,45,7,33,40,-7
13,107,13,31,105,111,-6
13,107,13,33,45,65,-20
13,107,13,43,105,88,17
13,107,13,51,0,45,-45
13,107,13,163,56,63,-7
13,107,13,165,34,0,34
13,107,13,167,76,41,35
13,107,13,175,63,118,-55
13,107,13,245,40,36,4
13,107,13,279,88,70,18
13,107,13,283,0,39,-39
13,109,13,29,35,0,35
13,109,13,31,156,118,38
13,109,13,51,58,64,-6
13,109,13,267,169,164,5
13,109,13,279,0,39,-39
13,111,12,21,53,0,53
13,111,13,57,39,81,-42
13,111,13,67,40,67,-27
13,111,13,89,35,0,35
13,111,13,121,47,37,10
13,111,13,123,151,124,27
13,111,13,135,41,0,41
13,111,13,227,27,46,-19
13,111,13,291,84,150,-66
13,111,37,39,53,46,7
13,111,47,139,84,129,-45
13,113,1,73,42,45,-3
13,113,1,81,29,26,3
13,113,4,13,0,31,-31
13,113,6,37,95,36,59
13,113,6,59,26,0,26
13,113,8,41,39,0,39
13,113,12,11,129,46,83
13,113,12,31,39,0,39
13,113,12,57,34,49,-15
13,113,12,86,116,31,85
13,113,12,95,48,38,10
13,113,12,99,39,34,5
13,113,12,117,0,29,-29
13,113,12,127,28,0,28
13,113,13,35,0,50,-50
13,113,13,45,48,96,-48
13,113,13,51,43,40,3
13,113,13,57,0,98,-98
13,113,13,59,30,38,-8
13,113,13,63,1582,969,613
13,113,13,67,258,395,-137
13,113,13,77,723,1850,-1127
13,113,13,89,313,314,-1
13,113,13,97,82,55,27
13,113,13,117,0,71,-71
13,113,13,121,1331,1356,-25
13,113,13,135,174,153,21
13,113,13,139,29,30,-1
13,113,13,151,463,346,117
13,113,13,153,25,0,25
13,113,13,171,0,39,-39
13,113,13,199,0,128,-128
13,113,13,215,47,29,18
13,113,13,217,34,27,7
13,113,13,223,44,45,-1
13,113,13,231,31,109,-78
13,113,13,255,180,197,-17
13,113,13,285,0,43,-43
13,113,17,31,63,0,63
13,113,24,33,38,0,38
13,113,36,47,39,0,39
13,113,36,59,62,0,62
13,113,36,61,0,28,-28
13,113,36,81,68,0,68
13,113,36,103,62,0,62
13,113,37,119,0,26,-26
13,113,39,49,33,0,33
13,113,42,101,32,0,32
13,113,45,19,30,33,-3
13,113,47,157,0,39,-39
13,113,48,113,39,38,1
13,113,48,201,0,52,-52
13,113,48,439,64,31,33
13,113,51,59,34,49,-15
13,115,1,15,0,30,-30
13,115,1,19,172,113,59
13,115,1,49,43,0,43
13,115,1,55,0,53,-53
13,115,1,73,0,33,-33
13,115,13,15,575,697,-122
13,115,13,19,80,156,-76
13,115,13,21,0,28,-28
13,115,13,45,54,61,-7
13,115,13,47,0,35,-35
13,115,13,55,264,242,22
13,115,13,57,98,61,37
13,115,13,59,0,31,-31
13,115,13,67,214,214,0
13,115,13,89,77,90,-13
13,115,13,97,38,57,-19
13,115,13,121,80,98,-18
13,115,13,129,346,365,-19
13,115,13,135,57,54,3
13,115,13,139,0,44,-44
13,115,13,143,0,37,-37
13,115,13,213,40,0,40
13,115,13,223,92,73,19
13,115,13,233,619,496,123
13,115,13,295,48,44,4
13,115,13,313,77,45,32
13,115,47,65,0,51,-51
13,117,1,73,0,31,-31
13,117,1,117,39,38,1
13,117,4,13,54,56,-2
13,117,6,37,155,47,108
13,117,6,59,38,46,-8
13,117,6,67,34,0,34
13,117,6,73,43,0,43
13,117,6,85,33,0,33
13,117,9,1,35,0,35
13,117,12,11,396,78,318
13,117,12,31,68,59,9
13,117,12,57,109,49,60
13,117,12,71,44,0,44
13,117,12,86,140,31,109
13,117,12,95,134,47,87
13,117,12,99,212,66,146
13,117,12,101,30,0,30
13,117,12,103,74,0,74
13,117,12,105,38,0,38
13,117,12,109,47,0,47
13,117,12,115,37,0,37
13,117,12,117,79,38,41
13,117,12,127,60,0,60
13,117,13,13,75,57,18
13,117,13,15,52,63,-11
13,117,13,51,56,38,18
13,117,13,57,638,635,3
13,117,13,59,59,63,-4
13,117,13,63,81,0,81
13,117,13,67,689,355,334
13,117,13,73,42,0,42
13,117,13,77,27,44,-17
13,117,13,85,528,668,-140
13,117,13,89,641,319,322
13,117,13,97,61,0,61
13,117,13,113,71,0,71
13,117,13,121,4887,1501,3386
13,117,13,123,0,32,-32
13,117,13,135,2318,828,1490
13,117,13,137,29,35,-6
13,117,13,139,667,694,-27
13,117,13,151,150,48,102
13,117,13,157,33,57,-24
13,117,13,187,228,381,-153
13,117,13,215,45,0,45
13,117,13,217,32,0,32
13,117,13,223,60,53,7
13,117,13,227,86,102,-16
13,117,13,247,76,0,76
13,117,13,291,0,27,-27
13,117,13,297,57,46,11
13,117,13,311,25,62,-37
13,117,17,31,70,0,70
13,117,20,91,45,0,45
13,117,24,5,43,0,43
13,117,26,125,48,0,48
13,117,26,163,36,0,36
13,117,29,189,54,0,54
13,117,34,23,61,0,61
13,117,34,25,47,0,47
13,117,36,47,27,0,27
13,117,36,55,39,0,39
13,117,36,59,43,0,43
13,117,36,81,46,0,46
13,117,36,103,108,0,108
13,117,37,81,47,0,47
13,117,37,119,101,78,23
13,117,37,183,47,31,16
13,117,39,35,32,0,32
13,117,39,49,37,0,37
13,117,42,29,36,0,36
13,117,42,95,46,0,46
13,117,45,19,0,31,-31
13,117,45,45,0,41,-41
13,117,47,37,38,54,-16
13,117,47,65,33,42,-9
13,117,47,93,37,0,37
13,117,47,157,40,0,40
13,117,48,29,66,0,66
13,117,48,85,43,70,-27
13,117,48,113,43,42,1
13,117,48,121,0,42,-42
13,117,48,201,59,42,17
13,117,48,439,53,0,53
13,117,51,59,37,0,37
13,117,53,33,0,43,-43
13,119,13,11,44,71,-27
13,119,13,59,60,64,-4
13,119,13,105,101,82,19
13,119,13,135,64,42,22
13,119,13,137,36,34,2
13,119,13,139,38,61,-23
13,119,13,147,294,313,-19
13,119,13,157,104,137,-33
13,119,13,195,95,68,27
13,119,13,257,178,212,-34
13,119,45,7,0,39,-39
13,121,1,3,75,45,30
13,121,1,15,53,46,7
13,121,1,17,36,0,36
13,121,1,55,28,0,28
13,121,1,69,30,47,-17
13,121,1,73,571,483,88
13,121,1,81,187,87,100
13,121,1,89,141,131,10
13,121,1,97,174,116,58
13,121,1,101,312,134,178
13,121,1,103,38,0,38
13,121,1,111,0,34,-34
13,121,1,113,70,0,70
13,121,1,117,106,116,-10
13,121,1,125,92,51,41
13,121,2,20,27,0,27
13,121,4,13,343,383,-40
13,121,4,19,47,46,1
13,121,5,119,62,47,15
13,121,6,1,225,191,34
13,121,6,13,126,81,45
13,121,6,37,1131,902,229
13,121,6,59,373,228,145
13,121,6,65,146,77,69
13,121,6,67,100,85,15
13,121,6,71,159,53,106
13,121,6,73,317,327,-10
13,121,6,75,131,213,-82
13,121,6,77,40,34,6
13,121,6,81,44,57,-13
13,121,6,85,141,305,-164
13,121,6,95,46,0,46
13,121,6,111,61,54,7
13,121,8,5,89,39,50
13,121,8,13,40,63,-23
13,121,8,31,126,170,-44
13,121,8,35,31,53,-22
13,121,8,41,48,85,-37
13,121,8,59,35,50,-15
13,121,8,69,25,39,-14
13,121,9,1,206,134,72
13,121,9,3,178,116,62
13,121,9,9,125,91,34
13,121,10,3,141,71,70
13,121,11,1,368,333,35
13,121,12,1,206,91,115
13,121,12,5,73,44,29
13,121,12,9,124,111,13
13,121,12,11,1282,540,742
13,121,12,19,48,0,48
13,121,12,21,89,70,19
13,121,12,31,485,383,102
13,121,12,33,151,99,52
13,121,12,35,27,0,27
13,121,12,53,28,0,28
13,121,12,57,595,392,203
13,121,12,61,26,0,26
13,121,12,69,76,29,47
13,121,12,71,114,93,21
13,121,12,73,284,150,134
13,121,12,81,102,64,38
13,121,12,83,59,29,30
13,121,12,85,44,0,44
13,121,12,86,1076,538,538
13,121,12,87,29,0,29
13,121,12,89,35,59,-24
13,121,12,91,123,72,51
13,121,12,95,698,432,266
13,121,12,97,64,45,19
13,121,12,99,680,384,296
13,121,12,101,71,52,19
13,121,12,103,279,225,54
13,121,12,105,143,104,39
13,121,12,109,93,138,-45
13,121,12,111,96,40,56
13,121,12,113,30,51,-21
13,121,12,115,142,70,72
13,121,12,117,240,120,120
13,121,12,127,161,51,110
13,121,12,131,42,31,11
13,121,13,9,104,43,61
13,121,13,13,116,157,-41
13,121,13,15,165,250,-85
13,121,13,21,412,212,200
13,121,13,23,29,0,29
13,121,13,29,31,0,31
13,121,13,31,101,73,28
13,121,13,35,67,71,-4
13,121,13,39,47,0,47
13,121,13,45,386,336,50
13,121,13,47,21,0,21
13,121,13,51,478,372,106
13,121,13,57,1579,2909,-1330
13,121,13,59,599,366,233
13,121,13,63,9724,10480,-756
13,121,13,67,11668,11910,-242
13,121,13,71,29,0,29
13,121,13,73,179,96,83
13,121,13,77,1053,1253,-200
13,121,13,81,36,0,36
13,121,13,85,86,154,-68
13,121,13,89,21258,22078,-820
13,121,13,95,162,131,31
13,121,13,97,2021,2203,-182
13,121,13,103,0,29,-29
13,121,13,111,37,47,-10
13,121,13,113,1356,1331,25
13,121,13,115,98,80,18
13,121,13,117,1501,4887,-3386
13,121,13,123,0,72,-72
13,121,13,127,101,127,-26
13,121,13,129,39,43,-4
13,121,13,133,25,39,-14
13,121,13,135,8244,7597,647
13,121,13,137,46,32,14
13,121,13,139,388,525,-137
13,121,13,143,33,46,-13
13,121,13,145,33,0,33
13,121,13,147,0,34,-34
13,121,13,149,0,32,-32
13,121,13,151,1730,1722,8
13,121,13,153,189,110,79
13,121,13,157,88,74,14
13,121,13,159,0,29,-29
13,121,13,171,36,0,36
13,121,13,175,36,0,36
13,121,13,177,23,0,23
13,121,13,179,74,50,24
13,121,13,185,122,58,64
13,121,13,187,79,93,-14
13,121,13,189,26,0,26
13,121,13,199,76,108,-32
13,121,13,207,40,65,-25
13,121,13,211,35,0,35
13,121,13,215,477,321,156
13,121,13,217,404,447,-43
13,121,13,219,49,30,19
13,121,13,223,533,553,-20
13,121,13,225,28,46,-18
13,121,13,227,100,125,-25
13,121,13,231,37,0,37
13,121,13,233,47,65,-18
13,121,13,237,0,37,-37
13,121,13,241,0,33,-33
13,121,13,245,316,259,57
13,121,13,247,543,510,33
13,121,13,255,192,226,-34
13,121,13,261,42,37,5
13,121,13,275,29,25,4
13,121,13,277,38,33,5
13,121,13,281,0,27,-27
13,121,13,285,145,136,9
13,121,13,291,0,30,-30
13,121,13,293,43,46,-3
13,121,13,295,21,0,21
13,121,13,297,186,208,-22
13,121,13,299,39,0,39
13,121,13,303,26,29,-3
13,121,13,311,39,41,-2
13,121,13,313,92,35,57
13,121,15,3,94,107,-13
13,121,17,19,31,32,-1
13,121,17,31,944,838,106
13,121,17,43,154,105,49
13,121,17,89,65,55,10
13,121,17,97,139,80,59
13,121,17,111,35,0,35
13,121,17,119,45,0,45
13,121,17,161,35,0,35
13,121,17,163,52,0,52
13,121,17,167,24,0,24
13,121,17,197,59,28,31
13,121,17,201,46,0,46
13,121,18,3,41,0,41
13,121,18,57,51,44,7
13,121,18,89,83,43,40
13,121,18,97,184,132,52
13,121,18,105,0,22,-22
13,121,18,141,36,24,12
13,121,18,157,47,0,47
13,121,19,153,24,28,-4
13,121,19,163,0,37,-37
13,121,20,91,83,67,16
13,121,20,173,26,44,-18
13,121,21,67,89,69,20
13,121,21,111,176,152,24
13,121,21,227,23,0,23
13,121,22,17,42,0,42
13,121,22,19,34,0,34
13,121,22,33,120,139,-19
13,121,22,51,107,219,-112
13,121,22,55,51,0,51
13,121,22,71,219,494,-275
13,121,22,73,38,0,38
13,121,22,103,47,66,-19
13,121,23,5,29,0,29
13,121,24,3,137,78,59
13,121,24,5,170,112,58
13,121,24,17,52,0,52
13,121,24,21,32,45,-13
13,121,24,25,28,0,28
13,121,24,27,100,71,29
13,121,24,31,316,233,83
13,121,24,33,351,170,181
13,121,24,510,174,131,43
13,121,25,9,76,69,7
13,121,25,13,70,0,70
13,121,25,17,303,255,48
13,121,25,21,98,59,39
13,121,25,23,50,0,50
13,121,25,25,200,165,35
13,121,25,27,84,0,84
13,121,26,21,28,27,1
13,121,26,49,81,33,48
13,121,26,65,65,0,65
13,121,26,77,44,0,44
13,121,26,81,86,0,86
13,121,26,99,95,0,95
13,121,26,125,394,95,299
13,121,26,145,25,0,25
13,121,26,161,151,44,107
13,121,26,163,518,132,386
13,121,27,37,27,39,-12
13,121,27,53,248,163,85
13,121,27,123,50,26,24
13,121,28,47,58,45,13
13,121,28,49,79,35,44
13,121,28,71,35,0,35
13,121,28,87,32,0,32
13,121,28,89,40,0,40
13,121,28,121,23,0,23
13,121,29,95,86,40,46
13,121,29,183,50,32,18
13,121,29,189,241,115,126
13,121,29,510,55,48,7
13,121,31,55,76,57,19
13,121,31,109,22,0,22
13,121,32,3,201,260,-59
13,121,32,31,0,40,-40
13,121,33,11,35,0,35
13,121,33,15,36,0,36
13,121,34,1,0,37,-37
13,121,34,3,162,105,57
13,121,34,5,73,34,39
13,121,34,7,78,0,78
13,121,34,13,215,136,79
13,121,34,17,163,154,9
13,121,34,21,65,40,25
13,121,34,23,192,124,68
13,121,34,25,102,46,56
13,121,34,27,69,73,-4
13,121,34,31,82,0,82
13,121,34,35,54,71,-17
13,121,34,39,126,47,79
13,121,35,1,25,22,3
13,121,35,13,25,0,25
13,121,36,1,72,22,50
13,121,36,5,377,196,181
13,121,36,27,35,0,35
13,121,36,29,128,90,38
13,121,36,45,35,0,35
13,121,36,47,584,423,161
13,121,36,55,132,74,58
13,121,36,59,227,109,118
13,121,36,61,684,808,-124
13,121,36,63,0,22,-22
13,121,36,65,31,0,31
13,121,36,67,75,23,52
13,121,36,71,39,0,39
13,121,36,81,408,183,225
13,121,36,85,36,26,10
13,121,36,87,37,0,37
13,121,36,91,0,21,-21
13,121,36,93,26,0,26
13,121,36,103,213,70,143
13,121,36,109,28,0,28
13,121,36,119,203,106,97
13,121,37,1,26,0,26
13,121,37,21,73,98,-25
13,121,37,25,27,58,-31
13,121,37,35,30,0,30
13,121,37,49,35,0,35
13,121,37,51,109,73,36
13,121,37,63,173,91,82
13,121,37,67,134,103,31
13,121,37,81,168,101,67
13,121,37,89,31,0,31
13,121,37,97,37,0,37
13,121,37,119,594,578,16
13,121,37,129,61,58,3
13,121,37,133,54,45,9
13,121,37,135,76,58,18
13,121,37,179,0,38,-38
13,121,37,183,344,285,59
13,121,37,189,25,0,25
13,121,39,17,67,24,43
13,121,39,35,347,132,215
13,121,39,49,316,198,118
13,121,39,57,36,0,36
13,121,39,61,272,134,138
13,121,39,95,56,33,23
13,121,39,99,32,0,32
13,121,39,113,122,40,82
13,121,39,133,34,0,34
13,121,39,151,61,0,61
13,121,39,153,125,47,78
13,121,39,165,51,0,51
13,121,39,173,25,0,25
13,121,40,27,27,31,-4
13,121,40,109,42,41,1
13,121,40,143,70,46,24
13,121,41,51,69,96,-27
13,121,41,67,45,67,-22
13,121,42,3,276,167,109
13,121,42,17,52,45,7
13,121,42,27,24,0,24
13,121,42,29,56,24,32
13,121,42,41,0,26,-26
13,121,42,43,39,0,39
13,121,42,45,70,60,10
13,121,42,77,49,0,49
13,121,42,79,28,0,28
13,121,42,89,26,0,26
13,121,42,91,125,114,11
13,121,42,101,299,181,118
13,121,42,133,0,29,-29
13,121,44,7,72,37,35
13,121,45,3,70,37,33
13,121,45,7,58,52,6
13,121,45,13,132,120,12
13,121,45,15,55,49,6
13,121,45,19,243,248,-5
13,121,45,35,38,0,38
13,121,45,41,28,0,28
13,121,45,45,197,224,-27
13,121,45,51,71,66,5
13,121,45,63,70,74,-4
13,121,45,73,0,46,-46
13,121,45,75,40,0,40
13,121,45,77,54,36,18
13,121,45,79,284,133,151
13,121,45,83,55,48,7
13,121,45,85,37,0,37
13,121,45,91,45,54,-9
13,121,47,9,32,27,5
13,121,47,37,367,309,58
13,121,47,65,289,156,133
13,121,47,93,175,134,41
13,121,47,113,28,0,28
13,121,47,125,82,40,42
13,121,47,149,64,82,-18
13,121,47,157,409,276,133
13,121,47,163,0,25,-25
13,121,47,165,30,0,30
13,121,47,179,45,0,45
13,121,47,187,73,115,-42
13,121,48,27,50,52,-2
13,121,48,29,160,194,-34
13,121,48,41,26,0,26
13,121,48,85,128,232,-104
13,121,48,113,383,375,8
13,121,48,121,145,109,36
13,121,48,141,69,54,15
13,121,48,157,88,92,-4
13,121,48,167,0,28,-28
13,121,48,201,486,543,-57
13,121,48,339,35,39,-4
13,121,48,439,176,249,-73
13,121,48,453,208,227,-19
13,121,48,491,37,50,-13
13,121,49,35,57,57,0
13,121,49,49,35,0,35
13,121,51,3,22,32,-10
13,121,51,13,117,134,-17
13,121,51,41,74,62,12
13,121,51,59,306,329,-23
13,121,51,87,116,116,0
13,121,51,107,113,91,22
13,121,51,153,106,78,28
13,121,51,510,82,78,4
13,121,51,540,29,24,5
13,121,51,550,54,32,22
13,121,51,650,84,29,55
13,121,51,700,87,53,34
13,121,51,710,137,50,87
13,121,51,760,94,50,44
13,121,51,770,24,0,24
13,121,51,800,28,0,28
13,121,51,810,142,78,64
13,121,53,33,260,363,-103
13,121,53,53,69,95,-26
13,121,53,61,65,55,10
13,121,55,25,70,27,43
13,121,55,79,195,71,124
13,121,55,133,44,0,44
13,121,55,139,25,0,25
13,123,12,11,41,0,41
13,123,12,71,49,0,49
13,123,12,99,47,0,47
13,123,12,103,27,0,27
13,123,13,15,41,37,4
13,123,13,57,172,164,8
13,123,13,67,97,81,16
13,123,13,85,33,64,-31
13,123,13,89,24,0,24
13,123,13,111,124,151,-27
13,123,13,117,32,0,32
13,123,13,121,72,0,72
13,123,13,135,57,0,57
13,123,13,213,82,77,5
13,123,13,227,211,219,-8
13,123,13,291,0,35,-35
13,123,13,313,0,51,-51
13,125,13,163,36,0,36
13,125,13,189,23,0,23
13,125,13,301,38,0,38
13,127,6,37,0,39,-39
13,127,12,9,39,0,39
13,127,12,11,99,33,66
13,127,12,19,0,34,-34
13,127,12,31,216,207,9
13,127,12,86,88,0,88
13,127,12,89,30,55,-25
13,127,12,95,51,32,19
13,127,12,99,49,0,49
13,127,12,103,35,0,35
13,127,13,1,44,0,44
13,127,13,21,43,43,0
13,127,13,25,301,396,-95
13,127,13,31,35,51,-16
13,127,13,39,316,287,29
13,127,13,51,207,209,-2
13,127,13,57,0,33,-33
13,127,13,59,43,41,2
13,127,13,63,32,0,32
13,127,13,67,85,42,43
13,127,13,69,36,0,36
13,127,13,89,80,72,8
13,127,13,121,127,101,26
13,127,13,135,63,64,-1
13,127,13,153,37,0,37
13,127,13,179,75,91,-16
13,127,13,185,66,68,-2
13,127,13,191,314,316,-2
13,127,13,229,37,52,-15
13,127,13,299,91,98,-7
13,127,13,305,172,202,-30
13,127,17,31,33,0,33
13,127,45,13,28,41,-13
13,127,45,19,0,38,-38
13,127,47,157,30,0,30
13,127,48,201,27,0,27
13,127,48,439,0,31,-31
13,127,51,59,0,36,-36
13,129,6,37,71,0,71
13,129,13,15,590,581,9
13,129,13,47,56,66,-10
13,129,13,55,72,66,6
13,129,13,57,83,47,36
13,129,13,67,173,95,78
13,129,13,89,31,46,-15
13,129,13,115,365,346,19
13,129,13,121,43,39,4
13,129,13,135,48,39,9
13,129,13,213,344,284,60
13,129,13,223,30,33,-3
13,129,13,227,99,60,39
13,129,13,233,48,0,48
13,129,13,295,0,61,-61
13,129,13,313,483,443,40
13,129,17,31,32,0,32
13,129,47,11,40,0,40
13,129,47,65,45,48,-3
13,129,48,201,0,55,-55
13,131,12,39,52,50,2
13,131,12,73,120,125,-5
13,131,12,86,36,0,36
13,131,13,71,53,0,53
13,131,13,87,133,134,-1
13,131,13,95,37,38,-1
13,131,13,185,0,26,-26
13,131,13,205,59,95,-36
13,131,13,275,342,445,-103
13,133,13,59,67,87,-20
13,133,13,67,48,0,48
13,133,13,89,0,36,-36
13,133,13,121,39,25,14
13,133,13,135,55,41,14
13,133,13,211,54,82,-28
13,133,13,217,34,0,34
13,133,13,219,0,59,-59
13,133,13,221,0,34,-34
13,133,13,237,114,142,-28
13,133,13,247,60,0,60
13,133,13,265,42,47,-5
13,135,1,3,44,54,-10
13,135,1,15,48,69,-21
13,135,1,51,0,49,-49
13,135,1,69,33,33,0
13,135,1,73,248,320,-72
13,135,1,81,80,46,34
13,135,1,89,110,141,-31
13,135,1,97,83,118,-35
13,135,1,101,132,107,25
13,135,1,117,80,152,-72
13,135,1,125,33,47,-14
13,135,4,13,261,250,11
13,135,4,19,52,46,6
13,135,5,7,0,34,-34
13,135,5,119,58,42,16
13,135,5,143,29,0,29
13,135,6,1,128,86,42
13,135,6,13,47,40,7
13,135,6,19,0,41,-41
13,135,6,29,38,0,38
13,135,6,37,889,625,264
13,135,6,59,237,208,29
13,135,6,65,161,93,68
13,135,6,67,74,66,8
13,135,6,71,164,97,67
13,135,6,73,266,181,85
13,135,6,75,0,44,-44
13,135,6,77,55,0,55
13,135,6,81,0,28,-28
13,135,6,83,38,0,38
13,135,6,85,116,101,15
13,135,6,95,31,0,31
13,135,6,111,74,36,38
13,135,8,5,80,70,10
13,135,8,13,0,33,-33
13,135,8,31,0,51,-51
13,135,8,35,0,33,-33
13,135,8,41,70,57,13
13,135,9,1,147,68,79
13,135,9,3,156,68,88
13,135,9,9,90,51,39
13,135,10,3,69,45,24
13,135,11,1,70,71,-1
13,135,12,1,77,95,-18
13,135,12,5,84,80,4
13,135,12,9,92,93,-1
13,135,12,11,1512,437,1075
13,135,12,15,36,0,36
13,135,12,19,61,38,23
13,135,12,21,120,56,64
13,135,12,31,311,231,80
13,135,12,33,88,102,-14
13,135,12,35,0,33,-33
13,135,12,53,39,0,39
13,135,12,57,399,303,96
13,135,12,61,26,0,26
13,135,12,69,64,88,-24
13,135,12,71,200,106,94
13,135,12,73,166,62,104
13,135,12,81,83,55,28
13,135,12,83,67,45,22
13,135,12,85,71,0,71
13,135,12,86,1232,482,750
13,135,12,89,0,39,-39
13,135,12,91,95,64,31
13,135,12,95,545,287,258
13,135,12,97,84,69,15
13,135,12,99,519,221,298
13,135,12,101,141,105,36
13,135,12,103,281,163,118
13,135,12,105,126,135,-9
13,135,12,109,51,84,-33
13,135,12,111,96,59,37
13,135,12,113,55,0,55
13,135,12,115,54,48,6
13,135,12,117,189,115,74
13,135,12,119,0,39,-39
13,135,12,127,119,77,42
13,135,12,131,0,40,-40
13,135,13,9,78,54,24
13,135,13,11,60,115,-55
13,135,13,13,1499,3588,-2089
13,135,13,15,113,113,0
13,135,13,21,199,186,13
13,135,13,29,0,47,-47
13,135,13,31,90,68,22
13,135,13,35,41,40,1
13,135,13,39,0,51,-51
13,135,13,45,115,198,-83
13,135,13,47,0,36,-36
13,135,13,51,261,235,26
13,135,13,57,864,747,117
13,135,13,59,543,552,-9
13,135,13,63,1213,1142,71
13,135,13,67,2914,2851,63
13,135,13,73,70,118,-48
13,135,13,77,182,191,-9
13,135,13,85,70,118,-48
13,135,13,89,16382,11447,4935
13,135,13,95,138,49,89
13,135,13,97,359,442,-83
13,135,13,111,0,41,-41
13,135,13,113,153,174,-21
13,135,13,115,54,57,-3
13,135,13,117,828,2318,-1490
13,135,13,119,42,64,-22
13,135,13,121,7597,8244,-647
13,135,13,123,0,57,-57
13,135,13,127,64,63,1
13,135,13,129,39,48,-9
13,135,13,133,41,55,-14
13,135,13,137,88,191,-103
13,135,13,139,1664,3167,-1503
13,135,13,147,66,90,-24
13,135,13,151,623,683,-60
13,135,13,153,120,162,-42
13,135,13,157,514,1541,-1027
13,135,13,159,45,66,-21
13,135,13,175,32,0,32
13,135,13,177,0,44,-44
13,135,13,179,85,27,58
13,135,13,185,95,102,-7
13,135,13,187,75,142,-67
13,135,13,195,32,120,-88
13,135,13,207,27,42,-15
13,135,13,211,27,116,-89
13,135,13,215,262,179,83
13,135,13,217,579,562,17
13,135,13,219,84,233,-149
13,135,13,221,0,36,-36
13,135,13,223,179,297,-118
13,135,13,227,29,91,-62
13,135,13,233,28,0,28
13,135,13,237,31,62,-31
13,135,13,241,0,46,-46
13,135,13,245,215,158,57
13,135,13,247,757,744,13
13,135,13,255,81,93,-12
13,135,13,257,57,71,-14
13,135,13,261,0,40,-40
13,135,13,277,0,27,-27
13,135,13,281,0,32,-32
13,135,13,285,76,57,19
13,135,13,291,0,51,-51
13,135,13,297,1413,2678,-1265
13,135,13,311,43,136,-93
13,135,13,313,67,48,19
13,135,15,3,89,68,21
13,135,16,1,0,50,-50
13,135,17,31,531,393,138
13,135,17,43,141,91,50
13,135,17,89,0,44,-44
13,135,17,97,57,68,-11
13,135,17,197,75,35,40
13,135,18,3,42,0,42
13,135,18,57,0,37,-37
13,135,18,89,47,41,6
13,135,18,97,126,83,43
13,135,19,153,54,37,17
13,135,20,91,45,52,-7
13,135,20,173,32,35,-3
13,135,21,15,0,42,-42
13,135,21,67,58,37,21
13,135,21,111,87,68,19
13,135,22,17,34,0,34
13,135,22,33,64,130,-66
13,135,22,51,123,150,-27
13,135,22,55,0,34,-34
13,135,22,57,50,0,50
13,135,22,71,84,278,-194
13,135,22,103,48,77,-29
13,135,22,109,75,0,75
13,135,24,3,86,76,10
13,135,24,5,164,58,106
13,135,24,21,40,0,40
13,135,24,27,82,34,48
13,135,24,31,198,130,68
13,135,24,33,313,127,186
13,135,24,510,96,66,30
13,135,25,9,70,39,31
13,135,25,13,46,33,13
13,135,25,17,124,83,41
13,135,25,21,84,32,52
13,135,25,23,41,0,41
13,135,25,25,108,58,50
13,135,25,27,78,41,37
13,135,26,49,101,0,101
13,135,26,65,37,0,37
13,135,26,77,35,0,35
13,135,26,81,103,51,52
13,135,26,93,35,0,35
13,135,26,99,71,38,33
13,135,26,125,187,83,104
13,135,26,161,66,0,66
13,135,26,163,358,70,288
13,135,27,53,109,118,-9
13,135,27,123,41,34,7
13,135,28,47,46,49,-3
13,135,28,49,65,28,37
13,135,28,59,45,43,2
13,135,28,121,31,0,31
13,135,29,95,39,0,39
13,135,29,189,142,86,56
13,135,29,510,51,0,51
13,135,31,55,53,0,53
13,135,32,3,212,182,30
13,135,32,31,30,0,30
13,135,33,11,25,0,25
13,135,34,1,41,0,41
13,135,34,3,221,72,149
13,135,34,5,89,0,89
13,135,34,7,42,0,42
13,135,34,13,348,74,274
13,135,34,17,132,69,63
13,135,34,21,57,34,23
13,135,34,23,296,59,237
13,135,34,25,64,37,27
13,135,34,27,95,36,59
13,135,34,29,47,0,47
13,135,34,31,182,0,182
13,135,34,35,50,0,50
13,135,34,39,195,53,142
13,135,35,1,26,24,2
13,135,36,1,47,34,13
13,135,36,5,628,205,423
13,135,36,27,35,0,35
13,135,36,29,134,35,99
13,135,36,47,835,286,549
13,135,36,55,142,45,97
13,135,36,59,495,107,388
13,135,36,61,218,178,40
13,135,36,65,37,0,37
13,135,36,67,70,43,27
13,135,36,71,92,0,92
13,135,36,81,1012,323,689
13,135,36,85,47,27,20
13,135,36,87,84,0,84
13,135,36,103,371,86,285
13,135,36,119,265,55,210
13,135,37,21,32,73,-41
13,135,37,35,34,35,-1
13,135,37,51,106,135,-29
13,135,37,63,37,58,-21
13,135,37,67,80,48,32
13,135,37,71,0,39,-39
13,135,37,81,154,102,52
13,135,37,89,41,0,41
13,135,37,97,42,39,3
13,135,37,101,32,0,32
13,135,37,119,329,353,-24
13,135,37,129,52,0,52
13,135,37,133,79,61,18
13,135,37,147,0,39,-39
13,135,37,183,205,296,-91
13,135,39,17,52,55,-3
13,135,39,35,172,93,79
13,135,39,49,163,137,26
13,135,39,57,33,0,33
13,135,39,61,86,72,14
13,135,39,93,36,0,36
13,135,39,95,55,0,55
13,135,39,113,73,0,73
13,135,39,153,45,0,45
13,135,39,165,0,52,-52
13,135,40,109,36,84,-48
13,135,40,143,44,24,20
13,135,41,51,0,28,-28
13,135,42,3,137,73,64
13,135,42,17,57,0,57
13,135,42,45,96,26,70
13,135,42,77,36,0,36
13,135,42,91,84,66,18
13,135,42,95,48,0,48
13,135,42,101,133,69,64
13,135,44,7,126,35,91
13,135,45,3,40,53,-13
13,135,45,7,55,96,-41
13,135,45,13,72,129,-57
13,135,45,15,38,51,-13
13,135,45,19,80,111,-31
13,135,45,35,60,49,11
13,135,45,41,48,0,48
13,135,45,45,194,282,-88
13,135,45,47,0,32,-32
13,135,45,51,45,39,6
13,135,45,63,70,93,-23
13,135,45,73,0,73,-73
13,135,45,77,34,36,-2
13,135,45,79,128,124,4
13,135,45,83,81,80,1
13,135,45,85,28,0,28
13,135,45,91,50,33,17
13,135,47,11,55,0,55
13,135,47,37,166,205,-39
13,135,47,65,134,104,30
13,135,47,93,130,123,7
13,135,47,125,43,36,7
13,135,47,149,46,69,-23
13,135,47,157,260,165,95
13,135,47,163,0,38,-38
13,135,47,187,0,87,-87
13,135,48,27,36,60,-24
13,135,48,29,57,125,-68
13,135,48,85,60,165,-105
13,135,48,113,226,285,-59
13,135,48,121,94,91,3
13,135,48,141,69,52,17
13,135,48,157,41,97,-56
13,135,48,201,358,518,-160
13,135,48,215,36,86,-50
13,135,48,339,38,93,-55
13,135,48,439,139,252,-113
13,135,48,453,86,70,16
13,135,49,35,66,77,-11
13,135,49,49,0,40,-40
13,135,50,7,26,0,26
13,135,51,13,0,37,-37
13,135,51,41,60,61,-1
13,135,51,59,201,163,38
13,135,51,87,58,65,-7
13,135,51,107,99,70,29
13,135,51,153,122,103,19
13,135,51,510,0,35,-35
13,135,51,550,69,35,34
13,135,51,650,42,0,42
13,135,51,700,72,0,72
13,135,51,710,79,38,41
13,135,51,760,43,34,9
13,135,51,810,146,77,69
13,135,53,33,103,167,-64
13,135,53,53,70,88,-18
13,135,53,61,57,0,57
13,135,55,25,30,39,-9
13,135,55,79,98,68,30
13,135,55,133,28,0,28
13,137,12,11,33,0,33
13,137,13,11,394,378,16
13,137,13,57,0,29,-29
13,137,13,59,36,39,-3
13,137,13,67,0,30,-30
13,137,13,89,0,24,-24
13,137,13,117,35,29,6
13,137,13,119,34,36,-2
13,137,13,121,32,46,-14
13,137,13,135,191,88,103
13,137,13,139,377,337,40
13,137,13,157,65,114,-49
13,137,13,187,38,0,38
13,137,13,241,86,49,37
13,137,13,257,170,137,33
13,137,13,311,426,318,108
13,139,1,3,0,28,-28
13,139,1,73,33,0,33
13,139,4,13,28,37,-9
13,139,6,37,138,68,70
13,139,6,59,29,0,29
13,139,6,73,32,38,-6
13,139,12,5,0,32,-32
13,139,12,11,144,40,104
13,139,12,31,38,56,-18
13,139,12,57,60,47,13
13,139,12,71,67,0,67
13,139,12,73,32,0,32
13,139,12,86,116,41,75
13,139,12,95,84,33,51
13,139,12,99,70,0,70
13,139,12,103,72,28,44
13,139,12,105,42,0,42
13,139,12,117,0,32,-32
13,139,12,127,34,0,34
13,139,13,11,234,290,-56
13,139,13,13,340,361,-21
13,139,13,15,46,39,7
13,139,13,31,35,0,35
13,139,13,45,41,33,8
13,139,13,51,43,51,-8
13,139,13,57,117,105,12
13,139,13,59,121,166,-45
13,139,13,63,70,40,30
13,139,13,67,234,171,63
13,139,13,73,0,35,-35
13,139,13,85,183,211,-28
13,139,13,89,354,251,103
13,139,13,95,33,0,33
13,139,13,97,30,42,-12
13,139,13,113,30,29,1
13,139,13,115,44,0,44
13,139,13,117,694,667,27
13,139,13,119,61,38,23
13,139,13,121,525,388,137
13,139,13,135,3167,1664,1503
13,139,13,137,337,377,-40
13,139,13,151,67,0,67
13,139,13,153,31,31,0
13,139,13,157,639,1019,-380
13,139,13,187,462,445,17
13,139,13,195,46,0,46
13,139,13,217,27,0,27
13,139,13,219,0,29,-29
13,139,13,223,48,45,3
13,139,13,241,34,44,-10
13,139,13,247,56,29,27
13,139,13,257,83,85,-2
13,139,13,291,30,38,-8
13,139,13,297,100,72,28
13,139,13,311,431,446,-15
13,139,17,31,53,0,53
13,139,36,59,47,0,47
13,139,36,81,40,0,40
13,139,36,103,35,0,35
13,139,37,21,0,27,-27
13,139,37,119,58,42,16
13,139,44,7,29,0,29
13,139,45,45,28,33,-5
13,139,47,37,31,0,31
13,139,47,65,38,0,38
13,139,47,93,45,0,45
13,139,47,157,0,46,-46
13,139,48,61,0,43,-43
13,139,48,201,0,79,-79
13,139,48,339,0,31,-31
13,141,13,9,142,250,-108
13,141,13,21,35,0,35
13,143,1,29,71,112,-41
13,143,13,15,0,28,-28
13,143,13,45,1021,870,151
13,143,13,67,82,85,-3
13,143,13,97,159,115,44
13,143,13,115,37,0,37
13,143,13,121,46,33,13
13,143,13,151,37,0,37
13,143,13,223,177,119,58
13,143,13,233,125,132,-7
13,145,1,17,36,41,-5
13,145,1,81,95,92,3
13,145,1,113,157,76,81
13,145,12,86,51,0,51
13,145,13,53,35,0,35
13,145,13,67,0,33,-33
13,145,13,121,0,33,-33
13,145,13,199,93,71,22
13,145,13,215,1411,952,459
13,145,13,263,44,0,44
13,145,13,285,181,250,-69
13,147,13,13,35,0,35
13,147,13,59,54,65,-11
13,147,13,105,191,132,59
13,147,13,119,313,294,19
13,147,13,121,34,0,34
13,147,13,135,90,66,24
13,147,13,157,0,41,-41
13,147,13,195,57,57,0
13,147,13,257,42,48,-6
13,147,45,7,73,129,-56
13,147,45,45,0,20,-20
13,147,45,73,0,46,-46
13,149,1,111,0,47,-47
13,149,13,45,224,269,-45
13,149,13,77,253,191,62
13,149,13,121,32,0,32
13,149,13,285,197,188,9
13,151,1,3,0,39,-39
13,151,1,73,64,48,16
13,151,1,81,0,46,-46
13,151,1,89,25,32,-7
13,151,1,101,36,33,3
13,151,4,13,48,53,-5
13,151,6,1,32,0,32
13,151,6,37,149,62,87
13,151,6,65,48,0,48
13,151,6,71,38,31,7
13,151,6,73,58,0,58
13,151,9,1,48,0,48
13,151,11,1,0,25,-25
13,151,12,5,0,58,-58
13,151,12,11,526,102,424
13,151,12,31,105,56,49
13,151,12,57,133,79,54
13,151,12,69,35,24,11
13,151,12,73,76,33,43
13,151,12,86,655,131,524
13,151,12,95,168,100,68
13,151,12,99,197,53,144
13,151,12,101,45,0,45
13,151,12,103,44,47,-3
13,151,12,105,65,28,37
13,151,12,111,61,0,61
13,151,12,115,0,34,-34
13,151,12,117,81,0,81
13,151,12,127,35,40,-5
13,151,13,9,31,0,31
13,151,13,13,0,72,-72
13,151,13,15,0,38,-38
13,151,13,21,227,121,106
13,151,13,35,562,863,-301
13,151,13,45,84,107,-23
13,151,13,51,86,92,-6
13,151,13,57,80,129,-49
13,151,13,59,41,41,0
13,151,13,63,5789,3462,2327
13,151,13,67,548,639,-91
13,151,13,77,264,524,-260
13,151,13,89,2003,1213,790
13,151,13,95,73,33,40
13,151,13,97,157,187,-30
13,151,13,113,346,463,-117
13,151,13,117,48,150,-102
13,151,13,121,1722,1730,-8
13,151,13,135,683,623,60
13,151,13,139,0,67,-67
13,151,13,143,0,37,-37
13,151,13,153,141,50,91
13,151,13,157,0,48,-48
13,151,13,159,63,113,-50
13,151,13,171,80,270,-190
13,151,13,175,0,33,-33
13,151,13,179,54,0,54
13,151,13,185,65,36,29
13,151,13,199,0,66,-66
13,151,13,207,91,224,-133
13,151,13,215,79,71,8
13,151,13,217,378,385,-7
13,151,13,223,49,95,-46
13,151,13,225,32,0,32
13,151,13,231,96,290,-194
13,151,13,237,0,32,-32
13,151,13,245,51,32,19
13,151,13,247,429,291,138
13,151,13,255,936,1214,-278
13,151,13,285,31,51,-20
13,151,13,293,58,82,-24
13,151,13,297,76,92,-16
13,151,15,3,65,0,65
13,151,17,31,100,50,50
13,151,22,33,35,0,35
13,151,22,71,0,54,-54
13,151,24,5,36,0,36
13,151,24,33,107,0,107
13,151,25,23,45,0,45
13,151,25,25,42,0,42
13,151,26,49,34,0,34
13,151,26,125,35,0,35
13,151,26,163,101,0,101
13,151,32,3,0,51,-51
13,151,34,5,33,0,33
13,151,34,13,111,0,111
13,151,34,23,50,0,50
13,151,34,39,59,0,59
13,151,36,5,114,0,114
13,151,36,47,324,71,253
13,151,36,59,117,30,87
13,151,36,61,51,0,51
13,151,36,81,226,59,167
13,151,36,103,104,0,104
13,151,36,119,29,0,29
13,151,37,51,50,43,7
13,151,37,81,32,0,32
13,151,37,119,78,81,-3
13,151,37,183,0,39,-39
13,151,39,35,72,39,33
13,151,39,49,46,0,46
13,151,39,61,32,0,32
13,151,40,31,49,0,49
13,151,42,101,49,0,49
13,151,45,19,0,32,-32
13,151,45,45,36,0,36
13,151,45,79,59,0,59
13,151,47,37,31,32,-1
13,151,47,125,42,0,42
13,151,47,157,61,39,22
13,151,48,27,0,37,-37
13,151,48,29,37,42,-5
13,151,48,113,32,0,32
13,151,48,201,41,122,-81
13,151,48,439,35,47,-12
13,151,51,59,48,55,-7
13,151,51,153,0,35,-35
13,151,51,710,35,0,35
13,151,51,810,47,0,47
13,151,53,53,47,0,47
13,153,1,73,0,33,-33
13,153,1,89,0,34,-34
13,153,1,101,53,53,0
13,153,2,20,82,50,32
13,153,4,13,51,50,1
13,153,4,19,64,0,64
13,153,6,37,37,44,-7
13,153,6,71,45,0,45
13,153,6,73,41,28,13
13,153,6,95,47,0,47
13,153,8,41,45,64,-19
13,153,12,1,26,0,26
13,153,12,5,117,0,117
13,153,12,9,59,78,-19
13,153,12,11,133,28,105
13,153,12,31,84,62,22
13,153,12,33,46,0,46
13,153,12,57,106,64,42
13,153,12,71,37,0,37
13,153,12,86,135,39,96
13,153,12,91,103,136,-33
13,153,12,95,78,53,25
13,153,12,99,73,35,38
13,153,12,101,57,0,57
13,153,12,103,74,0,74
13,153,12,105,0,38,-38
13,153,12,113,37,49,-12
13,153,12,127,50,36,14
13,153,13,9,45,50,-5
13,153,13,17,42,0,42
13,153,13,21,1565,1222,343
13,153,13,23,109,144,-35
13,153,13,31,48,50,-2
13,153,13,51,126,129,-3
13,153,13,57,39,29,10
13,153,13,59,48,57,-9
13,153,13,63,83,69,14
13,153,13,67,130,137,-7
13,153,13,69,30,0,30
13,153,13,71,34,32,2
13,153,13,73,0,53,-53
13,153,13,77,0,51,-51
13,153,13,79,240,215,25
13,153,13,81,82,41,41
13,153,13,89,126,148,-22
13,153,13,91,103,57,46
13,153,13,93,172,119,53
13,153,13,95,97,44,53
13,153,13,97,45,0,45
13,153,13,113,0,25,-25
13,153,13,121,110,189,-79
13,153,13,127,0,37,-37
13,153,13,135,162,120,42
13,153,13,139,31,31,0
13,153,13,151,50,141,-91
13,153,13,169,104,138,-34
13,153,13,175,95,58,37
13,153,13,177,40,0,40
13,153,13,179,30,0,30
13,153,13,185,138,73,65
13,153,13,193,224,198,26
13,153,13,207,76,122,-46
13,153,13,215,91,93,-2
13,153,13,223,47,38,9
13,153,13,225,1091,1087,4
13,153,13,235,216,149,67
13,153,13,237,41,0,41
13,153,13,245,44,31,13
13,153,13,261,110,0,110
13,153,13,269,57,66,-9
13,153,13,289,72,63,9
13,153,13,293,32,0,32
13,153,13,303,30,0,30
13,153,13,315,33,0,33
13,153,15,3,74,27,47
13,153,17,31,30,0,30
13,153,17,163,0,66,-66
13,153,22,15,0,41,-41
13,153,28,47,64,41,23
13,153,31,153,37,0,37
13,153,32,3,55,147,-92
13,153,34,5,36,0,36
13,153,37,51,34,48,-14
13,153,37,119,43,0,43
13,153,37,133,37,0,37
13,153,37,191,0,50,-50
13,153,39,57,0,32,-32
13,153,39,113,30,38,-8
13,153,40,109,40,57,-17
13,153,45,13,37,0,37
13,153,45,19,32,0,32
13,153,45,79,0,36,-36
13,153,45,85,82,30,52
13,153,47,157,24,0,24
13,153,48,27,34,31,3
13,153,48,29,103,143,-40
13,153,48,201,0,52,-52
13,153,48,439,30,33,-3
13,153,48,485,36,0,36
13,153,51,59,0,75,-75
13,153,51,153,0,43,-43
13,153,51,199,0,44,-44
13,153,51,650,0,39,-39
13,153,51,700,41,38,3
13,153,56,21,0,43,-43
13,155,13,17,269,234,35
13,155,13,19,0,48,-48
13,155,13,69,63,57,6
13,155,13,277,100,104,-4
13,157,12,11,66,0,66
13,157,13,11,342,369,-27
13,157,13,13,608,513,95
13,157,13,57,39,0,39
13,157,13,59,471,468,3
13,157,13,63,29,0,29
13,157,13,67,58,42,16
13,157,13,89,118,46,72
13,157,13,105,0,34,-34
13,157,13,117,57,33,24
13,157,13,119,137,104,33
13,157,13,121,74,88,-14
13,157,13,135,1541,514,1027
13,157,13,137,114,65,49
13,157,13,139,1019,639,380
13,157,13,147,41,0,41
13,157,13,151,48,0,48
13,157,13,195,284,302,-18
13,157,13,217,0,34,-34
13,157,13,219,121,69,52
13,157,13,221,52,0,52
13,157,13,257,41,57,-16
13,157,13,297,121,90,31
13,157,13,311,0,36,-36
13,159,13,35,75,53,22
13,159,13,63,34,0,34
13,159,13,89,0,37,-37
13,159,13,121,29,0,29
13,159,13,135,66,45,21
13,159,13,151,113,63,50
13,159,13,217,438,339,99
13,159,13,237,47,83,-36
13,159,13,247,129,62,67
13,159,13,297,70,63,7
13,161,13,1,187,182,5
13,161,13,5,44,0,44
13,161,13,69,78,95,-17
13,161,13,271,98,59,39
13,161,13,279,0,27,-27
13,163,13,33,74,78,-4
13,163,13,73,44,81,-37
13,163,13,107,63,56,7
13,163,13,125,0,36,-36
13,163,13,189,51,60,-9
13,163,13,245,164,194,-30
13,163,13,303,37,59,-22
13,165,13,31,100,123,-23
13,165,13,33,54,64,-10
13,165,13,107,0,34,-34
13,165,13,245,0,41,-41
13,165,13,251,58,29,29
13,167,13,107,41,76,-35
13,167,13,175,120,220,-100
13,167,13,303,52,44,8
13,169,13,9,212,172,40
13,169,13,21,1056,826,230
13,169,13,67,0,36,-36
13,169,13,153,138,104,34
13,169,13,207,47,104,-57
13,169,13,225,0,26,-26
13,169,13,237,66,39,27
13,169,13,289,110,43,67
13,169,13,319,60,35,25
13,171,13,21,0,38,-38
13,171,13,35,0,41,-41
13,171,13,63,110,54,56
13,171,13,67,31,0,31
13,171,13,113,39,0,39
13,171,13,121,0,36,-36
13,171,13,151,270,80,190
13,171,13,207,79,84,-5
13,171,13,231,123,80,43
13,171,13,255,376,431,-55
13,171,13,293,108,125,-17
13,173,13,19,96,99,-3
13,173,13,75,31,0,31
13,173,13,185,378,404,-26
13,173,37,51,107,0,107
13,175,12,86,77,0,77
13,175,13,9,57,48,9
13,175,13,21,98,132,-34
13,175,13,23,48,34,14
13,175,13,31,0,30,-30
13,175,13,51,0,68,-68
13,175,13,59,0,26,-26
13,175,13,63,0,49,-49
13,175,13,67,28,0,28
13,175,13,89,32,44,-12
13,175,13,91,110,77,33
13,175,13,107,118,63,55
13,175,13,121,0,36,-36
13,175,13,135,0,32,-32
13,175,13,151,33,0,33
13,175,13,153,58,95,-37
13,175,13,167,220,120,100
13,175,13,209,42,0,42
13,175,13,271,44,35,9
13,175,13,279,58,0,58
13,175,13,283,69,62,7
13,175,13,289,0,30,-30
13,175,13,303,92,63,29
13,175,13,319,47,46,1
13,177,12,31,0,36,-36
13,177,13,67,0,56,-56
13,177,13,71,44,0,44
13,177,13,81,45,43,2
13,177,13,95,1763,1124,639
13,177,13,121,0,23,-23
13,177,13,135,44,0,44
13,177,13,153,0,40,-40
13,177,13,185,35,28,7
13,177,13,205,71,58,13
13,177,13,261,138,94,44
13,177,13,273,71,103,-32
13,177,13,277,0,37,-37
13,177,13,321,132,119,13
13,177,37,133,52,0,52
13,179,1,89,0,50,-50
13,179,2,90,105,38,67
13,179,4,3,0,41,-41
13,179,4,13,0,89,-89
13,179,4,19,0,24,-24
13,179,6,37,37,67,-30
13,179,6,71,91,55,36
13,179,6,73,40,49,-9
13,179,6,77,0,31,-31
13,179,8,41,90,93,-3
13,179,12,9,0,37,-37
13,179,12,11,40,57,-17
13,179,12,19,0,38,-38
13,179,12,31,92,136,-44
13,179,12,57,61,71,-10
13,179,12,86,90,105,-15
13,179,12,91,55,50,5
13,179,12,95,59,79,-20
13,179,12,99,30,0,30
13,179,12,101,0,34,-34
13,179,12,103,0,46,-46
13,179,12,127,0,36,-36
13,179,13,21,0,46,-46
13,179,13,29,279,303,-24
13,179,13,31,79,84,-5
13,179,13,39,0,29,-29
13,179,13,51,610,836,-226
13,179,13,63,58,91,-33
13,179,13,67,43,49,-6
13,179,13,73,0,60,-60
13,179,13,89,43,70,-27
13,179,13,97,0,35,-35
13,179,13,103,53,107,-54
13,179,13,121,50,74,-24
13,179,13,127,91,75,16
13,179,13,135,27,85,-58
13,179,13,151,0,54,-54
13,179,13,153,0,30,-30
13,179,13,183,588,711,-123
13,179,13,185,0,46,-46
13,179,13,191,36,51,-15
13,179,13,215,86,102,-16
13,179,13,245,105,109,-4
13,179,13,267,79,144,-65
13,179,13,279,0,36,-36
13,179,13,305,95,148,-53
13,179,15,3,98,80,18
13,179,17,31,38,64,-26
13,179,21,47,69,47,22
13,179,21,93,138,84,54
13,179,22,115,62,0,62
13,179,26,163,0,35,-35
13,179,29,169,61,67,-6
13,179,32,3,21,35,-14
13,179,36,5,38,0,38
13,179,36,45,89,72,17
13,179,36,47,29,41,-12
13,179,37,51,103,228,-125
13,179,37,93,0,50,-50
13,179,37,119,0,50,-50
13,179,37,133,38,0,38
13,179,37,183,0,33,-33
13,179,40,31,94,74,20
13,179,42,101,0,44,-44
13,179,45,13,37,0,37
13,179,45,45,0,30,-30
13,179,45,63,0,46,-46
13,179,45,79,48,148,-100
13,179,47,125,50,89,-39
13,179,48,27,195,98,97
13,179,48,29,166,140,26
13,179,48,85,0,30,-30
13,179,48,99,0,43,-43
13,179,48,113,0,48,-48
13,179,48,141,122,77,45
13,179,48,201,52,90,-38
13,179,48,439,0,37,-37
13,179,51,59,42,64,-22
13,179,51,700,0,33,-33
13,179,53,53,103,127,-24
13,179,53,67,0,43,-43
13,181,13,73,91,94,-3
13,181,13,189,0,34,-34
13,181,13,245,76,89,-13
13,181,13,317,59,66,-7
13,183,13,31,37,0,37
13,183,13,51,62,64,-2
13,183,13,179,711,588,123
13,183,13,267,29,51,-22
13,183,13,305,95,101,-6
13,185,2,20,139,37,102
13,185,2,90,190,0,190
13,185,4,19,62,0,62
13,185,6,37,38,40,-2
13,185,6,73,24,34,-10
13,185,8,41,36,0,36
13,185,12,1,37,34,3
13,185,12,5,61,61,0
13,185,12,9,0,48,-48
13,185,12,11,112,55,57
13,185,12,23,35,43,-8
13,185,12,31,142,183,-41
13,185,12,47,96,86,10
13,185,12,57,107,103,4
13,185,12,69,30,0,30
13,185,12,73,85,133,-48
13,185,12,79,127,99,28
13,185,12,83,31,32,-1
13,185,12,86,167,58,109
13,185,12,91,37,50,-13
13,185,12,95,78,102,-24
13,185,12,99,55,33,22
13,185,12,103,66,39,27
13,185,12,105,53,57,-4
13,185,12,107,29,0,29
13,185,12,109,0,27,-27
13,185,12,121,39,39,0
13,185,12,127,38,0,38
13,185,13,17,41,29,12
13,185,13,19,241,347,-106
13,185,13,21,43,71,-28
13,185,13,27,646,547,99
13,185,13,31,0,47,-47
13,185,13,39,43,33,10
13,185,13,51,57,83,-26
13,185,13,57,32,47,-15
13,185,13,59,29,52,-23
13,185,13,63,56,49,7
13,185,13,65,34,55,-21
13,185,13,67,61,137,-76
13,185,13,69,110,44,66
13,185,13,71,106,86,20
13,185,13,75,371,327,44
13,185,13,87,27,0,27
13,185,13,89,74,141,-67
13,185,13,95,99,63,36
13,185,13,97,0,39,-39
13,185,13,101,159,110,49
13,185,13,121,58,122,-64
13,185,13,127,68,66,2
13,185,13,131,26,0,26
13,185,13,135,102,95,7
13,185,13,151,36,65,-29
13,185,13,153,73,138,-65
13,185,13,173,404,378,26
13,185,13,177,28,35,-7
13,185,13,179,46,0,46
13,185,13,215,38,61,-23
13,185,13,245,44,0,44
13,185,13,275,120,119,1
13,185,13,277,155,104,51
13,185,13,299,98,62,36
13,185,28,87,0,77,-77
13,185,32,3,54,38,16
13,185,35,1,81,52,29
13,185,35,35,40,0,40
13,185,37,51,812,32,780
13,185,37,85,214,0,214
13,185,37,119,0,23,-23
13,185,37,191,0,31,-31
13,185,40,47,0,60,-60
13,185,47,65,0,27,-27
13,185,48,29,36,80,-44
13,185,48,439,0,36,-36
13,185,48,465,0,69,-69
13,185,48,485,36,0,36
13,185,51,59,0,47,-47
13,185,53,53,0,37,-37
13,187,13,57,62,51,11
13,187,13,59,0,22,-22
13,187,13,63,31,0,31
13,187,13,67,46,0,46
13,187,13,85,286,227,59
13,187,13,89,52,29,23
13,187,13,117,381,228,153
13,187,13,121,93,79,14
13,187,13,135,142,75,67
13,187,13,137,0,38,-38
13,187,13,139,445,462,-17
13,187,13,291,34,0,34
13,187,13,311,137,179,-42
13,187,47,125,48,0,48
13,189,13,73,370,245,125
13,189,13,121,0,26,-26
13,189,13,125,50,23,27
13,189,13,163,60,51,9
13,189,13,181,34,0,34
13,189,13,245,209,279,-70
13,189,13,301,242,172,70
13,189,13,317,34,0,34
13,189,45,3,0,60,-60
13,191,12,31,25,26,-1
13,191,13,51,74,56,18
13,191,13,127,316,314,2
13,191,13,179,51,36,15
13,191,13,305,0,42,-42
13,193,13,93,0,55,-55
13,193,13,153,198,224,-26
13,193,13,225,34,94,-60
13,193,13,261,76,62,14
13,193,13,269,0,41,-41
13,195,13,11,73,62,11
13,195,13,13,77,58,19
13,195,13,59,803,631,172
13,195,13,105,52,52,0
13,195,13,119,68,95,-27
13,195,13,135,120,32,88
13,195,13,139,0,46,-46
13,195,13,147,57,57,0
13,195,13,157,302,284,18
13,195,13,219,110,103,7
13,195,13,221,139,171,-32
13,195,13,297,36,0,36
13,197,1,81,34,0,34
13,197,13,53,49,0,49
13,197,13,215,141,187,-46
13,197,13,249,41,32,9
13,199,13,63,65,46,19
13,199,13,77,359,402,-43
13,199,13,113,128,0,128
13,199,13,121,108,76,32
13,199,13,145,71,93,-22
13,199,13,151,66,0,66
13,199,13,215,65,81,-16
13,199,13,231,0,41,-41
13,199,13,255,35,40,-5
13,199,13,263,78,75,3
13,199,13,285,254,328,-74
13,199,13,293,59,72,-13
13,201,13,87,95,71,24
13,201,13,95,0,31,-31
13,201,13,99,63,36,27
13,201,13,253,52,86,-34
13,205,13,7,50,76,-26
13,205,13,71,58,183,-125
13,205,13,87,49,0,49
13,205,13,95,239,346,-107
13,205,13,131,95,59,36
13,205,13,177,58,71,-13
13,205,13,275,138,115,23
13,205,13,321,51,31,20
13,207,13,21,618,482,136
13,207,13,35,104,67,37
13,207,13,63,111,0,111
13,207,13,79,38,57,-19
13,207,13,89,31,25,6
13,207,13,121,65,40,25
13,207,13,135,42,27,15
13,207,13,151,224,91,133
13,207,13,153,122,76,46
13,207,13,169,104,47,57
13,207,13,171,84,79,5
13,207,13,225,49,0,49
13,207,13,255,70,47,23
13,207,13,293,0,33,-33
13,209,13,175,0,42,-42
13,209,13,267,0,37,-37
13,209,13,279,268,271,-3
13,209,13,283,0,45,-45
13,209,13,309,32,50,-18
13,211,13,59,85,85,0
13,211,13,67,34,0,34
13,211,13,89,64,47,17
13,211,13,121,0,35,-35
13,211,13,133,82,54,28
13,211,13,135,116,27,89
13,211,13,217,224,164,60
13,211,13,219,44,54,-10
13,211,13,237,146,65,81
13,211,13,247,124,44,80
13,211,13,297,161,168,-7
13,213,6,37,38,0,38
13,213,13,15,28,39,-11
13,213,13,47,78,104,-26
13,213,13,67,36,0,36
13,213,13,115,0,40,-40
13,213,13,123,77,82,-5
13,213,13,129,284,344,-60
13,213,13,295,45,46,-1
13,213,13,313,1500,1646,-146
13,213,47,11,53,53,0
13,213,47,65,39,44,-5
13,213,47,139,38,43,-5
13,215,1,1,0,38,-38
13,215,1,5,62,35,27
13,215,1,17,56,45,11
13,215,1,31,0,38,-38
13,215,1,45,37,0,37
13,215,1,51,33,0,33
13,215,1,69,34,36,-2
13,215,1,73,107,51,56
13,215,1,81,840,1276,-436
13,215,1,87,49,30,19
13,215,1,89,31,89,-58
13,215,1,101,112,99,13
13,215,1,113,1988,2371,-383
13,215,1,117,41,31,10
13,215,2,20,62,42,20
13,215,2,90,93,54,39
13,215,4,3,42,0,42
13,215,4,13,27,53,-26
13,215,6,37,58,35,23
13,215,6,71,42,82,-40
13,215,6,73,57,46,11
13,215,8,41,116,129,-13
13,215,12,5,47,44,3
13,215,12,11,103,49,54
13,215,12,31,80,122,-42
13,215,12,33,74,57,17
13,215,12,57,99,96,3
13,215,12,71,26,36,-10
13,215,12,73,59,39,20
13,215,12,86,106,54,52
13,215,12,91,55,55,0
13,215,12,95,88,67,21
13,215,12,99,37,0,37
13,215,12,103,43,30,13
13,215,12,105,0,36,-36
13,215,12,113,39,0,39
13,215,13,21,92,90,2
13,215,13,45,46,50,-4
13,215,13,51,139,121,18
13,215,13,53,964,719,245
13,215,13,57,51,60,-9
13,215,13,59,57,45,12
13,215,13,63,126,200,-74
13,215,13,67,154,280,-126
13,215,13,73,44,51,-7
13,215,13,77,63,135,-72
13,215,13,89,228,327,-99
13,215,13,95,145,74,71
13,215,13,97,63,59,4
13,215,13,113,29,47,-18
13,215,13,117,0,45,-45
13,215,13,121,321,477,-156
13,215,13,135,179,262,-83
13,215,13,145,952,1411,-459
13,215,13,151,71,79,-8
13,215,13,153,93,91,2
13,215,13,179,102,86,16
13,215,13,185,61,38,23
13,215,13,197,187,141,46
13,215,13,199,81,65,16
13,215,13,223,0,31,-31
13,215,13,245,79,86,-7
13,215,13,255,30,0,30
13,215,13,259,86,89,-3
13,215,13,261,56,51,5
13,215,13,263,169,104,65
13,215,13,273,29,0,29
13,215,13,285,205,213,-8
13,215,15,3,100,116,-16
13,215,17,31,63,48,15
13,215,18,97,39,38,1
13,215,20,61,39,104,-65
13,215,20,161,0,71,-71
13,215,21,47,85,0,85
13,215,21,93,55,0,55
13,215,22,71,0,39,-39
13,215,22,115,94,54,40
13,215,24,3,0,39,-39
13,215,24,25,58,0,58
13,215,24,33,36,0,36
13,215,26,163,66,0,66
13,215,28,47,0,30,-30
13,215,29,169,41,50,-9
13,215,32,3,0,47,-47
13,215,34,13,38,0,38
13,215,36,45,161,107,54
13,215,36,47,32,43,-11
13,215,36,71,60,0,60
13,215,37,51,218,368,-150
13,215,37,85,0,55,-55
13,215,37,93,0,47,-47
13,215,37,119,28,50,-22
13,215,37,125,0,34,-34
13,215,37,133,47,0,47
13,215,37,183,42,0,42
13,215,39,35,37,0,37
13,215,39,49,21,28,-7
13,215,39,153,33,0,33
13,215,40,31,91,0,91
13,215,42,3,44,0,44
13,215,45,19,0,27,-27
13,215,45,79,78,140,-62
13,215,47,37,27,30,-3
13,215,47,125,187,164,23
13,215,47,157,57,0,57
13,215,48,27,209,290,-81
13,215,48,29,123,161,-38
13,215,48,99,42,86,-44
13,215,48,113,46,67,-21
13,215,48,141,72,132,-60
13,215,48,201,73,89,-16
13,215,48,439,0,31,-31
13,215,51,59,67,52,15
13,215,51,153,0,41,-41
13,215,51,810,31,41,-10
13,215,53,53,157,221,-64
13,215,53,67,51,119,-68
13,217,4,13,32,0,32
13,217,6,37,46,0,46
13,217,6,73,28,0,28
13,217,9,1,33,0,33
13,217,12,11,217,41,176
13,217,12,31,0,43,-43
13,217,12,57,41,0,41
13,217,12,86,181,71,110
13,217,12,95,50,0,50
13,217,12,99,73,0,73
13,217,13,9,58,0,58
13,217,13,13,0,71,-71
13,217,13,21,27,30,-3
13,217,13,35,89,119,-30
13,217,13,45,46,0,46
13,217,13,51,0,30,-30
13,217,13,57,62,59,3
13,217,13,59,49,84,-35
13,217,13,63,263,175,88
13,217,13,67,207,170,37
13,217,13,77,0,40,-40
13,217,13,89,2096,1200,896
13,217,13,97,69,40,29
13,217,13,113,27,34,-7
13,217,13,117,0,32,-32
13,217,13,121,447,404,43
13,217,13,133,0,34,-34
13,217,13,135,562,579,-17
13,217,13,139,0,27,-27
13,217,13,151,385,378,7
13,217,13,157,34,0,34
13,217,13,159,339,438,-99
13,217,13,211,164,224,-60
13,217,13,237,0,53,-53
13,217,13,245,41,37,4
13,217,13,247,2548,1878,670
13,217,13,255,0,46,-46
13,217,13,297,480,769,-289
13,217,24,33,47,0,47
13,217,26,163,0,35,-35
13,217,34,13,32,0,32
13,217,34,23,35,0,35
13,217,36,5,71,36,35
13,217,36,47,134,46,88
13,217,36,59,51,0,51
13,217,36,81,92,0,92
13,217,39,151,27,0,27
13,219,13,13,154,142,12
13,219,13,21,38,0,38
13,219,13,59,1183,708,475
13,219,13,67,0,30,-30
13,219,13,89,35,0,35
13,219,13,121,30,49,-19
13,219,13,133,59,0,59
13,219,13,135,233,84,149
13,219,13,139,29,0,29
13,219,13,157,69,121,-52
13,219,13,195,103,110,-7
13,219,13,211,54,44,10
13,219,13,221,65,89,-24
13,219,13,247,85,0,85
13,219,13,297,64,84,-20
13,221,13,13,60,47,13
13,221,13,59,485,391,94
13,221,13,105,0,37,-37
13,221,13,133,34,0,34
13,221,13,135,36,0,36
13,221,13,157,0,52,-52
13,221,13,195,171,139,32
13,221,13,219,89,65,24
13,223,1,15,36,0,36
13,223,1,73,0,38,-38
13,223,4,13,47,53,-6
13,223,6,37,82,0,82
13,223,6,73,64,0,64
13,223,12,5,0,32,-32
13,223,12,11,306,71,235
13,223,12,31,56,50,6
13,223,12,57,75,59,16
13,223,12,71,31,0,31
13,223,12,86,195,0,195
13,223,12,95,116,58,58
13,223,12,99,127,57,70
13,223,12,103,52,0,52
13,223,13,15,557,474,83
13,223,13,45,635,611,24
13,223,13,51,0,53,-53
13,223,13,57,498,366,132
13,223,13,63,209,92,117
13,223,13,67,6035,3161,2874
13,223,13,77,72,56,16
13,223,13,89,290,173,117
13,223,13,97,1325,1182,143
13,223,13,113,45,44,1
13,223,13,115,73,92,-19
13,223,13,117,53,60,-7
13,223,13,121,553,533,20
13,223,13,129,33,30,3
13,223,13,135,297,179,118
13,223,13,139,45,48,-3
13,223,13,143,119,177,-58
13,223,13,151,95,49,46
13,223,13,153,38,47,-9
13,223,13,215,31,0,31
13,223,13,233,190,330,-140
13,223,17,31,43,0,43
13,223,22,71,0,39,-39
13,223,32,3,31,0,31
13,223,34,13,44,0,44
13,223,34,39,40,0,40
13,223,36,5,40,0,40
13,223,36,47,46,0,46
13,223,36,59,67,0,67
13,223,36,81,88,0,88
13,223,36,103,57,0,57
13,223,47,65,58,0,58
13,223,48,201,40,33,7
13,223,51,810,50,0,50
13,223,55,79,33,0,33
13,225,13,21,427,321,106
13,225,13,79,119,102,17
13,225,13,89,0,27,-27
13,225,13,121,46,28,18
13,225,13,151,0,32,-32
13,225,13,153,1087,1091,-4
13,225,13,169,26,0,26
13,225,13,193,94,34,60
13,225,13,207,0,49,-49
13,225,13,269,46,0,46
13,227,13,15,42,92,-50
13,227,13,57,790,594,196
13,227,13,67,200,127,73
13,227,13,85,0,38,-38
13,227,13,89,38,0,38
13,227,13,97,27,0,27
13,227,13,111,46,27,19
13,227,13,117,102,86,16
13,227,13,121,125,100,25
13,227,13,123,219,211,8
13,227,13,129,60,99,-39
13,227,13,135,91,29,62
13,229,12,31,50,38,12
13,229,13,5,38,29,9
13,229,13,25,108,77,31
13,229,13,69,44,0,44
13,229,13,127,52,37,15
13,229,13,299,642,486,156
13,229,13,305,67,58,9
13,231,13,63,136,57,79
13,231,13,77,63,32,31
13,231,13,89,0,27,-27
13,231,13,113,109,31,78
13,231,13,121,0,37,-37
13,231,13,151,290,96,194
13,231,13,171,80,123,-43
13,231,13,199,41,0,41
13,231,13,255,507,440,67
13,231,13,293,148,194,-46
13,233,1,15,33,29,4
13,233,1,19,33,0,33
13,233,13,15,250,296,-46
13,233,13,45,83,69,14
13,233,13,55,43,0,43
13,233,13,57,51,43,8
13,233,13,67,203,98,105
13,233,13,97,82,48,34
13,233,13,115,496,619,-123
13,233,13,121,65,47,18
13,233,13,129,0,48,-48
13,233,13,135,0,28,-28
13,233,13,143,132,125,7
13,233,13,223,330,190,140
13,235,13,21,0,51,-51
13,235,13,23,43,58,-15
13,235,13,91,27,33,-6
13,235,13,153,149,216,-67
13,237,13,9,236,276,-40
13,237,13,21,69,58,11
13,237,13,89,39,0,39
13,237,13,121,37,0,37
13,237,13,133,142,114,28
13,237,13,135,62,31,31
13,237,13,151,32,0,32
13,237,13,153,0,41,-41
13,237,13,159,83,47,36
13,237,13,169,39,66,-27
13,237,13,211,65,146,-81
13,237,13,217,53,0,53
13,237,13,247,40,0,40
13,237,13,297,35,0,35
13,239,1,5,72,80,-8
13,241,13,13,27,0,27
13,241,13,89,48,0,48
13,241,13,121,33,0,33
13,241,13,135,46,0,46
13,241,13,137,49,86,-37
13,241,13,139,44,34,10
13,241,13,257,38,43,-5
13,241,37,113,79,150,-71
13,241,45,73,0,35,-35
13,243,13,37,0,32,-32
13,243,13,95,43,82,-39
13,243,13,273,0,53,-53
13,245,1,73,58,56,2
13,245,2,20,49,0,49
13,245,4,3,73,81,-8
13,245,4,13,38,60,-22
13,245,6,37,61,68,-7
13,245,6,53,220,44,176
13,245,6,71,65,36,29
13,245,6,73,69,41,28
13,245,8,41,95,94,1
13,245,12,9,31,0,31
13,245,12,11,156,50,106
13,245,12,31,106,75,31
13,245,12,33,43,40,3
13,245,12,57,117,94,23
13,245,12,86,140,78,62
13,245,12,95,87,79,8
13,245,12,99,76,50,26
13,245,12,103,72,47,25
13,245,12,105,43,30,13
13,245,12,109,0,28,-28
13,245,12,117,0,38,-38
13,245,12,127,32,34,-2
13,245,13,9,31,0,31
13,245,13,21,69,72,-3
13,245,13,31,103,71,32
13,245,13,33,758,707,51
13,245,13,51,207,236,-29
13,245,13,59,141,79,62
13,245,13,63,95,159,-64
13,245,13,67,192,193,-1
13,245,13,73,3279,4501,-1222
13,245,13,77,28,0,28
13,245,13,89,223,305,-82
13,245,13,95,35,25,10
13,245,13,103,0,44,-44
13,245,13,107,36,40,-4
13,245,13,121,259,316,-57
13,245,13,135,158,215,-57
13,245,13,151,32,51,-19
13,245,13,153,31,44,-13
13,245,13,163,194,164,30
13,245,13,165,41,0,41
13,245,13,179,109,105,4
13,245,13,181,89,76,13
13,245,13,185,0,44,-44
13,245,13,189,279,209,70
13,245,13,215,86,79,7
13,245,13,217,37,41,-4
13,245,13,247,48,43,5
13,245,13,251,32,0,32
13,245,13,301,48,32,16
13,245,13,303,58,0,58
13,245,13,317,0,45,-45
13,245,15,3,137,156,-19
13,245,17,31,53,75,-22
13,245,18,97,24,0,24
13,245,20,61,39,72,-33
13,245,21,47,67,104,-37
13,245,21,93,52,0,52
13,245,22,115,50,57,-7
13,245,24,3,82,95,-13
13,245,24,21,0,51,-51
13,245,24,27,0,33,-33
13,245,24,31,36,39,-3
13,245,24,33,29,39,-10
13,245,24,510,23,52,-29
13,245,25,25,23,0,23
13,245,26,125,31,0,31
13,245,26,163,35,0,35
13,245,29,169,0,43,-43
13,245,32,3,29,61,-32
13,245,36,5,37,0,37
13,245,36,45,105,92,13
13,245,36,47,61,52,9
13,245,36,59,28,0,28
13,245,36,61,37,39,-2
13,245,36,81,36,0,36
13,245,37,21,0,25,-25
13,245,37,25,0,33,-33
13,245,37,51,170,274,-104
13,245,37,67,0,25,-25
13,245,37,81,0,39,-39
13,245,37,119,74,111,-37
13,245,37,133,47,39,8
13,245,37,183,44,36,8
13,245,39,35,39,0,39
13,245,39,153,28,0,28
13,245,40,31,97,53,44
13,245,42,3,27,0,27
13,245,42,101,54,0,54
13,245,45,3,1241,1591,-350
13,245,45,7,0,32,-32
13,245,45,11,34,0,34
13,245,45,13,40,52,-12
13,245,45,15,0,62,-62
13,245,45,19,76,108,-32
13,245,45,37,90,139,-49
13,245,45,45,74,47,27
13,245,45,47,53,0,53
13,245,45,63,70,143,-73
13,245,45,65,0,39,-39
13,245,45,75,33,25,8
13,245,45,79,174,224,-50
13,245,45,85,0,43,-43
13,245,45,91,33,0,33
13,245,47,37,36,34,2
13,245,47,65,0,35,-35
13,245,47,93,26,0,26
13,245,47,125,137,112,25
13,245,47,157,48,33,15
13,245,48,27,242,220,22
13,245,48,29,126,147,-21
13,245,48,99,0,69,-69
13,245,48,113,40,24,16
13,245,48,141,109,128,-19
13,245,48,201,55,71,-16
13,245,48,439,30,34,-4
13,245,48,451,82,0,82
13,245,51,41,38,0,38
13,245,51,59,56,97,-41
13,245,51,153,0,41,-41
13,245,51,650,46,0,46
13,245,51,700,75,30,45
13,245,51,710,42,0,42
13,245,51,810,62,0,62
13,245,53,53,145,159,-14
13,245,53,67,0,40,-40
13,247,6,37,56,0,56
13,247,12,11,256,67,189
13,247,12,31,35,0,35
13,247,12,73,26,0,26
13,247,12,86,173,47,126
13,247,12,95,29,0,29
13,247,12,99,70,0,70
13,247,12,103,35,0,35
13,247,13,9,27,28,-1
13,247,13,13,40,31,9
13,247,13,35,32,73,-41
13,247,13,45,0,33,-33
13,247,13,51,41,23,18
13,247,13,57,0,47,-47
13,247,13,59,37,97,-60
13,247,13,63,318,267,51
13,247,13,67,192,247,-55
13,247,13,77,0,28,-28
13,247,13,89,2936,1538,1398
13,247,13,97,68,45,23
13,247,13,117,0,76,-76
13,247,13,121,510,543,-33
13,247,13,133,0,60,-60
13,247,13,135,744,757,-13
13,247,13,139,29,56,-27
13,247,13,151,291,429,-138
13,247,13,159,62,129,-67
13,247,13,211,44,124,-80
13,247,13,217,1878,2548,-670
13,247,13,219,0,85,-85
13,247,13,237,0,40,-40
13,247,13,245,43,48,-5
13,247,13,255,0,38,-38
13,247,13,297,217,506,-289
13,247,17,31,41,30,11
13,247,24,33,49,0,49
13,247,26,163,66,0,66
13,247,36,5,78,0,78
13,247,36,47,163,0,163
13,247,36,59,78,0,78
13,247,36,81,105,0,105
13,247,36,103,36,0,36
13,247,36,119,34,0,34
13,247,37,119,0,33,-33
13,249,13,197,32,41,-9
13,249,13,261,269,200,69
13,251,13,31,217,300,-83
13,251,13,33,29,38,-9
13,251,13,51,74,46,28
13,251,13,103,119,90,29
13,251,13,165,29,58,-29
13,251,13,245,0,32,-32
13,253,1,69,35,33,2
13,253,13,87,196,160,36
13,253,13,99,74,63,11
13,253,13,201,86,52,34
13,255,12,11,37,0,37
13,255,12,86,36,0,36
13,255,13,21,51,38,13
13,255,13,35,252,265,-13
13,255,13,45,34,0,34
13,255,13,51,28,0,28
13,255,13,57,0,23,-23
13,255,13,59,0,25,-25
13,255,13,63,828,487,341
13,255,13,67,83,48,35
13,255,13,77,137,182,-45
13,255,13,89,104,100,4
13,255,13,97,38,0,38
13,255,13,113,197,180,17
13,255,13,121,226,192,34
13,255,13,135,93,81,12
13,255,13,151,1214,936,278
13,255,13,171,431,376,55
13,255,13,199,40,35,5
13,255,13,207,47,70,-23
13,255,13,215,0,30,-30
13,255,13,217,46,0,46
13,255,13,231,440,507,-67
13,255,13,247,38,0,38
13,255,13,293,180,163,17
13,257,13,11,70,36,34
13,257,13,13,68,0,68
13,257,13,59,0,44,-44
13,257,13,89,0,22,-22
13,257,13,119,212,178,34
13,257,13,135,71,57,14
13,257,13,137,137,170,-33
13,257,13,139,85,83,2
13,257,13,147,48,42,6
13,257,13,157,57,41,16
13,257,13,241,43,38,5
13,257,13,311,53,0,53
13,257,45,7,0,46,-46
13,257,45,73,49,67,-18
13,259,13,215,89,86,3
13,259,13,307,40,27,13
13,261,13,21,0,26,-26
13,261,13,81,70,55,15
13,261,13,89,0,48,-48
13,261,13,93,30,30,0
13,261,13,95,116,193,-77
13,261,13,121,37,42,-5
13,261,13,135,40,0,40
13,261,13,153,0,110,-110
13,261,13,177,94,138,-44
13,261,13,193,62,76,-14
13,261,13,215,51,56,-5
13,261,13,249,200,269,-69
13,261,13,273,33,0,33
13,263,13,145,0,44,-44
13,263,13,199,75,78,-3
13,263,13,215,104,169,-65
13,267,13,29,0,30,-30
13,267,13,31,90,80,10
13,267,13,43,72,70,2
13,267,13,51,78,62,16
13,267,13,103,0,31,-31
13,267,13,109,164,169,-5
13,267,13,179,144,79,65
13,267,13,183,51,29,22
13,267,13,209,37,0,37
13,267,13,279,152,136,16
13,267,13,305,36,33,3
13,269,13,21,0,27,-27
13,269,13,79,29,0,29
13,269,13,153,66,57,9
13,269,13,193,41,0,41
13,269,13,225,0,46,-46
13,269,13,293,0,31,-31
13,271,13,69,0,48,-48
13,271,13,91,98,88,10
13,271,13,161,59,98,-39
13,271,13,175,35,44,-9
13,271,13,309,69,55,14
13,273,13,95,220,312,-92
13,273,13,177,103,71,32
13,273,13,215,0,29,-29
13,273,13,243,53,0,53
13,273,13,261,0,33,-33
13,275,12,11,32,27,5
13,275,12,31,55,45,10
13,275,12,65,53,0,53
13,275,12,73,199,193,6
13,275,12,86,44,0,44
13,275,12,95,30,0,30
13,275,13,27,154,139,15
13,275,13,63,0,37,-37
13,275,13,71,221,221,0
13,275,13,87,60,45,15
13,275,13,89,0,46,-46
13,275,13,95,66,68,-2
13,275,13,121,25,29,-4
13,275,13,131,445,342,103
13,275,13,185,119,120,-1
13,275,13,205,115,138,-23
13,277,12,31,35,38,-3
13,277,12,99,25,0,25
13,277,13,17,84,87,-3
13,277,13,19,186,234,-48
13,277,13,21,0,48,-48
13,277,13,51,0,26,-26
13,277,13,59,28,27,1
13,277,13,67,0,27,-27
13,277,13,69,31,37,-6
13,277,13,71,206,153,53
13,277,13,75,155,136,19
13,277,13,81,49,0,49
13,277,13,89,35,26,9
13,277,13,95,95,88,7
13,277,13,121,33,38,-5
13,277,13,135,27,0,27
13,277,13,155,104,100,4
13,277,13,177,37,0,37
13,277,13,185,104,155,-51
13,277,13,287,166,138,28
13,277,13,321,133,159,-26
13,279,13,1,0,41,-41
13,279,13,31,42,53,-11
13,279,13,51,44,79,-35
13,279,13,107,70,88,-18
13,279,13,109,39,0,39
13,279,13,161,27,0,27
13,279,13,175,0,58,-58
13,279,13,179,36,0,36
13,279,13,209,271,268,3
13,279,13,267,136,152,-16
13,279,13,283,76,40,36
13,281,13,121,27,0,27
13,281,13,135,32,0,32
13,281,13,291,123,141,-18
13,281,37,43,110,96,14
13,283,13,107,39,0,39
13,283,13,175,62,69,-7
13,283,13,209,45,0,45
13,283,13,279,40,76,-36
13,285,1,17,456,388,68
13,285,1,81,110,132,-22
13,285,1,111,74,87,-13
13,285,13,45,46,74,-28
13,285,13,51,24,0,24
13,285,13,63,50,52,-2
13,285,13,67,73,57,16
13,285,13,77,295,293,2
13,285,13,89,59,66,-7
13,285,13,97,0,28,-28
13,285,13,113,43,0,43
13,285,13,121,136,145,-9
13,285,13,135,57,76,-19
13,285,13,145,250,181,69
13,285,13,149,188,197,-9
13,285,13,151,51,31,20
13,285,13,199,328,254,74
13,285,13,215,213,205,8
13,287,13,17,0,33,-33
13,287,13,81,60,93,-33
13,287,13,277,138,166,-28
13,287,13,321,39,56,-17
13,289,13,21,268,291,-23
13,289,13,23,43,0,43
13,289,13,153,63,72,-9
13,289,13,169,43,110,-67
13,289,13,175,30,0,30
13,289,13,319,36,34,2
13,291,12,57,33,0,33
13,291,12,71,45,0,45
13,291,12,81,30,0,30
13,291,12,95,41,0,41
13,291,12,99,53,0,53
13,291,12,103,32,0,32
13,291,12,127,40,0,40
13,291,13,57,46,39,7
13,291,13,67,38,28,10
13,291,13,111,150,84,66
13,291,13,117,27,0,27
13,291,13,121,30,0,30
13,291,13,123,35,0,35
13,291,13,135,51,0,51
13,291,13,139,38,30,8
13,291,13,187,0,34,-34
13,291,13,281,141,123,18
13,291,37,39,34,67,-33
13,291,37,43,0,49,-49
13,293,13,21,31,45,-14
13,293,13,63,0,55,-55
13,293,13,77,0,43,-43
13,293,13,121,46,43,3
13,293,13,151,82,58,24
13,293,13,153,0,32,-32
13,293,13,171,125,108,17
13,293,13,199,72,59,13
13,293,13,207,33,0,33
13,293,13,231,194,148,46
13,293,13,255,163,180,-17
13,293,13,269,31,0,31
13,295,1,49,31,43,-12
13,295,1,71,36,65,-29
13,295,12,103,28,0,28
13,295,13,15,62,0,62
13,295,13,47,1158,1253,-95
13,295,13,55,327,292,35
13,295,13,59,0,27,-27
13,295,13,67,30,36,-6
13,295,13,83,154,122,32
13,295,13,115,44,48,-4
13,295,13,121,0,21,-21
13,295,13,129,61,0,61
13,295,13,213,46,45,1
13,295,13,313,261,187,74
13,295,47,11,44,44,0
13,295,47,65,1338,1211,127
13,295,47,115,34,0,34
13,297,12,11,87,0,87
13,297,12,57,27,0,27
13,297,12,86,52,0,52
13,297,13,13,489,549,-60
13,297,13,57,43,64,-21
13,297,13,59,190,226,-36
13,297,13,63,54,58,-4
13,297,13,67,58,98,-40
13,297,13,89,453,306,147
13,297,13,97,28,0,28
13,297,13,117,46,57,-11
13,297,13,121,208,186,22
13,297,13,135,2678,1413,1265
13,297,13,139,72,100,-28
13,297,13,151,92,76,16
13,297,13,157,90,121,-31
13,297,13,159,63,70,-7
13,297,13,195,0,36,-36
13,297,13,211,168,161,7
13,297,13,217,769,480,289
13,297,13,219,84,64,20
13,297,13,237,0,35,-35
13,297,13,247,506,217,289
13,297,36,5,36,0,36
13,297,36,47,33,0,33
13,297,36,81,61,0,61
13,299,12,31,79,102,-23
13,299,12,89,46,41,5
13,299,13,1,0,33,-33
13,299,13,5,72,45,27
13,299,13,25,163,190,-27
13,299,13,39,54,43,11
13,299,13,49,42,0,42
13,299,13,51,42,66,-24
13,299,13,65,53,53,0
13,299,13,69,66,78,-12
13,299,13,121,0,39,-39
13,299,13,127,98,91,7
13,299,13,185,62,98,-36
13,299,13,229,486,642,-156
13,299,13,305,38,60,-22
13,301,13,73,38,0,38
13,301,13,125,0,38,-38
13,301,13,189,172,242,-70
13,301,13,245,32,48,-16
13,303,13,9,81,112,-31
13,303,13,21,0,48,-48
13,303,13,121,29,26,3
13,303,13,125,36,0,36
13,303,13,153,0,30,-30
13,303,13,163,59,37,22
13,303,13,167,44,52,-8
13,303,13,175,63,92,-29
13,303,13,245,0,58,-58
13,305,12,31,40,47,-7
13,305,13,1,56,63,-7
13,305,13,25,59,52,7
13,305,13,31,0,37,-37
13,305,13,51,36,33,3
13,305,13,127,202,172,30
13,305,13,179,148,95,53
13,305,13,183,101,95,6
13,305,13,191,42,0,42
13,305,13,229,58,67,-9
13,305,13,267,33,36,-3
13,305,13,299,60,38,22
13,307,13,259,0,40,-40
13,309,13,209,50,32,18
13,309,13,271,55,69,-14
13,311,12,99,30,0,30
13,311,13,11,32,50,-18
13,311,13,13,25,0,25
13,311,13,67,0,32,-32
13,311,13,85,29,30,-1
13,311,13,89,38,0,38
13,311,13,117,62,25,37
13,311,13,121,41,39,2
13,311,13,135,136,43,93
13,311,13,137,318,426,-108
13,311,13,139,446,431,15
13,311,13,157,36,0,36
13,311,13,187,179,137,42
13,311,13,257,0,53,-53
13,313,6,37,58,52,6
13,313,12,86,32,0,32
13,313,12,95,0,43,-43
13,313,13,15,52,91,-39
13,313,13,47,551,422,129
13,313,13,55,0,45,-45
13,313,13,57,35,0,35
13,313,13,59,0,28,-28
13,313,13,67,65,133,-68
13,313,13,89,33,46,-13
13,313,13,115,45,77,-32
13,313,13,121,35,92,-57
13,313,13,123,51,0,51
13,313,13,129,443,483,-40
13,313,13,135,48,67,-19
13,313,13,213,1646,1500,146
13,313,13,295,187,261,-74
13,313,17,31,49,65,-16
13,313,34,39,0,45,-45
13,313,47,11,116,107,9
13,313,47,65,234,284,-50
13,313,47,93,0,39,-39
13,313,48,201,0,57,-57
13,315,13,17,38,70,-32
13,315,13,81,53,73,-20
13,315,13,153,0,33,-33
13,317,13,59,44,72,-28
13,317,13,73,0,39,-39
13,317,13,181,66,59,7
13,317,13,189,0,34,-34
13,317,13,245,45,0,45
13,317,13,265,0,37,-37
13,319,13,9,170,204,-34
13,319,13,21,82,130,-48
13,319,13,169,35,60,-25
13,319,13,175,46,47,-1
13,319,13,289,34,36,-2
13,321,13,71,115,136,-21
13,321,13,81,51,64,-13
13,321,13,95,482,482,0
13,321,13,177,119,132,-13
13,321,13,205,31,51,-20
13,321,13,277,159,133,26
13,321,13,287,56,39,17
15,1,2,20,85,71,14
15,1,2,122,44,0,44
15,1,2,170,49,0,49
15,1,4,5,22,0,22
15,1,4,13,171,149,22
15,1,4,19,54,76,-22
15,1,6,1,83,85,-2
15,1,6,13,53,39,14
15,1,6,17,29,32,-3
15,1,6,23,25,0,25
15,1,6,29,27,0,27
15,1,6,37,297,175,122
15,1,6,41,40,0,40
15,1,6,45,23,0,23
15,1,6,53,47,24,23
15,1,6,57,0,30,-30
15,1,6,59,155,144,11
15,1,6,65,118,79,39
15,1,6,67,99,72,27
15,1,6,71,75,36,39
15,1,6,73,272,234,38
15,1,6,75,72,68,4
15,1,6,79,28,0,28
15,1,6,81,49,49,0
15,1,6,83,26,29,-3
15,1,6,85,98,84,14
15,1,6,87,59,38,21
15,1,6,89,0,26,-26
15,1,6,97,74,55,19
15,1,6,107,33,0,33
15,1,6,111,80,45,35
15,1,8,13,27,31,-4
15,1,8,41,32,43,-11
15,1,8,59,31,32,-1
15,1,8,69,44,0,44
15,1,12,95,0,27,-27
15,1,15,3,2378,1661,717
15,1,15,9,570,460,110
15,1,16,1,0,41,-41
15,1,17,31,72,46,26
15,1,27,53,33,0,33
15,1,32,3,218,286,-68
15,1,32,31,61,65,-4
15,1,35,1,22,0,22
15,1,41,5,36,42,-6
15,1,41,17,37,0,37
15,1,41,29,39,49,-10
15,1,41,39,38,54,-16
15,1,41,47,41,35,6
15,1,41,51,86,100,-14
15,1,41,67,65,85,-20
15,1,48,29,29,0,29
15,1,48,113,23,28,-5
15,1,48,201,47,40,7
15,1,48,453,0,25,-25
15,1,49,35,55,60,-5
15,1,49,49,40,0,40
15,1,53,11,47,50,-3
15,1,53,33,206,189,17
15,1,53,35,49,27,22
15,1,53,53,66,66,0
15,1,53,61,48,55,-7
15,1,53,63,39,64,-25
15,1,53,67,40,0,40
15,1,53,73,26,44,-18
15,3,1,1,42,0,42
15,3,1,3,0,38,-38
15,3,1,31,109,109,0
15,3,1,45,115,88,27
15,3,1,69,0,43,-43
15,3,1,73,36,23,13
15,3,1,81,31,0,31
15,3,1,89,36,81,-45
15,3,1,97,39,76,-37
15,3,1,101,89,68,21
15,3,2,16,0,26,-26
15,3,2,20,251,406,-155
15,3,2,90,147,61,86
15,3,2,110,0,41,-41
15,3,2,150,65,0,65
15,3,4,3,239,237,2
15,3,4,5,0,44,-44
15,3,4,13,706,995,-289
15,3,4,15,42,0,42
15,3,4,19,257,249,8
15,3,4,21,37,105,-68
15,3,4,25,52,33,19
15,3,4,27,42,70,-28
15,3,5,119,94,91,3
15,3,5,143,50,31,19
15,3,6,1,420,449,-29
15,3,6,7,39,0,39
15,3,6,13,205,234,-29
15,3,6,17,31,77,-46
15,3,6,19,98,106,-8
15,3,6,23,0,44,-44
15,3,6,29,100,146,-46
15,3,6,31,86,106,-20
15,3,6,37,1587,1775,-188
15,3,6,41,48,85,-37
15,3,6,53,496,340,156
15,3,6,55,0,47,-47
15,3,6,57,41,0,41
15,3,6,59,771,754,17
15,3,6,61,100,121,-21
15,3,6,65,412,469,-57
15,3,6,67,296,314,-18
15,3,6,71,568,464,104
15,3,6,73,2053,2717,-664
15,3,6,75,350,387,-37
15,3,6,77,120,128,-8
15,3,6,79,67,58,9
15,3,6,81,246,286,-40
15,3,6,83,156,139,17
15,3,6,85,381,447,-66
15,3,6,87,53,59,-6
15,3,6,89,0,42,-42
15,3,6,95,229,229,0
15,3,6,97,85,138,-53
15,3,6,99,61,75,-14
15,3,6,101,0,37,-37
15,3,6,107,36,84,-48
15,3,6,111,221,271,-50
15,3,6,113,31,63,-32
15,3,6,115,45,54,-9
15,3,8,1,50,51,-1
15,3,8,5,148,168,-20
15,3,8,13,53,62,-9
15,3,8,31,88,165,-77
15,3,8,35,55,91,-36
15,3,8,41,446,626,-180
15,3,8,59,67,82,-15
15,3,8,69,52,63,-11
15,3,8,101,30,0,30
15,3,8,123,31,38,-7
15,3,9,1,52,43,9
15,3,9,3,59,66,-7
15,3,9,9,37,48,-11
15,3,9,11,219,160,59
15,3,10,1,47,77,-30
15,3,10,3,46,46,0
15,3,10,5,34,0,34
15,3,11,1,139,125,14
15,3,12,1,34,28,6
15,3,12,5,89,65,24
15,3,12,9,70,95,-25
15,3,12,11,163,162,1
15,3,12,19,144,105,39
15,3,12,31,453,298,155
15,3,12,33,311,213,98
15,3,12,53,0,32,-32
15,3,12,57,176,245,-69
15,3,12,69,39,36,3
15,3,12,71,29,77,-48
15,3,12,73,43,0,43
15,3,12,81,37,0,37
15,3,12,83,36,29,7
15,3,12,85,23,0,23
15,3,12,86,178,172,6
15,3,12,87,31,0,31
15,3,12,91,125,190,-65
15,3,12,95,127,163,-36
15,3,12,97,25,58,-33
15,3,12,99,107,73,34
15,3,12,101,63,81,-18
15,3,12,103,105,155,-50
15,3,12,105,47,46,1
15,3,12,109,43,48,-5
15,3,12,113,66,157,-91
15,3,12,115,28,0,28
15,3,12,117,40,52,-12
15,3,12,127,52,45,7
15,3,13,39,93,114,-21
15,3,13,51,67,64,3
15,3,13,53,50,66,-16
15,3,13,67,62,86,-24
15,3,13,73,97,92,5
15,3,13,77,32,0,32
15,3,13,89,48,99,-51
15,3,13,121,107,94,13
15,3,13,135,68,89,-21
15,3,13,151,0,65,-65
15,3,13,153,27,74,-47
15,3,13,179,80,98,-18
15,3,13,215,116,100,16
15,3,13,245,156,137,19
15,3,15,1,1661,2378,-717
15,3,15,9,1324,1477,-153
15,3,16,1,61,138,-77
15,3,16,39,36,0,36
15,3,17,19,0,22,-22
15,3,17,31,354,309,45
15,3,17,43,90,77,13
15,3,17,97,137,201,-64
15,3,17,119,0,41,-41
15,3,17,143,39,0,39
15,3,17,163,97,135,-38
15,3,17,197,44,57,-13
15,3,17,201,25,0,25
15,3,18,3,31,0,31
15,3,18,97,67,88,-21
15,3,18,141,24,38,-14
15,3,19,153,21,44,-23
15,3,19,163,0,35,-35
15,3,20,61,65,105,-40
15,3,20,91,48,42,6
15,3,20,103,190,111,79
15,3,20,161,42,54,-12
15,3,20,173,58,74,-16
15,3,21,47,179,99,80
15,3,21,93,101,120,-19
15,3,21,111,37,50,-13
15,3,22,15,45,34,11
15,3,22,17,0,27,-27
15,3,22,33,0,43,-43
15,3,22,51,31,46,-15
15,3,22,71,43,51,-8
15,3,22,103,31,43,-12
15,3,22,115,143,91,52
15,3,23,5,68,62,6
15,3,23,31,96,106,-10
15,3,24,3,330,457,-127
15,3,24,5,50,53,-3
15,3,24,17,49,83,-34
15,3,24,21,42,58,-16
15,3,24,25,80,98,-18
15,3,24,27,97,111,-14
15,3,24,31,233,250,-17
15,3,24,33,129,155,-26
15,3,24,37,79,44,35
15,3,24,510,29,35,-6
15,3,25,1,44,0,44
15,3,25,9,46,40,6
15,3,25,17,150,176,-26
15,3,25,21,47,48,-1
15,3,25,23,38,28,10
15,3,25,25,69,74,-5
15,3,25,27,70,51,19
15,3,26,21,31,0,31
15,3,26,49,28,0,28
15,3,26,65,32,0,32
15,3,26,77,23,0,23
15,3,26,81,43,30,13
15,3,26,99,66,32,34
15,3,26,125,99,100,-1
15,3,26,139,34,32,2
15,3,26,161,48,23,25
15,3,26,163,106,77,29
15,3,27,3,0,33,-33
15,3,27,37,0,36,-36
15,3,27,53,122,85,37
15,3,27,123,51,49,2
15,3,28,47,78,166,-88
15,3,28,59,0,37,-37
15,3,29,47,41,37,4
15,3,29,77,54,43,11
15,3,29,95,90,53,37
15,3,29,169,209,163,46
15,3,29,183,42,41,1
15,3,29,189,69,66,3
15,3,30,31,26,0,26
15,3,31,55,40,63,-23
15,3,31,153,114,94,20
15,3,32,3,1344,2625,-1281
15,3,32,23,0,39,-39
15,3,32,31,156,188,-32
15,3,33,11,50,28,22
15,3,33,15,44,45,-1
15,3,34,3,57,48,9
15,3,34,5,68,67,1
15,3,34,7,0,40,-40
15,3,34,13,36,30,6
15,3,34,17,54,39,15
15,3,34,21,28,23,5
15,3,34,23,47,39,8
15,3,34,25,47,51,-4
15,3,34,27,29,0,29
15,3,34,29,36,32,4
15,3,34,39,27,23,4
15,3,35,1,101,154,-53
15,3,35,9,0,55,-55
15,3,35,13,0,68,-68
15,3,35,35,37,0,37
15,3,35,43,0,35,-35
15,3,35,49,23,0,23
15,3,36,5,61,59,2
15,3,36,29,66,68,-2
15,3,36,45,191,126,65
15,3,36,47,165,148,17
15,3,36,55,62,55,7
15,3,36,59,64,65,-1
15,3,36,61,204,213,-9
15,3,36,67,28,60,-32
15,3,36,71,87,55,32
15,3,36,81,129,149,-20
15,3,36,85,0,26,-26
15,3,36,91,90,30,60
15,3,36,103,106,72,34
15,3,36,119,39,43,-4
15,3,37,21,32,0,32
15,3,37,31,0,32,-32
15,3,37,49,172,95,77
15,3,37,51,410,379,31
15,3,37,63,37,58,-21
15,3,37,67,35,0,35
15,3,37,81,0,31,-31
15,3,37,85,42,40,2
15,3,37,93,36,38,-2
15,3,37,119,52,109,-57
15,3,37,129,32,33,-1
15,3,37,133,512,342,170
15,3,37,139,30,0,30
15,3,37,183,80,122,-42
15,3,37,191,37,38,-1
15,3,38,35,0,53,-53
15,3,38,101,0,45,-45
15,3,39,17,28,37,-9
15,3,39,35,75,76,-1
15,3,39,49,98,106,-8
15,3,39,57,0,64,-64
15,3,39,61,35,57,-22
15,3,39,95,33,33,0
15,3,39,113,75,104,-29
15,3,39,153,35,56,-21
15,3,40,27,47,44,3
15,3,40,31,324,166,158
15,3,40,47,0,45,-45
15,3,40,109,76,99,-23
15,3,40,143,36,78,-42
15,3,41,3,25,47,-22
15,3,41,5,78,105,-27
15,3,41,17,30,59,-29
15,3,41,19,37,0,37
15,3,41,29,40,55,-15
15,3,41,35,0,30,-30
15,3,41,39,101,135,-34
15,3,41,47,80,108,-28
15,3,41,51,180,288,-108
15,3,41,67,224,368,-144
15,3,42,3,98,90,8
15,3,42,17,40,67,-27
15,3,42,29,0,33,-33
15,3,42,41,76,82,-6
15,3,42,45,47,49,-2
15,3,42,49,27,37,-10
15,3,42,71,27,0,27
15,3,42,91,64,62,2
15,3,42,101,92,103,-11
15,3,42,129,0,29,-29
15,3,42,133,48,36,12
15,3,44,5,162,150,12
15,3,44,7,51,0,51
15,3,45,13,157,146,11
15,3,45,15,194,73,121
15,3,45,19,128,87,41
15,3,45,35,38,63,-25
15,3,45,45,28,34,-6
15,3,45,51,0,56,-56
15,3,45,79,152,179,-27
15,3,45,85,38,30,8
15,3,46,103,0,34,-34
15,3,47,37,55,71,-16
15,3,47,93,0,38,-38
15,3,47,125,222,187,35
15,3,47,149,34,0,34
15,3,47,157,86,101,-15
15,3,48,27,596,478,118
15,3,48,29,591,894,-303
15,3,48,39,34,31,3
15,3,48,61,32,0,32
15,3,48,85,104,101,3
15,3,48,91,0,37,-37
15,3,48,99,154,91,63
15,3,48,113,170,221,-51
15,3,48,121,73,83,-10
15,3,48,141,375,484,-109
15,3,48,157,40,83,-43
15,3,48,167,35,73,-38
15,3,48,187,29,105,-76
15,3,48,201,350,485,-135
15,3,48,209,0,45,-45
15,3,48,215,43,33,10
15,3,48,245,22,26,-4
15,3,48,303,27,38,-11
15,3,48,339,61,108,-47
15,3,48,355,87,154,-67
15,3,48,375,0,30,-30
15,3,48,409,72,42,30
15,3,48,439,189,280,-91
15,3,48,441,62,60,2
15,3,48,451,166,107,59
15,3,48,453,164,217,-53
15,3,48,485,43,40,3
15,3,48,491,58,145,-87
15,3,49,11,103,162,-59
15,3,49,35,317,347,-30
15,3,49,49,161,293,-132
15,3,49,53,70,62,8
15,3,49,57,0,68,-68
15,3,51,13,117,143,-26
15,3,51,41,46,56,-10
15,3,51,59,560,763,-203
15,3,51,87,25,0,25
15,3,51,95,0,44,-44
15,3,51,99,54,52,2
15,3,51,107,75,121,-46
15,3,51,149,51,46,5
15,3,51,153,227,370,-143
15,3,51,177,48,47,1
15,3,51,179,129,229,-100
15,3,51,199,69,100,-31
15,3,51,510,81,116,-35
15,3,51,550,158,218,-60
15,3,51,650,116,128,-12
15,3,51,700,152,165,-13
15,3,51,710,220,246,-26
15,3,51,740,73,35,38
15,3,51,800,34,81,-47
15,3,51,810,498,515,-17
15,3,53,5,0,41,-41
15,3,53,9,25,37,-12
15,3,53,11,131,223,-92
15,3,53,29,150,209,-59
15,3,53,33,871,1157,-286
15,3,53,35,444,579,-135
15,3,53,41,0,25,-25
15,3,53,45,0,26,-26
15,3,53,53,738,759,-21
15,3,53,57,21,0,21
15,3,53,61,339,419,-80
15,3,53,63,183,201,-18
15,3,53,67,190,269,-79
15,3,53,73,40,46,-6
15,3,53,75,0,25,-25
15,3,53,77,0,35,-35
15,3,55,9,28,0,28
15,3,55,25,53,56,-3
15,3,55,59,0,57,-57
15,3,55,79,78,55,23
15,3,55,133,40,0,40
15,3,56,21,0,49,-49
15,7,4,13,91,66,25
15,7,6,1,36,0,36
15,7,6,37,109,85,24
15,7,6,59,73,57,16
15,7,6,65,58,51,7
15,7,6,67,29,0,29
15,7,6,71,47,0,47
15,7,6,73,161,118,43
15,7,6,75,25,0,25
15,7,6,85,44,0,44
15,7,6,87,25,0,25
15,7,6,97,24,0,24
15,7,6,111,36,0,36
15,7,15,1,224,222,2
15,7,15,3,627,639,-12
15,7,17,31,24,0,24
15,7,32,3,83,109,-26
15,7,41,29,0,31,-31
15,7,41,39,0,28,-28
15,7,41,51,25,29,-4
15,7,41,67,29,0,29
15,7,49,35,0,35,-35
15,7,53,33,56,59,-3
15,9,2,20,56,0,56
15,9,4,5,0,26,-26
15,9,4,13,181,199,-18
15,9,4,19,41,39,2
15,9,6,1,63,55,8
15,9,6,7,43,0,43
15,9,6,13,40,50,-10
15,9,6,37,399,231,168
15,9,6,41,49,29,20
15,9,6,59,177,119,58
15,9,6,61,51,36,15
15,9,6,65,121,92,29
15,9,6,67,80,84,-4
15,9,6,71,76,67,9
15,9,6,73,246,199,47
15,9,6,75,56,56,0
15,9,6,79,27,27,0
15,9,6,81,55,30,25
15,9,6,83,69,36,33
15,9,6,85,92,54,38
15,9,6,87,42,35,7
15,9,6,97,43,54,-11
15,9,6,99,43,0,43
15,9,6,111,59,32,27
15,9,8,13,30,0,30
15,9,8,31,30,28,2
15,9,8,37,0,25,-25
15,9,8,41,0,31,-31
15,9,8,59,37,68,-31
15,9,12,86,0,31,-31
15,9,12,95,36,34,2
15,9,12,99,21,0,21
15,9,12,103,26,0,26
15,9,15,1,460,570,-110
15,9,15,3,1477,1324,153
15,9,17,31,81,61,20
15,9,25,17,22,0,22
15,9,26,81,28,0,28
15,9,27,53,28,0,28
15,9,32,3,259,447,-188
15,9,32,31,50,70,-20
15,9,36,61,34,0,34
15,9,41,5,27,25,2
15,9,41,17,39,48,-9
15,9,41,29,37,29,8
15,9,41,39,46,38,8
15,9,41,47,0,26,-26
15,9,41,51,79,96,-17
15,9,41,67,39,73,-34
15,9,48,29,26,44,-18
15,9,48,113,27,25,2
15,9,48,201,25,50,-25
15,9,48,453,41,37,4
15,9,49,35,65,38,27
15,9,53,11,27,45,-18
15,9,53,33,189,165,24
15,9,53,53,93,57,36
15,9,53,61,75,34,41
15,9,53,63,33,29,4
15,9,53,67,30,43,-13
16,1,2,20,146,68,78
16,1,2,90,50,37,13
16,1,4,5,30,27,3
16,1,4,13,758,432,326
16,1,4,15,40,35,5
16,1,4,19,133,61,72
16,1,4,21,34,37,-3
16,1,4,25,78,29,49
16,1,4,27,49,0,49
16,1,6,1,126,105,21
16,1,6,7,30,0,30
16,1,6,13,81,66,15
16,1,6,17,32,0,32
16,1,6,19,120,36,84
16,1,6,23,36,0,36
16,1,6,29,58,31,27
16,1,6,37,644,193,451
16,1,6,53,70,30,40
16,1,6,59,397,156,241
16,1,6,61,106,64,42
16,1,6,65,307,71,236
16,1,6,67,206,149,57
16,1,6,71,271,75,196
16,1,6,73,470,256,214
16,1,6,75,42,57,-15
16,1,6,77,95,0,95
16,1,6,79,68,27,41
16,1,6,81,50,30,20
16,1,6,83,51,31,20
16,1,6,85,255,370,-115
16,1,6,87,57,0,57
16,1,6,89,57,29,28
16,1,6,95,73,0,73
16,1,6,97,112,44,68
16,1,6,99,56,30,26
16,1,6,107,0,45,-45
16,1,6,111,107,72,35
16,1,8,1,49,62,-13
16,1,8,5,67,87,-20
16,1,8,13,46,38,8
16,1,8,31,53,79,-26
16,1,8,35,43,56,-13
16,1,8,41,132,80,52
16,1,8,59,46,82,-36
16,1,8,69,59,58,1
16,1,8,77,26,42,-16
16,1,11,1,0,32,-32
16,1,12,31,29,29,0
16,1,12,95,50,24,26
16,1,13,135,50,0,50
16,1,15,1,41,0,41
16,1,15,3,138,61,77
16,1,16,3,55,79,-24
16,1,16,5,522,342,180
16,1,16,11,80,105,-25
16,1,16,13,204,167,37
16,1,16,15,330,325,5
16,1,16,17,62,72,-10
16,1,16,19,491,353,138
16,1,16,27,5107,6474,-1367
16,1,16,31,123,104,19
16,1,16,35,0,54,-54
16,1,16,37,0,36,-36
16,1,16,39,632,459,173
16,1,16,43,53,39,14
16,1,16,45,463,428,35
16,1,16,47,96,85,11
16,1,16,49,52,64,-12
16,1,16,51,36,57,-21
16,1,16,53,104,79,25
16,1,16,55,293,307,-14
16,1,16,57,305,190,115
16,1,16,59,38,44,-6
16,1,16,65,171,67,104
16,1,16,67,122,63,59
16,1,16,69,116,88,28
16,1,16,73,109,126,-17
16,1,16,75,250,212,38
16,1,16,81,35,52,-17
16,1,16,83,733,530,203
16,1,16,85,347,309,38
16,1,16,87,105,97,8
16,1,17,31,76,85,-9
16,1,17,43,33,0,33
16,1,20,91,45,0,45
16,1,24,31,33,0,33
16,1,25,17,31,40,-9
16,1,26,81,36,0,36
16,1,26,163,37,0,37
16,1,27,19,0,257,-257
16,1,27,37,0,58,-58
16,1,27,53,56,191,-135
16,1,27,139,0,75,-75
16,1,29,77,34,0,34
16,1,29,95,0,24,-24
16,1,30,13,68,48,20
16,1,30,29,47,61,-14
16,1,30,31,87,72,15
16,1,30,49,62,44,18
16,1,30,63,137,74,63
16,1,30,81,24,28,-4
16,1,30,111,72,47,25
16,1,32,3,549,329,220
16,1,32,5,30,0,30
16,1,32,7,128,96,32
16,1,32,31,204,158,46
16,1,35,1,67,75,-8
16,1,36,29,30,0,30
16,1,36,61,0,26,-26
16,1,36,81,0,28,-28
16,1,37,51,0,40,-40
16,1,37,119,37,35,2
16,1,38,17,34,0,34
16,1,38,35,26,0,26
16,1,39,49,27,0,27
16,1,39,113,0,40,-40
16,1,40,109,41,0,41
16,1,41,1,60,57,3
16,1,41,3,38,0,38
16,1,41,5,87,128,-41
16,1,41,17,138,78,60
16,1,41,19,28,0,28
16,1,41,29,77,40,37
16,1,41,35,31,0,31
16,1,41,39,137,134,3
16,1,41,41,0,42,-42
16,1,41,43,0,25,-25
16,1,41,45,237,123,114
16,1,41,47,95,69,26
16,1,41,51,263,277,-14
16,1,41,53,38,43,-5
16,1,41,59,61,48,13
16,1,41,61,58,35,23
16,1,41,67,182,226,-44
16,1,41,71,35,44,-9
16,1,42,3,0,28,-28
16,1,46,103,37,0,37
16,1,47,157,31,0,31
16,1,48,29,57,79,-22
16,1,48,85,36,42,-6
16,1,48,113,36,45,-9
16,1,48,121,0,43,-43
16,1,48,141,36,0,36
16,1,48,201,79,79,0
16,1,48,439,55,62,-7
16,1,48,453,39,49,-10
16,1,48,491,30,31,-1
16,1,49,5,97,94,3
16,1,49,11,149,180,-31
16,1,49,35,496,636,-140
16,1,49,49,344,527,-183
16,1,49,53,65,74,-9
16,1,49,57,60,78,-18
16,1,51,13,0,23,-23
16,1,51,59,54,53,1
16,1,51,153,111,149,-38
16,1,51,810,41,0,41
16,1,53,3,69,29,40
16,1,53,5,93,119,-26
16,1,53,7,44,0,44
16,1,53,11,189,165,24
16,1,53,21,31,0,31
16,1,53,25,36,0,36
16,1,53,29,31,0,31
16,1,53,33,631,557,74
16,1,53,35,55,49,6
16,1,53,53,170,137,33
16,1,53,57,45,0,45
16,1,53,61,230,137,93
16,1,53,63,312,230,82
16,1,53,67,82,70,12
16,1,53,71,0,27,-27
16,1,53,73,49,68,-19
16,1,53,75,45,40,5
16,1,53,77,50,42,8
16,1,55,25,35,0,35
16,1,55,79,31,0,31
16,1,56,21,36,0,36
16,1,56,39,0,31,-31
16,3,16,1,79,55,24
16,3,16,27,44,31,13
16,3,16,85,55,63,-8
16,5,4,13,120,61,59
16,5,4,19,0,43,-43
16,5,6,37,63,0,63
16,5,6,65,29,0,29
16,5,6,71,58,0,58
16,5,6,73,49,0,49
16,5,16,1,342,522,-180
16,5,16,7,73,54,19
16,5,16,11,559,614,-55
16,5,16,13,0,34,-34
16,5,16,19,389,516,-127
16,5,16,23,30,0,30
16,5,16,27,144,143,1
16,5,16,29,112,117,-5
16,5,16,31,59,49,10
16,5,16,41,64,80,-16
16,5,16,43,37,47,-10
16,5,16,51,65,110,-45
16,5,16,55,40,43,-3
16,5,16,57,53,47,6
16,5,16,59,33,28,5
16,5,16,65,132,89,43
16,5,16,67,63,54,9
16,5,16,71,58,40,18
16,5,16,77,268,180,88
16,5,16,81,0,35,-35
16,5,16,83,170,200,-30
16,5,30,31,28,28,0
16,5,32,3,101,101,0
16,5,32,7,27,0,27
16,5,32,31,30,24,6
16,5,41,51,0,28,-28
16,5,49,3,0,44,-44
16,5,49,5,87,64,23
16,5,49,11,104,104,0
16,5,49,35,206,221,-15
16,5,49,49,158,106,52
16,5,49,53,51,31,20
16,5,49,57,82,62,20
16,5,53,33,63,47,16
16,5,53,63,38,43,-5
16,5,56,23,36,40,-4
16,5,56,37,47,0,47
16,7,16,5,54,73,-19
16,7,49,5,43,38,5
16,9,16,55,185,207,-22
16,9,16,57,44,39,5
16,9,53,63,63,48,15
16,11,4,13,53,34,19
16,11,16,1,105,80,25
16,11,16,5,614,559,55
16,11,16,19,746,1001,-255
16,11,16,27,65,67,-2
16,11,16,43,0,37,-37
16,11,16,51,82,129,-47
16,11,16,65,64,122,-58
16,11,16,77,117,78,39
16,11,16,83,64,0,64
16,11,32,3,62,32,30
16,11,49,5,47,44,3
16,11,49,11,0,37,-37
16,11,49,35,89,86,3
16,11,49,49,43,35,8
16,11,49,57,36,0,36
16,13,4,13,0,40,-40
16,13,6,37,30,49,-19
16,13,6,59,0,43,-43
16,13,6,73,20,30,-10
16,13,16,1,167,204,-37
16,13,16,5,34,0,34
16,13,16,25,38,38,0
16,13,16,47,40,0,40
16,13,16,53,37,0,37
16,13,16,63,48,132,-84
16,13,16,83,113,99,14
16,13,32,3,0,27,-27
16,13,41,17,0,30,-30
16,13,41,51,0,45,-45
16,13,49,35,28,44,-16
16,13,53,33,59,73,-14
16,13,53,53,30,0,30
16,15,16,1,325,330,-5
16,15,16,27,49,41,8
16,15,16,45,0,35,-35
16,17,4,13,32,54,-22
16,17,6,37,44,0,44
16,17,6,59,29,0,29
16,17,6,67,26,0,26
16,17,6,71,51,0,51
16,17,6,73,42,0,42
16,17,16,1,72,62,10
16,17,16,21,127,104,23
16,17,16,27,0,36,-36
16,17,16,55,448,634,-186
16,17,16,57,60,68,-8
16,17,16,69,29,0,29
16,17,30,89,31,35,-4
16,17,41,17,34,0,34
16,17,41,51,35,0,35
16,17,53,11,43,0,43
16,17,53,33,82,72,10
16,17,53,51,119,118,1
16,17,53,53,0,38,-38
16,17,53,61,69,0,69
16,17,53,63,242,228,14
16,17,53,65,40,0,40
16,19,4,13,141,106,35
16,19,6,37,176,0,176
16,19,6,59,47,0,47
16,19,6,71,73,0,73
16,19,6,73,85,31,54
16,19,8,41,39,0,39
16,19,16,1,353,491,-138
16,19,16,5,516,389,127
16,19,16,11,1001,746,255
16,19,16,23,46,0,46
16,19,16,27,144,112,32
16,19,16,33,37,0,37
16,19,16,43,139,84,55
16,19,16,51,929,972,-43
16,19,16,55,0,55,-55
16,19,16,57,42,43,-1
16,19,16,59,41,0,41
16,19,16,65,635,336,299
16,19,16,67,30,0,30
16,19,16,81,81,80,1
16,19,16,83,146,113,33
16,19,30,31,0,44,-44
16,19,30,111,0,39,-39
16,19,32,3,185,89,96
16,19,32,31,43,0,43
16,19,49,5,134,111,23
16,19,49,11,122,112,10
16,19,49,35,305,287,18
16,19,49,49,242,219,23
16,19,49,53,80,37,43
16,19,49,57,43,49,-6
16,19,53,5,52,84,-32
16,19,53,33,65,67,-2
16,19,53,53,65,0,65
16,19,53,61,0,29,-29
16,19,53,63,53,50,3
16,19,56,23,39,0,39
16,19,56,37,34,0,34
16,19,56,39,0,32,-32
16,21,16,17,104,127,-23
16,21,16,55,133,136,-3
16,21,53,63,28,35,-7
16,23,16,5,0,30,-30
16,23,16,19,0,46,-46
16,27,2,20,38,37,1
16,27,4,13,268,150,118
16,27,4,15,34,0,34
16,27,6,1,32,0,32
16,27,6,13,75,0,75
16,27,6,17,34,0,34
16,27,6,19,48,0,48
16,27,6,29,68,0,68
16,27,6,37,461,77,384
16,27,6,59,174,55,119
16,27,6,61,45,0,45
16,27,6,65,171,66,105
16,27,6,67,140,60,80
16,27,6,71,231,44,187
16,27,6,73,218,84,134
16,27,6,77,49,0,49
16,27,6,85,49,30,19
16,27,6,87,45,0,45
16,27,6,89,49,0,49
16,27,6,95,35,0,35
16,27,6,97,65,0,65
16,27,6,99,33,0,33
16,27,6,111,122,0,122
16,27,8,41,33,0,33
16,27,16,1,6474,5107,1367
16,27,16,3,31,44,-13
16,27,16,5,143,144,-1
16,27,16,11,67,65,2
16,27,16,15,41,49,-8
16,27,16,17,36,0,36
16,27,16,19,112,144,-32
16,27,16,31,0,56,-56
16,27,16,39,161,86,75
16,27,16,45,233,220,13
16,27,16,47,0,45,-45
16,27,16,49,39,0,39
16,27,16,53,40,0,40
16,27,16,55,57,152,-95
16,27,16,57,83,64,19
16,27,16,65,55,52,3
16,27,16,67,0,59,-59
16,27,16,69,38,61,-23
16,27,16,73,591,550,41
16,27,16,75,336,335,1
16,27,16,83,166,194,-28
16,27,16,85,99,120,-21
16,27,16,87,137,91,46
16,27,30,13,30,0,30
16,27,30,111,0,27,-27
16,27,32,3,168,159,9
16,27,32,7,43,48,-5
16,27,32,31,105,47,58
16,27,41,1,32,0,32
16,27,41,5,51,39,12
16,27,41,17,46,57,-11
16,27,41,19,34,0,34
16,27,41,35,0,49,-49
16,27,41,39,30,68,-38
16,27,41,45,299,187,112
16,27,41,47,76,46,30
16,27,41,51,75,54,21
16,27,41,59,47,0,47
16,27,41,61,0,41,-41
16,27,41,67,65,71,-6
16,27,41,71,38,0,38
16,27,48,29,0,54,-54
16,27,48,113,0,34,-34
16,27,48,201,0,34,-34
16,27,48,215,0,32,-32
16,27,49,5,58,49,9
16,27,49,11,0,53,-53
16,27,49,35,147,179,-32
16,27,49,49,132,120,12
16,27,49,57,46,54,-8
16,27,53,5,48,70,-22
16,27,53,11,53,38,15
16,27,53,33,143,117,26
16,27,53,35,42,0,42
16,27,53,53,105,94,11
16,27,53,61,75,90,-15
16,27,53,63,57,65,-8
16,27,53,67,0,45,-45
16,27,53,77,42,62,-20
16,29,16,5,117,112,5
16,29,49,35,0,30,-30
16,31,16,1,104,123,-19
16,31,16,5,49,59,-10
16,31,16,27,56,0,56
16,31,16,53,47,53,-6
16,31,16,65,0,35,-35
16,31,16,67,597,590,7
16,31,16,83,134,164,-30
16,31,49,5,0,33,-33
16,31,49,35,41,26,15
16,31,49,49,0,56,-56
16,35,16,1,54,0,54
16,35,16,49,29,0,29
16,35,16,57,32,54,-22
16,35,16,61,0,35,-35
16,35,16,69,115,187,-72
16,35,53,3,0,34,-34
16,37,16,1,36,0,36
16,37,16,59,38,0,38
16,39,2,20,193,65,128
16,39,2,90,126,0,126
16,39,4,13,40,94,-54
16,39,6,37,28,0,28
16,39,6,115,0,43,-43
16,39,8,41,44,46,-2
16,39,12,91,38,35,3
16,39,15,3,0,36,-36
16,39,16,1,459,632,-173
16,39,16,27,86,161,-75
16,39,16,53,0,31,-31
16,39,16,73,53,42,11
16,39,16,83,43,57,-14
16,39,29,101,32,0,32
16,39,32,3,37,81,-44
16,39,35,9,88,0,88
16,39,37,191,112,0,112
16,39,45,85,0,41,-41
16,39,46,103,0,39,-39
16,39,48,485,30,0,30
16,39,49,11,43,39,4
16,39,53,53,0,29,-29
16,39,53,63,0,49,-49
16,41,16,5,80,64,16
16,41,49,5,298,245,53
16,41,49,11,44,0,44
16,41,49,35,41,72,-31
16,41,49,49,95,0,95
16,43,16,1,39,53,-14
16,43,16,5,47,37,10
16,43,16,11,37,0,37
16,43,16,19,84,139,-55
16,43,16,51,67,103,-36
16,43,16,65,316,298,18
16,43,16,81,58,0,58
16,43,49,35,0,42,-42
16,45,16,1,428,463,-35
16,45,16,15,35,0,35
16,45,16,27,220,233,-13
16,45,16,75,44,79,-35
16,45,16,85,24,0,24
16,45,16,87,0,37,-37
16,45,41,45,0,53,-53
16,47,16,1,85,96,-11
16,47,16,13,0,40,-40
16,47,16,27,45,0,45
16,47,16,53,245,375,-130
16,47,16,63,77,0,77
16,47,16,83,280,392,-112
16,49,16,1,64,52,12
16,49,16,27,0,39,-39
16,49,16,35,0,29,-29
16,49,16,55,0,35,-35
16,49,16,61,71,94,-23
16,49,16,69,135,137,-2
16,49,16,85,28,0,28
16,49,53,3,0,40,-40
16,49,53,63,0,28,-28
16,51,16,1,57,36,21
16,51,16,5,110,65,45
16,51,16,11,129,82,47
16,51,16,19,972,929,43
16,51,16,43,103,67,36
16,51,16,65,473,210,263
16,51,49,5,48,0,48
16,51,49,35,78,54,24
16,51,49,49,85,44,41
16,53,16,1,79,104,-25
16,53,16,13,0,37,-37
16,53,16,27,0,40,-40
16,53,16,31,53,47,6
16,53,16,39,31,0,31
16,53,16,47,375,245,130
16,53,16,63,55,0,55
16,53,16,67,86,73,13
16,53,16,83,777,828,-51
16,53,32,3,64,0,64
16,55,2,20,51,0,51
16,55,2,90,28,0,28
16,55,2,170,34,0,34
16,55,4,13,218,104,114
16,55,4,15,32,0,32
16,55,4,19,50,65,-15
16,55,6,1,34,0,34
16,55,6,13,29,0,29
16,55,6,23,81,0,81
16,55,6,29,38,0,38
16,55,6,37,268,82,186
16,55,6,59,125,59,66
16,55,6,65,159,46,113
16,55,6,67,74,42,32
16,55,6,71,123,28,95
16,55,6,73,220,89,131
16,55,6,77,34,0,34
16,55,6,79,42,0,42
16,55,6,83,37,0,37
16,55,6,89,28,0,28
16,55,6,97,37,0,37
16,55,6,111,100,31,69
16,55,16,1,307,293,14
16,55,16,5,43,40,3
16,55,16,9,207,185,22
16,55,16,17,634,448,186
16,55,16,19,55,0,55
16,55,16,21,136,133,3
16,55,16,27,152,57,95
16,55,16,49,35,0,35
16,55,16,57,278,265,13
16,55,16,69,87,88,-1
16,55,16,79,349,300,49
16,55,16,83,45,0,45
16,55,30,29,55,75,-20
16,55,30,31,53,28,25
16,55,30,49,0,36,-36
16,55,30,53,36,45,-9
16,55,30,63,171,111,60
16,55,30,81,34,0,34
16,55,30,89,34,0,34
16,55,30,111,40,0,40
16,55,32,3,189,74,115
16,55,32,7,27,0,27
16,55,32,31,46,0,46
16,55,41,5,45,0,45
16,55,41,17,48,38,10
16,55,41,39,0,35,-35
16,55,41,47,28,33,-5
16,55,41,51,71,65,6
16,55,41,59,0,26,-26
16,55,41,67,84,59,25
16,55,49,35,70,46,24
16,55,53,3,42,37,5
16,55,53,5,60,88,-28
16,55,53,11,92,86,6
16,55,53,21,24,0,24
16,55,53,25,35,41,-6
16,55,53,33,315,229,86
16,55,53,35,59,39,20
16,55,53,51,29,57,-28
16,55,53,53,119,125,-6
16,55,53,57,43,24,19
16,55,53,61,154,155,-1
16,55,53,63,1590,1593,-3
16,55,53,65,33,53,-20
16,55,53,67,52,52,0
16,55,53,73,46,33,13
16,55,53,75,55,39,16
16,55,53,77,53,25,28
16,57,2,20,37,0,37
16,57,4,13,0,25,-25
16,57,6,1,0,30,-30
16,57,6,37,35,0,35
16,57,16,1,190,305,-115
16,57,16,5,47,53,-6
16,57,16,9,39,44,-5
16,57,16,17,68,60,8
16,57,16,19,43,42,1
16,57,16,27,64,83,-19
16,57,16,35,54,32,22
16,57,16,55,265,278,-13
16,57,16,69,259,221,38
16,57,16,83,59,39,20
16,57,16,85,0,31,-31
16,57,32,3,0,28,-28
16,57,41,5,0,29,-29
16,57,41,51,0,57,-57
16,57,41,59,33,0,33
16,57,41,67,0,45,-45
16,57,49,35,41,36,5
16,57,53,3,60,86,-26
16,57,53,5,41,69,-28
16,57,53,11,0,47,-47
16,57,53,33,58,167,-109
16,57,53,53,25,38,-13
16,57,53,61,54,26,28
16,57,53,63,136,178,-42
16,57,53,71,0,30,-30
16,57,53,73,0,21,-21
16,57,53,75,255,306,-51
16,59,16,1,44,38,6
16,59,16,5,28,33,-5
16,59,16,19,0,41,-41
16,59,16,37,0,38,-38
16,61,16,35,35,0,35
16,61,16,49,94,71,23
16,61,16,69,92,103,-11
16,63,16,13,132,48,84
16,63,16,47,0,77,-77
16,63,16,53,0,55,-55
16,63,16,83,63,104,-41
16,65,4,13,76,120,-44
16,65,6,37,38,0,38
16,65,6,65,35,0,35
16,65,16,1,67,171,-104
16,65,16,5,89,132,-43
16,65,16,11,122,64,58
16,65,16,19,336,635,-299
16,65,16,27,52,55,-3
16,65,16,31,35,0,35
16,65,16,43,298,316,-18
16,65,16,51,210,473,-263
16,65,16,81,63,54,9
16,65,16,83,0,51,-51
16,65,32,3,72,72,0
16,65,41,67,29,38,-9
16,65,48,201,32,0,32
16,65,49,5,64,95,-31
16,65,49,11,74,69,5
16,65,49,35,187,276,-89
16,65,49,49,195,364,-169
16,65,49,53,0,43,-43
16,65,49,57,0,49,-49
16,65,53,5,30,31,-1
16,65,53,33,74,57,17
16,65,53,53,48,0,48
16,65,53,61,0,44,-44
16,65,53,63,48,38,10
16,65,56,23,49,44,5
16,67,4,13,42,0,42
16,67,16,1,63,122,-59
16,67,16,5,54,63,-9
16,67,16,19,0,30,-30
16,67,16,27,59,0,59
16,67,16,31,590,597,-7
16,67,16,53,73,86,-13
16,67,16,83,126,187,-61
16,67,49,11,0,33,-33
16,67,49,35,31,35,-4
16,69,4,13,32,0,32
16,69,16,1,88,116,-28
16,69,16,17,0,29,-29
16,69,16,27,61,38,23
16,69,16,35,187,115,72
16,69,16,49,137,135,2
16,69,16,55,88,87,1
16,69,16,57,221,259,-38
16,69,16,61,103,92,11
16,69,41,51,0,26,-26
16,69,53,3,726,998,-272
16,69,53,23,30,0,30
16,69,53,33,23,78,-55
16,69,53,53,0,30,-30
16,69,53,63,60,178,-118
16,69,53,75,56,63,-7
16,71,16,5,40,58,-18
16,71,49,3,44,57,-13
16,71,49,5,0,39,-39
16,71,49,35,38,0,38
16,71,49,57,46,0,46
16,73,16,1,126,109,17
16,73,16,27,550,591,-41
16,73,16,39,42,53,-11
16,75,16,1,212,250,-38
16,75,16,27,335,336,-1
16,75,16,45,79,44,35
16,75,16,85,43,0,43
16,75,16,87,160,150,10
16,75,41,45,432,330,102
16,77,16,5,180,268,-88
16,77,16,11,78,117,-39
16,79,16,55,300,349,-49
16,79,53,63,61,61,0
16,81,4,13,36,0,36
16,81,16,1,52,35,17
16,81,16,5,35,0,35
16,81,16,19,80,81,-1
16,81,16,43,0,58,-58
16,81,16,65,54,63,-9
16,81,49,35,31,0,31
16,81,56,39,263,115,148
16,83,4,13,122,63,59
16,83,4,15,35,0,35
16,83,6,37,84,29,55
16,83,6,65,54,0,54
16,83,6,67,42,0,42
16,83,6,71,41,0,41
16,83,6,73,41,33,8
16,83,6,99,37,0,37
16,83,16,1,530,733,-203
16,83,16,5,200,170,30
16,83,16,11,0,64,-64
16,83,16,13,99,113,-14
16,83,16,19,113,146,-33
16,83,16,27,194,166,28
16,83,16,31,164,134,30
16,83,16,39,57,43,14
16,83,16,47,392,280,112
16,83,16,53,828,777,51
16,83,16,55,0,45,-45
16,83,16,57,39,59,-20
16,83,16,63,104,63,41
16,83,16,65,51,0,51
16,83,16,67,187,126,61
16,83,32,3,132,75,57
16,83,32,7,169,99,70
16,83,32,31,42,0,42
16,83,41,5,0,32,-32
16,83,41,39,0,29,-29
16,83,49,5,70,44,26
16,83,49,11,52,65,-13
16,83,49,35,117,135,-18
16,83,49,49,64,64,0
16,83,49,57,0,30,-30
16,83,53,5,0,40,-40
16,83,53,33,47,63,-16
16,85,16,1,309,347,-38
16,85,16,3,63,55,8
16,85,16,27,120,99,21
16,85,16,45,0,24,-24
16,85,16,49,0,28,-28
16,85,16,57,31,0,31
16,85,16,75,0,43,-43
16,87,16,1,97,105,-8
16,87,16,27,91,137,-46
16,87,16,45,37,0,37
16,87,16,75,150,160,-10
16,87,41,45,100,71,29
17,1,4,13,0,44,-44
17,1,17,9,38,51,-13
17,1,17,19,29,44,-15
17,1,17,31,71,112,-41
17,1,17,43,0,29,-29
17,1,17,67,157,115,42
17,1,17,95,24,0,24
17,1,17,109,71,52,19
17,1,17,113,0,45,-45
17,1,17,115,0,50,-50
17,1,17,119,0,73,-73
17,1,17,137,0,28,-28
17,1,17,143,29,32,-3
17,1,17,149,133,86,47
17,1,17,167,76,77,-1
17,1,19,111,35,43,-8
17,1,29,19,28,43,-15
17,1,29,111,150,115,35
17,1,29,127,210,186,24
17,1,29,183,31,60,-29
17,1,29,189,64,61,3
17,3,17,153,84,76,8
17,3,17,181,43,56,-13
17,3,29,31,104,165,-61
17,5,17,27,94,91,3
17,5,17,51,51,129,-78
17,5,17,119,264,319,-55
17,5,17,135,73,133,-60
17,5,17,163,61,39,22
17,7,4,13,36,29,7
17,7,17,31,716,488,228
17,7,17,37,149,150,-1
17,7,17,43,219,116,103
17,7,17,89,635,295,340
17,7,17,97,72,43,29
17,7,17,111,652,437,215
17,7,17,141,60,60,0
17,7,17,197,56,0,56
17,7,17,201,1436,1839,-403
17,7,55,105,60,76,-16
17,7,55,127,61,0,61
17,9,17,1,51,38,13
17,9,17,17,37,0,37
17,9,17,137,38,26,12
17,9,17,149,0,28,-28
17,9,17,169,0,48,-48
17,11,17,31,99,90,9
17,11,17,37,0,26,-26
17,11,17,43,42,34,8
17,11,17,73,123,142,-19
17,11,17,99,643,675,-32
17,11,17,103,77,80,-3
17,11,17,113,25,33,-8
17,11,17,123,41,37,4
17,11,17,141,49,0,49
17,11,17,143,37,46,-9
17,11,17,155,96,95,1
17,11,17,161,0,32,-32
17,11,17,175,34,0,34
17,11,17,179,25,36,-11
17,11,17,195,59,67,-8
17,11,17,197,49,0,49
17,13,17,83,38,78,-40
17,13,17,119,45,0,45
17,15,17,31,38,48,-10
17,15,17,43,52,0,52
17,15,17,85,54,45,9
17,15,17,89,0,32,-32
17,15,17,103,51,28,23
17,15,17,141,56,78,-22
17,15,17,177,95,169,-74
17,15,17,195,141,156,-15
17,15,17,201,0,23,-23
17,15,19,45,39,95,-56
17,15,19,97,0,37,-37
17,15,19,163,29,0,29
17,17,17,9,0,37,-37
17,17,17,125,0,32,-32
17,17,17,129,28,0,28
17,17,17,137,181,138,43
17,17,17,167,110,184,-74
17,17,17,169,162,100,62
17,17,17,187,0,42,-42
17,19,1,73,0,26,-26
17,19,4,13,118,109,9
17,19,4,19,44,47,-3
17,19,6,1,51,91,-40
17,19,6,37,111,155,-44
17,19,6,59,0,38,-38
17,19,6,65,0,24,-24
17,19,6,71,0,31,-31
17,19,6,73,71,112,-41
17,19,6,75,0,29,-29
17,19,6,81,0,23,-23
17,19,6,85,23,263,-240
17,19,8,5,0,38,-38
17,19,8,13,0,32,-32
17,19,8,31,0,31,-31
17,19,8,69,0,43,-43
17,19,9,9,0,23,-23
17,19,11,1,24,49,-25
17,19,12,57,0,32,-32
17,19,12,71,32,0,32
17,19,12,73,0,24,-24
17,19,12,95,36,0,36
17,19,12,99,0,34,-34
17,19,12,103,32,26,6
17,19,13,89,32,42,-10
17,19,13,121,32,31,1
17,19,15,3,22,0,22
17,19,17,1,44,29,15
17,19,17,29,250,213,37
17,19,17,31,1198,1784,-586
17,19,17,37,46,43,3
17,19,17,39,104,81,23
17,19,17,41,370,355,15
17,19,17,43,231,282,-51
17,19,17,45,40,0,40
17,19,17,49,59,54,5
17,19,17,53,422,312,110
17,19,17,73,21,28,-7
17,19,17,75,129,139,-10
17,19,17,77,52,75,-23
17,19,17,81,0,26,-26
17,19,17,89,98,81,17
17,19,17,91,113,76,37
17,19,17,93,0,44,-44
17,19,17,97,114,163,-49
17,19,17,99,32,53,-21
17,19,17,105,69,28,41
17,19,17,107,33,34,-1
17,19,17,111,37,48,-11
17,19,17,113,407,491,-84
17,19,17,115,223,174,49
17,19,17,119,68,80,-12
17,19,17,139,53,31,22
17,19,17,143,96,165,-69
17,19,17,147,415,428,-13
17,19,17,161,31,0,31
17,19,17,163,62,56,6
17,19,17,167,183,233,-50
17,19,17,173,27,0,27
17,19,17,179,53,87,-34
17,19,17,183,716,653,63
17,19,17,195,29,0,29
17,19,17,197,152,123,29
17,19,17,199,25,36,-11
17,19,17,201,62,51,11
17,19,18,57,46,52,-6
17,19,18,63,0,37,-37
17,19,18,89,0,30,-30
17,19,18,97,62,124,-62
17,19,18,105,0,32,-32
17,19,18,141,37,0,37
17,19,18,157,67,76,-9
17,19,18,167,40,0,40
17,19,19,103,37,0,37
17,19,21,67,0,22,-22
17,19,21,111,0,44,-44
17,19,24,5,0,25,-25
17,19,24,31,28,73,-45
17,19,24,33,26,0,26
17,19,25,17,65,106,-41
17,19,25,25,26,40,-14
17,19,26,65,0,28,-28
17,19,26,125,39,32,7
17,19,26,161,37,29,8
17,19,26,163,44,0,44
17,19,27,53,56,74,-18
17,19,27,123,0,30,-30
17,19,29,19,30,41,-11
17,19,29,183,0,46,-46
17,19,29,189,78,133,-55
17,19,29,510,0,54,-54
17,19,31,55,0,38,-38
17,19,32,3,0,61,-61
17,19,34,17,0,35,-35
17,19,34,23,0,39,-39
17,19,36,47,0,55,-55
17,19,36,61,26,87,-61
17,19,36,81,0,27,-27
17,19,37,63,0,26,-26
17,19,37,119,0,37,-37
17,19,37,183,33,42,-9
17,19,39,35,0,43,-43
17,19,39,49,49,53,-4
17,19,39,61,36,32,4
17,19,41,51,0,30,-30
17,19,41,67,0,35,-35
17,19,42,3,0,69,-69
17,19,42,101,0,31,-31
17,19,47,37,39,57,-18
17,19,47,157,0,57,-57
17,19,48,29,35,0,35
17,19,48,85,0,44,-44
17,19,48,113,0,94,-94
17,19,48,201,45,100,-55
17,19,48,215,44,0,44
17,19,48,439,44,55,-11
17,19,48,453,47,63,-16
17,19,51,13,26,0,26
17,19,51,59,35,63,-28
17,19,53,33,44,108,-64
17,19,55,25,46,81,-35
17,19,55,79,54,40,14
17,21,17,29,43,28,15
17,21,17,31,32,29,3
17,21,17,51,0,42,-42
17,21,17,113,28,37,-9
17,21,17,115,228,214,14
17,21,17,117,34,0,34
17,21,17,119,0,34,-34
17,21,17,135,110,130,-20
17,21,17,167,379,429,-50
17,21,17,173,177,238,-61
17,21,29,189,0,25,-25
17,23,17,29,95,97,-2
17,23,17,33,55,43,12
17,23,17,35,55,78,-23
17,23,17,45,121,107,14
17,23,17,49,0,23,-23
17,23,18,97,0,21,-21
17,23,18,167,116,158,-42
17,25,17,49,70,74,-4
17,25,17,77,0,32,-32
17,25,17,81,29,0,29
17,25,17,121,37,68,-31
17,25,17,159,65,101,-36
17,25,17,191,150,104,46
17,27,17,5,91,94,-3
17,27,17,81,40,47,-7
17,27,17,119,212,276,-64
17,27,17,121,170,160,10
17,27,17,163,569,380,189
17,27,17,189,103,106,-3
17,27,29,189,0,59,-59
17,27,29,510,31,29,2
17,29,17,19,213,250,-37
17,29,17,21,28,43,-15
17,29,17,23,97,95,2
17,29,17,31,127,171,-44
17,29,17,33,29,0,29
17,29,17,35,249,303,-54
17,29,17,41,213,237,-24
17,29,17,43,20,44,-24
17,29,17,45,140,74,66
17,29,17,49,116,116,0
17,29,17,77,24,0,24
17,29,17,113,0,41,-41
17,29,17,115,55,88,-33
17,29,17,119,0,42,-42
17,29,17,139,152,187,-35
17,29,17,163,0,29,-29
17,29,17,167,53,54,-1
17,29,17,173,171,128,43
17,29,17,179,0,28,-28
17,29,17,183,61,33,28
17,29,17,197,34,25,9
17,29,18,97,26,0,26
17,29,18,167,0,31,-31
17,31,1,3,23,40,-17
17,31,1,73,188,209,-21
17,31,1,81,33,0,33
17,31,1,89,124,139,-15
17,31,1,97,62,80,-18
17,31,1,101,85,63,22
17,31,1,103,0,51,-51
17,31,1,117,30,65,-35
17,31,1,125,43,76,-33
17,31,2,20,61,79,-18
17,31,2,90,0,38,-38
17,31,4,3,42,44,-2
17,31,4,5,39,31,8
17,31,4,13,2158,3280,-1122
17,31,4,15,0,38,-38
17,31,4,19,292,501,-209
17,31,4,21,64,241,-177
17,31,4,25,59,65,-6
17,31,4,27,33,83,-50
17,31,5,5,0,65,-65
17,31,5,7,81,131,-50
17,31,5,31,0,33,-33
17,31,5,35,0,35,-35
17,31,5,45,0,29,-29
17,31,5,51,40,48,-8
17,31,5,69,0,50,-50
17,31,5,93,0,47,-47
17,31,5,107,0,36,-36
17,31,5,119,159,192,-33
17,31,5,125,0,26,-26
17,31,5,143,81,81,0
17,31,6,1,565,803,-238
17,31,6,13,245,347,-102
17,31,6,19,86,93,-7
17,31,6,23,32,0,32
17,31,6,29,97,97,0
17,31,6,31,31,0,31
17,31,6,37,3157,4160,-1003
17,31,6,41,74,94,-20
17,31,6,47,42,0,42
17,31,6,53,149,108,41
17,31,6,55,0,31,-31
17,31,6,57,24,0,24
17,31,6,59,958,1067,-109
17,31,6,61,37,61,-24
17,31,6,65,342,391,-49
17,31,6,67,227,261,-34
17,31,6,71,344,363,-19
17,31,6,73,1393,1620,-227
17,31,6,75,990,1163,-173
17,31,6,77,81,88,-7
17,31,6,79,39,42,-3
17,31,6,81,204,430,-226
17,31,6,83,109,126,-17
17,31,6,85,599,1007,-408
17,31,6,87,69,53,16
17,31,6,95,56,77,-21
17,31,6,97,60,95,-35
17,31,6,99,108,61,47
17,31,6,107,47,31,16
17,31,6,111,149,139,10
17,31,6,113,65,59,6
17,31,8,1,94,149,-55
17,31,8,5,294,299,-5
17,31,8,13,224,348,-124
17,31,8,14,53,82,-29
17,31,8,31,575,812,-237
17,31,8,35,89,147,-58
17,31,8,37,60,72,-12
17,31,8,41,216,297,-81
17,31,8,45,0,39,-39
17,31,8,59,141,200,-59
17,31,8,67,30,0,30
17,31,8,69,109,164,-55
17,31,8,77,0,46,-46
17,31,8,97,20,42,-22
17,31,8,117,32,67,-35
17,31,8,123,37,60,-23
17,31,9,1,392,403,-11
17,31,9,3,249,246,3
17,31,9,7,42,40,2
17,31,9,9,211,246,-35
17,31,9,11,36,52,-16
17,31,9,13,27,0,27
17,31,10,3,184,177,7
17,31,11,1,940,869,71
17,31,12,1,124,63,61
17,31,12,5,56,39,17
17,31,12,9,107,126,-19
17,31,12,11,901,839,62
17,31,12,15,44,58,-14
17,31,12,17,0,53,-53
17,31,12,19,54,68,-14
17,31,12,21,201,295,-94
17,31,12,31,416,268,148
17,31,12,33,81,82,-1
17,31,12,35,46,59,-13
17,31,12,53,50,44,6
17,31,12,55,0,43,-43
17,31,12,57,602,727,-125
17,31,12,69,73,112,-39
17,31,12,71,322,477,-155
17,31,12,73,180,98,82
17,31,12,81,94,158,-64
17,31,12,83,62,82,-20
17,31,12,85,37,43,-6
17,31,12,86,911,935,-24
17,31,12,87,75,52,23
17,31,12,91,64,33,31
17,31,12,95,803,631,172
17,31,12,97,166,192,-26
17,31,12,99,578,689,-111
17,31,12,101,135,195,-60
17,31,12,103,453,532,-79
17,31,12,105,180,170,10
17,31,12,109,51,70,-19
17,31,12,111,68,49,19
17,31,12,113,0,34,-34
17,31,12,115,238,237,1
17,31,12,117,225,167,58
17,31,12,119,0,74,-74
17,31,12,127,129,109,20
17,31,13,21,35,60,-25
17,31,13,51,105,95,10
17,31,13,57,81,69,12
17,31,13,59,63,54,9
17,31,13,63,198,234,-36
17,31,13,67,469,606,-137
17,31,13,89,539,570,-31
17,31,13,97,74,75,-1
17,31,13,113,0,63,-63
17,31,13,117,0,70,-70
17,31,13,121,838,944,-106
17,31,13,127,0,33,-33
17,31,13,129,0,32,-32
17,31,13,135,393,531,-138
17,31,13,139,0,53,-53
17,31,13,151,50,100,-50
17,31,13,153,0,30,-30
17,31,13,179,64,38,26
17,31,13,215,48,63,-15
17,31,13,223,0,43,-43
17,31,13,245,75,53,22
17,31,13,247,30,41,-11
17,31,13,313,65,49,16
17,31,15,1,46,72,-26
17,31,15,3,309,354,-45
17,31,15,7,0,24,-24
17,31,15,9,61,81,-20
17,31,16,1,85,76,9
17,31,17,1,112,71,41
17,31,17,7,488,716,-228
17,31,17,11,90,99,-9
17,31,17,15,48,38,10
17,31,17,19,1784,1198,586
17,31,17,21,29,32,-3
17,31,17,29,171,127,44
17,31,17,37,1179,1277,-98
17,31,17,43,23081,29190,-6109
17,31,17,49,31,39,-8
17,31,17,53,23,36,-13
17,31,17,55,32,48,-16
17,31,17,57,30,0,30
17,31,17,63,387,679,-292
17,31,17,73,84,77,7
17,31,17,75,93,159,-66
17,31,17,77,488,339,149
17,31,17,81,70,29,41
17,31,17,85,49,109,-60
17,31,17,87,0,28,-28
17,31,17,89,7098,11274,-4176
17,31,17,91,919,1861,-942
17,31,17,93,813,2583,-1770
17,31,17,95,121,182,-61
17,31,17,97,11734,16096,-4362
17,31,17,99,329,444,-115
17,31,17,103,96,114,-18
17,31,17,105,123,88,35
17,31,17,107,27,41,-14
17,31,17,109,163,92,71
17,31,17,111,3758,5748,-1990
17,31,17,113,928,942,-14
17,31,17,115,334,271,63
17,31,17,117,29,0,29
17,31,17,119,270,229,41
17,31,17,121,0,38,-38
17,31,17,123,0,41,-41
17,31,17,127,0,26,-26
17,31,17,131,25,0,25
17,31,17,137,55,33,22
17,31,17,139,27,0,27
17,31,17,141,173,181,-8
17,31,17,143,658,576,82
17,31,17,161,328,375,-47
17,31,17,163,254,238,16
17,31,17,167,718,827,-109
17,31,17,177,145,154,-9
17,31,17,179,154,134,20
17,31,17,183,314,428,-114
17,31,17,195,99,135,-36
17,31,17,197,12900,22154,-9254
17,31,17,199,96,126,-30
17,31,17,201,1419,1965,-546
17,31,17,203,52,61,-9
17,31,18,3,402,370,32
17,31,18,5,64,31,33
17,31,18,11,61,55,6
17,31,18,17,33,0,33
17,31,18,19,34,42,-8
17,31,18,35,61,51,10
17,31,18,39,307,303,4
17,31,18,43,30,0,30
17,31,18,53,44,0,44
17,31,18,57,432,421,11
17,31,18,59,20,31,-11
17,31,18,63,102,113,-11
17,31,18,67,37,31,6
17,31,18,73,78,107,-29
17,31,18,81,51,82,-31
17,31,18,85,64,79,-15
17,31,18,89,6322,12633,-6311
17,31,18,91,280,364,-84
17,31,18,95,33,41,-8
17,31,18,97,1392,1362,30
17,31,18,99,51,60,-9
17,31,18,105,463,230,233
17,31,18,107,20,0,20
17,31,18,109,24,0,24
17,31,18,111,0,60,-60
17,31,18,127,679,1178,-499
17,31,18,141,698,547,151
17,31,18,149,80,87,-7
17,31,18,157,597,451,146
17,31,18,163,105,121,-16
17,31,18,167,70,64,6
17,31,18,177,25,0,25
17,31,18,181,30,49,-19
17,31,19,13,133,116,17
17,31,19,21,0,119,-119
17,31,19,33,28,0,28
17,31,19,45,47,37,10
17,31,19,49,61,63,-2
17,31,19,57,54,148,-94
17,31,19,61,340,256,84
17,31,19,67,49,0,49
17,31,19,87,27,0,27
17,31,19,103,657,659,-2
17,31,19,113,243,245,-2
17,31,19,115,0,44,-44
17,31,19,139,33,83,-50
17,31,19,153,415,412,3
17,31,19,157,22,0,22
17,31,19,163,237,630,-393
17,31,19,169,161,93,68
17,31,19,179,24,0,24
17,31,19,193,44,52,-8
17,31,20,45,117,67,50
17,31,20,61,39,59,-20
17,31,20,91,539,381,158
17,31,20,155,23,0,23
17,31,20,161,65,24,41
17,31,20,173,128,178,-50
17,31,20,177,68,35,33
17,31,20,209,41,55,-14
17,31,21,15,26,51,-25
17,31,21,47,52,80,-28
17,31,21,67,186,135,51
17,31,21,73,0,30,-30
17,31,21,93,0,41,-41
17,31,21,111,363,435,-72
17,31,21,117,53,58,-5
17,31,21,145,36,39,-3
17,31,21,227,46,0,46
17,31,22,15,28,30,-2
17,31,22,17,39,49,-10
17,31,22,33,102,106,-4
17,31,22,51,127,140,-13
17,31,22,55,47,0,47
17,31,22,71,144,293,-149
17,31,22,73,0,36,-36
17,31,22,89,25,0,25
17,31,22,103,59,34,25
17,31,22,115,0,28,-28
17,31,23,1,25,0,25
17,31,23,5,71,79,-8
17,31,23,31,0,21,-21
17,31,24,3,157,152,5
17,31,24,5,241,198,43
17,31,24,21,43,48,-5
17,31,24,25,45,31,14
17,31,24,27,96,85,11
17,31,24,31,532,522,10
17,31,24,33,142,234,-92
17,31,24,47,24,26,-2
17,31,24,510,322,220,102
17,31,25,1,48,49,-1
17,31,25,3,26,29,-3
17,31,25,5,74,49,25
17,31,25,9,190,141,49
17,31,25,13,50,42,8
17,31,25,15,61,29,32
17,31,25,17,849,917,-68
17,31,25,21,333,269,64
17,31,25,23,66,53,13
17,31,25,25,779,579,200
17,31,25,27,157,113,44
17,31,26,5,80,180,-100
17,31,26,15,23,0,23
17,31,26,17,61,0,61
17,31,26,21,287,401,-114
17,31,26,23,38,0,38
17,31,26,25,131,63,68
17,31,26,27,32,75,-43
17,31,26,29,39,0,39
17,31,26,37,68,34,34
17,31,26,41,28,0,28
17,31,26,43,32,0,32
17,31,26,45,65,34,31
17,31,26,47,45,0,45
17,31,26,49,273,77,196
17,31,26,55,133,47,86
17,31,26,59,28,0,28
17,31,26,65,541,227,314
17,31,26,67,25,0,25
17,31,26,73,72,0,72
17,31,26,75,116,0,116
17,31,26,77,522,287,235
17,31,26,81,884,508,376
17,31,26,87,29,0,29
17,31,26,89,34,0,34
17,31,26,91,31,31,0
17,31,26,93,156,48,108
17,31,26,99,605,196,409
17,31,26,101,23,0,23
17,31,26,103,65,27,38
17,31,26,105,35,38,-3
17,31,26,107,31,0,31
17,31,26,111,73,53,20
17,31,26,115,61,0,61
17,31,26,121,121,105,16
17,31,26,125,2228,939,1289
17,31,26,139,251,216,35
17,31,26,145,86,41,45
17,31,26,147,66,1013,-947
17,31,26,149,48,58,-10
17,31,26,155,25,0,25
17,31,26,159,126,174,-48
17,31,26,161,1043,572,471
17,31,26,163,1418,632,786
17,31,27,3,129,125,4
17,31,27,19,57,40,17
17,31,27,37,311,220,91
17,31,27,53,1951,1740,211
17,31,27,109,112,118,-6
17,31,27,123,651,524,127
17,31,27,131,34,0,34
17,31,27,137,41,149,-108
17,31,27,139,47,36,11
17,31,27,145,59,0,59
17,31,27,163,107,125,-18
17,31,27,169,68,54,14
17,31,28,11,32,37,-5
17,31,28,25,0,33,-33
17,31,28,27,0,24,-24
17,31,28,33,33,72,-39
17,31,28,47,39,74,-35
17,31,28,49,148,140,8
17,31,28,51,43,39,4
17,31,28,59,0,27,-27
17,31,28,81,0,37,-37
17,31,28,83,0,39,-39
17,31,28,87,0,29,-29
17,31,28,89,48,66,-18
17,31,28,105,27,0,27
17,31,28,107,0,24,-24
17,31,28,121,37,69,-32
17,31,28,133,0,29,-29
17,31,28,149,0,39,-39
17,31,28,151,46,49,-3
17,31,29,1,25,0,25
17,31,29,19,219,121,98
17,31,29,29,0,24,-24
17,31,29,31,27,33,-6
17,31,29,47,92,75,17
17,31,29,51,59,62,-3
17,31,29,71,21,0,21
17,31,29,77,149,79,70
17,31,29,95,450,366,84
17,31,29,97,28,0,28
17,31,29,99,39,26,13
17,31,29,165,55,70,-15
17,31,29,183,178,186,-8
17,31,29,189,1279,954,325
17,31,29,510,592,465,127
17,31,30,29,0,31,-31
17,31,30,31,27,38,-11
17,31,30,63,21,32,-11
17,31,31,55,409,354,55
17,31,31,109,215,125,90
17,31,31,153,37,62,-25
17,31,32,3,1280,2041,-761
17,31,32,31,91,116,-25
17,31,33,9,40,34,6
17,31,33,11,78,60,18
17,31,33,13,37,0,37
17,31,33,15,73,51,22
17,31,33,17,31,0,31
17,31,34,1,56,43,13
17,31,34,3,243,267,-24
17,31,34,5,82,40,42
17,31,34,7,91,74,17
17,31,34,9,0,24,-24
17,31,34,13,185,164,21
17,31,34,17,439,558,-119
17,31,34,19,29,31,-2
17,31,34,21,154,142,12
17,31,34,23,316,380,-64
17,31,34,25,80,77,3
17,31,34,27,168,141,27
17,31,34,29,39,51,-12
17,31,34,31,56,86,-30
17,31,34,35,101,75,26
17,31,34,39,98,116,-18
17,31,35,1,204,249,-45
17,31,35,13,47,39,8
17,31,35,43,0,43,-43
17,31,35,49,58,80,-22
17,31,36,1,83,66,17
17,31,36,5,189,214,-25
17,31,36,7,35,0,35
17,31,36,27,38,24,14
17,31,36,29,305,151,154
17,31,36,45,65,83,-18
17,31,36,47,840,1068,-228
17,31,36,55,190,149,41
17,31,36,59,261,165,96
17,31,36,61,2005,2766,-761
17,31,36,63,27,32,-5
17,31,36,67,110,76,34
17,31,36,69,46,0,46
17,31,36,71,55,34,21
17,31,36,81,634,596,38
17,31,36,83,26,0,26
17,31,36,85,42,48,-6
17,31,36,87,35,58,-23
17,31,36,91,60,0,60
17,31,36,93,42,22,20
17,31,36,103,238,201,37
17,31,36,109,117,88,29
17,31,36,119,285,271,14
17,31,37,21,95,77,18
17,31,37,25,0,27,-27
17,31,37,37,0,31,-31
17,31,37,49,39,42,-3
17,31,37,51,120,160,-40
17,31,37,63,207,222,-15
17,31,37,67,72,88,-16
17,31,37,81,107,135,-28
17,31,37,97,0,56,-56
17,31,37,119,441,626,-185
17,31,37,129,46,74,-28
17,31,37,133,146,102,44
17,31,37,135,111,67,44
17,31,37,147,23,0,23
17,31,37,179,0,50,-50
17,31,37,183,307,389,-82
17,31,38,17,0,33,-33
17,31,38,35,34,0,34
17,31,39,3,40,0,40
17,31,39,9,38,27,11
17,31,39,17,225,128,97
17,31,39,23,31,28,3
17,31,39,25,58,39,19
17,31,39,35,1245,686,559
17,31,39,41,107,63,44
17,31,39,43,31,0,31
17,31,39,45,27,0,27
17,31,39,49,1269,1003,266
17,31,39,55,49,0,49
17,31,39,57,95,76,19
17,31,39,61,760,563,197
17,31,39,63,24,0,24
17,31,39,85,91,52,39
17,31,39,89,32,35,-3
17,31,39,93,83,55,28
17,31,39,95,319,127,192
17,31,39,99,46,21,25
17,31,39,101,26,0,26
17,31,39,103,55,0,55
17,31,39,109,26,0,26
17,31,39,113,341,162,179
17,31,39,133,67,0,67
17,31,39,139,26,31,-5
17,31,39,151,95,51,44
17,31,39,153,305,138,167
17,31,39,155,40,0,40
17,31,39,165,129,92,37
17,31,39,169,30,0,30
17,31,39,173,127,53,74
17,31,40,27,56,71,-15
17,31,40,31,52,44,8
17,31,40,109,163,131,32
17,31,40,119,39,0,39
17,31,40,143,190,184,6
17,31,41,3,0,29,-29
17,31,41,5,36,52,-16
17,31,41,17,0,37,-37
17,31,41,29,33,42,-9
17,31,41,39,79,71,8
17,31,41,51,300,533,-233
17,31,41,67,124,191,-67
17,31,42,3,625,486,139
17,31,42,7,22,0,22
17,31,42,11,45,0,45
17,31,42,17,120,125,-5
17,31,42,19,44,0,44
17,31,42,27,82,74,8
17,31,42,29,103,132,-29
17,31,42,41,53,32,21
17,31,42,43,63,80,-17
17,31,42,45,120,94,26
17,31,42,49,90,48,42
17,31,42,69,37,0,37
17,31,42,71,55,62,-7
17,31,42,77,75,57,18
17,31,42,79,28,0,28
17,31,42,91,245,309,-64
17,31,42,95,54,34,20
17,31,42,101,527,527,0
17,31,42,125,22,0,22
17,31,42,129,43,46,-3
17,31,42,133,30,36,-6
17,31,44,3,0,35,-35
17,31,44,5,27,30,-3
17,31,44,7,169,138,31
17,31,45,13,55,76,-21
17,31,45,15,28,43,-15
17,31,45,19,112,125,-13
17,31,45,35,32,0,32
17,31,45,45,104,139,-35
17,31,45,51,33,41,-8
17,31,45,63,39,39,0
17,31,45,77,25,0,25
17,31,45,79,101,90,11
17,31,45,83,36,46,-10
17,31,45,85,28,0,28
17,31,45,91,57,57,0
17,31,46,99,69,58,11
17,31,47,9,0,30,-30
17,31,47,37,481,569,-88
17,31,47,53,0,30,-30
17,31,47,65,104,85,19
17,31,47,93,116,118,-2
17,31,47,113,34,50,-16
17,31,47,125,66,97,-31
17,31,47,149,49,116,-67
17,31,47,155,0,65,-65
17,31,47,157,745,696,49
17,31,47,165,40,68,-28
17,31,47,167,0,28,-28
17,31,47,179,0,34,-34
17,31,47,187,61,99,-38
17,31,47,189,0,58,-58
17,31,48,27,144,271,-127
17,31,48,29,462,775,-313
17,31,48,39,59,82,-23
17,31,48,41,33,24,9
17,31,48,61,37,136,-99
17,31,48,85,270,524,-254
17,31,48,91,0,28,-28
17,31,48,113,1125,1476,-351
17,31,48,121,218,363,-145
17,31,48,135,0,28,-28
17,31,48,139,0,55,-55
17,31,48,141,185,268,-83
17,31,48,157,155,321,-166
17,31,48,167,45,62,-17
17,31,48,187,0,45,-45
17,31,48,201,1169,1827,-658
17,31,48,209,36,53,-17
17,31,48,215,130,215,-85
17,31,48,245,35,56,-21
17,31,48,303,29,28,1
17,31,48,309,43,31,12
17,31,48,339,80,189,-109
17,31,48,355,44,77,-33
17,31,48,397,0,33,-33
17,31,48,423,30,37,-7
17,31,48,439,541,797,-256
17,31,48,441,29,0,29
17,31,48,453,570,885,-315
17,31,48,479,53,101,-48
17,31,48,491,96,196,-100
17,31,49,11,41,42,-1
17,31,49,35,257,296,-39
17,31,49,43,0,28,-28
17,31,49,49,106,81,25
17,31,50,7,80,89,-9
17,31,50,23,24,0,24
17,31,50,25,0,41,-41
17,31,51,3,51,74,-23
17,31,51,13,425,359,66
17,31,51,41,34,64,-30
17,31,51,59,487,531,-44
17,31,51,87,121,133,-12
17,31,51,107,150,118,32
17,31,51,121,43,0,43
17,31,51,153,89,122,-33
17,31,51,179,37,0,37
17,31,51,510,203,162,41
17,31,51,540,64,41,23
17,31,51,550,50,30,20
17,31,51,600,0,29,-29
17,31,51,650,59,68,-9
17,31,51,700,68,73,-5
17,31,51,710,178,127,51
17,31,51,740,34,0,34
17,31,51,760,144,92,52
17,31,51,810,192,170,22
17,31,53,5,35,0,35
17,31,53,11,35,53,-18
17,31,53,29,35,35,0
17,31,53,33,1082,1390,-308
17,31,53,35,70,63,7
17,31,53,53,169,185,-16
17,31,53,61,102,199,-97
17,31,53,63,31,62,-31
17,31,53,67,37,35,2
17,31,53,73,32,49,-17
17,31,54,61,49,0,49
17,31,55,1,26,65,-39
17,31,55,9,303,239,64
17,31,55,21,53,63,-10
17,31,55,25,1581,1442,139
17,31,55,27,39,43,-4
17,31,55,29,21,73,-52
17,31,55,35,50,45,5
17,31,55,39,68,101,-33
17,31,55,43,29,23,6
17,31,55,45,21,55,-34
17,31,55,55,63,59,4
17,31,55,57,0,47,-47
17,31,55,59,551,998,-447
17,31,55,63,80,89,-9
17,31,55,71,71,29,42
17,31,55,73,78,91,-13
17,31,55,79,2093,2112,-19
17,31,55,81,0,24,-24
17,31,55,85,29,56,-27
17,31,55,87,140,157,-17
17,31,55,89,149,88,61
17,31,55,93,20,0,20
17,31,55,97,33,48,-15
17,31,55,101,340,309,31
17,31,55,105,279,269,10
17,31,55,111,60,73,-13
17,31,55,113,0,27,-27
17,31,55,117,128,99,29
17,31,55,125,0,45,-45
17,31,55,127,248,353,-105
17,31,55,131,90,84,6
17,31,55,133,426,473,-47
17,31,55,139,141,106,35
17,31,55,141,45,45,0
17,31,56,39,0,27,-27
17,33,17,23,43,55,-12
17,33,17,29,0,29,-29
17,33,17,79,57,44,13
17,33,17,101,95,105,-10
17,33,17,159,60,47,13
17,33,18,167,37,48,-11
17,35,17,23,78,55,23
17,35,17,29,303,249,54
17,35,17,49,91,105,-14
17,35,17,173,0,39,-39
17,37,4,13,38,83,-45
17,37,6,73,0,21,-21
17,37,17,7,150,149,1
17,37,17,11,26,0,26
17,37,17,19,43,46,-3
17,37,17,31,1277,1179,98
17,37,17,43,719,626,93
17,37,17,63,30,0,30
17,37,17,89,1833,1111,722
17,37,17,91,31,0,31
17,37,17,93,478,399,79
17,37,17,97,160,137,23
17,37,17,99,282,420,-138
17,37,17,103,186,192,-6
17,37,17,111,307,270,37
17,37,17,113,46,57,-11
17,37,17,141,443,582,-139
17,37,17,143,31,31,0
17,37,17,161,0,20,-20
17,37,17,177,34,40,-6
17,37,17,179,28,0,28
17,37,17,195,37,54,-17
17,37,17,197,210,204,6
17,37,17,201,283,405,-122
17,37,27,53,0,25,-25
17,37,32,3,29,42,-13
17,37,48,113,0,34,-34
17,37,48,201,0,30,-30
17,37,55,25,0,54,-54
17,37,55,79,0,31,-31
17,37,55,105,0,30,-30
17,39,17,19,81,104,-23
17,39,17,107,71,59,12
17,39,17,113,294,292,2
17,39,17,115,136,115,21
17,39,17,147,45,64,-19
17,39,17,179,31,0,31
17,41,17,19,355,370,-15
17,41,17,29,237,213,24
17,41,17,45,56,53,3
17,41,17,113,0,24,-24
17,41,17,115,0,34,-34
17,41,17,139,100,104,-4
17,41,17,147,55,78,-23
17,43,1,73,0,37,-37
17,43,4,3,0,25,-25
17,43,4,13,363,935,-572
17,43,4,19,63,162,-99
17,43,4,21,0,62,-62
17,43,4,25,0,37,-37
17,43,5,7,0,42,-42
17,43,5,119,33,53,-20
17,43,6,1,82,160,-78
17,43,6,13,79,82,-3
17,43,6,37,400,528,-128
17,43,6,53,35,0,35
17,43,6,59,221,262,-41
17,43,6,61,0,40,-40
17,43,6,65,65,82,-17
17,43,6,67,77,50,27
17,43,6,71,102,63,39
17,43,6,73,262,349,-87
17,43,6,75,48,62,-14
17,43,6,81,40,52,-12
17,43,6,83,0,28,-28
17,43,6,85,112,261,-149
17,43,6,111,40,45,-5
17,43,8,5,52,84,-32
17,43,8,13,37,50,-13
17,43,8,14,0,32,-32
17,43,8,31,80,123,-43
17,43,8,35,52,77,-25
17,43,8,41,64,132,-68
17,43,8,59,36,74,-38
17,43,8,69,26,44,-18
17,43,8,123,0,37,-37
17,43,9,1,99,114,-15
17,43,9,3,69,45,24
17,43,9,9,54,55,-1
17,43,10,3,36,39,-3
17,43,11,1,58,86,-28
17,43,12,9,38,41,-3
17,43,12,11,153,131,22
17,43,12,15,0,41,-41
17,43,12,17,0,31,-31
17,43,12,21,88,138,-50
17,43,12,31,92,59,33
17,43,12,57,135,178,-43
17,43,12,69,35,47,-12
17,43,12,71,91,171,-80
17,43,12,81,51,61,-10
17,43,12,83,0,28,-28
17,43,12,86,98,122,-24
17,43,12,95,201,162,39
17,43,12,97,0,38,-38
17,43,12,99,105,129,-24
17,43,12,101,40,51,-11
17,43,12,103,102,159,-57
17,43,12,105,0,57,-57
17,43,12,109,0,33,-33
17,43,12,115,0,103,-103
17,43,12,117,52,65,-13
17,43,12,119,0,33,-33
17,43,12,127,0,24,-24
17,43,13,51,0,35,-35
17,43,13,57,25,0,25
17,43,13,67,125,102,23
17,43,13,89,67,73,-6
17,43,13,121,105,154,-49
17,43,13,135,91,141,-50
17,43,15,3,77,90,-13
17,43,16,1,0,33,-33
17,43,17,1,29,0,29
17,43,17,7,116,219,-103
17,43,17,11,34,42,-8
17,43,17,15,0,52,-52
17,43,17,19,282,231,51
17,43,17,29,44,20,24
17,43,17,31,29190,23081,6109
17,43,17,37,626,719,-93
17,43,17,63,156,213,-57
17,43,17,73,28,0,28
17,43,17,75,24,0,24
17,43,17,77,47,58,-11
17,43,17,85,0,45,-45
17,43,17,89,4886,8128,-3242
17,43,17,91,105,102,3
17,43,17,93,1325,3976,-2651
17,43,17,95,27,31,-4
17,43,17,97,1104,1278,-174
17,43,17,99,189,306,-117
17,43,17,103,60,97,-37
17,43,17,105,35,0,35
17,43,17,109,50,28,22
17,43,17,111,649,1020,-371
17,43,17,113,246,247,-1
17,43,17,115,75,50,25
17,43,17,119,86,62,24
17,43,17,141,89,163,-74
17,43,17,143,200,180,20
17,43,17,161,103,74,29
17,43,17,163,45,71,-26
17,43,17,167,124,118,6
17,43,17,177,46,50,-4
17,43,17,179,59,71,-12
17,43,17,183,32,0,32
17,43,17,195,34,41,-7
17,43,17,197,6125,8397,-2272
17,43,17,199,99,0,99
17,43,17,201,313,392,-79
17,43,17,203,22,0,22
17,43,18,3,73,83,-10
17,43,18,57,120,149,-29
17,43,18,63,0,56,-56
17,43,18,71,210,0,210
17,43,18,81,0,41,-41
17,43,18,89,304,356,-52
17,43,18,91,34,33,1
17,43,18,97,222,176,46
17,43,18,105,36,40,-4
17,43,18,127,75,72,3
17,43,18,139,36,0,36
17,43,18,141,103,65,38
17,43,18,157,93,46,47
17,43,18,163,26,0,26
17,43,18,167,60,0,60
17,43,19,61,23,34,-11
17,43,19,103,70,86,-16
17,43,19,113,21,54,-33
17,43,19,153,63,101,-38
17,43,19,163,78,74,4
17,43,20,91,110,90,20
17,43,21,15,37,0,37
17,43,21,67,43,45,-2
17,43,21,111,78,96,-18
17,43,24,3,29,0,29
17,43,24,5,43,32,11
17,43,24,27,42,0,42
17,43,24,31,61,78,-17
17,43,24,33,33,0,33
17,43,24,510,0,29,-29
17,43,25,9,0,48,-48
17,43,25,17,98,108,-10
17,43,25,21,43,39,4
17,43,25,25,55,52,3
17,43,25,27,38,0,38
17,43,26,21,44,57,-13
17,43,26,25,27,0,27
17,43,26,49,34,0,34
17,43,26,65,52,56,-4
17,43,26,77,87,53,34
17,43,26,81,163,129,34
17,43,26,93,28,0,28
17,43,26,99,137,71,66
17,43,26,125,339,199,140
17,43,26,139,53,62,-9
17,43,26,147,0,53,-53
17,43,26,161,181,48,133
17,43,26,163,466,110,356
17,43,27,3,41,27,14
17,43,27,37,48,66,-18
17,43,27,53,258,263,-5
17,43,27,109,0,24,-24
17,43,27,123,61,43,18
17,43,27,163,32,0,32
17,43,29,19,0,31,-31
17,43,29,47,27,0,27
17,43,29,95,37,69,-32
17,43,29,183,74,63,11
17,43,29,189,249,265,-16
17,43,29,510,48,54,-6
17,43,31,55,76,84,-8
17,43,31,109,31,0,31
17,43,31,153,0,33,-33
17,43,32,3,195,398,-203
17,43,32,31,35,29,6
17,43,34,1,0,26,-26
17,43,34,3,60,65,-5
17,43,34,7,0,30,-30
17,43,34,13,0,34,-34
17,43,34,17,61,31,30
17,43,34,23,108,148,-40
17,43,34,27,0,44,-44
17,43,34,31,35,0,35
17,43,34,35,0,43,-43
17,43,35,1,0,49,-49
17,43,36,5,0,32,-32
17,43,36,29,35,40,-5
17,43,36,47,67,106,-39
17,43,36,55,62,27,35
17,43,36,59,33,52,-19
17,43,36,61,84,172,-88
17,43,36,81,75,61,14
17,43,36,103,26,44,-18
17,43,36,119,0,44,-44
17,43,37,51,24,0,24
17,43,37,55,0,26,-26
17,43,37,81,31,0,31
17,43,37,119,89,128,-39
17,43,37,133,51,35,16
17,43,37,183,98,118,-20
17,43,39,17,41,33,8
17,43,39,35,143,111,32
17,43,39,49,189,184,5
17,43,39,57,31,0,31
17,43,39,61,102,71,31
17,43,39,95,43,31,12
17,43,39,113,73,55,18
17,43,39,153,52,50,2
17,43,39,165,39,0,39
17,43,40,109,36,47,-11
17,43,40,143,39,59,-20
17,43,41,51,33,88,-55
17,43,41,67,39,43,-4
17,43,42,3,91,90,1
17,43,42,17,55,0,55
17,43,42,29,36,50,-14
17,43,42,45,0,44,-44
17,43,42,77,30,0,30
17,43,42,91,43,46,-3
17,43,42,101,42,44,-2
17,43,42,129,0,32,-32
17,43,45,13,0,34,-34
17,43,45,19,0,41,-41
17,43,45,45,0,73,-73
17,43,45,79,37,30,7
17,43,47,1,40,0,40
17,43,47,37,59,92,-33
17,43,47,65,0,21,-21
17,43,47,93,53,27,26
17,43,47,157,122,73,49
17,43,47,187,0,47,-47
17,43,48,27,30,0,30
17,43,48,29,107,153,-46
17,43,48,39,0,35,-35
17,43,48,85,93,162,-69
17,43,48,113,149,208,-59
17,43,48,121,64,80,-16
17,43,48,141,32,66,-34
17,43,48,157,38,87,-49
17,43,48,201,205,341,-136
17,43,48,215,50,47,3
17,43,48,339,29,87,-58
17,43,48,439,109,214,-105
17,43,48,453,55,101,-46
17,43,48,491,37,86,-49
17,43,49,35,99,77,22
17,43,49,49,47,35,12
17,43,51,13,27,55,-28
17,43,51,59,137,120,17
17,43,51,87,39,50,-11
17,43,51,107,49,47,2
17,43,51,510,28,30,-2
17,43,51,810,47,31,16
17,43,53,33,153,273,-120
17,43,53,53,0,40,-40
17,43,53,61,27,54,-27
17,43,53,67,0,29,-29
17,43,55,9,46,30,16
17,43,55,25,249,254,-5
17,43,55,29,0,26,-26
17,43,55,59,95,141,-46
17,43,55,73,0,43,-43
17,43,55,79,222,271,-49
17,43,55,89,0,37,-37
17,43,55,101,58,64,-6
17,43,55,105,30,39,-9
17,43,55,111,0,33,-33
17,43,55,127,74,108,-34
17,43,55,133,178,146,32
17,43,55,139,36,29,7
17,45,17,19,0,40,-40
17,45,17,23,107,121,-14
17,45,17,29,74,140,-66
17,45,17,41,53,56,-3
17,45,17,183,87,36,51
17,45,18,165,49,34,15
17,45,18,167,64,99,-35
17,47,17,159,28,31,-3
17,47,17,185,66,81,-15
17,47,17,191,60,34,26
17,47,17,193,53,28,25
17,49,17,19,54,59,-5
17,49,17,23,23,0,23
17,49,17,25,74,70,4
17,49,17,29,116,116,0
17,49,17,31,39,31,8
17,49,17,35,105,91,14
17,49,17,51,204,177,27
17,49,17,77,0,34,-34
17,49,17,79,119,80,39
17,49,17,115,28,0,28
17,49,17,119,45,22,23
17,49,17,121,35,31,4
17,49,17,159,0,29,-29
17,49,17,167,33,53,-20
17,49,17,173,149,179,-30
17,49,18,97,0,24,-24
17,49,29,189,0,25,-25
17,51,17,5,129,51,78
17,51,17,21,42,0,42
17,51,17,49,177,204,-27
17,51,17,115,31,0,31
17,51,17,119,66,91,-25
17,51,17,121,128,121,7
17,51,17,135,59,57,2
17,51,17,163,0,32,-32
17,51,17,173,60,56,4
17,51,29,189,0,21,-21
17,53,17,19,312,422,-110
17,53,17,31,36,23,13
17,53,17,75,161,166,-5
17,53,17,91,26,0,26
17,53,17,105,74,46,28
17,53,17,113,45,85,-40
17,53,17,183,43,51,-8
17,53,17,197,31,0,31
17,55,17,31,48,32,16
17,55,17,65,51,38,13
17,55,17,77,120,150,-30
17,55,17,81,105,220,-115
17,55,17,119,0,25,-25
17,55,17,121,0,38,-38
17,55,17,145,118,95,23
17,55,17,163,48,37,11
17,55,17,165,75,78,-3
17,55,17,197,38,0,38
17,55,17,199,593,620,-27
17,57,17,31,0,30,-30
17,57,17,95,103,145,-42
17,57,17,109,127,198,-71
17,57,17,113,0,22,-22
17,57,17,125,62,96,-34
17,57,17,143,359,435,-76
17,57,17,167,30,0,30
17,57,17,169,62,36,26
17,57,17,179,238,233,5
17,57,17,187,58,0,58
17,59,17,165,109,86,23
17,59,17,193,39,82,-43
17,61,17,83,166,147,19
17,61,17,117,59,29,30
17,61,17,119,67,104,-37
17,61,17,137,119,162,-43
17,61,17,167,27,45,-18
17,61,17,171,47,42,5
17,63,4,13,0,33,-33
17,63,17,31,679,387,292
17,63,17,37,0,30,-30
17,63,17,43,213,156,57
17,63,17,89,65,43,22
17,63,17,91,99,101,-2
17,63,17,93,141,148,-7
17,63,17,97,44,0,44
17,63,17,99,298,368,-70
17,63,17,105,151,206,-55
17,63,17,113,0,36,-36
17,63,17,197,2220,1383,837
17,65,17,55,38,51,-13
17,65,17,81,63,48,15
17,65,17,191,0,35,-35
17,65,17,193,46,42,4
17,67,17,1,115,157,-42
17,67,17,71,43,0,43
17,67,17,109,97,154,-57
17,67,19,57,0,40,-40
17,67,19,111,217,293,-76
17,69,17,165,56,50,6
17,71,17,67,0,43,-43
17,71,17,187,61,59,2
17,71,19,57,105,117,-12
17,73,4,13,32,0,32
17,73,17,11,142,123,19
17,73,17,19,28,21,7
17,73,17,31,77,84,-7
17,73,17,43,0,28,-28
17,73,17,95,134,138,-4
17,73,17,109,0,28,-28
17,73,17,113,38,58,-20
17,73,17,131,96,92,4
17,73,17,143,75,114,-39
17,73,17,161,1045,1095,-50
17,73,17,175,83,90,-7
17,73,17,179,46,28,18
17,73,17,187,38,0,38
17,73,17,195,78,62,16
17,73,19,163,182,207,-25
17,75,17,19,139,129,10
17,75,17,31,159,93,66
17,75,17,43,0,24,-24
17,75,17,53,166,161,5
17,75,17,91,542,448,94
17,75,17,105,0,38,-38
17,75,17,113,27,39,-12
17,75,17,183,108,125,-17
17,75,17,197,89,33,56
17,75,18,111,46,76,-30
17,77,4,13,0,46,-46
17,77,6,37,0,49,-49
17,77,6,73,28,28,0
17,77,6,85,0,29,-29
17,77,17,19,75,52,23
17,77,17,25,32,0,32
17,77,17,29,0,24,-24
17,77,17,31,339,488,-149
17,77,17,43,58,47,11
17,77,17,49,34,0,34
17,77,17,55,150,120,30
17,77,17,81,77,51,26
17,77,17,87,43,0,43
17,77,17,89,32,41,-9
17,77,17,97,55,61,-6
17,77,17,111,31,0,31
17,77,17,113,43,0,43
17,77,17,115,24,24,0
17,77,17,119,56,82,-26
17,77,17,121,47,27,20
17,77,17,143,45,48,-3
17,77,17,145,189,177,12
17,77,17,157,161,122,39
17,77,17,163,122,123,-1
17,77,17,165,34,32,2
17,77,17,167,51,116,-65
17,77,17,181,143,162,-19
17,77,17,197,36,41,-5
17,77,17,199,659,831,-172
17,77,17,201,0,45,-45
17,77,18,163,22,0,22
17,77,21,111,0,39,-39
17,77,27,53,0,27,-27
17,77,29,31,52,51,1
17,77,29,189,84,121,-37
17,77,29,510,31,83,-52
17,77,32,3,0,25,-25
17,77,34,23,0,60,-60
17,77,47,37,0,26,-26
17,77,47,157,0,43,-43
17,77,48,29,0,28,-28
17,77,48,201,0,27,-27
17,77,48,453,0,26,-26
17,77,53,33,0,32,-32
17,79,17,33,44,57,-13
17,79,17,49,80,119,-39
17,79,17,159,57,52,5
17,81,17,19,26,0,26
17,81,17,25,0,29,-29
17,81,17,27,47,40,7
17,81,17,31,29,70,-41
17,81,17,55,220,105,115
17,81,17,65,48,63,-15
17,81,17,77,51,77,-26
17,81,17,119,36,90,-54
17,81,17,121,283,255,28
17,81,17,145,39,0,39
17,81,17,163,54,79,-25
17,81,17,189,106,109,-3
17,81,17,191,106,64,42
17,81,17,199,76,100,-24
17,81,29,189,39,43,-4
17,83,17,13,78,38,40
17,83,17,61,147,166,-19
17,83,17,117,171,116,55
17,83,17,119,674,514,160
17,83,17,163,34,0,34
17,83,29,183,0,39,-39
17,83,29,189,93,81,12
17,83,29,510,0,21,-21
17,85,17,15,45,54,-9
17,85,17,31,109,49,60
17,85,17,43,45,0,45
17,85,17,89,45,0,45
17,85,17,177,161,163,-2
17,85,17,197,35,0,35
17,85,17,201,22,37,-15
17,85,19,61,299,397,-98
17,85,55,25,0,23,-23
17,85,55,43,72,79,-7
17,85,55,65,35,37,-2
17,87,17,31,28,0,28
17,87,17,77,0,43,-43
17,87,17,127,38,45,-7
17,87,17,165,27,27,0
17,87,17,181,57,52,5
17,87,17,199,220,199,21
17,87,21,145,34,24,10
17,89,1,89,0,33,-33
17,89,2,20,0,38,-38
17,89,4,13,253,425,-172
17,89,4,19,46,50,-4
17,89,4,21,0,31,-31
17,89,6,1,0,31,-31
17,89,6,37,185,145,40
17,89,6,59,85,104,-19
17,89,6,65,66,40,26
17,89,6,71,92,50,42
17,89,6,73,131,170,-39
17,89,6,75,0,24,-24
17,89,6,85,0,68,-68
17,89,8,1,0,55,-55
17,89,8,31,40,59,-19
17,89,8,35,43,0,43
17,89,8,41,39,32,7
17,89,8,69,25,36,-11
17,89,11,1,24,31,-7
17,89,12,11,53,61,-8
17,89,12,21,48,39,9
17,89,12,57,70,42,28
17,89,12,71,84,112,-28
17,89,12,81,0,56,-56
17,89,12,86,51,31,20
17,89,12,95,46,84,-38
17,89,12,99,63,54,9
17,89,12,103,51,62,-11
17,89,12,105,32,42,-10
17,89,12,115,45,37,8
17,89,12,117,38,0,38
17,89,12,127,36,0,36
17,89,13,67,33,0,33
17,89,13,89,0,29,-29
17,89,13,121,55,65,-10
17,89,13,135,44,0,44
17,89,17,7,295,635,-340
17,89,17,15,32,0,32
17,89,17,19,81,98,-17
17,89,17,31,11274,7098,4176
17,89,17,37,1111,1833,-722
17,89,17,43,8128,4886,3242
17,89,17,63,43,65,-22
17,89,17,77,41,32,9
17,89,17,85,0,45,-45
17,89,17,91,62,58,4
17,89,17,93,1706,3588,-1882
17,89,17,97,724,689,35
17,89,17,99,231,308,-77
17,89,17,103,48,97,-49
17,89,17,111,1984,2450,-466
17,89,17,113,87,108,-21
17,89,17,115,49,0,49
17,89,17,141,66,185,-119
17,89,17,143,73,52,21
17,89,17,161,30,54,-24
17,89,17,163,0,31,-31
17,89,17,167,60,58,2
17,89,17,177,32,28,4
17,89,17,195,40,39,1
17,89,17,197,1069,981,88
17,89,17,199,0,37,-37
17,89,17,201,418,610,-192
17,89,18,3,0,34,-34
17,89,18,39,27,0,27
17,89,18,57,60,72,-12
17,89,18,89,92,72,20
17,89,18,97,62,58,4
17,89,18,127,0,31,-31
17,89,18,141,0,29,-29
17,89,19,103,0,26,-26
17,89,19,113,0,58,-58
17,89,19,153,0,49,-49
17,89,19,163,33,0,33
17,89,20,91,58,84,-26
17,89,21,111,37,39,-2
17,89,25,17,0,32,-32
17,89,26,77,36,0,36
17,89,26,81,34,83,-49
17,89,26,125,89,69,20
17,89,26,161,43,0,43
17,89,26,163,76,34,42
17,89,27,53,76,119,-43
17,89,27,123,48,28,20
17,89,29,95,40,33,7
17,89,29,189,64,90,-26
17,89,29,510,25,0,25
17,89,31,55,55,51,4
17,89,32,3,151,150,1
17,89,35,1,0,33,-33
17,89,36,61,32,43,-11
17,89,37,119,0,58,-58
17,89,37,183,0,54,-54
17,89,39,35,53,44,9
17,89,39,49,63,53,10
17,89,39,61,41,31,10
17,89,39,153,35,0,35
17,89,41,51,0,26,-26
17,89,42,29,0,44,-44
17,89,47,37,42,42,0
17,89,47,65,0,23,-23
17,89,47,93,0,25,-25
17,89,47,157,0,46,-46
17,89,48,29,38,104,-66
17,89,48,85,61,67,-6
17,89,48,113,98,105,-7
17,89,48,121,48,53,-5
17,89,48,141,0,47,-47
17,89,48,157,0,50,-50
17,89,48,201,105,171,-66
17,89,48,215,49,51,-2
17,89,48,339,0,35,-35
17,89,48,439,95,123,-28
17,89,48,453,0,45,-45
17,89,49,35,0,40,-40
17,89,53,33,41,72,-31
17,89,53,53,0,40,-40
17,89,55,25,74,116,-42
17,89,55,59,83,37,46
17,89,55,79,84,155,-71
17,89,55,105,60,55,5
17,89,55,127,52,42,10
17,89,55,133,57,73,-16
17,91,4,13,31,107,-76
17,91,6,73,40,23,17
17,91,12,71,0,32,-32
17,91,12,103,26,0,26
17,91,17,19,76,113,-37
17,91,17,31,1861,919,942
17,91,17,37,0,31,-31
17,91,17,43,102,105,-3
17,91,17,53,0,26,-26
17,91,17,63,101,99,2
17,91,17,75,448,542,-94
17,91,17,89,58,62,-4
17,91,17,93,0,35,-35
17,91,17,97,43,34,9
17,91,17,99,24,43,-19
17,91,17,105,74,56,18
17,91,17,113,34,115,-81
17,91,17,119,0,33,-33
17,91,17,143,0,27,-27
17,91,17,183,0,33,-33
17,91,17,197,1194,672,522
17,91,17,201,0,34,-34
17,91,18,57,0,29,-29
17,91,18,89,105,126,-21
17,91,18,97,0,61,-61
17,91,18,111,39,0,39
17,91,18,127,0,40,-40
17,91,32,3,30,0,30
17,91,39,49,29,0,29
17,91,47,37,0,30,-30
17,91,55,79,0,30,-30
17,93,4,13,73,90,-17
17,93,6,37,41,29,12
17,93,6,73,34,0,34
17,93,12,57,0,31,-31
17,93,17,19,44,0,44
17,93,17,31,2583,813,1770
17,93,17,37,399,478,-79
17,93,17,43,3976,1325,2651
17,93,17,63,148,141,7
17,93,17,89,3588,1706,1882
17,93,17,91,35,0,35
17,93,17,97,105,64,41
17,93,17,99,405,466,-61
17,93,17,103,0,63,-63
17,93,17,105,0,23,-23
17,93,17,111,87,83,4
17,93,17,113,51,28,23
17,93,17,143,66,0,66
17,93,17,197,2882,1187,1695
17,93,17,201,51,56,-5
17,93,18,89,54,0,54
17,93,48,439,35,0,35
17,93,55,133,0,35,-35
17,95,4,13,0,43,-43
17,95,17,1,0,24,-24
17,95,17,31,182,121,61
17,95,17,43,31,27,4
17,95,17,57,145,103,42
17,95,17,73,138,134,4
17,95,17,109,89,66,23
17,95,17,113,44,61,-17
17,95,17,131,74,67,7
17,95,17,143,250,342,-92
17,95,17,161,48,130,-82
17,95,17,175,32,0,32
17,95,17,179,78,88,-10
17,95,17,187,288,219,69
17,95,19,57,33,0,33
17,95,19,163,40,58,-18
17,97,2,20,0,28,-28
17,97,4,13,356,723,-367
17,97,4,19,53,124,-71
17,97,4,21,0,70,-70
17,97,4,25,0,36,-36
17,97,6,1,54,50,4
17,97,6,13,65,83,-18
17,97,6,31,53,0,53
17,97,6,37,336,342,-6
17,97,6,53,39,0,39
17,97,6,59,147,203,-56
17,97,6,65,87,122,-35
17,97,6,67,33,49,-16
17,97,6,71,91,64,27
17,97,6,73,551,710,-159
17,97,6,75,23,75,-52
17,97,6,81,50,47,3
17,97,6,85,85,152,-67
17,97,6,111,85,82,3
17,97,8,5,62,60,2
17,97,8,13,41,78,-37
17,97,8,31,65,90,-25
17,97,8,35,33,49,-16
17,97,8,41,57,73,-16
17,97,8,59,0,32,-32
17,97,8,69,36,29,7
17,97,9,1,75,55,20
17,97,9,3,0,59,-59
17,97,9,9,43,37,6
17,97,9,11,0,34,-34
17,97,10,3,43,0,43
17,97,11,1,28,57,-29
17,97,12,1,0,30,-30
17,97,12,11,186,147,39
17,97,12,15,0,40,-40
17,97,12,21,39,85,-46
17,97,12,31,205,206,-1
17,97,12,33,47,30,17
17,97,12,57,107,117,-10
17,97,12,69,0,44,-44
17,97,12,71,69,110,-41
17,97,12,81,31,41,-10
17,97,12,83,0,40,-40
17,97,12,86,117,94,23
17,97,12,95,72,86,-14
17,97,12,99,68,190,-122
17,97,12,101,26,32,-6
17,97,12,103,116,106,10
17,97,12,105,0,30,-30
17,97,12,115,30,68,-38
17,97,12,117,34,31,3
17,97,12,119,0,31,-31
17,97,12,127,0,38,-38
17,97,13,57,0,42,-42
17,97,13,67,79,62,17
17,97,13,89,57,66,-9
17,97,13,121,80,139,-59
17,97,13,135,68,57,11
17,97,15,3,201,137,64
17,97,17,7,43,72,-29
17,97,17,19,163,114,49
17,97,17,31,16096,11734,4362
17,97,17,37,137,160,-23
17,97,17,43,1278,1104,174
17,97,17,63,0,44,-44
17,97,17,77,61,55,6
17,97,17,89,689,724,-35
17,97,17,91,34,43,-9
17,97,17,93,64,105,-41
17,97,17,99,50,0,50
17,97,17,103,28,0,28
17,97,17,111,2355,3127,-772
17,97,17,113,82,120,-38
17,97,17,119,41,41,0
17,97,17,143,41,91,-50
17,97,17,161,34,26,8
17,97,17,167,60,68,-8
17,97,17,177,0,29,-29
17,97,17,179,0,35,-35
17,97,17,183,30,0,30
17,97,17,197,356,359,-3
17,97,17,201,141,193,-52
17,97,18,3,37,0,37
17,97,18,57,119,117,2
17,97,18,89,92,104,-12
17,97,18,97,69,141,-72
17,97,18,105,0,30,-30
17,97,18,127,34,0,34
17,97,18,141,42,47,-5
17,97,18,157,41,49,-8
17,97,19,103,36,61,-25
17,97,19,113,0,91,-91
17,97,19,153,43,68,-25
17,97,19,163,0,91,-91
17,97,20,91,66,84,-18
17,97,21,67,0,28,-28
17,97,21,111,56,60,-4
17,97,22,51,0,36,-36
17,97,24,3,39,0,39
17,97,24,5,44,34,10
17,97,24,31,79,109,-30
17,97,25,17,97,99,-2
17,97,25,21,33,36,-3
17,97,25,25,0,35,-35
17,97,26,21,22,42,-20
17,97,26,49,34,0,34
17,97,26,53,0,24,-24
17,97,26,65,22,0,22
17,97,26,77,58,47,11
17,97,26,81,55,41,14
17,97,26,125,219,92,127
17,97,26,159,0,26,-26
17,97,26,161,134,64,70
17,97,26,163,127,87,40
17,97,27,37,31,45,-14
17,97,27,53,106,183,-77
17,97,27,123,41,37,4
17,97,28,47,0,32,-32
17,97,29,19,0,31,-31
17,97,29,95,24,40,-16
17,97,29,183,0,63,-63
17,97,29,189,124,100,24
17,97,29,510,30,42,-12
17,97,31,55,36,0,36
17,97,32,3,169,258,-89
17,97,32,31,0,31,-31
17,97,34,3,0,40,-40
17,97,34,13,37,29,8
17,97,34,17,28,33,-5
17,97,34,23,73,75,-2
17,97,34,27,65,0,65
17,97,35,1,33,35,-2
17,97,36,47,48,65,-17
17,97,36,55,49,0,49
17,97,36,61,75,191,-116
17,97,36,81,28,34,-6
17,97,37,51,0,33,-33
17,97,37,63,27,29,-2
17,97,37,119,49,99,-50
17,97,37,133,79,76,3
17,97,37,183,44,108,-64
17,97,39,35,75,72,3
17,97,39,41,0,86,-86
17,97,39,49,126,226,-100
17,97,39,61,66,59,7
17,97,39,93,28,0,28
17,97,39,95,25,0,25
17,97,39,153,27,0,27
17,97,40,27,0,36,-36
17,97,41,51,0,38,-38
17,97,41,67,0,41,-41
17,97,42,3,54,71,-17
17,97,42,17,45,0,45
17,97,42,29,41,35,6
17,97,42,91,81,0,81
17,97,42,101,27,37,-10
17,97,45,13,0,40,-40
17,97,45,19,0,40,-40
17,97,45,45,0,36,-36
17,97,47,37,39,43,-4
17,97,47,157,100,69,31
17,97,47,187,0,47,-47
17,97,48,27,54,42,12
17,97,48,29,71,133,-62
17,97,48,85,55,142,-87
17,97,48,113,113,217,-104
17,97,48,121,50,93,-43
17,97,48,141,0,52,-52
17,97,48,201,99,207,-108
17,97,48,215,0,50,-50
17,97,48,339,0,48,-48
17,97,48,355,40,0,40
17,97,48,409,36,0,36
17,97,48,439,161,172,-11
17,97,48,453,36,116,-80
17,97,48,491,0,95,-95
17,97,49,35,40,35,5
17,97,51,13,0,39,-39
17,97,51,41,0,45,-45
17,97,51,59,68,111,-43
17,97,51,99,0,74,-74
17,97,51,153,33,25,8
17,97,51,550,81,69,12
17,97,51,650,0,59,-59
17,97,51,700,38,34,4
17,97,51,710,188,171,17
17,97,51,740,0,23,-23
17,97,51,810,166,285,-119
17,97,53,33,87,176,-89
17,97,53,35,57,83,-26
17,97,53,53,57,0,57
17,97,53,61,68,91,-23
17,97,55,9,52,73,-21
17,97,55,25,144,214,-70
17,97,55,59,1765,3312,-1547
17,97,55,75,0,29,-29
17,97,55,79,327,374,-47
17,97,55,87,38,33,5
17,97,55,89,35,41,-6
17,97,55,101,205,340,-135
17,97,55,105,25,55,-30
17,97,55,117,0,35,-35
17,97,55,127,187,280,-93
17,97,55,133,161,144,17
17,97,55,139,0,38,-38
17,99,4,13,29,71,-42
17,99,6,73,36,33,3
17,99,17,11,675,643,32
17,99,17,19,53,32,21
17,99,17,31,444,329,115
17,99,17,37,420,282,138
17,99,17,43,306,189,117
17,99,17,63,368,298,70
17,99,17,89,308,231,77
17,99,17,91,43,24,19
17,99,17,93,466,405,61
17,99,17,97,0,50,-50
17,99,17,103,151,119,32
17,99,17,105,210,176,34
17,99,17,111,31,28,3
17,99,17,113,87,171,-84
17,99,17,119,0,24,-24
17,99,17,123,135,100,35
17,99,17,141,55,38,17
17,99,17,143,56,111,-55
17,99,17,155,184,134,50
17,99,17,161,33,0,33
17,99,17,167,0,39,-39
17,99,17,179,31,37,-6
17,99,17,197,336,298,38
17,99,17,201,39,66,-27
17,99,17,203,41,66,-25
17,99,32,3,0,37,-37
17,101,17,33,105,95,10
17,101,17,159,82,54,28
17,101,17,185,36,29,7
17,101,18,83,151,202,-51
17,103,17,11,80,77,3
17,103,17,15,28,51,-23
17,103,17,31,114,96,18
17,103,17,37,192,186,6
17,103,17,43,97,60,37
17,103,17,89,97,48,49
17,103,17,93,63,0,63
17,103,17,97,0,28,-28
17,103,17,99,119,151,-32
17,103,17,113,0,22,-22
17,103,17,141,419,352,67
17,103,17,195,430,530,-100
17,103,17,197,40,31,9
17,103,17,201,88,96,-8
17,105,17,19,28,69,-41
17,105,17,31,88,123,-35
17,105,17,43,0,35,-35
17,105,17,53,46,74,-28
17,105,17,63,206,151,55
17,105,17,75,38,0,38
17,105,17,91,56,74,-18
17,105,17,93,23,0,23
17,105,17,99,176,210,-34
17,105,17,113,412,500,-88
17,105,17,143,0,42,-42
17,105,17,179,35,38,-3
17,105,17,197,174,101,73
17,105,17,203,27,93,-66
17,107,17,19,34,33,1
17,107,17,31,41,27,14
17,107,17,39,59,71,-12
17,107,17,113,232,208,24
17,107,17,115,133,141,-8
17,107,17,125,92,71,21
17,107,17,129,31,34,-3
17,107,17,143,52,0,52
17,107,17,167,220,254,-34
17,107,17,179,96,85,11
17,109,17,1,52,71,-19
17,109,17,31,92,163,-71
17,109,17,43,28,50,-22
17,109,17,57,198,127,71
17,109,17,67,154,97,57
17,109,17,73,28,0,28
17,109,17,95,66,89,-23
17,109,17,113,0,38,-38
17,109,17,125,27,0,27
17,109,17,143,49,83,-34
17,109,17,161,34,45,-11
17,109,17,167,42,59,-17
17,109,17,169,49,50,-1
17,109,17,179,20,33,-13
17,109,17,187,74,64,10
17,109,17,197,0,33,-33
17,109,19,57,24,0,24
17,109,19,111,46,0,46
17,109,19,163,0,49,-49
17,111,4,13,185,319,-134
17,111,4,19,26,58,-32
17,111,4,21,0,32,-32
17,111,6,37,81,89,-8
17,111,6,59,0,46,-46
17,111,6,71,0,30,-30
17,111,6,73,118,106,12
17,111,6,85,35,0,35
17,111,8,31,0,33,-33
17,111,8,41,0,52,-52
17,111,8,69,0,34,-34
17,111,11,1,0,20,-20
17,111,12,11,97,27,70
17,111,12,57,0,57,-57
17,111,12,71,41,90,-49
17,111,12,81,0,28,-28
17,111,12,83,0,25,-25
17,111,12,95,0,31,-31
17,111,12,99,0,27,-27
17,111,12,101,0,32,-32
17,111,12,103,41,52,-11
17,111,12,115,34,0,34
17,111,12,127,0,30,-30
17,111,13,121,0,35,-35
17,111,17,7,437,652,-215
17,111,17,19,48,37,11
17,111,17,31,5748,3758,1990
17,111,17,37,270,307,-37
17,111,17,43,1020,649,371
17,111,17,77,0,31,-31
17,111,17,89,2450,1984,466
17,111,17,93,83,87,-4
17,111,17,97,3127,2355,772
17,111,17,99,28,31,-3
17,111,17,113,45,72,-27
17,111,17,141,56,41,15
17,111,17,143,34,0,34
17,111,17,167,0,24,-24
17,111,17,177,0,40,-40
17,111,17,197,199,102,97
17,111,17,201,299,534,-235
17,111,18,97,0,42,-42
17,111,19,103,0,30,-30
17,111,19,163,0,39,-39
17,111,21,67,22,0,22
17,111,26,81,0,31,-31
17,111,26,125,66,0,66
17,111,27,37,29,0,29
17,111,27,53,50,43,7
17,111,29,189,28,26,2
17,111,31,55,0,44,-44
17,111,32,3,57,99,-42
17,111,45,45,0,31,-31
17,111,47,37,0,34,-34
17,111,48,29,0,63,-63
17,111,48,85,0,53,-53
17,111,48,113,0,37,-37
17,111,48,121,0,38,-38
17,111,48,201,42,46,-4
17,111,48,439,0,46,-46
17,111,48,453,0,41,-41
17,111,51,810,0,27,-27
17,111,53,33,0,44,-44
17,111,55,25,58,99,-41
17,111,55,59,211,327,-116
17,111,55,79,49,94,-45
17,111,55,101,43,57,-14
17,111,55,105,47,72,-25
17,111,55,127,506,473,33
17,111,55,133,51,97,-46
17,113,4,13,84,144,-60
17,113,6,37,49,59,-10
17,113,6,73,44,30,14
17,113,6,85,0,33,-33
17,113,12,11,0,31,-31
17,113,12,31,0,29,-29
17,113,12,57,26,0,26
17,113,12,71,0,33,-33
17,113,12,105,0,40,-40
17,113,12,115,0,24,-24
17,113,13,89,0,31,-31
17,113,17,1,45,0,45
17,113,17,11,33,25,8
17,113,17,19,491,407,84
17,113,17,21,37,28,9
17,113,17,29,41,0,41
17,113,17,31,942,928,14
17,113,17,37,57,46,11
17,113,17,39,292,294,-2
17,113,17,41,24,0,24
17,113,17,43,247,246,1
17,113,17,53,85,45,40
17,113,17,57,22,0,22
17,113,17,63,36,0,36
17,113,17,73,58,38,20
17,113,17,75,39,27,12
17,113,17,77,0,43,-43
17,113,17,89,108,87,21
17,113,17,91,115,34,81
17,113,17,93,28,51,-23
17,113,17,95,61,44,17
17,113,17,97,120,82,38
17,113,17,99,171,87,84
17,113,17,103,22,0,22
17,113,17,105,500,412,88
17,113,17,107,208,232,-24
17,113,17,109,38,0,38
17,113,17,111,72,45,27
17,113,17,115,164,184,-20
17,113,17,119,34,69,-35
17,113,17,123,35,0,35
17,113,17,125,26,0,26
17,113,17,137,37,0,37
17,113,17,143,367,291,76
17,113,17,147,59,60,-1
17,113,17,161,35,63,-28
17,113,17,163,38,35,3
17,113,17,167,245,239,6
17,113,17,173,21,0,21
17,113,17,177,36,0,36
17,113,17,179,397,536,-139
17,113,17,183,79,82,-3
17,113,17,197,185,159,26
17,113,17,201,68,48,20
17,113,17,203,388,265,123
17,113,18,57,0,37,-37
17,113,18,89,24,0,24
17,113,18,97,48,60,-12
17,113,18,157,42,40,2
17,113,19,103,0,31,-31
17,113,19,153,42,44,-2
17,113,19,163,31,33,-2
17,113,21,111,0,37,-37
17,113,26,125,103,42,61
17,113,26,163,40,0,40
17,113,27,37,0,28,-28
17,113,27,53,34,37,-3
17,113,29,19,45,59,-14
17,113,29,183,49,0,49
17,113,29,189,82,95,-13
17,113,29,510,33,24,9
17,113,32,3,0,52,-52
17,113,34,23,0,40,-40
17,113,37,119,0,48,-48
17,113,37,183,0,30,-30
17,113,39,35,0,29,-29
17,113,39,49,0,48,-48
17,113,47,149,0,43,-43
17,113,48,29,0,40,-40
17,113,48,85,0,47,-47
17,113,48,113,0,27,-27
17,113,48,121,0,28,-28
17,113,48,201,0,38,-38
17,113,48,439,0,28,-28
17,113,48,453,0,22,-22
17,113,53,33,0,56,-56
17,113,55,25,35,56,-21
17,113,55,79,0,48,-48
17,115,4,13,26,41,-15
17,115,6,73,26,0,26
17,115,12,57,0,29,-29
17,115,12,71,0,27,-27
17,115,12,95,36,0,36
17,115,17,1,50,0,50
17,115,17,19,174,223,-49
17,115,17,21,214,228,-14
17,115,17,29,88,55,33
17,115,17,31,271,334,-63
17,115,17,39,115,136,-21
17,115,17,41,34,0,34
17,115,17,43,50,75,-25
17,115,17,49,0,28,-28
17,115,17,51,0,31,-31
17,115,17,77,24,24,0
17,115,17,89,0,49,-49
17,115,17,107,141,133,8
17,115,17,113,184,164,20
17,115,17,119,48,88,-40
17,115,17,137,41,0,41
17,115,17,139,237,236,1
17,115,17,143,93,163,-70
17,115,17,147,201,192,9
17,115,17,163,44,48,-4
17,115,17,167,270,363,-93
17,115,17,173,174,199,-25
17,115,17,179,44,96,-52
17,115,17,183,24,37,-13
17,115,17,197,33,53,-20
17,115,18,97,78,88,-10
17,115,29,183,0,36,-36
17,115,29,189,32,89,-57
17,115,29,510,25,40,-15
17,115,47,37,0,33,-33
17,115,48,201,0,33,-33
17,115,55,79,0,25,-25
17,117,17,21,0,34,-34
17,117,17,31,0,29,-29
17,117,17,61,29,59,-30
17,117,17,83,116,171,-55
17,117,17,119,839,846,-7
17,117,17,135,292,279,13
17,117,17,137,44,66,-22
17,117,17,163,90,59,31
17,117,17,167,395,475,-80
17,117,29,189,61,48,13
17,117,29,510,0,30,-30
17,119,4,13,70,80,-10
17,119,6,37,64,35,29
17,119,6,71,29,0,29
17,119,6,73,87,48,39
17,119,8,5,32,0,32
17,119,8,31,0,28,-28
17,119,8,41,33,49,-16
17,119,12,31,29,35,-6
17,119,12,103,0,30,-30
17,119,13,121,0,45,-45
17,119,15,3,41,0,41
17,119,17,1,73,0,73
17,119,17,5,319,264,55
17,119,17,13,0,45,-45
17,119,17,19,80,68,12
17,119,17,21,34,0,34
17,119,17,27,276,212,64
17,119,17,29,42,0,42
17,119,17,31,229,270,-41
17,119,17,43,62,86,-24
17,119,17,49,22,45,-23
17,119,17,51,91,66,25
17,119,17,55,25,0,25
17,119,17,61,104,67,37
17,119,17,77,82,56,26
17,119,17,81,90,36,54
17,119,17,83,514,674,-160
17,119,17,91,33,0,33
17,119,17,97,41,41,0
17,119,17,99,24,0,24
17,119,17,113,69,34,35
17,119,17,115,88,48,40
17,119,17,117,846,839,7
17,119,17,121,63,62,1
17,119,17,133,141,119,22
17,119,17,135,131,109,22
17,119,17,137,40,59,-19
17,119,17,143,82,42,40
17,119,17,149,0,32,-32
17,119,17,157,74,0,74
17,119,17,161,24,0,24
17,119,17,163,2808,2762,46
17,119,17,167,224,220,4
17,119,17,179,40,28,12
17,119,17,189,46,74,-28
17,119,17,197,60,62,-2
17,119,17,199,78,48,30
17,119,17,201,32,0,32
17,119,18,97,44,26,18
17,119,19,153,0,28,-28
17,119,20,91,0,36,-36
17,119,20,173,36,0,36
17,119,29,19,53,52,1
17,119,29,29,0,33,-33
17,119,29,31,28,0,28
17,119,29,47,0,47,-47
17,119,29,51,26,0,26
17,119,29,71,41,53,-12
17,119,29,77,28,39,-11
17,119,29,95,41,39,2
17,119,29,99,145,180,-35
17,119,29,183,356,445,-89
17,119,29,187,32,0,32
17,119,29,189,1418,1384,34
17,119,29,219,22,0,22
17,119,29,510,572,683,-111
17,119,32,3,65,84,-19
17,119,36,61,0,23,-23
17,119,37,51,31,0,31
17,119,37,133,0,32,-32
17,119,47,37,0,26,-26
17,119,47,157,28,0,28
17,119,48,27,0,37,-37
17,119,48,29,0,63,-63
17,119,48,85,0,40,-40
17,119,48,113,0,30,-30
17,119,48,201,47,53,-6
17,119,48,439,34,45,-11
17,119,53,33,0,27,-27
17,119,53,61,0,43,-43
17,119,55,25,0,30,-30
17,119,55,79,0,31,-31
17,121,17,25,68,37,31
17,121,17,27,160,170,-10
17,121,17,31,38,0,38
17,121,17,49,31,35,-4
17,121,17,51,121,128,-7
17,121,17,55,38,0,38
17,121,17,77,27,47,-20
17,121,17,81,255,283,-28
17,121,17,119,62,63,-1
17,121,17,163,47,81,-34
17,121,17,167,0,29,-29
17,121,17,189,193,138,55
17,121,17,199,45,0,45
17,121,29,189,30,36,-6
17,123,17,11,37,41,-4
17,123,17,31,41,0,41
17,123,17,99,100,135,-35
17,123,17,113,0,35,-35
17,123,17,143,192,275,-83
17,123,17,155,35,41,-6
17,123,17,175,0,36,-36
17,123,17,179,68,49,19
17,123,17,203,56,151,-95
17,125,17,17,32,0,32
17,125,17,57,96,62,34
17,125,17,107,71,92,-21
17,125,17,109,0,27,-27
17,125,17,113,0,26,-26
17,125,17,129,40,0,40
17,125,17,143,89,84,5
17,125,17,167,54,66,-12
17,125,17,179,226,312,-86
17,127,17,31,26,0,26
17,127,17,87,45,38,7
17,127,17,151,67,39,28
17,127,17,153,50,0,50
17,127,21,83,0,35,-35
17,127,21,145,209,317,-108
17,129,17,17,0,28,-28
17,129,17,107,34,31,3
17,129,17,125,0,40,-40
17,129,17,137,0,33,-33
17,129,17,167,577,448,129
17,131,17,31,0,25,-25
17,131,17,73,92,96,-4
17,131,17,95,67,74,-7
17,131,17,161,420,364,56
17,131,17,187,73,37,36
17,131,19,139,54,79,-25
17,131,19,163,51,63,-12
17,133,17,119,119,141,-22
17,133,17,157,144,143,1
17,133,17,163,759,400,359
17,133,29,99,88,63,25
17,133,29,183,64,29,35
17,133,29,189,346,270,76
17,133,29,510,98,118,-20
17,135,17,5,133,73,60
17,135,17,21,130,110,20
17,135,17,51,57,59,-2
17,135,17,117,279,292,-13
17,135,17,119,109,131,-22
17,135,17,167,191,236,-45
17,135,29,189,32,0,32
17,137,17,1,28,0,28
17,137,17,9,26,38,-12
17,137,17,17,138,181,-43
17,137,17,31,33,55,-22
17,137,17,61,162,119,43
17,137,17,113,0,37,-37
17,137,17,115,0,41,-41
17,137,17,117,66,44,22
17,137,17,119,59,40,19
17,137,17,129,33,0,33
17,137,17,149,55,44,11
17,137,17,167,308,456,-148
17,137,17,171,159,109,50
17,139,17,19,31,53,-22
17,139,17,29,187,152,35
17,139,17,31,0,27,-27
17,139,17,41,104,100,4
17,139,17,115,236,237,-1
17,139,17,147,0,50,-50
17,139,17,167,0,33,-33
17,139,17,173,117,100,17
17,141,4,13,31,44,-13
17,141,17,7,60,60,0
17,141,17,11,0,49,-49
17,141,17,15,78,56,22
17,141,17,31,181,173,8
17,141,17,37,582,443,139
17,141,17,43,163,89,74
17,141,17,89,185,66,119
17,141,17,99,38,55,-17
17,141,17,103,352,419,-67
17,141,17,111,41,56,-15
17,141,17,177,124,133,-9
17,141,17,195,124,160,-36
17,141,17,197,41,41,0
17,141,17,201,895,985,-90
17,141,55,25,0,38,-38
17,143,4,13,66,118,-52
17,143,4,19,33,40,-7
17,143,6,37,32,49,-17
17,143,6,67,0,42,-42
17,143,6,73,72,61,11
17,143,8,31,0,22,-22
17,143,12,31,0,33,-33
17,143,12,57,24,0,24
17,143,12,71,0,30,-30
17,143,12,86,0,21,-21
17,143,13,67,0,60,-60
17,143,13,89,0,34,-34
17,143,15,3,0,39,-39
17,143,17,1,32,29,3
17,143,17,11,46,37,9
17,143,17,19,165,96,69
17,143,17,31,576,658,-82
17,143,17,37,31,31,0
17,143,17,43,180,200,-20
17,143,17,57,435,359,76
17,143,17,73,114,75,39
17,143,17,77,48,45,3
17,143,17,89,52,73,-21
17,143,17,91,27,0,27
17,143,17,93,0,66,-66
17,143,17,95,342,250,92
17,143,17,97,91,41,50
17,143,17,99,111,56,55
17,143,17,105,42,0,42
17,143,17,107,0,52,-52
17,143,17,109,83,49,34
17,143,17,111,0,34,-34
17,143,17,113,291,367,-76
17,143,17,115,163,93,70
17,143,17,119,42,82,-40
17,143,17,123,275,192,83
17,143,17,125,84,89,-5
17,143,17,161,104,65,39
17,143,17,163,30,34,-4
17,143,17,167,197,151,46
17,143,17,175,116,118,-2
17,143,17,179,2850,3435,-585
17,143,17,183,47,41,6
17,143,17,187,38,27,11
17,143,17,195,41,0,41
17,143,17,197,101,155,-54
17,143,17,201,63,85,-22
17,143,17,203,448,606,-158
17,143,18,5,0,46,-46
17,143,18,57,0,38,-38
17,143,18,97,53,67,-14
17,143,18,157,41,54,-13
17,143,19,113,0,21,-21
17,143,19,153,25,0,25
17,143,19,163,46,68,-22
17,143,20,91,0,40,-40
17,143,26,99,30,0,30
17,143,26,125,40,61,-21
17,143,26,163,100,0,100
17,143,27,53,0,61,-61
17,143,29,183,0,38,-38
17,143,29,189,76,143,-67
17,143,29,510,0,36,-36
17,143,32,3,49,67,-18
17,143,37,119,0,21,-21
17,143,37,183,58,82,-24
17,143,39,49,36,24,12
17,143,45,45,0,52,-52
17,143,47,37,34,44,-10
17,143,47,157,43,33,10
17,143,48,29,0,33,-33
17,143,48,85,0,43,-43
17,143,48,113,41,67,-26
17,143,48,201,56,131,-75
17,143,48,439,0,34,-34
17,143,51,810,0,33,-33
17,143,53,33,0,29,-29
17,143,55,25,35,46,-11
17,143,55,79,45,56,-11
17,145,17,55,95,118,-23
17,145,17,77,177,189,-12
17,145,17,81,0,39,-39
17,145,17,157,186,147,39
17,145,17,163,38,67,-29
17,145,17,189,40,45,-5
17,145,17,199,71,78,-7
17,147,17,19,428,415,13
17,147,17,39,64,45,19
17,147,17,41,78,55,23
17,147,17,113,60,59,1
17,147,17,115,192,201,-9
17,147,17,139,50,0,50
17,149,17,1,86,133,-47
17,149,17,9,28,0,28
17,149,17,119,32,0,32
17,149,17,137,44,55,-11
17,149,17,167,43,54,-11
17,149,29,127,42,41,1
17,149,29,163,23,45,-22
17,151,17,127,39,67,-28
17,151,17,165,40,0,40
17,153,17,3,76,84,-8
17,153,17,127,0,50,-50
17,153,17,181,39,48,-9
17,153,29,31,34,47,-13
17,155,17,11,95,96,-1
17,155,17,99,134,184,-50
17,155,17,123,41,35,6
17,157,17,77,122,161,-39
17,157,17,119,0,74,-74
17,157,17,133,143,144,-1
17,157,17,145,147,186,-39
17,157,17,163,344,358,-14
17,157,17,189,40,32,8
17,157,17,199,30,52,-22
17,157,29,31,0,26,-26
17,157,29,157,53,75,-22
17,157,29,189,31,60,-29
17,157,29,510,0,42,-42
17,159,17,25,101,65,36
17,159,17,33,47,60,-13
17,159,17,47,31,28,3
17,159,17,49,29,0,29
17,159,17,79,52,57,-5
17,159,17,101,54,82,-28
17,159,17,191,51,43,8
17,159,18,83,0,41,-41
17,161,4,13,66,114,-48
17,161,6,13,0,29,-29
17,161,6,37,38,97,-59
17,161,6,73,33,63,-30
17,161,6,85,0,27,-27
17,161,8,41,0,34,-34
17,161,12,11,0,25,-25
17,161,12,95,0,25,-25
17,161,13,67,0,24,-24
17,161,13,121,0,35,-35
17,161,17,11,32,0,32
17,161,17,19,0,31,-31
17,161,17,31,375,328,47
17,161,17,37,20,0,20
17,161,17,43,74,103,-29
17,161,17,73,1095,1045,50
17,161,17,89,54,30,24
17,161,17,95,130,48,82
17,161,17,97,26,34,-8
17,161,17,99,0,33,-33
17,161,17,109,45,34,11
17,161,17,113,63,35,28
17,161,17,119,0,24,-24
17,161,17,131,364,420,-56
17,161,17,143,65,104,-39
17,161,17,167,40,26,14
17,161,17,179,28,0,28
17,161,17,187,52,0,52
17,161,17,195,217,196,21
17,161,17,197,0,48,-48
17,161,17,201,51,42,9
17,161,18,97,0,39,-39
17,161,19,13,55,33,22
17,161,19,45,68,81,-13
17,161,19,57,0,29,-29
17,161,19,61,39,39,0
17,161,19,103,52,88,-36
17,161,19,113,70,85,-15
17,161,19,139,78,147,-69
17,161,19,153,70,111,-41
17,161,19,163,1895,2760,-865
17,161,27,53,0,70,-70
17,161,29,189,0,40,-40
17,161,32,3,25,47,-22
17,161,34,23,0,53,-53
17,161,37,119,0,54,-54
17,161,39,49,0,39,-39
17,161,48,29,0,43,-43
17,161,48,85,0,36,-36
17,161,48,113,0,29,-29
17,161,48,201,0,48,-48
17,161,48,439,0,45,-45
17,161,51,59,0,33,-33
17,161,53,33,0,80,-80
17,161,55,79,43,38,5
17,163,1,1,0,47,-47
17,163,1,101,49,0,49
17,163,2,20,77,0,77
17,163,2,90,38,0,38
17,163,4,13,126,145,-19
17,163,4,19,50,0,50
17,163,5,119,79,39,40
17,163,6,29,42,0,42
17,163,6,37,58,58,0
17,163,6,53,36,0,36
17,163,6,73,86,94,-8
17,163,6,95,60,82,-22
17,163,8,31,0,31,-31
17,163,8,41,90,94,-4
17,163,11,1,0,42,-42
17,163,12,9,0,44,-44
17,163,12,11,0,36,-36
17,163,12,31,46,27,19
17,163,12,33,28,0,28
17,163,12,57,68,62,6
17,163,12,86,35,0,35
17,163,12,91,84,52,32
17,163,12,103,0,33,-33
17,163,13,67,0,38,-38
17,163,13,89,0,30,-30
17,163,13,121,0,52,-52
17,163,13,153,66,0,66
17,163,15,3,135,97,38
17,163,17,5,39,61,-22
17,163,17,19,56,62,-6
17,163,17,27,380,569,-189
17,163,17,29,29,0,29
17,163,17,31,238,254,-16
17,163,17,43,71,45,26
17,163,17,51,32,0,32
17,163,17,55,37,48,-11
17,163,17,77,123,122,1
17,163,17,81,79,54,25
17,163,17,83,0,34,-34
17,163,17,89,31,0,31
17,163,17,113,35,38,-3
17,163,17,115,48,44,4
17,163,17,117,59,90,-31
17,163,17,119,2762,2808,-46
17,163,17,121,81,47,34
17,163,17,133,400,759,-359
17,163,17,143,34,30,4
17,163,17,145,67,38,29
17,163,17,157,358,344,14
17,163,17,167,154,121,33
17,163,17,179,0,30,-30
17,163,17,189,177,160,17
17,163,17,197,51,32,19
17,163,17,199,75,50,25
17,163,18,97,46,80,-34
17,163,20,91,0,48,-48
17,163,20,173,43,54,-11
17,163,21,111,0,29,-29
17,163,24,3,33,0,33
17,163,24,33,26,36,-10
17,163,28,47,93,53,40
17,163,29,19,50,80,-30
17,163,29,31,49,38,11
17,163,29,71,47,36,11
17,163,29,77,0,25,-25
17,163,29,95,32,70,-38
17,163,29,99,170,257,-87
17,163,29,183,201,290,-89
17,163,29,187,0,30,-30
17,163,29,189,1457,1488,-31
17,163,29,510,956,929,27
17,163,31,153,83,41,42
17,163,32,3,81,185,-104
17,163,34,5,66,0,66
17,163,35,1,32,0,32
17,163,37,51,41,36,5
17,163,37,133,0,44,-44
17,163,39,49,0,26,-26
17,163,39,57,39,0,39
17,163,39,113,66,36,30
17,163,40,109,53,0,53
17,163,40,143,0,40,-40
17,163,45,19,0,35,-35
17,163,47,37,0,26,-26
17,163,47,125,32,34,-2
17,163,47,157,80,49,31
17,163,48,27,0,31,-31
17,163,48,29,95,213,-118
17,163,48,85,0,48,-48
17,163,48,113,40,41,-1
17,163,48,121,0,27,-27
17,163,48,141,0,44,-44
17,163,48,201,0,68,-68
17,163,48,439,0,62,-62
17,163,48,441,64,0,64
17,163,51,59,133,152,-19
17,163,51,153,82,61,21
17,163,51,650,43,0,43
17,163,51,700,99,0,99
17,163,51,810,46,39,7
17,163,53,33,34,0,34
17,163,53,53,43,44,-1
17,163,53,63,0,41,-41
17,165,17,55,78,75,3
17,165,17,59,86,109,-23
17,165,17,69,50,56,-6
17,165,17,77,32,34,-2
17,165,17,87,27,27,0
17,165,17,151,0,40,-40
17,165,17,193,66,39,27
17,165,17,199,161,212,-51
17,165,18,163,35,43,-8
17,167,4,13,81,166,-85
17,167,4,19,0,26,-26
17,167,6,37,41,48,-7
17,167,6,59,0,25,-25
17,167,6,71,0,32,-32
17,167,6,73,37,44,-7
17,167,8,31,0,25,-25
17,167,8,41,27,0,27
17,167,12,21,0,31,-31
17,167,12,31,0,30,-30
17,167,12,95,30,0,30
17,167,12,103,57,27,30
17,167,13,121,0,24,-24
17,167,17,1,77,76,1
17,167,17,17,184,110,74
17,167,17,19,233,183,50
17,167,17,21,429,379,50
17,167,17,29,54,53,1
17,167,17,31,827,718,109
17,167,17,43,118,124,-6
17,167,17,49,53,33,20
17,167,17,57,0,30,-30
17,167,17,61,45,27,18
17,167,17,77,116,51,65
17,167,17,89,58,60,-2
17,167,17,97,68,60,8
17,167,17,99,39,0,39
17,167,17,107,254,220,34
17,167,17,109,59,42,17
17,167,17,111,24,0,24
17,167,17,113,239,245,-6
17,167,17,115,363,270,93
17,167,17,117,475,395,80
17,167,17,119,220,224,-4
17,167,17,121,29,0,29
17,167,17,125,66,54,12
17,167,17,129,448,577,-129
17,167,17,135,236,191,45
17,167,17,137,456,308,148
17,167,17,139,33,0,33
17,167,17,143,151,197,-46
17,167,17,149,54,43,11
17,167,17,161,26,40,-14
17,167,17,163,121,154,-33
17,167,17,169,34,0,34
17,167,17,171,37,0,37
17,167,17,173,27,60,-33
17,167,17,179,108,99,9
17,167,17,183,28,0,28
17,167,17,197,139,58,81
17,167,17,199,35,47,-12
17,167,17,201,65,32,33
17,167,18,97,29,47,-18
17,167,20,91,0,43,-43
17,167,21,111,0,33,-33
17,167,27,53,32,49,-17
17,167,29,19,27,0,27
17,167,29,29,21,0,21
17,167,29,95,40,0,40
17,167,29,183,33,74,-41
17,167,29,189,109,208,-99
17,167,29,510,71,149,-78
17,167,32,3,29,47,-18
17,167,47,37,0,45,-45
17,167,47,157,41,44,-3
17,167,48,113,0,44,-44
17,167,48,201,26,50,-24
17,167,48,439,0,30,-30
17,167,48,453,0,46,-46
17,167,53,33,0,23,-23
17,167,55,25,0,31,-31
17,167,55,79,48,46,2
17,169,17,9,48,0,48
17,169,17,17,100,162,-62
17,169,17,57,36,62,-26
17,169,17,109,50,49,1
17,169,17,167,0,34,-34
17,171,17,61,42,47,-5
17,171,17,137,109,159,-50
17,171,17,167,0,37,-37
17,173,17,19,0,27,-27
17,173,17,21,238,177,61
17,173,17,29,128,171,-43
17,173,17,35,39,0,39
17,173,17,49,179,149,30
17,173,17,51,56,60,-4
17,173,17,113,0,21,-21
17,173,17,115,199,174,25
17,173,17,139,100,117,-17
17,173,17,167,60,27,33
17,175,17,11,0,34,-34
17,175,17,73,90,83,7
17,175,17,95,0,32,-32
17,175,17,123,36,0,36
17,175,17,143,118,116,2
17,175,17,179,34,37,-3
17,177,4,13,0,51,-51
17,177,17,15,169,95,74
17,177,17,31,154,145,9
17,177,17,37,40,34,6
17,177,17,43,50,46,4
17,177,17,85,163,161,2
17,177,17,89,28,32,-4
17,177,17,97,29,0,29
17,177,17,111,40,0,40
17,177,17,113,0,36,-36
17,177,17,141,133,124,9
17,177,17,195,0,33,-33
17,177,17,197,38,0,38
17,177,17,201,454,461,-7
17,177,19,61,0,31,-31
17,177,55,25,30,77,-47
17,177,55,45,83,148,-65
17,177,55,105,31,38,-7
17,179,4,13,54,62,-8
17,179,6,37,25,28,-3
17,179,6,73,34,28,6
17,179,17,11,36,25,11
17,179,17,19,87,53,34
17,179,17,29,28,0,28
17,179,17,31,134,154,-20
17,179,17,37,0,28,-28
17,179,17,39,0,31,-31
17,179,17,43,71,59,12
17,179,17,57,233,238,-5
17,179,17,73,28,46,-18
17,179,17,95,88,78,10
17,179,17,97,35,0,35
17,179,17,99,37,31,6
17,179,17,105,38,35,3
17,179,17,107,85,96,-11
17,179,17,109,33,20,13
17,179,17,113,536,397,139
17,179,17,115,96,44,52
17,179,17,119,28,40,-12
17,179,17,123,49,68,-19
17,179,17,125,312,226,86
17,179,17,143,3435,2850,585
17,179,17,161,0,28,-28
17,179,17,163,30,0,30
17,179,17,167,99,108,-9
17,179,17,175,37,34,3
17,179,17,197,56,51,5
17,179,17,201,0,28,-28
17,179,17,203,595,642,-47
17,179,19,163,0,36,-36
17,179,29,189,0,46,-46
17,179,32,3,0,21,-21
17,179,48,201,0,31,-31
17,181,17,3,56,43,13
17,181,17,77,162,143,19
17,181,17,87,52,57,-5
17,181,17,153,48,39,9
17,181,17,199,78,105,-27
17,181,29,31,47,72,-25
17,183,6,73,0,33,-33
17,183,8,41,0,23,-23
17,183,17,19,653,716,-63
17,183,17,29,33,61,-28
17,183,17,31,428,314,114
17,183,17,43,0,32,-32
17,183,17,45,36,87,-51
17,183,17,53,51,43,8
17,183,17,75,125,108,17
17,183,17,91,33,0,33
17,183,17,97,0,30,-30
17,183,17,113,82,79,3
17,183,17,115,37,24,13
17,183,17,143,41,47,-6
17,183,17,167,0,28,-28
17,183,17,197,29,0,29
17,183,18,45,111,190,-79
17,183,18,63,33,35,-2
17,183,18,97,56,111,-55
17,183,18,157,50,66,-16
17,183,18,165,62,79,-17
17,183,18,167,26,0,26
17,183,18,171,61,74,-13
17,185,17,47,81,66,15
17,185,17,101,29,36,-7
17,185,17,193,37,39,-2
17,185,18,51,54,79,-25
17,185,18,163,38,67,-29
17,187,17,17,42,0,42
17,187,17,57,0,58,-58
17,187,17,71,59,61,-2
17,187,17,73,0,38,-38
17,187,17,95,219,288,-69
17,187,17,109,64,74,-10
17,187,17,131,37,73,-36
17,187,17,143,27,38,-11
17,187,17,161,0,52,-52
17,187,19,57,0,28,-28
17,187,19,163,0,32,-32
17,189,17,27,106,103,3
17,189,17,81,109,106,3
17,189,17,119,74,46,28
17,189,17,121,138,193,-55
17,189,17,145,45,40,5
17,189,17,157,32,40,-8
17,189,17,163,160,177,-17
17,191,17,25,104,150,-46
17,191,17,47,34,60,-26
17,191,17,65,35,0,35
17,191,17,81,64,106,-42
17,191,17,159,43,51,-8
17,191,17,193,64,73,-9
17,191,18,163,31,0,31
17,193,17,47,28,53,-25
17,193,17,59,82,39,43
17,193,17,65,42,46,-4
17,193,17,165,39,66,-27
17,193,17,185,39,37,2
17,193,17,191,73,64,9
17,193,18,129,40,37,3
17,193,18,163,64,74,-10
17,195,4,13,34,48,-14
17,195,17,11,67,59,8
17,195,17,15,156,141,15
17,195,17,19,0,29,-29
17,195,17,31,135,99,36
17,195,17,37,54,37,17
17,195,17,43,41,34,7
17,195,17,73,62,78,-16
17,195,17,89,39,40,-1
17,195,17,103,530,430,100
17,195,17,141,160,124,36
17,195,17,143,0,41,-41
17,195,17,161,196,217,-21
17,195,17,177,33,0,33
17,195,17,201,94,77,17
17,195,19,45,255,300,-45
17,195,19,163,82,87,-5
17,197,1,73,0,27,-27
17,197,4,13,220,517,-297
17,197,4,19,51,62,-11
17,197,4,21,0,65,-65
17,197,5,7,0,65,-65
17,197,6,1,0,51,-51
17,197,6,13,0,44,-44
17,197,6,37,205,219,-14
17,197,6,59,111,131,-20
17,197,6,65,55,60,-5
17,197,6,67,0,33,-33
17,197,6,71,69,52,17
17,197,6,73,146,138,8
17,197,6,81,0,28,-28
17,197,6,85,25,51,-26
17,197,8,1,0,28,-28
17,197,8,5,37,46,-9
17,197,8,13,0,20,-20
17,197,8,35,0,76,-76
17,197,8,41,35,36,-1
17,197,8,59,0,38,-38
17,197,11,1,0,34,-34
17,197,12,11,63,88,-25
17,197,12,21,30,62,-32
17,197,12,31,32,40,-8
17,197,12,57,44,59,-15
17,197,12,69,0,33,-33
17,197,12,71,68,126,-58
17,197,12,81,0,35,-35
17,197,12,86,37,34,3
17,197,12,95,56,73,-17
17,197,12,97,28,0,28
17,197,12,99,31,57,-26
17,197,12,101,0,71,-71
17,197,12,103,91,75,16
17,197,12,105,0,35,-35
17,197,12,109,0,47,-47
17,197,12,115,0,79,-79
17,197,12,127,42,50,-8
17,197,13,51,24,0,24
17,197,13,63,0,38,-38
17,197,13,67,61,81,-20
17,197,13,89,37,55,-18
17,197,13,121,28,59,-31
17,197,13,135,35,75,-40
17,197,15,3,57,44,13
17,197,17,7,0,56,-56
17,197,17,11,0,49,-49
17,197,17,19,123,152,-29
17,197,17,29,25,34,-9
17,197,17,31,22154,12900,9254
17,197,17,37,204,210,-6
17,197,17,43,8397,6125,2272
17,197,17,53,0,31,-31
17,197,17,55,0,38,-38
17,197,17,63,1383,2220,-837
17,197,17,75,33,89,-56
17,197,17,77,41,36,5
17,197,17,85,0,35,-35
17,197,17,89,981,1069,-88
17,197,17,91,672,1194,-522
17,197,17,93,1187,2882,-1695
17,197,17,97,359,356,3
17,197,17,99,298,336,-38
17,197,17,103,31,40,-9
17,197,17,105,101,174,-73
17,197,17,109,33,0,33
17,197,17,111,102,199,-97
17,197,17,113,159,185,-26
17,197,17,115,53,33,20
17,197,17,119,62,60,2
17,197,17,141,41,41,0
17,197,17,143,155,101,54
17,197,17,161,48,0,48
17,197,17,163,32,51,-19
17,197,17,167,58,139,-81
17,197,17,177,0,38,-38
17,197,17,179,51,56,-5
17,197,17,183,0,29,-29
17,197,17,199,0,31,-31
17,197,17,201,94,163,-69
17,197,18,3,40,37,3
17,197,18,39,0,37,-37
17,197,18,57,74,104,-30
17,197,18,63,0,23,-23
17,197,18,73,0,32,-32
17,197,18,89,600,1135,-535
17,197,18,91,31,46,-15
17,197,18,97,57,109,-52
17,197,18,127,85,117,-32
17,197,18,141,41,44,-3
17,197,18,157,32,40,-8
17,197,18,181,0,28,-28
17,197,19,103,40,43,-3
17,197,19,113,0,55,-55
17,197,19,153,37,29,8
17,197,19,163,30,69,-39
17,197,20,91,44,82,-38
17,197,20,173,0,42,-42
17,197,21,111,34,30,4
17,197,24,3,50,0,50
17,197,24,31,54,41,13
17,197,25,17,38,0,38
17,197,26,21,0,44,-44
17,197,26,65,37,0,37
17,197,26,77,41,58,-17
17,197,26,81,72,43,29
17,197,26,125,136,125,11
17,197,26,161,66,38,28
17,197,26,163,132,92,40
17,197,27,37,48,0,48
17,197,27,53,72,102,-30
17,197,27,123,0,25,-25
17,197,28,49,0,34,-34
17,197,29,19,0,40,-40
17,197,29,95,50,0,50
17,197,29,183,0,55,-55
17,197,29,189,82,88,-6
17,197,29,510,0,23,-23
17,197,31,55,53,47,6
17,197,31,109,41,0,41
17,197,32,3,181,241,-60
17,197,34,23,31,0,31
17,197,35,1,38,40,-2
17,197,36,61,0,55,-55
17,197,36,81,52,0,52
17,197,37,119,0,53,-53
17,197,37,133,38,34,4
17,197,37,183,34,58,-24
17,197,39,35,72,37,35
17,197,39,49,61,65,-4
17,197,39,61,0,30,-30
17,197,39,95,0,56,-56
17,197,39,113,36,0,36
17,197,39,153,0,45,-45
17,197,40,143,35,0,35
17,197,42,3,0,37,-37
17,197,42,29,0,56,-56
17,197,47,37,47,62,-15
17,197,47,125,39,0,39
17,197,47,157,63,82,-19
17,197,48,27,0,63,-63
17,197,48,29,55,97,-42
17,197,48,85,68,90,-22
17,197,48,113,52,99,-47
17,197,48,121,38,54,-16
17,197,48,157,0,69,-69
17,197,48,201,152,198,-46
17,197,48,215,41,38,3
17,197,48,339,0,41,-41
17,197,48,439,81,147,-66
17,197,48,453,0,64,-64
17,197,49,35,0,36,-36
17,197,51,59,32,50,-18
17,197,51,810,0,39,-39
17,197,53,33,50,60,-10
17,197,55,9,58,28,30
17,197,55,25,48,74,-26
17,197,55,59,37,58,-21
17,197,55,79,131,127,4
17,197,55,133,0,82,-82
17,199,4,13,0,27,-27
17,199,17,19,36,25,11
17,199,17,31,126,96,30
17,199,17,43,0,99,-99
17,199,17,55,620,593,27
17,199,17,77,831,659,172
17,199,17,81,100,76,24
17,199,17,87,199,220,-21
17,199,17,89,37,0,37
17,199,17,119,48,78,-30
17,199,17,121,0,45,-45
17,199,17,145,78,71,7
17,199,17,157,52,30,22
17,199,17,163,50,75,-25
17,199,17,165,212,161,51
17,199,17,167,47,35,12
17,199,17,181,105,78,27
17,199,17,197,31,0,31
17,199,18,163,0,30,-30
17,199,21,145,34,29,5
17,199,29,31,43,0,43
17,199,29,189,58,72,-14
17,199,29,510,25,40,-15
17,199,48,201,28,0,28
17,201,4,13,150,298,-148
17,201,4,19,49,63,-14
17,201,4,21,0,30,-30
17,201,6,37,107,80,27
17,201,6,59,29,37,-8
17,201,6,65,37,0,37
17,201,6,67,28,0,28
17,201,6,71,0,39,-39
17,201,6,73,70,53,17
17,201,8,41,0,45,-45
17,201,8,69,0,29,-29
17,201,11,1,0,21,-21
17,201,12,21,0,42,-42
17,201,12,31,0,48,-48
17,201,12,57,0,34,-34
17,201,12,71,42,33,9
17,201,12,86,31,0,31
17,201,12,95,25,31,-6
17,201,12,99,0,23,-23
17,201,12,103,0,40,-40
17,201,12,105,0,29,-29
17,201,12,115,0,42,-42
17,201,13,121,0,46,-46
17,201,15,3,0,25,-25
17,201,17,7,1839,1436,403
17,201,17,15,23,0,23
17,201,17,19,51,62,-11
17,201,17,31,1965,1419,546
17,201,17,37,405,283,122
17,201,17,43,392,313,79
17,201,17,77,45,0,45
17,201,17,85,37,22,15
17,201,17,89,610,418,192
17,201,17,91,34,0,34
17,201,17,93,56,51,5
17,201,17,97,193,141,52
17,201,17,99,66,39,27
17,201,17,103,96,88,8
17,201,17,111,534,299,235
17,201,17,113,48,68,-20
17,201,17,119,0,32,-32
17,201,17,141,985,895,90
17,201,17,143,85,63,22
17,201,17,161,42,51,-9
17,201,17,167,32,65,-33
17,201,17,177,461,454,7
17,201,17,179,28,0,28
17,201,17,195,77,94,-17
17,201,17,197,163,94,69
17,201,18,89,0,33,-33
17,201,18,97,75,66,9
17,201,19,61,37,0,37
17,201,19,103,0,35,-35
17,201,19,113,37,34,3
17,201,19,153,0,55,-55
17,201,19,163,0,45,-45
17,201,21,111,0,38,-38
17,201,26,81,33,0,33
17,201,26,99,33,0,33
17,201,26,125,59,0,59
17,201,26,163,85,63,22
17,201,27,53,51,52,-1
17,201,27,123,0,28,-28
17,201,29,95,0,43,-43
17,201,29,183,0,48,-48
17,201,29,189,53,39,14
17,201,32,3,64,129,-65
17,201,35,1,32,0,32
17,201,36,67,61,0,61
17,201,37,51,37,0,37
17,201,39,35,30,0,30
17,201,39,49,0,34,-34
17,201,41,51,0,30,-30
17,201,47,37,33,32,1
17,201,47,93,0,35,-35
17,201,47,157,0,42,-42
17,201,48,27,0,37,-37
17,201,48,29,0,48,-48
17,201,48,113,0,58,-58
17,201,48,121,0,35,-35
17,201,48,201,36,69,-33
17,201,48,439,41,78,-37
17,201,53,33,41,47,-6
17,201,55,25,128,255,-127
17,201,55,45,0,44,-44
17,201,55,55,32,0,32
17,201,55,59,27,0,27
17,201,55,79,148,195,-47
17,201,55,87,0,27,-27
17,201,55,101,32,34,-2
17,201,55,105,881,839,42
17,201,55,127,56,92,-36
17,201,55,131,0,36,-36
17,201,55,133,66,94,-28
17,203,17,31,61,52,9
17,203,17,43,0,22,-22
17,203,17,99,66,41,25
17,203,17,105,93,27,66
17,203,17,113,265,388,-123
17,203,17,123,151,56,95
17,203,17,143,606,448,158
17,203,17,179,642,595,47
18,1,4,13,0,25,-25
18,1,18,3,330,360,-30
18,1,18,35,36,0,36
18,1,18,69,0,36,-36
18,1,18,75,132,119,13
18,1,18,97,28,63,-35
18,1,18,179,190,210,-20
18,1,39,107,46,46,0
18,1,39,161,99,67,32
18,3,4,13,133,258,-125
18,3,4,19,0,66,-66
18,3,6,37,98,116,-18
18,3,6,59,0,35,-35
18,3,6,65,35,31,4
18,3,6,71,52,46,6
18,3,6,73,67,94,-27
18,3,8,41,35,35,0
18,3,12,9,0,40,-40
18,3,12,11,28,58,-30
18,3,12,15,0,29,-29
18,3,12,21,0,35,-35
18,3,12,31,32,34,-2
18,3,12,57,51,72,-21
18,3,12,69,0,25,-25
18,3,12,71,52,87,-35
18,3,12,81,31,32,-1
18,3,12,95,31,50,-19
18,3,12,99,29,43,-14
18,3,12,103,74,62,12
18,3,12,105,34,45,-11
18,3,12,115,27,55,-28
18,3,12,127,0,36,-36
18,3,13,67,36,54,-18
18,3,13,89,0,26,-26
18,3,13,121,0,41,-41
18,3,13,135,0,42,-42
18,3,15,3,0,31,-31
18,3,17,31,370,402,-32
18,3,17,43,83,73,10
18,3,17,89,34,0,34
18,3,17,97,0,37,-37
18,3,17,197,37,40,-3
18,3,18,1,360,330,30
18,3,18,5,27,42,-15
18,3,18,9,33,0,33
18,3,18,11,30,0,30
18,3,18,17,35,61,-26
18,3,18,19,33,0,33
18,3,18,33,801,875,-74
18,3,18,35,205,161,44
18,3,18,39,191,210,-19
18,3,18,49,0,25,-25
18,3,18,53,181,141,40
18,3,18,57,193,411,-218
18,3,18,59,0,42,-42
18,3,18,63,76,121,-45
18,3,18,67,57,68,-11
18,3,18,69,634,529,105
18,3,18,75,34,27,7
18,3,18,81,73,81,-8
18,3,18,85,326,304,22
18,3,18,87,146,135,11
18,3,18,89,144,150,-6
18,3,18,91,30,57,-27
18,3,18,95,97,98,-1
18,3,18,97,560,1061,-501
18,3,18,99,28,23,5
18,3,18,103,57,57,0
18,3,18,105,93,132,-39
18,3,18,113,614,579,35
18,3,18,127,63,69,-6
18,3,18,141,259,260,-1
18,3,18,151,310,377,-67
18,3,18,157,99,159,-60
18,3,18,167,31,28,3
18,3,18,169,158,123,35
18,3,18,179,554,531,23
18,3,18,183,736,834,-98
18,3,21,67,0,66,-66
18,3,21,111,38,94,-56
18,3,25,17,0,25,-25
18,3,26,21,35,0,35
18,3,26,23,50,36,14
18,3,26,25,42,46,-4
18,3,26,49,51,0,51
18,3,26,65,52,38,14
18,3,26,75,31,0,31
18,3,26,77,50,33,17
18,3,26,81,81,53,28
18,3,26,91,31,0,31
18,3,26,99,55,30,25
18,3,26,125,88,96,-8
18,3,26,139,0,28,-28
18,3,26,161,0,51,-51
18,3,26,163,110,60,50
18,3,27,53,0,31,-31
18,3,29,189,39,48,-9
18,3,32,3,60,98,-38
18,3,35,1,0,30,-30
18,3,36,47,0,40,-40
18,3,36,61,0,26,-26
18,3,36,63,77,0,77
18,3,36,81,48,0,48
18,3,37,51,0,53,-53
18,3,37,81,0,30,-30
18,3,37,119,0,43,-43
18,3,37,133,0,28,-28
18,3,37,183,0,31,-31
18,3,39,3,107,43,64
18,3,39,17,0,32,-32
18,3,39,35,74,36,38
18,3,39,39,149,82,67
18,3,39,49,124,155,-31
18,3,39,57,0,28,-28
18,3,39,61,42,68,-26
18,3,39,95,108,47,61
18,3,39,107,29,0,29
18,3,39,113,90,51,39
18,3,39,125,137,93,44
18,3,39,153,61,26,35
18,3,39,161,97,59,38
18,3,39,165,0,26,-26
18,3,39,171,49,39,10
18,3,39,173,0,33,-33
18,3,40,143,0,26,-26
18,3,41,51,0,29,-29
18,3,42,3,33,22,11
18,3,42,101,0,23,-23
18,3,45,19,0,31,-31
18,3,45,45,0,39,-39
18,3,47,37,37,83,-46
18,3,47,93,0,58,-58
18,3,47,157,38,40,-2
18,3,48,27,0,31,-31
18,3,48,29,0,30,-30
18,3,48,85,40,0,40
18,3,48,113,35,65,-30
18,3,48,121,0,43,-43
18,3,48,201,59,102,-43
18,3,48,339,0,45,-45
18,3,48,439,58,41,17
18,3,48,453,0,27,-27
18,3,51,810,0,33,-33
18,3,53,33,0,62,-62
18,3,55,25,0,41,-41
18,3,55,79,24,41,-17
18,5,17,31,31,64,-33
18,5,17,143,46,0,46
18,5,18,3,42,27,15
18,5,18,13,211,190,21
18,5,18,19,0,48,-48
18,5,18,31,244,178,66
18,5,18,35,26,0,26
18,5,18,57,63,54,9
18,5,18,59,34,33,1
18,5,18,63,32,33,-1
18,5,18,71,536,408,128
18,5,18,77,40,0,40
18,5,18,79,458,394,64
18,5,18,81,583,665,-82
18,5,18,93,30,0,30
18,5,18,97,289,467,-178
18,5,18,105,99,110,-11
18,5,18,109,0,49,-49
18,5,18,137,46,32,14
18,5,18,143,34,35,-1
18,5,18,145,119,145,-26
18,5,18,157,78,42,36
18,5,18,163,28,0,28
18,5,18,167,36,0,36
18,5,21,67,23,0,23
18,5,21,111,22,47,-25
18,5,26,125,40,39,1
18,5,26,161,23,0,23
18,5,26,163,29,0,29
18,5,36,13,32,0,32
18,5,39,49,40,0,40
18,5,39,61,21,0,21
18,7,18,73,34,0,34
18,7,18,89,31,0,31
18,7,18,111,85,63,22
18,7,18,157,335,352,-17
18,7,18,171,37,83,-46
18,7,18,181,37,54,-17
18,9,18,3,0,33,-33
18,9,18,35,181,221,-40
18,9,18,53,144,135,9
18,9,18,75,89,60,29
18,9,18,97,31,40,-9
18,9,18,135,0,33,-33
18,9,18,179,91,96,-5
18,11,12,71,0,27,-27
18,11,17,31,55,61,-6
18,11,18,3,0,30,-30
18,11,18,23,170,184,-14
18,11,18,57,521,552,-31
18,11,18,59,0,27,-27
18,11,18,63,352,305,47
18,11,18,67,36,0,36
18,11,18,81,68,71,-3
18,11,18,89,37,0,37
18,11,18,95,32,38,-6
18,11,18,97,1498,947,551
18,11,18,105,30,45,-15
18,11,18,107,136,166,-30
18,11,18,109,49,47,2
18,11,18,133,39,49,-10
18,11,18,157,196,133,63
18,11,18,167,26,0,26
18,13,18,5,190,211,-21
18,13,18,71,0,26,-26
18,13,18,81,218,265,-47
18,13,18,97,186,168,18
18,13,18,105,225,299,-74
18,13,18,109,83,87,-4
18,13,18,119,0,29,-29
18,15,18,17,128,89,39
18,15,18,23,127,158,-31
18,15,18,67,127,83,44
18,15,18,97,0,46,-46
18,15,18,157,455,489,-34
18,15,18,181,158,176,-18
18,17,6,37,0,29,-29
18,17,17,31,0,33,-33
18,17,18,3,61,35,26
18,17,18,15,89,128,-39
18,17,18,23,0,50,-50
18,17,18,49,100,93,7
18,17,18,57,0,78,-78
18,17,18,67,331,317,14
18,17,18,97,64,102,-38
18,17,18,103,367,225,142
18,17,18,131,86,0,86
18,17,18,157,114,146,-32
18,17,18,181,107,126,-19
18,19,4,13,0,34,-34
18,19,6,37,42,0,42
18,19,12,71,26,0,26
18,19,17,31,42,34,8
18,19,18,3,0,33,-33
18,19,18,5,48,0,48
18,19,18,25,37,50,-13
18,19,18,43,2750,2480,270
18,19,18,61,462,391,71
18,19,18,71,28,31,-3
18,19,18,77,82,93,-11
18,19,18,81,0,33,-33
18,19,18,97,69,158,-89
18,19,18,105,24,0,24
18,19,18,143,349,304,45
18,19,18,157,34,0,34
18,19,18,163,37,41,-4
18,19,18,175,406,334,72
18,19,21,29,88,96,-8
18,19,21,67,38,35,3
18,19,21,93,67,35,32
18,19,21,111,2447,1858,589
18,19,21,179,32,38,-6
18,19,21,185,40,67,-27
18,19,21,211,58,44,14
18,19,32,3,25,0,25
18,21,18,55,77,52,25
18,21,18,63,49,55,-6
18,21,18,83,0,28,-28
18,21,18,97,102,75,27
18,21,18,105,28,35,-7
18,21,18,119,136,73,63
18,21,18,121,86,81,5
18,21,18,133,192,150,42
18,21,18,153,44,45,-1
18,21,18,167,603,632,-29
18,23,18,11,184,170,14
18,23,18,15,158,127,31
18,23,18,17,50,0,50
18,23,18,57,104,59,45
18,23,18,67,123,143,-20
18,23,18,95,30,0,30
18,23,18,97,129,187,-58
18,23,18,105,0,33,-33
18,23,18,107,48,43,5
18,23,18,157,793,830,-37
18,23,18,181,40,45,-5
18,25,18,19,50,37,13
18,25,18,37,52,71,-19
18,25,18,43,48,64,-16
18,25,18,61,171,272,-101
18,25,18,117,73,71,2
18,25,18,175,34,32,2
18,25,21,111,40,44,-4
18,27,18,37,94,91,3
18,27,18,51,41,33,8
18,27,18,55,58,76,-18
18,27,18,83,143,144,-1
18,27,18,93,43,0,43
18,27,18,97,35,46,-11
18,27,18,101,97,105,-8
18,27,18,105,30,47,-17
18,27,18,125,77,97,-20
18,27,18,163,45,85,-40
18,27,18,167,41,0,41
18,29,18,47,138,186,-48
18,29,18,97,40,49,-9
18,29,18,115,208,241,-33
18,29,18,137,440,461,-21
18,29,18,155,96,106,-10
18,29,21,15,130,177,-47
18,29,21,37,29,34,-5
18,29,21,117,104,152,-48
18,29,39,17,161,131,30
18,29,39,25,51,41,10
18,29,39,61,1421,913,508
18,29,39,165,39,34,5
18,31,18,5,178,244,-66
18,31,18,41,26,49,-23
18,31,18,47,129,105,24
18,31,18,57,0,24,-24
18,31,18,71,0,29,-29
18,31,18,79,85,70,15
18,31,18,81,0,41,-41
18,31,18,97,95,114,-19
18,31,18,137,198,179,19
18,31,18,139,97,150,-53
18,31,18,145,213,202,11
18,31,39,61,0,40,-40
18,33,18,3,875,801,74
18,33,18,35,0,32,-32
18,33,18,39,0,28,-28
18,33,18,87,97,88,9
18,33,18,97,0,45,-45
18,33,18,113,460,427,33
18,33,18,151,456,444,12
18,33,18,183,27,63,-36
18,33,39,39,30,32,-2
18,33,39,171,57,81,-24
18,35,4,13,0,41,-41
18,35,6,37,0,40,-40
18,35,6,73,26,0,26
18,35,11,1,0,28,-28
18,35,12,57,0,31,-31
18,35,12,71,27,0,27
18,35,12,103,30,30,0
18,35,17,31,51,61,-10
18,35,18,1,0,36,-36
18,35,18,3,161,205,-44
18,35,18,5,0,26,-26
18,35,18,9,221,181,40
18,35,18,33,32,0,32
18,35,18,39,42,0,42
18,35,18,53,192,188,4
18,35,18,57,173,469,-296
18,35,18,59,42,84,-42
18,35,18,63,35,37,-2
18,35,18,65,261,361,-100
18,35,18,67,71,46,25
18,35,18,75,228,131,97
18,35,18,81,76,67,9
18,35,18,85,43,47,-4
18,35,18,89,48,67,-19
18,35,18,95,765,846,-81
18,35,18,97,386,737,-351
18,35,18,105,82,96,-14
18,35,18,127,29,0,29
18,35,18,135,383,382,1
18,35,18,141,61,50,11
18,35,18,157,62,112,-50
18,35,18,177,97,79,18
18,35,21,111,0,24,-24
18,35,39,49,0,37,-37
18,35,39,61,0,38,-38
18,35,47,37,0,31,-31
18,37,18,25,71,52,19
18,37,18,27,91,94,-3
18,37,18,43,0,36,-36
18,37,18,51,73,54,19
18,37,18,57,0,43,-43
18,37,18,83,0,28,-28
18,37,18,97,54,62,-8
18,37,18,101,90,84,6
18,37,18,105,33,32,1
18,37,18,117,103,74,29
18,37,18,123,79,55,24
18,37,18,125,186,173,13
18,37,18,147,222,243,-21
18,37,18,163,185,171,14
18,37,18,173,59,68,-9
18,37,21,111,0,27,-27
18,39,4,13,53,99,-46
18,39,6,37,71,64,7
18,39,6,71,0,48,-48
18,39,6,73,29,0,29
18,39,8,31,0,32,-32
18,39,12,57,0,38,-38
18,39,12,71,36,52,-16
18,39,12,115,40,32,8
18,39,17,31,303,307,-4
18,39,17,89,0,27,-27
18,39,17,197,37,0,37
18,39,18,3,210,191,19
18,39,18,33,28,0,28
18,39,18,35,0,42,-42
18,39,18,49,0,52,-52
18,39,18,57,42,89,-47
18,39,18,67,41,0,41
18,39,18,69,30,0,30
18,39,18,85,644,707,-63
18,39,18,87,429,432,-3
18,39,18,89,58,46,12
18,39,18,91,55,73,-18
18,39,18,97,155,307,-152
18,39,18,99,225,249,-24
18,39,18,105,29,58,-29
18,39,18,113,243,200,43
18,39,18,127,38,54,-16
18,39,18,141,2338,2321,17
18,39,18,149,36,0,36
18,39,18,151,49,51,-2
18,39,18,157,60,85,-25
18,39,18,163,24,0,24
18,39,18,169,39,0,39
18,39,18,183,28,37,-9
18,39,26,21,160,144,16
18,39,26,27,671,781,-110
18,39,26,77,43,65,-22
18,39,26,81,49,50,-1
18,39,26,149,312,273,39
18,39,26,163,59,30,29
18,39,27,53,0,33,-33
18,39,32,3,0,44,-44
18,39,39,95,0,36,-36
18,39,47,37,0,33,-33
18,39,48,113,0,58,-58
18,39,48,121,0,27,-27
18,39,48,201,0,50,-50
18,39,48,215,0,73,-73
18,39,48,453,0,24,-24
18,41,18,31,49,26,23
18,41,18,47,157,151,6
18,41,18,57,0,24,-24
18,41,18,59,0,33,-33
18,41,18,65,59,29,30
18,41,18,97,56,82,-26
18,41,18,139,138,124,14
18,41,18,145,51,77,-26
18,41,18,161,145,102,43
18,41,18,177,281,273,8
18,41,39,17,0,29,-29
18,43,17,31,0,30,-30
18,43,18,19,2480,2750,-270
18,43,18,25,64,48,16
18,43,18,37,36,0,36
18,43,18,61,719,651,68
18,43,18,77,0,30,-30
18,43,18,97,43,76,-33
18,43,18,105,0,26,-26
18,43,18,117,0,34,-34
18,43,18,143,92,60,32
18,43,18,163,25,27,-2
18,43,18,175,201,239,-38
18,43,21,29,102,41,61
18,43,21,67,31,0,31
18,43,21,93,49,29,20
18,43,21,111,1411,1110,301
18,43,21,185,32,0,32
18,45,17,183,190,111,79
18,45,18,97,36,50,-14
18,45,18,107,167,158,9
18,45,18,121,0,77,-77
18,45,18,157,193,183,10
18,45,18,165,97,73,24
18,45,18,167,35,0,35
18,45,18,171,161,176,-15
18,47,18,29,186,138,48
18,47,18,31,105,129,-24
18,47,18,41,151,157,-6
18,47,18,97,33,58,-25
18,47,18,137,186,210,-24
18,47,18,139,62,29,33
18,47,18,161,39,56,-17
18,47,18,177,48,36,12
18,47,39,17,125,107,18
18,47,39,61,195,187,8
18,47,39,165,0,32,-32
18,49,18,3,25,0,25
18,49,18,17,93,100,-7
18,49,18,39,52,0,52
18,49,18,57,0,26,-26
18,49,18,67,36,56,-20
18,49,18,85,169,201,-32
18,49,18,89,25,0,25
18,49,18,97,33,52,-19
18,49,18,99,172,171,1
18,49,18,103,64,134,-70
18,49,18,131,90,66,24
18,49,18,141,39,44,-5
18,49,18,149,74,45,29
18,49,18,169,37,51,-14
18,51,17,185,79,54,25
18,51,18,27,33,41,-8
18,51,18,37,54,73,-19
18,51,18,83,54,79,-25
18,51,18,97,56,48,8
18,51,18,125,110,161,-51
18,51,18,129,90,54,36
18,51,18,157,0,32,-32
18,51,18,163,536,621,-85
18,51,18,173,119,132,-13
18,51,21,101,0,28,-28
18,53,4,13,0,36,-36
18,53,17,31,0,44,-44
18,53,18,3,141,181,-40
18,53,18,9,135,144,-9
18,53,18,35,188,192,-4
18,53,18,57,99,126,-27
18,53,18,59,0,25,-25
18,53,18,65,32,0,32
18,53,18,67,119,199,-80
18,53,18,69,117,149,-32
18,53,18,85,37,58,-21
18,53,18,95,205,212,-7
18,53,18,97,178,208,-30
18,53,18,103,184,115,69
18,53,18,105,0,46,-46
18,53,18,157,0,30,-30
18,53,18,169,193,124,69
18,53,18,179,0,47,-47
18,55,18,21,52,77,-25
18,55,18,27,76,58,18
18,55,18,83,70,58,12
18,55,18,93,105,135,-30
18,55,18,97,113,100,13
18,55,18,101,29,0,29
18,55,18,105,651,718,-67
18,55,18,109,36,43,-7
18,55,18,119,80,91,-11
18,55,18,153,176,175,1
18,55,18,163,0,30,-30
18,55,18,167,87,117,-30
18,57,4,13,235,184,51
18,57,4,19,49,42,7
18,57,6,1,32,0,32
18,57,6,37,226,107,119
18,57,6,59,90,41,49
18,57,6,65,41,35,6
18,57,6,67,50,0,50
18,57,6,73,95,103,-8
18,57,6,75,0,21,-21
18,57,6,77,37,0,37
18,57,8,5,56,0,56
18,57,8,31,0,33,-33
18,57,8,41,35,44,-9
18,57,9,3,39,0,39
18,57,11,1,0,23,-23
18,57,12,11,60,34,26
18,57,12,21,35,51,-16
18,57,12,31,38,0,38
18,57,12,57,75,72,3
18,57,12,71,56,96,-40
18,57,12,81,36,0,36
18,57,12,86,31,49,-18
18,57,12,95,52,83,-31
18,57,12,99,45,49,-4
18,57,12,101,43,0,43
18,57,12,103,96,73,23
18,57,12,115,33,31,2
18,57,12,117,53,52,1
18,57,13,67,0,65,-65
18,57,13,89,0,35,-35
18,57,13,121,44,51,-7
18,57,13,135,37,0,37
18,57,17,19,52,46,6
18,57,17,31,421,432,-11
18,57,17,43,149,120,29
18,57,17,89,72,60,12
18,57,17,91,29,0,29
18,57,17,97,117,119,-2
18,57,17,113,37,0,37
18,57,17,143,38,0,38
18,57,17,197,104,74,30
18,57,18,3,411,193,218
18,57,18,5,54,63,-9
18,57,18,11,552,521,31
18,57,18,17,78,0,78
18,57,18,23,59,104,-45
18,57,18,31,24,0,24
18,57,18,35,469,173,296
18,57,18,37,43,0,43
18,57,18,39,89,42,47
18,57,18,41,24,0,24
18,57,18,49,26,0,26
18,57,18,53,126,99,27
18,57,18,59,548,547,1
18,57,18,63,482,443,39
18,57,18,65,108,60,48
18,57,18,67,433,183,250
18,57,18,69,33,0,33
18,57,18,71,42,0,42
18,57,18,81,379,289,90
18,57,18,83,33,0,33
18,57,18,85,44,48,-4
18,57,18,89,210,89,121
18,57,18,91,61,0,61
18,57,18,95,1034,1055,-21
18,57,18,97,10583,6285,4298
18,57,18,99,43,0,43
18,57,18,103,83,38,45
18,57,18,105,259,181,78
18,57,18,107,52,37,15
18,57,18,109,93,117,-24
18,57,18,127,115,59,56
18,57,18,133,49,30,19
18,57,18,141,233,100,133
18,57,18,145,45,58,-13
18,57,18,157,373,203,170
18,57,18,159,214,213,1
18,57,18,163,140,79,61
18,57,18,167,113,45,68
18,57,18,169,33,0,33
18,57,18,173,53,0,53
18,57,18,177,64,0,64
18,57,20,91,60,55,5
18,57,21,15,32,0,32
18,57,21,67,39,40,-1
18,57,21,111,101,104,-3
18,57,24,31,33,0,33
18,57,26,49,42,0,42
18,57,26,65,52,0,52
18,57,26,77,43,0,43
18,57,26,81,87,47,40
18,57,26,99,43,0,43
18,57,26,125,127,114,13
18,57,26,161,60,23,37
18,57,26,163,139,44,95
18,57,27,53,72,64,8
18,57,29,183,30,0,30
18,57,29,189,89,78,11
18,57,31,55,50,47,3
18,57,32,3,83,80,3
18,57,34,23,34,0,34
18,57,35,1,44,0,44
18,57,36,29,27,0,27
18,57,36,55,34,0,34
18,57,36,61,39,40,-1
18,57,37,119,93,77,16
18,57,37,183,63,92,-29
18,57,39,17,105,44,61
18,57,39,25,44,0,44
18,57,39,35,60,72,-12
18,57,39,41,74,0,74
18,57,39,49,170,121,49
18,57,39,61,91,93,-2
18,57,39,113,60,46,14
18,57,39,165,94,71,23
18,57,40,109,0,27,-27
18,57,42,3,40,0,40
18,57,45,91,0,62,-62
18,57,47,37,66,24,42
18,57,47,93,0,29,-29
18,57,47,157,38,31,7
18,57,47,165,0,35,-35
18,57,47,187,0,32,-32
18,57,48,29,31,45,-14
18,57,48,85,111,64,47
18,57,48,113,52,41,11
18,57,48,121,0,45,-45
18,57,48,201,44,84,-40
18,57,48,439,35,97,-62
18,57,48,453,0,36,-36
18,57,51,59,92,36,56
18,57,51,107,44,0,44
18,57,51,153,58,0,58
18,57,53,33,64,36,28
18,57,55,25,65,53,12
18,57,55,79,43,24,19
18,57,55,133,47,0,47
18,59,12,103,29,0,29
18,59,17,31,31,20,11
18,59,18,3,42,0,42
18,59,18,5,33,34,-1
18,59,18,11,27,0,27
18,59,18,35,84,42,42
18,59,18,41,33,0,33
18,59,18,53,25,0,25
18,59,18,57,547,548,-1
18,59,18,63,147,123,24
18,59,18,65,341,330,11
18,59,18,81,139,204,-65
18,59,18,95,354,379,-25
18,59,18,97,2722,1942,780
18,59,18,105,22,38,-16
18,59,18,109,0,43,-43
18,59,18,139,101,122,-21
18,59,18,145,264,286,-22
18,59,18,157,41,31,10
18,59,18,167,39,0,39
18,59,18,177,53,31,22
18,59,39,49,38,0,38
18,61,18,19,391,462,-71
18,61,18,25,272,171,101
18,61,18,43,651,719,-68
18,61,18,97,0,28,-28
18,61,18,175,141,107,34
18,61,21,29,0,37,-37
18,61,21,111,308,288,20
18,61,21,163,46,38,8
18,63,4,13,59,69,-10
18,63,6,37,72,0,72
18,63,6,65,24,0,24
18,63,6,73,53,34,19
18,63,12,57,0,26,-26
18,63,12,71,53,37,16
18,63,12,103,41,42,-1
18,63,17,19,37,0,37
18,63,17,31,113,102,11
18,63,17,43,56,0,56
18,63,17,183,35,33,2
18,63,17,197,23,0,23
18,63,18,3,121,76,45
18,63,18,5,33,32,1
18,63,18,11,305,352,-47
18,63,18,21,55,49,6
18,63,18,35,37,35,2
18,63,18,57,443,482,-39
18,63,18,59,123,147,-24
18,63,18,65,39,0,39
18,63,18,67,60,34,26
18,63,18,81,294,342,-48
18,63,18,89,86,0,86
18,63,18,91,34,0,34
18,63,18,93,23,0,23
18,63,18,95,74,40,34
18,63,18,97,6839,4593,2246
18,63,18,105,86,76,10
18,63,18,107,137,108,29
18,63,18,109,574,806,-232
18,63,18,119,59,45,14
18,63,18,121,34,30,4
18,63,18,127,37,26,11
18,63,18,133,418,592,-174
18,63,18,141,49,22,27
18,63,18,145,51,0,51
18,63,18,157,186,98,88
18,63,18,163,48,0,48
18,63,18,167,215,64,151
18,63,18,177,41,32,9
18,63,21,111,0,48,-48
18,63,26,163,40,0,40
18,63,32,3,43,0,43
18,63,37,119,0,40,-40
18,63,39,49,38,40,-2
18,63,39,61,52,22,30
18,63,39,113,38,0,38
18,63,48,439,0,56,-56
18,65,18,35,361,261,100
18,65,18,41,29,59,-30
18,65,18,53,0,32,-32
18,65,18,57,60,108,-48
18,65,18,59,330,341,-11
18,65,18,63,0,39,-39
18,65,18,81,0,26,-26
18,65,18,95,367,411,-44
18,65,18,97,276,268,8
18,65,18,105,0,38,-38
18,65,18,135,55,64,-9
18,65,18,139,147,82,65
18,65,18,145,42,30,12
18,65,18,177,253,129,124
18,67,17,31,31,37,-6
18,67,18,3,68,57,11
18,67,18,11,0,36,-36
18,67,18,15,83,127,-44
18,67,18,17,317,331,-14
18,67,18,23,143,123,20
18,67,18,35,46,71,-25
18,67,18,39,0,41,-41
18,67,18,49,56,36,20
18,67,18,53,199,119,80
18,67,18,57,183,433,-250
18,67,18,63,34,60,-26
18,67,18,69,36,0,36
18,67,18,81,0,29,-29
18,67,18,85,53,0,53
18,67,18,95,100,104,-4
18,67,18,97,303,418,-115
18,67,18,103,634,505,129
18,67,18,105,29,0,29
18,67,18,141,39,31,8
18,67,18,157,114,245,-131
18,67,18,159,355,333,22
18,67,18,169,30,29,1
18,67,55,79,46,0,46
18,69,18,1,36,0,36
18,69,18,3,529,634,-105
18,69,18,39,0,30,-30
18,69,18,53,149,117,32
18,69,18,57,0,33,-33
18,69,18,67,0,36,-36
18,69,18,85,59,37,22
18,69,18,95,35,0,35
18,69,18,97,36,71,-35
18,69,18,113,37,33,4
18,69,18,169,155,157,-2
18,69,18,179,150,175,-25
18,69,18,183,98,86,12
18,71,17,43,0,210,-210
18,71,18,5,408,536,-128
18,71,18,13,26,0,26
18,71,18,19,31,28,3
18,71,18,31,29,0,29
18,71,18,57,0,42,-42
18,71,18,77,44,41,3
18,71,18,79,402,412,-10
18,71,18,81,37,86,-49
18,71,18,93,95,75,20
18,71,18,97,103,136,-33
18,71,18,105,25,32,-7
18,71,18,143,295,276,19
18,71,18,175,90,95,-5
18,71,21,111,36,29,7
18,73,17,31,107,78,29
18,73,17,197,32,0,32
18,73,18,7,0,34,-34
18,73,18,89,723,308,415
18,73,18,91,25,30,-5
18,73,18,97,31,65,-34
18,73,18,111,229,244,-15
18,73,18,127,329,266,63
18,73,18,131,99,87,12
18,73,18,149,53,0,53
18,73,18,157,79,201,-122
18,73,18,181,85,149,-64
18,75,18,1,119,132,-13
18,75,18,3,27,34,-7
18,75,18,9,60,89,-29
18,75,18,35,131,228,-97
18,75,18,97,29,33,-4
18,75,18,135,130,108,22
18,75,18,179,46,45,1
18,75,39,107,36,34,2
18,77,18,5,0,40,-40
18,77,18,19,93,82,11
18,77,18,43,30,0,30
18,77,18,71,41,44,-3
18,77,18,79,157,146,11
18,77,18,81,50,36,14
18,77,18,97,50,53,-3
18,77,18,137,72,48,24
18,77,18,143,191,185,6
18,77,18,155,152,74,78
18,77,21,41,49,87,-38
18,77,21,111,42,56,-14
18,77,21,223,149,132,17
18,79,18,5,394,458,-64
18,79,18,31,70,85,-15
18,79,18,71,412,402,10
18,79,18,77,146,157,-11
18,79,18,81,71,41,30
18,79,18,97,71,133,-62
18,79,18,105,0,28,-28
18,79,18,137,63,51,12
18,79,18,143,66,70,-4
18,81,4,13,72,59,13
18,81,6,29,33,0,33
18,81,6,37,60,29,31
18,81,6,73,31,0,31
18,81,12,71,0,43,-43
18,81,12,103,29,41,-12
18,81,17,31,82,51,31
18,81,17,43,41,0,41
18,81,18,3,81,73,8
18,81,18,5,665,583,82
18,81,18,11,71,68,3
18,81,18,13,265,218,47
18,81,18,19,33,0,33
18,81,18,31,41,0,41
18,81,18,35,67,76,-9
18,81,18,57,289,379,-90
18,81,18,59,204,139,65
18,81,18,63,342,294,48
18,81,18,65,26,0,26
18,81,18,67,29,0,29
18,81,18,71,86,37,49
18,81,18,77,36,50,-14
18,81,18,79,41,71,-30
18,81,18,89,58,57,1
18,81,18,93,50,0,50
18,81,18,95,75,75,0
18,81,18,97,7470,5516,1954
18,81,18,103,33,0,33
18,81,18,105,251,170,81
18,81,18,109,635,678,-43
18,81,18,119,0,34,-34
18,81,18,133,46,43,3
18,81,18,139,26,0,26
18,81,18,141,60,43,17
18,81,18,145,397,330,67
18,81,18,157,77,41,36
18,81,18,163,56,49,7
18,81,18,167,74,51,23
18,81,18,177,43,0,43
18,81,21,111,50,43,7
18,81,26,125,32,0,32
18,81,26,163,30,0,30
18,81,37,183,0,37,-37
18,81,39,49,37,36,1
18,81,39,61,32,0,32
18,81,48,201,35,31,4
18,83,17,101,202,151,51
18,83,17,159,41,0,41
18,83,18,21,28,0,28
18,83,18,27,144,143,1
18,83,18,37,28,0,28
18,83,18,51,79,54,25
18,83,18,55,58,70,-12
18,83,18,57,0,33,-33
18,83,18,97,74,112,-38
18,83,18,101,29,0,29
18,83,18,105,27,55,-28
18,83,18,125,49,50,-1
18,83,18,153,79,93,-14
18,83,18,163,109,135,-26
18,83,18,167,49,45,4
18,83,18,173,0,39,-39
18,85,4,13,0,34,-34
18,85,12,21,0,35,-35
18,85,12,71,26,33,-7
18,85,17,31,79,64,15
18,85,18,3,304,326,-22
18,85,18,35,47,43,4
18,85,18,39,707,644,63
18,85,18,49,201,169,32
18,85,18,53,58,37,21
18,85,18,57,48,44,4
18,85,18,67,0,53,-53
18,85,18,69,37,59,-22
18,85,18,87,31,0,31
18,85,18,89,76,0,76
18,85,18,95,77,26,51
18,85,18,97,91,134,-43
18,85,18,99,246,226,20
18,85,18,103,43,38,5
18,85,18,105,0,41,-41
18,85,18,113,213,221,-8
18,85,18,127,36,0,36
18,85,18,141,103,143,-40
18,85,18,149,0,35,-35
18,85,18,157,0,24,-24
18,85,18,169,218,240,-22
18,85,18,183,311,261,50
18,87,18,3,135,146,-11
18,87,18,33,88,97,-9
18,87,18,39,432,429,3
18,87,18,85,0,31,-31
18,87,18,97,0,27,-27
18,87,18,113,393,433,-40
18,87,18,151,196,248,-52
18,87,26,23,43,54,-11
18,87,26,149,218,311,-93
18,89,1,89,32,0,32
18,89,2,20,0,37,-37
18,89,4,13,192,361,-169
18,89,4,19,32,34,-2
18,89,4,21,0,43,-43
18,89,6,37,99,142,-43
18,89,6,59,0,30,-30
18,89,6,65,37,37,0
18,89,6,71,50,35,15
18,89,6,73,80,80,0
18,89,8,5,0,45,-45
18,89,8,31,0,25,-25
18,89,8,41,32,30,2
18,89,12,11,56,0,56
18,89,12,21,0,35,-35
18,89,12,31,43,54,-11
18,89,12,57,37,66,-29
18,89,12,69,0,36,-36
18,89,12,71,49,78,-29
18,89,12,81,0,28,-28
18,89,12,86,0,28,-28
18,89,12,95,55,56,-1
18,89,12,97,0,34,-34
18,89,12,99,26,62,-36
18,89,12,101,0,30,-30
18,89,12,103,41,71,-30
18,89,12,105,0,58,-58
18,89,12,127,0,30,-30
18,89,13,67,26,86,-60
18,89,13,89,32,62,-30
18,89,13,121,43,83,-40
18,89,13,135,41,47,-6
18,89,17,19,30,0,30
18,89,17,31,12633,6322,6311
18,89,17,43,356,304,52
18,89,17,89,72,92,-20
18,89,17,91,126,105,21
18,89,17,93,0,54,-54
18,89,17,97,104,92,12
18,89,17,113,0,24,-24
18,89,17,197,1135,600,535
18,89,17,201,33,0,33
18,89,18,3,150,144,6
18,89,18,7,0,31,-31
18,89,18,11,0,37,-37
18,89,18,35,67,48,19
18,89,18,39,46,58,-12
18,89,18,49,0,25,-25
18,89,18,57,89,210,-121
18,89,18,63,0,86,-86
18,89,18,73,308,723,-415
18,89,18,81,57,58,-1
18,89,18,85,0,76,-76
18,89,18,91,361,577,-216
18,89,18,95,38,0,38
18,89,18,97,714,1533,-819
18,89,18,105,119,107,12
18,89,18,111,217,274,-57
18,89,18,127,3318,5582,-2264
18,89,18,131,0,44,-44
18,89,18,141,169,200,-31
18,89,18,149,70,162,-92
18,89,18,157,232,370,-138
18,89,18,163,39,46,-7
18,89,18,167,60,62,-2
18,89,18,181,0,57,-57
18,89,21,111,43,28,15
18,89,26,21,0,43,-43
18,89,26,77,0,35,-35
18,89,26,81,71,90,-19
18,89,26,99,63,0,63
18,89,26,125,41,40,1
18,89,26,161,37,0,37
18,89,26,163,109,91,18
18,89,27,37,43,0,43
18,89,27,53,87,121,-34
18,89,27,123,36,52,-16
18,89,29,189,44,67,-23
18,89,32,3,145,273,-128
18,89,36,47,0,28,-28
18,89,36,61,28,33,-5
18,89,37,51,0,26,-26
18,89,37,119,35,31,4
18,89,37,133,25,0,25
18,89,37,183,0,26,-26
18,89,39,17,0,28,-28
18,89,39,35,34,37,-3
18,89,39,49,82,64,18
18,89,39,61,25,32,-7
18,89,40,143,0,31,-31
18,89,42,3,0,37,-37
18,89,47,37,38,50,-12
18,89,47,157,75,66,9
18,89,48,27,34,54,-20
18,89,48,29,0,93,-93
18,89,48,113,55,76,-21
18,89,48,201,68,131,-63
18,89,48,439,33,111,-78
18,89,48,453,0,38,-38
18,89,51,700,0,28,-28
18,89,51,810,34,0,34
18,89,53,33,0,28,-28
18,89,53,53,0,32,-32
18,89,55,25,38,55,-17
18,89,55,79,74,152,-78
18,89,55,133,0,28,-28
18,91,4,13,30,58,-28
18,91,6,37,0,21,-21
18,91,6,73,39,0,39
18,91,12,71,0,27,-27
18,91,12,95,32,0,32
18,91,17,31,364,280,84
18,91,17,43,33,34,-1
18,91,17,197,46,31,15
18,91,18,3,57,30,27
18,91,18,39,73,55,18
18,91,18,57,0,61,-61
18,91,18,63,0,34,-34
18,91,18,73,30,25,5
18,91,18,89,577,361,216
18,91,18,97,147,245,-98
18,91,18,99,57,42,15
18,91,18,105,25,23,2
18,91,18,127,1384,845,539
18,91,18,141,442,574,-132
18,91,18,149,147,154,-7
18,91,18,157,54,66,-12
18,91,26,21,219,235,-16
18,91,26,163,47,0,47
18,91,32,3,0,31,-31
18,91,55,79,24,28,-4
18,93,18,5,0,30,-30
18,93,18,27,0,43,-43
18,93,18,55,135,105,30
18,93,18,63,0,23,-23
18,93,18,71,75,95,-20
18,93,18,81,0,50,-50
18,93,18,97,92,78,14
18,93,18,101,60,46,14
18,93,18,105,668,654,14
18,93,18,109,31,24,7
18,93,18,117,272,228,44
18,93,18,119,34,36,-2
18,93,18,163,0,25,-25
18,93,18,167,0,36,-36
18,93,18,175,70,67,3
18,95,4,13,49,53,-4
18,95,12,57,34,30,4
18,95,12,71,0,32,-32
18,95,12,103,31,32,-1
18,95,12,105,29,0,29
18,95,17,31,41,33,8
18,95,18,3,98,97,1
18,95,18,11,38,32,6
18,95,18,23,0,30,-30
18,95,18,35,846,765,81
18,95,18,53,212,205,7
18,95,18,57,1055,1034,21
18,95,18,59,379,354,25
18,95,18,63,40,74,-34
18,95,18,65,411,367,44
18,95,18,67,104,100,4
18,95,18,69,0,35,-35
18,95,18,81,75,75,0
18,95,18,85,26,77,-51
18,95,18,89,0,38,-38
18,95,18,97,1116,1032,84
18,95,18,103,0,36,-36
18,95,18,105,29,35,-6
18,95,18,109,0,32,-32
18,95,18,127,0,28,-28
18,95,18,135,52,29,23
18,95,18,145,0,42,-42
18,95,18,157,56,71,-15
18,95,18,159,128,146,-18
18,95,18,177,23,27,-4
18,95,39,17,0,35,-35
18,95,39,113,0,35,-35
18,97,1,73,43,62,-19
18,97,1,89,0,63,-63
18,97,1,101,0,30,-30
18,97,2,20,29,40,-11
18,97,4,13,252,430,-178
18,97,4,19,74,109,-35
18,97,5,119,54,34,20
18,97,6,1,53,91,-38
18,97,6,13,0,42,-42
18,97,6,29,36,0,36
18,97,6,37,555,415,140
18,97,6,53,0,37,-37
18,97,6,59,105,129,-24
18,97,6,65,137,64,73
18,97,6,67,63,65,-2
18,97,6,71,155,107,48
18,97,6,73,220,253,-33
18,97,6,75,36,44,-8
18,97,6,81,0,41,-41
18,97,6,85,52,101,-49
18,97,6,111,39,39,0
18,97,8,1,0,41,-41
18,97,8,5,88,58,30
18,97,8,13,27,36,-9
18,97,8,31,91,100,-9
18,97,8,35,0,34,-34
18,97,8,41,87,79,8
18,97,8,59,31,36,-5
18,97,9,3,36,41,-5
18,97,9,9,31,0,31
18,97,10,3,38,0,38
18,97,11,1,67,93,-26
18,97,12,1,25,52,-27
18,97,12,5,38,0,38
18,97,12,9,29,53,-24
18,97,12,11,181,112,69
18,97,12,15,56,49,7
18,97,12,21,56,81,-25
18,97,12,31,122,145,-23
18,97,12,33,34,35,-1
18,97,12,57,131,199,-68
18,97,12,69,34,38,-4
18,97,12,71,140,182,-42
18,97,12,73,35,25,10
18,97,12,81,31,51,-20
18,97,12,83,32,44,-12
18,97,12,86,155,131,24
18,97,12,91,38,46,-8
18,97,12,95,140,161,-21
18,97,12,99,106,106,0
18,97,12,101,68,73,-5
18,97,12,103,160,180,-20
18,97,12,105,55,89,-34
18,97,12,111,0,34,-34
18,97,12,115,80,123,-43
18,97,12,117,50,54,-4
18,97,12,127,57,67,-10
18,97,13,51,0,43,-43
18,97,13,63,42,46,-4
18,97,13,67,116,134,-18
18,97,13,89,133,149,-16
18,97,13,121,132,184,-52
18,97,13,135,83,126,-43
18,97,13,215,38,39,-1
18,97,13,245,0,24,-24
18,97,15,3,88,67,21
18,97,17,19,124,62,62
18,97,17,23,21,0,21
18,97,17,29,0,26,-26
18,97,17,31,1362,1392,-30
18,97,17,43,176,222,-46
18,97,17,49,24,0,24
18,97,17,89,58,62,-4
18,97,17,91,61,0,61
18,97,17,97,141,69,72
18,97,17,111,42,0,42
18,97,17,113,60,48,12
18,97,17,115,88,78,10
18,97,17,119,26,44,-18
18,97,17,143,67,53,14
18,97,17,161,39,0,39
18,97,17,163,80,46,34
18,97,17,167,47,29,18
18,97,17,183,111,56,55
18,97,17,197,109,57,52
18,97,17,201,66,75,-9
18,97,18,1,63,28,35
18,97,18,3,1061,560,501
18,97,18,5,467,289,178
18,97,18,9,40,31,9
18,97,18,11,947,1498,-551
18,97,18,13,168,186,-18
18,97,18,15,46,0,46
18,97,18,17,102,64,38
18,97,18,19,158,69,89
18,97,18,21,75,102,-27
18,97,18,23,187,129,58
18,97,18,27,46,35,11
18,97,18,29,49,40,9
18,97,18,31,114,95,19
18,97,18,33,45,0,45
18,97,18,35,737,386,351
18,97,18,37,62,54,8
18,97,18,39,307,155,152
18,97,18,41,82,56,26
18,97,18,43,76,43,33
18,97,18,45,50,36,14
18,97,18,47,58,33,25
18,97,18,49,52,33,19
18,97,18,51,48,56,-8
18,97,18,53,208,178,30
18,97,18,55,100,113,-13
18,97,18,57,6285,10583,-4298
18,97,18,59,1942,2722,-780
18,97,18,61,28,0,28
18,97,18,63,4593,6839,-2246
18,97,18,65,268,276,-8
18,97,18,67,418,303,115
18,97,18,69,71,36,35
18,97,18,71,136,103,33
18,97,18,73,65,31,34
18,97,18,75,33,29,4
18,97,18,77,53,50,3
18,97,18,79,133,71,62
18,97,18,81,5516,7470,-1954
18,97,18,83,112,74,38
18,97,18,85,134,91,43
18,97,18,87,27,0,27
18,97,18,89,1533,714,819
18,97,18,91,245,147,98
18,97,18,93,78,92,-14
18,97,18,95,1032,1116,-84
18,97,18,99,79,42,37
18,97,18,103,87,66,21
18,97,18,105,1108,716,392
18,97,18,107,231,199,32
18,97,18,109,1721,2201,-480
18,97,18,111,29,0,29
18,97,18,113,48,0,48
18,97,18,117,47,54,-7
18,97,18,119,213,275,-62
18,97,18,121,65,63,2
18,97,18,127,294,160,134
18,97,18,129,22,0,22
18,97,18,131,31,0,31
18,97,18,133,431,481,-50
18,97,18,135,63,35,28
18,97,18,137,80,50,30
18,97,18,139,128,124,4
18,97,18,141,828,353,475
18,97,18,143,34,31,3
18,97,18,145,787,768,19
18,97,18,147,39,0,39
18,97,18,151,76,26,50
18,97,18,153,40,54,-14
18,97,18,155,0,34,-34
18,97,18,157,961,579,382
18,97,18,159,71,72,-1
18,97,18,163,459,272,187
18,97,18,165,34,41,-7
18,97,18,167,658,403,255
18,97,18,169,51,44,7
18,97,18,173,77,24,53
18,97,18,175,22,0,22
18,97,18,177,357,159,198
18,97,18,179,43,0,43
18,97,18,181,88,59,29
18,97,18,183,36,29,7
18,97,19,103,35,39,-4
18,97,19,153,50,75,-25
18,97,19,163,30,26,4
18,97,20,91,38,55,-17
18,97,20,173,0,51,-51
18,97,21,15,59,44,15
18,97,21,47,51,42,9
18,97,21,59,27,0,27
18,97,21,67,94,98,-4
18,97,21,93,28,33,-5
18,97,21,101,23,0,23
18,97,21,111,341,362,-21
18,97,21,117,31,29,2
18,97,21,125,0,38,-38
18,97,21,151,39,0,39
18,97,21,227,37,42,-5
18,97,22,51,39,0,39
18,97,22,71,0,59,-59
18,97,24,3,28,45,-17
18,97,24,5,51,40,11
18,97,24,31,83,72,11
18,97,24,33,82,49,33
18,97,24,510,29,28,1
18,97,25,17,80,109,-29
18,97,25,25,39,33,6
18,97,26,21,130,96,34
18,97,26,25,41,0,41
18,97,26,49,124,44,80
18,97,26,65,52,37,15
18,97,26,75,32,0,32
18,97,26,77,118,49,69
18,97,26,81,159,90,69
18,97,26,93,39,0,39
18,97,26,99,87,45,42
18,97,26,125,229,116,113
18,97,26,139,32,23,9
18,97,26,145,37,0,37
18,97,26,161,105,66,39
18,97,26,163,258,116,142
18,97,27,37,36,0,36
18,97,27,53,118,161,-43
18,97,27,123,44,44,0
18,97,28,47,0,32,-32
18,97,28,49,38,0,38
18,97,29,19,22,0,22
18,97,29,47,0,29,-29
18,97,29,95,63,81,-18
18,97,29,183,29,28,1
18,97,29,189,126,179,-53
18,97,29,510,88,69,19
18,97,31,55,46,52,-6
18,97,32,3,209,202,7
18,97,32,31,43,0,43
18,97,34,5,48,0,48
18,97,34,17,28,43,-15
18,97,34,23,55,53,2
18,97,35,1,70,34,36
18,97,36,5,75,52,23
18,97,36,29,32,27,5
18,97,36,45,41,0,41
18,97,36,47,114,69,45
18,97,36,55,47,0,47
18,97,36,59,43,0,43
18,97,36,61,98,148,-50
18,97,36,67,27,0,27
18,97,36,81,82,105,-23
18,97,36,103,84,0,84
18,97,36,119,26,0,26
18,97,37,51,55,62,-7
18,97,37,63,0,40,-40
18,97,37,67,37,0,37
18,97,37,81,57,59,-2
18,97,37,97,0,34,-34
18,97,37,119,77,182,-105
18,97,37,133,29,56,-27
18,97,37,183,61,76,-15
18,97,39,17,110,103,7
18,97,39,25,32,41,-9
18,97,39,35,152,161,-9
18,97,39,41,53,33,20
18,97,39,49,369,339,30
18,97,39,57,63,40,23
18,97,39,61,312,208,104
18,97,39,93,28,35,-7
18,97,39,95,89,53,36
18,97,39,113,225,146,79
18,97,39,151,36,30,6
18,97,39,153,93,32,61
18,97,39,165,61,60,1
18,97,39,173,31,0,31
18,97,40,109,34,41,-7
18,97,40,143,65,28,37
18,97,41,51,45,79,-34
18,97,42,3,94,70,24
18,97,42,29,0,46,-46
18,97,42,91,33,24,9
18,97,42,101,54,70,-16
18,97,44,7,27,0,27
18,97,45,19,50,58,-8
18,97,45,45,0,44,-44
18,97,45,51,35,32,3
18,97,45,63,0,41,-41
18,97,45,79,0,27,-27
18,97,45,91,0,35,-35
18,97,47,37,203,201,2
18,97,47,65,31,0,31
18,97,47,93,44,50,-6
18,97,47,125,54,74,-20
18,97,47,149,30,60,-30
18,97,47,157,99,128,-29
18,97,47,165,0,51,-51
18,97,48,27,69,65,4
18,97,48,29,93,140,-47
18,97,48,85,34,66,-32
18,97,48,113,129,177,-48
18,97,48,121,42,100,-58
18,97,48,141,51,78,-27
18,97,48,157,0,61,-61
18,97,48,201,177,317,-140
18,97,48,215,39,122,-83
18,97,48,339,0,39,-39
18,97,48,439,105,175,-70
18,97,48,453,61,122,-61
18,97,48,491,0,53,-53
18,97,49,35,58,47,11
18,97,51,13,29,44,-15
18,97,51,59,79,97,-18
18,97,51,87,26,0,26
18,97,51,153,74,37,37
18,97,51,510,0,29,-29
18,97,51,710,49,0,49
18,97,51,760,0,29,-29
18,97,51,810,59,62,-3
18,97,53,33,117,160,-43
18,97,53,53,58,82,-24
18,97,53,61,36,36,0
18,97,53,63,0,37,-37
18,97,53,67,0,34,-34
18,97,55,9,0,33,-33
18,97,55,25,54,102,-48
18,97,55,79,211,120,91
18,97,55,133,26,0,26
18,99,17,31,60,51,9
18,99,18,3,23,28,-5
18,99,18,39,249,225,24
18,99,18,49,171,172,-1
18,99,18,57,0,43,-43
18,99,18,85,226,246,-20
18,99,18,91,42,57,-15
18,99,18,97,42,79,-37
18,99,18,103,33,0,33
18,99,18,127,37,59,-22
18,99,18,131,47,78,-31
18,99,18,141,656,636,20
18,99,18,149,310,274,36
18,99,18,157,0,38,-38
18,101,18,27,105,97,8
18,101,18,37,84,90,-6
18,101,18,55,0,29,-29
18,101,18,83,0,29,-29
18,101,18,93,46,60,-14
18,101,18,105,0,38,-38
18,101,18,117,46,0,46
18,101,18,163,0,30,-30
18,103,18,3,57,57,0
18,103,18,17,225,367,-142
18,103,18,49,134,64,70
18,103,18,53,115,184,-69
18,103,18,57,38,83,-45
18,103,18,67,505,634,-129
18,103,18,81,0,33,-33
18,103,18,85,38,43,-5
18,103,18,95,36,0,36
18,103,18,97,66,87,-21
18,103,18,99,0,33,-33
18,103,18,157,0,81,-81
18,103,18,169,170,188,-18
18,105,4,13,59,65,-6
18,105,4,19,28,25,3
18,105,6,1,23,65,-42
18,105,6,37,89,95,-6
18,105,6,59,25,0,25
18,105,6,73,93,37,56
18,105,6,75,0,23,-23
18,105,6,85,0,85,-85
18,105,8,13,0,38,-38
18,105,11,1,38,63,-25
18,105,12,11,28,0,28
18,105,12,71,39,0,39
18,105,12,86,0,35,-35
18,105,12,103,29,0,29
18,105,13,59,0,25,-25
18,105,13,121,22,0,22
18,105,17,19,32,0,32
18,105,17,31,230,463,-233
18,105,17,43,40,36,4
18,105,17,97,30,0,30
18,105,18,3,132,93,39
18,105,18,5,110,99,11
18,105,18,11,45,30,15
18,105,18,13,299,225,74
18,105,18,19,0,24,-24
18,105,18,21,35,28,7
18,105,18,23,33,0,33
18,105,18,27,47,30,17
18,105,18,35,96,82,14
18,105,18,37,32,33,-1
18,105,18,39,58,29,29
18,105,18,43,26,0,26
18,105,18,53,46,0,46
18,105,18,55,718,651,67
18,105,18,57,181,259,-78
18,105,18,59,38,22,16
18,105,18,63,76,86,-10
18,105,18,65,38,0,38
18,105,18,67,0,29,-29
18,105,18,71,32,25,7
18,105,18,79,28,0,28
18,105,18,81,170,251,-81
18,105,18,83,55,27,28
18,105,18,85,41,0,41
18,105,18,89,107,119,-12
18,105,18,91,23,25,-2
18,105,18,93,654,668,-14
18,105,18,95,35,29,6
18,105,18,97,716,1108,-392
18,105,18,101,38,0,38
18,105,18,109,222,225,-3
18,105,18,117,36,27,9
18,105,18,119,385,406,-21
18,105,18,127,92,44,48
18,105,18,133,33,0,33
18,105,18,137,21,0,21
18,105,18,141,132,64,68
18,105,18,145,30,0,30
18,105,18,157,106,106,0
18,105,18,163,96,92,4
18,105,18,167,120,70,50
18,105,18,177,20,0,20
18,105,21,111,67,106,-39
18,105,24,31,45,23,22
18,105,25,17,40,38,2
18,105,25,25,0,24,-24
18,105,26,125,36,42,-6
18,105,26,161,43,43,0
18,105,27,53,0,76,-76
18,105,29,189,27,57,-30
18,105,29,510,0,23,-23
18,105,32,3,35,0,35
18,105,34,17,0,37,-37
18,105,36,47,0,40,-40
18,105,36,61,49,93,-44
18,105,36,81,0,36,-36
18,105,37,119,0,40,-40
18,105,39,17,0,26,-26
18,105,39,35,28,38,-10
18,105,39,49,50,46,4
18,105,39,61,60,58,2
18,105,39,113,25,0,25
18,105,41,51,21,20,1
18,105,42,3,26,0,26
18,105,42,101,25,26,-1
18,105,47,37,0,58,-58
18,105,47,157,0,38,-38
18,105,48,113,0,40,-40
18,105,48,201,44,60,-16
18,105,48,439,0,47,-47
18,105,48,453,32,39,-7
18,105,49,35,40,0,40
18,105,49,49,40,0,40
18,105,51,59,32,70,-38
18,105,53,33,56,90,-34
18,105,55,25,0,36,-36
18,105,55,79,23,23,0
18,107,17,31,0,20,-20
18,107,18,11,166,136,30
18,107,18,23,43,48,-5
18,107,18,45,158,167,-9
18,107,18,57,37,52,-15
18,107,18,63,108,137,-29
18,107,18,97,199,231,-32
18,107,18,121,112,56,56
18,107,18,133,130,147,-17
18,107,18,157,261,385,-124
18,107,18,167,40,35,5
18,109,4,13,30,0,30
18,109,12,71,0,27,-27
18,109,17,31,0,24,-24
18,109,18,5,49,0,49
18,109,18,11,47,49,-2
18,109,18,13,87,83,4
18,109,18,55,43,36,7
18,109,18,57,117,93,24
18,109,18,59,43,0,43
18,109,18,63,806,574,232
18,109,18,81,678,635,43
18,109,18,93,24,31,-7
18,109,18,95,32,0,32
18,109,18,97,2201,1721,480
18,109,18,105,225,222,3
18,109,18,119,150,152,-2
18,109,18,133,109,114,-5
18,109,18,157,40,0,40
18,109,18,167,46,46,0
18,111,17,31,60,0,60
18,111,17,75,76,46,30
18,111,17,91,0,39,-39
18,111,18,7,63,85,-22
18,111,18,73,244,229,15
18,111,18,89,274,217,57
18,111,18,97,0,29,-29
18,111,18,127,50,38,12
18,111,18,157,61,96,-35
18,113,18,3,579,614,-35
18,113,18,33,427,460,-33
18,113,18,39,200,243,-43
18,113,18,69,33,37,-4
18,113,18,85,221,213,8
18,113,18,87,433,393,40
18,113,18,97,0,48,-48
18,113,18,151,122,78,44
18,113,18,183,276,281,-5
18,113,26,149,0,31,-31
18,115,18,29,241,208,33
18,115,18,137,33,0,33
18,115,18,155,143,121,22
18,115,21,15,0,53,-53
18,115,39,61,47,31,16
18,117,18,25,71,73,-2
18,117,18,37,74,103,-29
18,117,18,43,34,0,34
18,117,18,93,228,272,-44
18,117,18,97,54,47,7
18,117,18,101,0,46,-46
18,117,18,105,27,36,-9
18,117,18,175,63,90,-27
18,119,18,13,29,0,29
18,119,18,21,73,136,-63
18,119,18,55,91,80,11
18,119,18,63,45,59,-14
18,119,18,81,34,0,34
18,119,18,93,36,34,2
18,119,18,97,275,213,62
18,119,18,105,406,385,21
18,119,18,109,152,150,2
18,119,18,133,154,160,-6
18,119,18,167,46,51,-5
18,121,18,21,81,86,-5
18,121,18,45,77,0,77
18,121,18,63,30,34,-4
18,121,18,97,63,65,-2
18,121,18,107,56,112,-56
18,121,18,133,45,65,-20
18,121,18,165,161,143,18
18,121,18,167,213,189,24
18,123,18,37,55,79,-24
18,123,18,147,230,157,73
18,123,18,163,44,69,-25
18,123,18,173,29,26,3
18,123,21,59,49,50,-1
18,123,21,91,61,74,-13
18,123,21,111,0,32,-32
18,125,18,27,97,77,20
18,125,18,37,173,186,-13
18,125,18,51,161,110,51
18,125,18,83,50,49,1
18,125,18,163,64,62,2
18,127,4,13,80,170,-90
18,127,4,19,0,31,-31
18,127,6,37,37,47,-10
18,127,6,73,62,52,10
18,127,8,31,0,24,-24
18,127,12,57,0,30,-30
18,127,12,71,24,30,-6
18,127,12,99,39,0,39
18,127,12,103,0,28,-28
18,127,17,31,1178,679,499
18,127,17,43,72,75,-3
18,127,17,89,31,0,31
18,127,17,91,40,0,40
18,127,17,97,0,34,-34
18,127,17,197,117,85,32
18,127,18,3,69,63,6
18,127,18,35,0,29,-29
18,127,18,39,54,38,16
18,127,18,57,59,115,-56
18,127,18,63,26,37,-11
18,127,18,73,266,329,-63
18,127,18,85,0,36,-36
18,127,18,89,5582,3318,2264
18,127,18,91,845,1384,-539
18,127,18,95,28,0,28
18,127,18,97,160,294,-134
18,127,18,99,59,37,22
18,127,18,105,44,92,-48
18,127,18,111,38,50,-12
18,127,18,131,0,50,-50
18,127,18,141,111,185,-74
18,127,18,149,172,214,-42
18,127,18,157,114,110,4
18,127,18,167,35,0,35
18,127,26,21,37,41,-4
18,127,26,125,34,0,34
18,127,26,163,35,0,35
18,127,32,3,58,69,-11
18,127,42,3,25,0,25
18,127,47,37,0,34,-34
18,127,48,201,36,30,6
18,127,55,79,0,30,-30
18,129,17,193,37,40,-3
18,129,18,51,54,90,-36
18,129,18,97,0,22,-22
18,129,18,163,932,921,11
18,129,18,173,82,63,19
18,131,18,17,0,86,-86
18,131,18,49,66,90,-24
18,131,18,73,87,99,-12
18,131,18,89,44,0,44
18,131,18,97,0,31,-31
18,131,18,99,78,47,31
18,131,18,127,50,0,50
18,131,18,149,199,195,4
18,131,18,157,35,41,-6
18,131,18,181,40,68,-28
18,133,18,11,49,39,10
18,133,18,21,150,192,-42
18,133,18,57,30,49,-19
18,133,18,63,592,418,174
18,133,18,81,43,46,-3
18,133,18,97,481,431,50
18,133,18,105,0,33,-33
18,133,18,107,147,130,17
18,133,18,109,114,109,5
18,133,18,119,160,154,6
18,133,18,121,65,45,20
18,133,18,157,40,43,-3
18,133,18,167,75,122,-47
18,135,18,9,33,0,33
18,135,18,35,382,383,-1
18,135,18,65,64,55,9
18,135,18,75,108,130,-22
18,135,18,95,29,52,-23
18,135,18,97,35,63,-28
18,135,18,177,221,222,-1
18,135,39,37,223,286,-63
18,137,18,5,32,46,-14
18,137,18,29,461,440,21
18,137,18,31,179,198,-19
18,137,18,47,210,186,24
18,137,18,77,48,72,-24
18,137,18,79,51,63,-12
18,137,18,97,50,80,-30
18,137,18,105,0,21,-21
18,137,18,115,0,33,-33
18,137,18,145,0,31,-31
18,137,18,155,49,52,-3
18,137,21,15,27,36,-9
18,137,21,117,0,38,-38
18,137,39,17,0,39,-39
18,137,39,61,156,103,53
18,139,17,43,0,36,-36
18,139,18,31,150,97,53
18,139,18,41,124,138,-14
18,139,18,47,29,62,-33
18,139,18,59,122,101,21
18,139,18,65,82,147,-65
18,139,18,81,0,26,-26
18,139,18,97,124,128,-4
18,139,18,145,201,277,-76
18,141,4,13,129,169,-40
18,141,4,19,0,49,-49
18,141,6,1,0,21,-21
18,141,6,37,105,111,-6
18,141,6,59,41,42,-1
18,141,6,65,45,27,18
18,141,6,71,36,58,-22
18,141,6,73,84,94,-10
18,141,6,85,0,44,-44
18,141,6,111,0,33,-33
18,141,8,31,0,26,-26
18,141,8,41,0,32,-32
18,141,11,1,26,48,-22
18,141,12,11,63,33,30
18,141,12,21,0,30,-30
18,141,12,31,0,31,-31
18,141,12,57,50,53,-3
18,141,12,71,47,34,13
18,141,12,86,46,35,11
18,141,12,95,38,41,-3
18,141,12,99,65,25,40
18,141,12,101,0,29,-29
18,141,12,103,43,75,-32
18,141,13,67,0,52,-52
18,141,13,121,24,36,-12
18,141,15,3,38,24,14
18,141,17,19,0,37,-37
18,141,17,31,547,698,-151
18,141,17,43,65,103,-38
18,141,17,89,29,0,29
18,141,17,97,47,42,5
18,141,17,197,44,41,3
18,141,18,3,260,259,1
18,141,18,35,50,61,-11
18,141,18,39,2321,2338,-17
18,141,18,49,44,39,5
18,141,18,57,100,233,-133
18,141,18,63,22,49,-27
18,141,18,67,31,39,-8
18,141,18,81,43,60,-17
18,141,18,85,143,103,40
18,141,18,89,200,169,31
18,141,18,91,574,442,132
18,141,18,97,353,828,-475
18,141,18,99,636,656,-20
18,141,18,105,64,132,-68
18,141,18,127,185,111,74
18,141,18,149,136,111,25
18,141,18,151,29,0,29
18,141,18,157,81,179,-98
18,141,21,111,52,36,16
18,141,24,31,23,0,23
18,141,25,17,0,23,-23
18,141,25,25,0,23,-23
18,141,26,5,0,30,-30
18,141,26,21,1172,788,384
18,141,26,25,30,0,30
18,141,26,27,420,673,-253
18,141,26,65,49,44,5
18,141,26,77,121,86,35
18,141,26,81,72,74,-2
18,141,26,99,33,0,33
18,141,26,121,29,0,29
18,141,26,125,104,33,71
18,141,26,149,31,39,-8
18,141,26,159,37,40,-3
18,141,26,161,36,0,36
18,141,26,163,74,33,41
18,141,27,53,52,34,18
18,141,29,19,34,0,34
18,141,29,95,0,28,-28
18,141,29,189,42,52,-10
18,141,32,3,49,107,-58
18,141,36,55,24,0,24
18,141,36,61,37,56,-19
18,141,37,119,0,40,-40
18,141,37,183,0,29,-29
18,141,39,35,42,29,13
18,141,39,49,0,55,-55
18,141,39,61,42,35,7
18,141,39,95,35,0,35
18,141,39,113,0,38,-38
18,141,40,143,0,23,-23
18,141,41,51,0,22,-22
18,141,42,3,0,45,-45
18,141,45,45,0,35,-35
18,141,47,37,39,48,-9
18,141,47,93,0,39,-39
18,141,47,157,32,0,32
18,141,48,85,0,36,-36
18,141,48,113,71,96,-25
18,141,48,201,57,56,1
18,141,48,215,0,58,-58
18,141,48,439,32,53,-21
18,141,48,453,0,36,-36
18,141,49,35,35,0,35
18,141,51,59,34,36,-2
18,141,51,810,22,0,22
18,141,53,33,30,40,-10
18,141,55,25,25,48,-23
18,141,55,79,41,70,-29
18,143,18,5,35,34,1
18,143,18,19,304,349,-45
18,143,18,43,60,92,-32
18,143,18,71,276,295,-19
18,143,18,77,185,191,-6
18,143,18,79,70,66,4
18,143,18,97,31,34,-3
18,143,18,175,109,117,-8
18,143,21,111,82,90,-8
18,145,18,5,145,119,26
18,145,18,31,202,213,-11
18,145,18,41,77,51,26
18,145,18,57,58,45,13
18,145,18,59,286,264,22
18,145,18,63,0,51,-51
18,145,18,65,30,42,-12
18,145,18,81,330,397,-67
18,145,18,95,42,0,42
18,145,18,97,768,787,-19
18,145,18,105,0,30,-30
18,145,18,137,31,0,31
18,145,18,139,277,201,76
18,145,18,177,71,0,71
18,147,18,37,243,222,21
18,147,18,97,0,39,-39
18,147,18,123,157,230,-73
18,147,18,163,134,248,-114
18,147,18,173,183,199,-16
18,147,21,59,75,111,-36
18,149,17,31,87,80,7
18,149,18,39,0,36,-36
18,149,18,49,45,74,-29
18,149,18,73,0,53,-53
18,149,18,85,35,0,35
18,149,18,89,162,70,92
18,149,18,91,154,147,7
18,149,18,99,274,310,-36
18,149,18,127,214,172,42
18,149,18,131,195,199,-4
18,149,18,141,111,136,-25
18,151,18,3,377,310,67
18,151,18,33,444,456,-12
18,151,18,39,51,49,2
18,151,18,87,248,196,52
18,151,18,97,26,76,-50
18,151,18,113,78,122,-44
18,151,18,141,0,29,-29
18,151,18,183,0,37,-37
18,151,26,23,184,106,78
18,151,26,59,57,51,6
18,151,26,149,50,0,50
18,151,39,171,107,48,59
18,153,18,21,45,44,1
18,153,18,55,175,176,-1
18,153,18,83,93,79,14
18,153,18,97,54,40,14
18,153,18,167,320,331,-11
18,155,18,29,106,96,10
18,155,18,77,74,152,-78
18,155,18,97,34,0,34
18,155,18,115,121,143,-22
18,155,18,137,52,49,3
18,155,21,15,0,47,-47
18,155,39,61,49,0,49
18,157,4,13,81,100,-19
18,157,4,19,0,46,-46
18,157,6,1,25,25,0
18,157,6,37,79,111,-32
18,157,6,59,0,29,-29
18,157,6,65,30,0,30
18,157,6,71,33,0,33
18,157,6,73,50,96,-46
18,157,6,75,0,20,-20
18,157,6,85,42,123,-81
18,157,8,41,0,31,-31
18,157,12,9,26,0,26
18,157,12,31,0,37,-37
18,157,12,57,41,29,12
18,157,12,71,27,40,-13
18,157,12,95,0,32,-32
18,157,13,121,0,47,-47
18,157,17,19,76,67,9
18,157,17,31,451,597,-146
18,157,17,43,46,93,-47
18,157,17,97,49,41,8
18,157,17,113,40,42,-2
18,157,17,143,54,41,13
18,157,17,183,66,50,16
18,157,17,197,40,32,8
18,157,18,3,159,99,60
18,157,18,5,42,78,-36
18,157,18,7,352,335,17
18,157,18,11,133,196,-63
18,157,18,15,489,455,34
18,157,18,17,146,114,32
18,157,18,19,0,34,-34
18,157,18,23,830,793,37
18,157,18,35,112,62,50
18,157,18,39,85,60,25
18,157,18,45,183,193,-10
18,157,18,51,32,0,32
18,157,18,53,30,0,30
18,157,18,57,203,373,-170
18,157,18,59,31,41,-10
18,157,18,63,98,186,-88
18,157,18,67,245,114,131
18,157,18,73,201,79,122
18,157,18,81,41,77,-36
18,157,18,85,24,0,24
18,157,18,89,370,232,138
18,157,18,91,66,54,12
18,157,18,95,71,56,15
18,157,18,97,579,961,-382
18,157,18,99,38,0,38
18,157,18,103,81,0,81
18,157,18,105,106,106,0
18,157,18,107,385,261,124
18,157,18,109,0,40,-40
18,157,18,111,96,61,35
18,157,18,127,110,114,-4
18,157,18,131,41,35,6
18,157,18,133,43,40,3
18,157,18,141,179,81,98
18,157,18,163,84,47,37
18,157,18,167,87,39,48
18,157,18,169,27,0,27
18,157,18,171,168,163,5
18,157,18,173,34,0,34
18,157,18,177,30,33,-3
18,157,18,181,606,482,124
18,157,20,91,27,37,-10
18,157,21,67,0,30,-30
18,157,21,111,29,40,-11
18,157,24,31,0,40,-40
18,157,25,17,34,48,-14
18,157,25,25,22,0,22
18,157,26,65,29,0,29
18,157,26,125,27,35,-8
18,157,26,161,0,42,-42
18,157,26,163,36,34,2
18,157,27,53,30,61,-31
18,157,29,189,29,36,-7
18,157,32,3,34,38,-4
18,157,36,61,28,33,-5
18,157,36,81,0,30,-30
18,157,37,119,0,39,-39
18,157,37,183,28,50,-22
18,157,39,17,0,30,-30
18,157,39,35,0,37,-37
18,157,39,49,50,68,-18
18,157,39,61,35,48,-13
18,157,39,113,0,33,-33
18,157,41,67,0,40,-40
18,157,42,3,0,27,-27
18,157,47,37,0,36,-36
18,157,47,93,26,0,26
18,157,47,157,0,36,-36
18,157,48,29,0,31,-31
18,157,48,113,0,51,-51
18,157,48,201,0,103,-103
18,157,48,453,0,44,-44
18,157,51,59,27,40,-13
18,157,51,121,0,30,-30
18,157,53,33,0,60,-60
18,157,55,25,30,62,-32
18,157,55,79,31,46,-15
18,159,18,57,213,214,-1
18,159,18,67,333,355,-22
18,159,18,95,146,128,18
18,159,18,97,72,71,1
18,161,18,41,102,145,-43
18,161,18,47,56,39,17
18,161,18,177,131,134,-3
18,161,39,17,83,115,-32
18,161,39,135,0,38,-38
18,163,4,13,38,65,-27
18,163,6,37,44,28,16
18,163,6,73,38,0,38
18,163,8,41,0,30,-30
18,163,12,57,30,24,6
18,163,12,99,0,21,-21
18,163,12,103,33,39,-6
18,163,12,117,30,0,30
18,163,17,31,121,105,16
18,163,17,43,0,26,-26
18,163,17,77,0,22,-22
18,163,17,165,43,35,8
18,163,17,185,67,38,29
18,163,17,191,0,31,-31
18,163,17,193,74,64,10
18,163,17,199,30,0,30
18,163,18,5,0,28,-28
18,163,18,19,41,37,4
18,163,18,27,85,45,40
18,163,18,37,171,185,-14
18,163,18,39,0,24,-24
18,163,18,43,27,25,2
18,163,18,51,621,536,85
18,163,18,55,30,0,30
18,163,18,57,79,140,-61
18,163,18,63,0,48,-48
18,163,18,81,49,56,-7
18,163,18,83,135,109,26
18,163,18,89,46,39,7
18,163,18,93,25,0,25
18,163,18,97,272,459,-187
18,163,18,101,30,0,30
18,163,18,105,92,96,-4
18,163,18,123,69,44,25
18,163,18,125,62,64,-2
18,163,18,129,921,932,-11
18,163,18,147,248,134,114
18,163,18,157,47,84,-37
18,163,18,167,64,57,7
18,163,18,173,2063,2726,-663
18,163,21,15,0,35,-35
18,163,21,47,39,0,39
18,163,21,59,145,137,8
18,163,21,67,26,31,-5
18,163,21,101,502,568,-66
18,163,21,107,83,66,17
18,163,21,111,84,191,-107
18,163,21,145,43,0,43
18,163,21,221,0,30,-30
18,163,21,225,50,49,1
18,163,21,227,27,0,27
18,163,21,233,47,40,7
18,163,29,183,0,31,-31
18,163,29,189,50,48,2
18,163,29,510,0,26,-26
18,163,32,3,0,44,-44
18,163,39,49,0,28,-28
18,163,39,61,29,30,-1
18,163,47,37,48,125,-77
18,163,47,125,33,0,33
18,163,47,149,0,32,-32
18,163,47,157,0,36,-36
18,163,47,165,0,25,-25
18,163,48,201,28,40,-12
18,163,48,439,0,33,-33
18,163,53,33,0,25,-25
18,165,17,45,34,49,-15
18,165,17,183,79,62,17
18,165,18,45,73,97,-24
18,165,18,97,41,34,7
18,165,18,121,143,161,-18
18,165,18,167,265,310,-45
18,167,4,13,0,39,-39
18,167,6,37,0,26,-26
18,167,12,105,0,24,-24
18,167,17,19,0,40,-40
18,167,17,23,158,116,42
18,167,17,29,31,0,31
18,167,17,31,64,70,-6
18,167,17,33,48,37,11
18,167,17,43,0,60,-60
18,167,17,45,99,64,35
18,167,17,183,0,26,-26
18,167,18,3,28,31,-3
18,167,18,5,0,36,-36
18,167,18,11,0,26,-26
18,167,18,21,632,603,29
18,167,18,27,0,41,-41
18,167,18,45,0,35,-35
18,167,18,55,117,87,30
18,167,18,57,45,113,-68
18,167,18,59,0,39,-39
18,167,18,63,64,215,-151
18,167,18,81,51,74,-23
18,167,18,83,45,49,-4
18,167,18,89,62,60,2
18,167,18,93,36,0,36
18,167,18,97,403,658,-255
18,167,18,105,70,120,-50
18,167,18,107,35,40,-5
18,167,18,109,46,46,0
18,167,18,119,51,46,5
18,167,18,121,189,213,-24
18,167,18,127,0,35,-35
18,167,18,133,122,75,47
18,167,18,153,331,320,11
18,167,18,157,39,87,-48
18,167,18,163,57,64,-7
18,167,18,165,310,265,45
18,167,21,111,0,47,-47
18,167,29,189,0,25,-25
18,167,39,49,0,27,-27
18,167,48,201,0,37,-37
18,169,18,3,123,158,-35
18,169,18,39,0,39,-39
18,169,18,49,51,37,14
18,169,18,53,124,193,-69
18,169,18,57,0,33,-33
18,169,18,67,29,30,-1
18,169,18,69,157,155,2
18,169,18,85,240,218,22
18,169,18,97,44,51,-7
18,169,18,103,188,170,18
18,169,18,157,0,27,-27
18,169,18,183,59,45,14
18,171,17,183,74,61,13
18,171,18,7,83,37,46
18,171,18,45,176,161,15
18,171,18,157,163,168,-5
18,173,18,37,68,59,9
18,173,18,51,132,119,13
18,173,18,57,0,53,-53
18,173,18,83,39,0,39
18,173,18,97,24,77,-53
18,173,18,123,26,29,-3
18,173,18,129,63,82,-19
18,173,18,147,199,183,16
18,173,18,157,0,34,-34
18,173,18,163,2726,2063,663
18,173,21,59,52,67,-15
18,173,21,101,132,91,41
18,173,21,111,37,51,-14
18,173,47,37,0,26,-26
18,175,18,19,334,406,-72
18,175,18,25,32,34,-2
18,175,18,43,239,201,38
18,175,18,61,107,141,-34
18,175,18,71,95,90,5
18,175,18,93,67,70,-3
18,175,18,97,0,22,-22
18,175,18,117,90,63,27
18,175,18,143,117,109,8
18,175,21,111,104,102,2
18,177,4,13,0,35,-35
18,177,17,31,0,25,-25
18,177,18,35,79,97,-18
18,177,18,41,273,281,-8
18,177,18,47,36,48,-12
18,177,18,57,0,64,-64
18,177,18,59,31,53,-22
18,177,18,63,32,41,-9
18,177,18,65,129,253,-124
18,177,18,81,0,43,-43
18,177,18,95,27,23,4
18,177,18,97,159,357,-198
18,177,18,105,0,20,-20
18,177,18,135,222,221,1
18,177,18,145,0,71,-71
18,177,18,157,33,30,3
18,177,18,161,134,131,3
18,177,39,17,58,38,20
18,177,39,37,64,0,64
18,177,39,49,0,69,-69
18,177,39,61,33,63,-30
18,177,39,109,0,30,-30
18,177,39,113,76,63,13
18,177,39,135,234,240,-6
18,179,18,1,210,190,20
18,179,18,3,531,554,-23
18,179,18,9,96,91,5
18,179,18,53,47,0,47
18,179,18,69,175,150,25
18,179,18,75,45,46,-1
18,179,18,97,0,43,-43
18,181,4,13,0,23,-23
18,181,17,31,49,30,19
18,181,17,197,28,0,28
18,181,18,7,54,37,17
18,181,18,15,176,158,18
18,181,18,17,126,107,19
18,181,18,23,45,40,5
18,181,18,73,149,85,64
18,181,18,89,57,0,57
18,181,18,97,59,88,-29
18,181,18,131,68,40,28
18,181,18,157,482,606,-124
18,183,18,3,834,736,98
18,183,18,33,63,27,36
18,183,18,39,37,28,9
18,183,18,69,86,98,-12
18,183,18,85,261,311,-50
18,183,18,97,29,36,-7
18,183,18,113,281,276,5
18,183,18,151,37,0,37
18,183,18,169,45,59,-14
19,1,19,29,28,63,-35
19,1,19,49,0,47,-47
19,1,19,77,70,48,22
19,1,19,121,34,37,-3
19,1,19,153,89,94,-5
19,1,19,175,64,90,-26
19,1,19,181,0,26,-26
19,3,19,137,37,32,5
19,3,19,153,0,29,-29
19,3,19,175,38,42,-4
19,5,19,13,33,35,-2
19,5,19,43,79,81,-2
19,5,19,65,36,63,-27
19,5,19,113,28,43,-15
19,5,19,191,111,149,-38
19,5,27,55,51,22,29
19,5,55,63,22,0,22
19,7,19,135,71,71,0
19,7,19,153,57,64,-7
19,7,19,169,0,22,-22
19,7,19,179,36,96,-60
19,7,19,185,42,65,-23
19,9,19,27,45,41,4
19,9,19,29,44,41,3
19,9,19,153,0,25,-25
19,9,19,165,59,0,59
19,11,19,13,79,110,-31
19,11,19,19,30,0,30
19,11,19,61,0,49,-49
19,11,19,95,70,79,-9
19,11,19,103,102,116,-14
19,11,19,105,0,28,-28
19,11,19,113,882,842,40
19,11,19,153,0,58,-58
19,11,19,157,38,0,38
19,11,19,171,70,60,10
19,13,4,13,72,78,-6
19,13,6,37,0,38,-38
19,13,8,31,0,22,-22
19,13,17,31,116,133,-17
19,13,17,161,33,55,-22
19,13,19,5,35,33,2
19,13,19,11,110,79,31
19,13,19,15,23,0,23
19,13,19,17,579,463,116
19,13,19,19,253,283,-30
19,13,19,23,237,189,48
19,13,19,33,143,74,69
19,13,19,37,97,66,31
19,13,19,43,32,0,32
19,13,19,45,35,0,35
19,13,19,49,30,79,-49
19,13,19,55,83,34,49
19,13,19,57,39,0,39
19,13,19,61,157,98,59
19,13,19,65,146,84,62
19,13,19,67,53,55,-2
19,13,19,75,237,277,-40
19,13,19,83,60,56,4
19,13,19,99,37,0,37
19,13,19,103,138,236,-98
19,13,19,113,389,502,-113
19,13,19,127,66,57,9
19,13,19,139,31,26,5
19,13,19,149,20,0,20
19,13,19,153,266,615,-349
19,13,19,157,0,26,-26
19,13,19,163,134,174,-40
19,13,19,169,71,100,-29
19,13,19,171,156,134,22
19,13,19,187,85,38,47
19,13,19,191,62,45,17
19,13,19,193,41,0,41
19,13,19,195,34,0,34
19,13,20,91,0,48,-48
19,13,27,37,36,0,36
19,13,27,53,68,94,-26
19,13,29,95,0,24,-24
19,13,31,55,29,53,-24
19,13,32,3,24,25,-1
19,13,48,29,31,0,31
19,13,48,201,27,0,27
19,13,55,25,0,36,-36
19,13,55,79,39,41,-2
19,15,19,13,0,23,-23
19,15,19,49,111,112,-1
19,15,19,73,67,0,67
19,15,19,79,45,36,9
19,15,19,153,263,400,-137
19,15,19,169,479,436,43
19,15,19,187,48,49,-1
19,17,19,13,463,579,-116
19,17,19,23,150,169,-19
19,17,19,37,72,55,17
19,17,19,65,59,50,9
19,17,19,67,30,0,30
19,17,19,103,0,38,-38
19,17,19,113,29,51,-22
19,17,19,153,45,50,-5
19,19,19,11,0,30,-30
19,19,19,13,283,253,30
19,19,19,55,47,54,-7
19,19,19,65,159,145,14
19,19,19,103,0,33,-33
19,19,19,113,118,192,-74
19,19,19,153,0,30,-30
19,21,6,37,30,39,-9
19,21,17,31,119,0,119
19,21,19,35,70,75,-5
19,21,19,41,88,88,0
19,21,19,47,39,50,-11
19,21,19,141,0,43,-43
19,21,19,151,63,52,11
19,21,19,153,30,75,-45
19,21,19,161,60,74,-14
19,21,19,169,0,42,-42
19,21,19,193,29,59,-30
19,21,27,105,0,46,-46
19,21,31,55,0,50,-50
19,21,46,99,0,34,-34
19,21,48,215,36,51,-15
19,23,19,13,189,237,-48
19,23,19,17,169,150,19
19,23,19,37,31,0,31
19,23,19,67,44,0,44
19,23,19,69,33,0,33
19,23,19,75,45,28,17
19,23,19,153,0,45,-45
19,25,19,27,43,37,6
19,25,19,151,64,34,30
19,25,19,153,44,46,-2
19,25,19,161,0,29,-29
19,25,19,169,0,40,-40
19,25,19,187,146,183,-37
19,27,19,9,41,45,-4
19,27,19,25,37,43,-6
19,27,19,47,114,59,55
19,27,19,49,0,47,-47
19,27,19,73,73,34,39
19,27,19,77,44,31,13
19,27,19,103,0,31,-31
19,27,19,153,108,203,-95
19,27,19,161,57,50,7
19,27,19,169,23,97,-74
19,27,19,187,0,22,-22
19,27,31,55,0,26,-26
19,29,19,1,63,28,35
19,29,19,9,41,44,-3
19,29,19,137,56,44,12
19,29,19,153,43,55,-12
19,29,19,155,68,93,-25
19,29,19,169,0,44,-44
19,29,31,55,45,49,-4
19,29,31,153,0,32,-32
19,31,19,45,42,56,-14
19,31,19,103,286,285,1
19,31,19,105,34,39,-5
19,31,19,113,161,176,-15
19,31,19,139,164,209,-45
19,31,19,163,227,142,85
19,33,4,13,27,34,-7
19,33,17,31,0,28,-28
19,33,19,13,74,143,-69
19,33,19,37,31,0,31
19,33,19,49,0,26,-26
19,33,19,67,182,185,-3
19,33,19,69,138,119,19
19,33,19,81,199,133,66
19,33,19,103,43,72,-29
19,33,19,109,29,0,29
19,33,19,113,40,72,-32
19,33,19,131,65,45,20
19,33,19,153,116,226,-110
19,33,19,169,58,115,-57
19,33,19,187,29,0,29
19,33,19,189,121,100,21
19,33,19,195,124,183,-59
19,33,19,197,71,51,20
19,33,27,37,28,0,28
19,33,27,53,63,46,17
19,35,19,21,75,70,5
19,35,19,93,30,0,30
19,35,19,141,58,57,1
19,35,19,149,0,72,-72
19,35,19,153,0,43,-43
19,35,19,169,0,32,-32
19,35,19,193,51,101,-50
19,37,19,13,66,97,-31
19,37,19,17,55,72,-17
19,37,19,23,0,31,-31
19,37,19,33,0,31,-31
19,37,19,65,0,33,-33
19,37,19,67,110,95,15
19,37,19,89,60,35,25
19,37,19,153,0,39,-39
19,39,19,49,0,24,-24
19,39,19,53,109,44,65
19,39,19,117,27,0,27
19,39,19,121,0,31,-31
19,39,19,153,147,174,-27
19,39,19,175,30,45,-15
19,39,19,181,64,68,-4
19,41,19,21,88,88,0
19,41,19,59,118,174,-56
19,41,19,63,36,0,36
19,41,19,141,85,38,47
19,41,19,147,96,93,3
19,41,19,153,33,75,-42
19,41,19,187,25,0,25
19,41,19,193,37,0,37
19,41,46,99,0,30,-30
19,43,19,5,81,79,2
19,43,19,13,0,32,-32
19,43,19,55,78,144,-66
19,43,19,61,65,102,-37
19,43,19,65,74,119,-45
19,43,19,103,0,32,-32
19,43,19,113,46,76,-30
19,43,19,153,0,34,-34
19,43,55,23,96,126,-30
19,43,55,43,26,0,26
19,45,17,15,95,39,56
19,45,17,31,37,47,-10
19,45,17,161,81,68,13
19,45,17,195,300,255,45
19,45,19,13,0,35,-35
19,45,19,31,56,42,14
19,45,19,61,34,50,-16
19,45,19,97,250,287,-37
19,45,19,103,37,68,-31
19,45,19,113,51,95,-44
19,45,19,153,0,80,-80
19,45,19,163,340,561,-221
19,45,19,169,0,48,-48
19,47,19,21,50,39,11
19,47,19,27,59,114,-55
19,47,19,85,35,35,0
19,47,19,133,34,38,-4
19,47,19,153,43,82,-39
19,47,19,155,0,33,-33
19,47,19,161,0,43,-43
19,47,19,165,61,54,7
19,47,19,169,0,37,-37
19,47,19,193,0,37,-37
19,47,31,55,64,91,-27
19,49,4,13,57,58,-1
19,49,6,37,61,26,35
19,49,17,31,63,61,2
19,49,19,1,47,0,47
19,49,19,13,79,30,49
19,49,19,15,112,111,1
19,49,19,27,47,0,47
19,49,19,33,26,0,26
19,49,19,39,24,0,24
19,49,19,73,62,40,22
19,49,19,77,179,191,-12
19,49,19,99,31,0,31
19,49,19,103,105,31,74
19,49,19,113,116,55,61
19,49,19,117,22,0,22
19,49,19,121,123,134,-11
19,49,19,125,40,0,40
19,49,19,127,43,35,8
19,49,19,153,4096,2470,1626
19,49,19,163,75,35,40
19,49,19,169,224,88,136
19,49,19,175,35,0,35
19,49,19,181,184,117,67
19,49,19,187,50,0,50
19,49,20,91,58,32,26
19,49,27,53,26,71,-45
19,49,27,123,34,0,34
19,49,31,55,97,52,45
19,49,31,109,41,0,41
19,51,19,179,122,141,-19
19,53,19,39,44,109,-65
19,53,19,153,64,65,-1
19,53,19,159,48,0,48
19,55,19,13,34,83,-49
19,55,19,19,54,47,7
19,55,19,43,144,78,66
19,55,19,61,137,177,-40
19,55,19,103,0,33,-33
19,55,19,105,29,69,-40
19,55,19,113,136,251,-115
19,55,19,153,0,62,-62
19,57,17,31,148,54,94
19,57,17,67,40,0,40
19,57,17,71,117,105,12
19,57,17,95,0,33,-33
19,57,17,109,0,24,-24
19,57,17,161,29,0,29
19,57,17,187,28,0,28
19,57,19,13,0,39,-39
19,57,19,87,232,243,-11
19,57,19,103,84,144,-60
19,57,19,111,263,202,61
19,57,19,113,50,111,-61
19,57,19,115,90,96,-6
19,57,19,139,22,35,-13
19,57,19,153,30,89,-59
19,57,19,163,45,72,-27
19,57,19,169,0,33,-33
19,57,19,183,0,34,-34
19,59,19,41,174,118,56
19,59,19,63,93,69,24
19,59,19,113,0,26,-26
19,59,19,141,41,36,5
19,59,19,143,58,45,13
19,59,19,147,41,0,41
19,59,19,153,44,62,-18
19,59,19,169,0,29,-29
19,59,19,193,32,0,32
19,59,27,63,54,49,5
19,59,46,99,0,40,-40
19,61,4,13,61,75,-14
19,61,6,73,0,27,-27
19,61,8,31,0,32,-32
19,61,8,41,34,0,34
19,61,17,31,256,340,-84
19,61,17,43,34,23,11
19,61,17,85,397,299,98
19,61,17,161,39,39,0
19,61,17,177,31,0,31
19,61,17,201,0,37,-37
19,61,19,11,49,0,49
19,61,19,13,98,157,-59
19,61,19,43,102,65,37
19,61,19,45,50,34,16
19,61,19,55,177,137,40
19,61,19,97,259,250,9
19,61,19,103,76,173,-97
19,61,19,105,82,60,22
19,61,19,113,183,293,-110
19,61,19,153,123,145,-22
19,61,19,163,143,192,-49
19,61,19,169,0,35,-35
19,61,27,53,0,37,-37
19,61,27,123,0,25,-25
19,61,55,25,71,124,-53
19,61,55,43,233,237,-4
19,61,55,65,49,31,18
19,61,55,79,0,31,-31
19,63,19,41,0,36,-36
19,63,19,59,69,93,-24
19,63,19,147,44,50,-6
19,63,27,63,26,0,26
19,63,27,91,38,29,9
19,65,19,5,63,36,27
19,65,19,13,84,146,-62
19,65,19,17,50,59,-9
19,65,19,19,145,159,-14
19,65,19,37,33,0,33
19,65,19,43,119,74,45
19,65,19,103,0,36,-36
19,65,19,113,54,95,-41
19,65,19,153,0,23,-23
19,65,19,191,38,53,-15
19,67,17,31,0,49,-49
19,67,19,13,55,53,2
19,67,19,17,0,30,-30
19,67,19,23,0,44,-44
19,67,19,33,185,182,3
19,67,19,37,95,110,-15
19,67,19,69,0,36,-36
19,67,19,103,0,24,-24
19,67,19,131,87,55,32
19,67,19,153,0,40,-40
19,69,19,23,0,33,-33
19,69,19,33,119,138,-19
19,69,19,67,36,0,36
19,69,19,83,37,118,-81
19,69,19,113,0,25,-25
19,69,19,153,0,37,-37
19,69,19,169,0,26,-26
19,69,19,197,24,0,24
19,71,19,129,89,47,42
19,71,19,145,113,113,0
19,71,19,155,30,89,-59
19,71,31,55,25,42,-17
19,71,31,109,0,25,-25
19,71,31,131,45,47,-2
19,71,48,201,44,0,44
19,73,19,15,0,67,-67
19,73,19,27,34,73,-39
19,73,19,49,40,62,-22
19,73,19,77,39,45,-6
19,73,19,153,55,90,-35
19,73,19,169,32,79,-47
19,73,19,187,35,30,5
19,75,19,13,277,237,40
19,75,19,23,28,45,-17
19,75,19,83,60,46,14
19,75,19,127,127,58,69
19,75,19,153,0,52,-52
19,75,19,171,41,53,-12
19,77,19,1,48,70,-22
19,77,19,27,31,44,-13
19,77,19,49,191,179,12
19,77,19,73,45,39,6
19,77,19,153,193,196,-3
19,77,19,169,0,35,-35
19,79,19,15,36,45,-9
19,79,19,83,39,76,-37
19,79,19,153,52,134,-82
19,79,19,169,111,250,-139
19,79,19,187,159,126,33
19,79,19,197,93,67,26
19,81,19,33,133,199,-66
19,81,19,109,36,33,3
19,81,19,153,0,65,-65
19,81,19,189,89,61,28
19,81,19,197,59,69,-10
19,83,19,13,56,60,-4
19,83,19,69,118,37,81
19,83,19,75,46,60,-14
19,83,19,79,76,39,37
19,83,19,103,0,25,-25
19,83,19,127,63,87,-24
19,83,19,153,54,106,-52
19,83,19,169,84,149,-65
19,85,19,47,35,35,0
19,85,19,133,0,29,-29
19,85,19,155,214,247,-33
19,85,19,165,45,43,2
19,85,19,169,0,26,-26
19,85,31,55,157,211,-54
19,85,31,153,0,31,-31
19,85,31,177,0,49,-49
19,87,17,31,0,27,-27
19,87,19,57,243,232,11
19,87,19,101,84,67,17
19,87,19,103,58,102,-44
19,87,19,111,97,116,-19
19,87,19,113,44,46,-2
19,87,19,115,75,47,28
19,87,19,153,41,29,12
19,87,19,177,42,39,3
19,87,19,183,135,90,45
19,89,19,37,35,60,-25
19,89,19,131,37,44,-7
19,89,19,191,107,60,47
19,89,27,45,50,39,11
19,89,27,99,28,0,28
19,89,27,109,0,36,-36
19,91,19,109,65,63,2
19,91,19,151,32,0,32
19,91,19,153,0,43,-43
19,91,19,187,98,130,-32
19,91,19,197,28,40,-12
19,93,19,35,0,30,-30
19,93,19,153,0,30,-30
19,93,19,161,61,42,19
19,93,19,193,65,89,-24
19,95,19,11,79,70,9
19,95,19,103,241,251,-10
19,95,19,107,28,50,-22
19,95,19,113,140,166,-26
19,95,19,153,0,30,-30
19,95,19,157,55,51,4
19,95,19,183,31,42,-11
19,97,17,15,37,0,37
19,97,19,45,287,250,37
19,97,19,61,250,259,-9
19,97,19,103,0,58,-58
19,97,19,105,33,37,-4
19,97,19,113,28,75,-47
19,97,19,153,0,29,-29
19,97,19,163,88,93,-5
19,99,19,13,0,37,-37
19,99,19,49,0,31,-31
19,99,19,103,43,24,19
19,99,19,113,47,49,-2
19,99,19,123,45,0,45
19,99,19,125,157,139,18
19,99,19,127,102,62,40
19,99,19,153,781,880,-99
19,99,19,157,175,136,39
19,99,19,169,84,102,-18
19,99,19,179,0,28,-28
19,99,19,181,52,46,6
19,101,19,87,67,84,-17
19,101,19,103,46,49,-3
19,101,19,107,77,80,-3
19,101,19,153,0,47,-47
19,101,19,177,104,96,8
19,101,19,179,70,108,-38
19,101,19,183,44,37,7
19,103,4,13,144,152,-8
19,103,6,1,0,40,-40
19,103,6,37,57,103,-46
19,103,6,59,31,47,-16
19,103,6,73,48,90,-42
19,103,6,75,0,52,-52
19,103,6,85,0,54,-54
19,103,8,5,0,36,-36
19,103,8,31,36,76,-40
19,103,8,41,27,35,-8
19,103,8,69,0,39,-39
19,103,11,1,0,29,-29
19,103,12,1,0,31,-31
19,103,17,19,0,37,-37
19,103,17,31,659,657,2
19,103,17,43,86,70,16
19,103,17,89,26,0,26
19,103,17,97,61,36,25
19,103,17,111,30,0,30
19,103,17,113,31,0,31
19,103,17,161,88,52,36
19,103,17,197,43,40,3
19,103,17,201,35,0,35
19,103,18,97,39,35,4
19,103,19,11,116,102,14
19,103,19,13,236,138,98
19,103,19,17,38,0,38
19,103,19,19,33,0,33
19,103,19,27,31,0,31
19,103,19,31,285,286,-1
19,103,19,33,72,43,29
19,103,19,43,32,0,32
19,103,19,45,68,37,31
19,103,19,49,31,105,-74
19,103,19,55,33,0,33
19,103,19,57,144,84,60
19,103,19,61,173,76,97
19,103,19,65,36,0,36
19,103,19,67,24,0,24
19,103,19,83,25,0,25
19,103,19,87,102,58,44
19,103,19,95,251,241,10
19,103,19,97,58,0,58
19,103,19,99,24,43,-19
19,103,19,101,49,46,3
19,103,19,105,48,47,1
19,103,19,107,63,25,38
19,103,19,111,78,46,32
19,103,19,113,1616,1485,131
19,103,19,115,76,27,49
19,103,19,123,26,0,26
19,103,19,125,52,0,52
19,103,19,127,51,31,20
19,103,19,139,368,243,125
19,103,19,153,417,664,-247
19,103,19,155,57,40,17
19,103,19,157,39,41,-2
19,103,19,163,365,277,88
19,103,19,169,196,140,56
19,103,19,171,25,0,25
19,103,19,179,45,35,10
19,103,19,181,29,0,29
19,103,19,183,408,361,47
19,103,19,187,54,26,28
19,103,19,191,40,25,15
19,103,19,193,71,43,28
19,103,20,91,65,38,27
19,103,24,31,0,34,-34
19,103,25,17,44,30,14
19,103,25,25,0,26,-26
19,103,26,161,33,67,-34
19,103,27,37,0,36,-36
19,103,27,53,120,176,-56
19,103,27,109,44,59,-15
19,103,27,123,39,84,-45
19,103,29,95,47,54,-7
19,103,29,189,50,44,6
19,103,29,510,0,30,-30
19,103,31,55,71,88,-17
19,103,31,109,28,33,-5
19,103,32,3,0,26,-26
19,103,36,47,44,30,14
19,103,36,61,48,48,0
19,103,37,135,0,31,-31
19,103,39,35,0,29,-29
19,103,39,49,38,0,38
19,103,41,51,0,45,-45
19,103,42,101,0,40,-40
19,103,47,37,40,0,40
19,103,48,29,34,42,-8
19,103,48,113,38,58,-20
19,103,48,201,28,66,-38
19,103,48,439,34,0,34
19,103,48,453,0,32,-32
19,103,49,49,37,0,37
19,103,53,33,50,62,-12
19,103,55,25,74,106,-32
19,103,55,63,24,0,24
19,103,55,79,31,49,-18
19,105,19,11,28,0,28
19,105,19,31,39,34,5
19,105,19,55,69,29,40
19,105,19,61,60,82,-22
19,105,19,97,37,33,4
19,105,19,103,47,48,-1
19,105,19,113,426,413,13
19,105,19,187,0,40,-40
19,107,19,95,50,28,22
19,107,19,101,80,77,3
19,107,19,103,25,63,-38
19,107,19,113,36,24,12
19,107,19,123,78,88,-10
19,107,19,179,71,77,-6
19,107,19,183,79,95,-16
19,109,19,33,0,29,-29
19,109,19,81,33,36,-3
19,109,19,91,63,65,-2
19,109,19,147,64,48,16
19,109,19,153,39,74,-35
19,109,19,187,0,25,-25
19,109,19,189,0,45,-45
19,111,17,1,43,35,8
19,111,17,67,293,217,76
19,111,17,109,0,46,-46
19,111,19,57,202,263,-61
19,111,19,87,116,97,19
19,111,19,103,46,78,-32
19,111,19,113,46,73,-27
19,111,19,153,36,60,-24
19,111,19,163,0,39,-39
19,111,19,177,27,51,-24
19,111,29,45,95,105,-10
19,113,4,13,175,131,44
19,113,4,19,38,29,9
19,113,6,37,84,88,-4
19,113,6,59,34,42,-8
19,113,6,65,49,0,49
19,113,6,73,70,36,34
19,113,6,85,29,0,29
19,113,8,5,0,39,-39
19,113,8,31,0,51,-51
19,113,8,41,45,28,17
19,113,12,9,0,50,-50
19,113,12,71,0,33,-33
19,113,12,86,22,0,22
19,113,12,127,26,0,26
19,113,17,31,245,243,2
19,113,17,43,54,21,33
19,113,17,89,58,0,58
19,113,17,97,91,0,91
19,113,17,143,21,0,21
19,113,17,161,85,70,15
19,113,17,197,55,0,55
19,113,17,201,34,37,-3
19,113,19,5,43,28,15
19,113,19,11,842,882,-40
19,113,19,13,502,389,113
19,113,19,17,51,29,22
19,113,19,19,192,118,74
19,113,19,31,176,161,15
19,113,19,33,72,40,32
19,113,19,43,76,46,30
19,113,19,45,95,51,44
19,113,19,49,55,116,-61
19,113,19,55,251,136,115
19,113,19,57,111,50,61
19,113,19,59,26,0,26
19,113,19,61,293,183,110
19,113,19,65,95,54,41
19,113,19,69,25,0,25
19,113,19,87,46,44,2
19,113,19,95,166,140,26
19,113,19,97,75,28,47
19,113,19,99,49,47,2
19,113,19,103,1485,1616,-131
19,113,19,105,413,426,-13
19,113,19,107,24,36,-12
19,113,19,111,73,46,27
19,113,19,123,36,0,36
19,113,19,127,94,53,41
19,113,19,139,92,54,38
19,113,19,153,325,567,-242
19,113,19,157,44,43,1
19,113,19,163,170,171,-1
19,113,19,169,152,144,8
19,113,19,171,81,54,27
19,113,19,179,31,36,-5
19,113,19,181,0,34,-34
19,113,19,183,90,62,28
19,113,19,187,38,0,38
19,113,19,191,51,26,25
19,113,19,193,39,0,39
19,113,20,91,90,48,42
19,113,21,111,0,30,-30
19,113,27,37,51,55,-4
19,113,27,53,92,126,-34
19,113,27,109,0,30,-30
19,113,27,123,43,29,14
19,113,29,47,44,0,44
19,113,29,95,82,0,82
19,113,29,183,0,53,-53
19,113,29,189,48,30,18
19,113,31,55,92,73,19
19,113,31,153,0,41,-41
19,113,32,3,32,55,-23
19,113,35,1,52,0,52
19,113,36,61,0,26,-26
19,113,38,17,20,0,20
19,113,48,29,23,0,23
19,113,48,85,37,101,-64
19,113,48,113,36,38,-2
19,113,48,141,24,0,24
19,113,48,201,38,65,-27
19,113,48,439,48,0,48
19,113,48,453,24,40,-16
19,113,51,59,36,0,36
19,113,53,33,26,47,-21
19,113,53,53,0,34,-34
19,113,55,25,54,71,-17
19,113,55,63,27,0,27
19,113,55,79,47,36,11
19,115,17,31,44,0,44
19,115,19,57,96,90,6
19,115,19,87,47,75,-28
19,115,19,103,27,76,-49
19,115,19,139,258,233,25
19,115,19,183,33,87,-54
19,117,19,39,0,27,-27
19,117,19,49,0,22,-22
19,117,19,125,0,62,-62
19,117,19,153,67,116,-49
19,117,19,181,62,97,-35
19,117,19,185,48,80,-32
19,119,19,143,28,39,-11
19,119,19,167,98,120,-22
19,119,27,133,48,0,48
19,119,46,83,0,50,-50
19,119,46,99,95,140,-45
19,121,19,1,37,34,3
19,121,19,39,31,0,31
19,121,19,49,134,123,11
19,121,19,153,445,346,99
19,121,19,169,0,33,-33
19,121,19,175,38,38,0
19,121,19,181,117,117,0
19,123,19,99,0,45,-45
19,123,19,103,0,26,-26
19,123,19,107,88,78,10
19,123,19,113,0,36,-36
19,123,19,125,135,176,-41
19,123,19,135,42,37,5
19,123,19,153,83,151,-68
19,123,19,157,63,55,8
19,123,19,179,191,199,-8
19,125,19,49,0,40,-40
19,125,19,99,139,157,-18
19,125,19,103,0,52,-52
19,125,19,117,62,0,62
19,125,19,123,176,135,41
19,125,19,135,71,33,38
19,125,19,153,290,541,-251
19,125,19,157,32,30,2
19,125,19,169,57,45,12
19,125,19,179,44,44,0
19,125,19,181,109,109,0
19,127,19,13,57,66,-9
19,127,19,49,35,43,-8
19,127,19,75,58,127,-69
19,127,19,83,87,63,24
19,127,19,99,62,102,-40
19,127,19,103,31,51,-20
19,127,19,113,53,94,-41
19,127,19,153,234,317,-83
19,127,19,157,43,49,-6
19,127,19,169,125,154,-29
19,127,19,171,287,230,57
19,127,19,179,48,46,2
19,129,19,71,47,89,-42
19,129,19,137,35,55,-20
19,129,19,145,39,0,39
19,129,19,155,246,266,-20
19,129,31,25,0,29,-29
19,129,31,55,164,154,10
19,129,31,153,109,89,20
19,131,19,33,45,65,-20
19,131,19,67,55,87,-32
19,131,19,89,44,37,7
19,131,19,195,0,30,-30
19,131,27,99,47,0,47
19,133,19,47,38,34,4
19,133,19,85,29,0,29
19,133,19,149,0,25,-25
19,133,19,193,160,166,-6
19,133,31,55,32,0,32
19,135,19,7,71,71,0
19,135,19,123,37,42,-5
19,135,19,125,33,71,-38
19,135,19,153,53,34,19
19,135,19,179,83,96,-13
19,137,19,3,32,37,-5
19,137,19,29,44,56,-12
19,137,19,129,55,35,20
19,137,19,145,121,125,-4
19,137,19,155,57,77,-20
19,137,31,55,44,67,-23
19,139,17,31,83,33,50
19,139,17,131,79,54,25
19,139,17,161,147,78,69
19,139,19,13,26,31,-5
19,139,19,31,209,164,45
19,139,19,57,35,22,13
19,139,19,103,243,368,-125
19,139,19,113,54,92,-38
19,139,19,115,233,258,-25
19,139,19,153,31,80,-49
19,139,19,163,301,370,-69
19,139,19,169,28,47,-19
19,139,20,91,0,43,-43
19,141,19,21,43,0,43
19,141,19,35,57,58,-1
19,141,19,41,38,85,-47
19,141,19,59,36,41,-5
19,141,19,143,73,63,10
19,141,19,153,0,28,-28
19,141,19,167,157,109,48
19,141,19,193,34,39,-5
19,141,46,99,0,63,-63
19,143,19,59,45,58,-13
19,143,19,119,39,28,11
19,143,19,141,63,73,-10
19,143,27,105,51,0,51
19,145,19,71,113,113,0
19,145,19,129,0,39,-39
19,145,19,137,125,121,4
19,145,19,153,24,0,24
19,145,19,155,39,40,-1
19,145,19,173,36,50,-14
19,145,29,5,0,28,-28
19,145,29,147,53,40,13
19,145,31,55,31,63,-32
19,147,19,41,93,96,-3
19,147,19,59,0,41,-41
19,147,19,63,50,44,6
19,147,19,109,48,64,-16
19,147,19,151,0,26,-26
19,147,19,153,31,56,-25
19,149,19,13,0,20,-20
19,149,19,35,72,0,72
19,149,19,133,25,0,25
19,149,19,153,39,52,-13
19,149,19,167,102,117,-15
19,149,19,169,0,29,-29
19,149,19,193,456,476,-20
19,149,31,43,40,0,40
19,149,31,55,0,35,-35
19,149,46,27,0,24,-24
19,149,46,99,33,47,-14
19,149,46,127,56,38,18
19,151,19,21,52,63,-11
19,151,19,25,34,64,-30
19,151,19,91,0,32,-32
19,151,19,147,26,0,26
19,151,19,153,0,21,-21
19,151,19,187,0,42,-42
19,153,4,13,331,374,-43
19,153,4,19,50,42,8
19,153,6,1,0,33,-33
19,153,6,13,0,22,-22
19,153,6,37,212,174,38
19,153,6,59,90,53,37
19,153,6,65,37,41,-4
19,153,6,67,45,53,-8
19,153,6,71,74,36,38
19,153,6,73,156,103,53
19,153,6,75,0,28,-28
19,153,6,85,53,49,4
19,153,8,1,41,38,3
19,153,8,5,62,62,0
19,153,8,31,96,154,-58
19,153,8,35,0,45,-45
19,153,8,41,71,55,16
19,153,8,59,30,57,-27
19,153,8,69,38,46,-8
19,153,8,123,22,0,22
19,153,9,3,0,29,-29
19,153,11,1,0,41,-41
19,153,12,11,0,42,-42
19,153,12,31,34,38,-4
19,153,12,57,69,41,28
19,153,12,71,35,49,-14
19,153,12,95,33,40,-7
19,153,12,99,39,0,39
19,153,12,103,64,43,21
19,153,13,89,46,0,46
19,153,13,121,28,24,4
19,153,13,135,37,54,-17
19,153,15,3,44,21,23
19,153,17,31,412,415,-3
19,153,17,43,101,63,38
19,153,17,89,49,0,49
19,153,17,97,68,43,25
19,153,17,113,44,42,2
19,153,17,119,28,0,28
19,153,17,143,0,25,-25
19,153,17,161,111,70,41
19,153,17,197,29,37,-8
19,153,17,201,55,0,55
19,153,18,97,75,50,25
19,153,19,1,94,89,5
19,153,19,3,29,0,29
19,153,19,7,64,57,7
19,153,19,9,25,0,25
19,153,19,11,58,0,58
19,153,19,13,615,266,349
19,153,19,15,400,263,137
19,153,19,17,50,45,5
19,153,19,19,30,0,30
19,153,19,21,75,30,45
19,153,19,23,45,0,45
19,153,19,25,46,44,2
19,153,19,27,203,108,95
19,153,19,29,55,43,12
19,153,19,33,226,116,110
19,153,19,35,43,0,43
19,153,19,37,39,0,39
19,153,19,39,174,147,27
19,153,19,41,75,33,42
19,153,19,43,34,0,34
19,153,19,45,80,0,80
19,153,19,47,82,43,39
19,153,19,49,2470,4096,-1626
19,153,19,53,65,64,1
19,153,19,55,62,0,62
19,153,19,57,89,30,59
19,153,19,59,62,44,18
19,153,19,61,145,123,22
19,153,19,65,23,0,23
19,153,19,67,40,0,40
19,153,19,69,37,0,37
19,153,19,73,90,55,35
19,153,19,75,52,0,52
19,153,19,77,196,193,3
19,153,19,79,134,52,82
19,153,19,81,65,0,65
19,153,19,83,106,54,52
19,153,19,87,29,41,-12
19,153,19,91,43,0,43
19,153,19,93,30,0,30
19,153,19,95,30,0,30
19,153,19,97,29,0,29
19,153,19,99,880,781,99
19,153,19,101,47,0,47
19,153,19,103,664,417,247
19,153,19,109,74,39,35
19,153,19,111,60,36,24
19,153,19,113,567,325,242
19,153,19,117,116,67,49
19,153,19,121,346,445,-99
19,153,19,123,151,83,68
19,153,19,125,541,290,251
19,153,19,127,317,234,83
19,153,19,135,34,53,-19
19,153,19,139,80,31,49
19,153,19,141,28,0,28
19,153,19,145,0,24,-24
19,153,19,147,56,31,25
19,153,19,149,52,39,13
19,153,19,151,21,0,21
19,153,19,155,116,87,29
19,153,19,157,105,78,27
19,153,19,159,40,37,3
19,153,19,161,32,36,-4
19,153,19,163,254,251,3
19,153,19,165,53,0,53
19,153,19,167,49,0,49
19,153,19,169,1901,1128,773
19,153,19,171,104,32,72
19,153,19,175,143,97,46
19,153,19,179,162,102,60
19,153,19,181,1666,1951,-285
19,153,19,183,46,28,18
19,153,19,185,45,37,8
19,153,19,187,232,121,111
19,153,19,189,36,37,-1
19,153,19,191,43,0,43
19,153,19,193,203,131,72
19,153,19,197,60,32,28
19,153,20,91,192,208,-16
19,153,20,173,28,78,-50
19,153,20,177,31,0,31
19,153,20,209,24,0,24
19,153,22,71,0,31,-31
19,153,24,31,0,38,-38
19,153,26,125,35,0,35
19,153,26,163,43,0,43
19,153,27,3,33,45,-12
19,153,27,37,144,67,77
19,153,27,53,250,300,-50
19,153,27,109,43,41,2
19,153,27,123,103,114,-11
19,153,27,139,46,23,23
19,153,27,163,58,37,21
19,153,29,19,55,25,30
19,153,29,21,28,28,0
19,153,29,29,0,31,-31
19,153,29,47,97,62,35
19,153,29,77,54,57,-3
19,153,29,95,107,132,-25
19,153,29,147,22,0,22
19,153,29,165,0,30,-30
19,153,29,183,24,42,-18
19,153,29,189,58,78,-20
19,153,29,510,0,50,-50
19,153,31,55,329,297,32
19,153,31,109,163,108,55
19,153,31,153,115,72,43
19,153,32,3,112,137,-25
19,153,34,23,0,38,-38
19,153,36,47,0,42,-42
19,153,36,61,40,51,-11
19,153,37,119,34,81,-47
19,153,37,183,41,28,13
19,153,38,17,25,37,-12
19,153,39,35,57,39,18
19,153,39,49,53,49,4
19,153,40,109,31,0,31
19,153,40,143,41,39,2
19,153,41,51,35,67,-32
19,153,41,67,0,38,-38
19,153,42,3,0,31,-31
19,153,46,99,95,113,-18
19,153,47,37,0,25,-25
19,153,47,157,51,0,51
19,153,48,29,32,78,-46
19,153,48,85,60,69,-9
19,153,48,113,62,101,-39
19,153,48,121,37,28,9
19,153,48,141,0,48,-48
19,153,48,201,61,123,-62
19,153,48,215,0,46,-46
19,153,48,439,57,104,-47
19,153,48,453,0,88,-88
19,153,48,491,0,35,-35
19,153,49,35,78,54,24
19,153,49,49,34,0,34
19,153,51,59,0,33,-33
19,153,53,33,63,87,-24
19,153,53,53,0,31,-31
19,153,55,25,55,71,-16
19,153,55,79,46,69,-23
19,153,55,133,24,39,-15
19,155,4,13,40,38,2
19,155,6,37,29,0,29
19,155,6,73,0,35,-35
19,155,19,29,93,68,25
19,155,19,47,33,0,33
19,155,19,71,89,30,59
19,155,19,85,247,214,33
19,155,19,103,40,57,-17
19,155,19,129,266,246,20
19,155,19,137,77,57,20
19,155,19,145,40,39,1
19,155,19,153,87,116,-29
19,155,19,165,161,111,50
19,155,19,169,21,62,-41
19,155,19,193,49,62,-13
19,155,31,25,37,35,2
19,155,31,53,27,35,-8
19,155,31,55,2007,1998,9
19,155,31,109,61,83,-22
19,155,31,153,415,556,-141
19,155,31,177,60,44,16
19,155,32,3,0,36,-36
19,157,17,31,0,22,-22
19,157,19,11,0,38,-38
19,157,19,13,26,0,26
19,157,19,95,51,55,-4
19,157,19,99,136,175,-39
19,157,19,103,41,39,2
19,157,19,113,43,44,-1
19,157,19,123,55,63,-8
19,157,19,125,30,32,-2
19,157,19,127,49,43,6
19,157,19,153,78,105,-27
19,157,19,169,0,37,-37
19,157,19,171,50,50,0
19,159,19,53,0,48,-48
19,159,19,153,37,40,-3
19,159,19,175,37,34,3
19,161,19,21,74,60,14
19,161,19,25,29,0,29
19,161,19,27,50,57,-7
19,161,19,47,43,0,43
19,161,19,93,42,61,-19
19,161,19,153,36,32,4
19,163,4,13,258,87,171
19,163,6,1,51,0,51
19,163,6,13,69,0,69
19,163,6,37,171,54,117
19,163,6,59,88,0,88
19,163,6,67,30,0,30
19,163,6,73,70,62,8
19,163,6,85,142,0,142
19,163,8,31,36,24,12
19,163,8,41,48,31,17
19,163,9,1,42,0,42
19,163,9,3,119,0,119
19,163,9,7,47,0,47
19,163,9,9,35,0,35
19,163,12,11,56,0,56
19,163,12,31,86,0,86
19,163,12,71,0,36,-36
19,163,12,95,30,32,-2
19,163,12,99,34,0,34
19,163,12,105,26,0,26
19,163,13,67,43,0,43
19,163,13,89,48,0,48
19,163,13,121,37,0,37
19,163,15,3,35,0,35
19,163,17,15,0,29,-29
19,163,17,31,630,237,393
19,163,17,43,74,78,-4
19,163,17,73,207,182,25
19,163,17,89,0,33,-33
19,163,17,95,58,40,18
19,163,17,97,91,0,91
19,163,17,109,49,0,49
19,163,17,111,39,0,39
19,163,17,113,33,31,2
19,163,17,131,63,51,12
19,163,17,143,68,46,22
19,163,17,161,2760,1895,865
19,163,17,179,36,0,36
19,163,17,187,32,0,32
19,163,17,195,87,82,5
19,163,17,197,69,30,39
19,163,17,201,45,0,45
19,163,18,97,26,30,-4
19,163,19,13,174,134,40
19,163,19,31,142,227,-85
19,163,19,45,561,340,221
19,163,19,49,35,75,-40
19,163,19,57,72,45,27
19,163,19,61,192,143,49
19,163,19,97,93,88,5
19,163,19,103,277,365,-88
19,163,19,111,39,0,39
19,163,19,113,171,170,1
19,163,19,139,370,301,69
19,163,19,153,251,254,-3
19,163,19,169,70,105,-35
19,163,19,179,62,0,62
19,163,19,183,27,35,-8
19,163,19,187,0,23,-23
19,163,20,91,89,67,22
19,163,25,17,78,0,78
19,163,25,21,66,0,66
19,163,26,125,60,0,60
19,163,26,163,65,0,65
19,163,27,53,333,76,257
19,163,27,123,65,0,65
19,163,29,95,47,39,8
19,163,29,183,37,0,37
19,163,29,189,88,49,39
19,163,31,55,37,44,-7
19,163,31,153,0,34,-34
19,163,32,3,59,61,-2
19,163,33,11,32,0,32
19,163,34,17,146,0,146
19,163,34,23,105,0,105
19,163,34,27,46,0,46
19,163,36,55,40,0,40
19,163,36,81,42,0,42
19,163,37,119,146,25,121
19,163,37,183,50,55,-5
19,163,39,35,29,0,29
19,163,39,49,93,32,61
19,163,39,61,24,0,24
19,163,39,113,35,0,35
19,163,42,3,35,0,35
19,163,42,91,54,0,54
19,163,47,157,47,50,-3
19,163,48,27,38,0,38
19,163,48,29,50,73,-23
19,163,48,85,102,0,102
19,163,48,113,104,45,59
19,163,48,201,114,44,70
19,163,48,439,33,36,-3
19,163,49,35,33,0,33
19,163,51,59,26,0,26
19,163,51,87,56,0,56
19,163,53,33,212,48,164
19,163,55,25,54,50,4
19,163,55,79,124,40,84
19,163,55,133,102,0,102
19,165,19,9,0,59,-59
19,165,19,47,54,61,-7
19,165,19,85,43,45,-2
19,165,19,153,0,53,-53
19,165,19,155,111,161,-50
19,165,31,55,44,80,-36
19,167,19,119,120,98,22
19,167,19,141,109,157,-48
19,167,19,149,117,102,15
19,167,19,153,0,49,-49
19,167,19,169,0,36,-36
19,167,19,193,62,75,-13
19,167,31,55,0,23,-23
19,167,46,83,37,54,-17
19,167,46,99,64,166,-102
19,169,4,13,85,116,-31
19,169,4,19,0,26,-26
19,169,6,1,0,36,-36
19,169,6,37,31,42,-11
19,169,6,73,28,0,28
19,169,6,85,0,30,-30
19,169,8,5,0,22,-22
19,169,8,31,0,35,-35
19,169,17,31,93,161,-68
19,169,19,7,22,0,22
19,169,19,13,100,71,29
19,169,19,15,436,479,-43
19,169,19,21,42,0,42
19,169,19,25,40,0,40
19,169,19,27,97,23,74
19,169,19,29,44,0,44
19,169,19,33,115,58,57
19,169,19,35,32,0,32
19,169,19,45,48,0,48
19,169,19,47,37,0,37
19,169,19,49,88,224,-136
19,169,19,57,33,0,33
19,169,19,59,29,0,29
19,169,19,61,35,0,35
19,169,19,69,26,0,26
19,169,19,73,79,32,47
19,169,19,77,35,0,35
19,169,19,79,250,111,139
19,169,19,83,149,84,65
19,169,19,85,26,0,26
19,169,19,99,102,84,18
19,169,19,103,140,196,-56
19,169,19,113,144,152,-8
19,169,19,121,33,0,33
19,169,19,125,45,57,-12
19,169,19,127,154,125,29
19,169,19,139,47,28,19
19,169,19,149,29,0,29
19,169,19,153,1128,1901,-773
19,169,19,155,62,21,41
19,169,19,157,37,0,37
19,169,19,163,105,70,35
19,169,19,167,36,0,36
19,169,19,179,44,0,44
19,169,19,181,85,86,-1
19,169,19,187,114,55,59
19,169,19,191,27,0,27
19,169,19,193,92,49,43
19,169,19,197,49,0,49
19,169,20,45,74,0,74
19,169,20,91,0,70,-70
19,169,25,17,0,30,-30
19,169,27,37,20,38,-18
19,169,27,53,82,135,-53
19,169,27,109,0,36,-36
19,169,27,123,0,48,-48
19,169,27,163,0,51,-51
19,169,29,95,0,35,-35
19,169,31,55,67,69,-2
19,169,31,109,25,41,-16
19,169,31,153,0,55,-55
19,169,32,3,0,37,-37
19,169,46,99,29,0,29
19,169,48,113,0,37,-37
19,169,48,201,0,27,-27
19,169,48,453,0,26,-26
19,169,53,33,0,41,-41
19,169,55,25,37,34,3
19,171,19,11,60,70,-10
19,171,19,13,134,156,-22
19,171,19,75,53,41,12
19,171,19,103,0,25,-25
19,171,19,113,54,81,-27
19,171,19,127,230,287,-57
19,171,19,153,32,104,-72
19,171,19,157,50,50,0
19,173,19,145,50,36,14
19,173,19,175,30,45,-15
19,173,29,147,36,44,-8
19,175,19,1,90,64,26
19,175,19,3,42,38,4
19,175,19,39,45,30,15
19,175,19,49,0,35,-35
19,175,19,121,38,38,0
19,175,19,153,97,143,-46
19,175,19,159,34,37,-3
19,175,19,173,45,30,15
19,175,19,181,0,38,-38
19,177,19,87,39,42,-3
19,177,19,101,96,104,-8
19,177,19,111,51,27,24
19,177,19,179,0,42,-42
19,179,17,31,0,24,-24
19,179,19,7,96,36,60
19,179,19,51,141,122,19
19,179,19,99,28,0,28
19,179,19,101,108,70,38
19,179,19,103,35,45,-10
19,179,19,107,77,71,6
19,179,19,113,36,31,5
19,179,19,123,199,191,8
19,179,19,125,44,44,0
19,179,19,127,46,48,-2
19,179,19,135,96,83,13
19,179,19,153,102,162,-60
19,179,19,163,0,62,-62
19,179,19,169,0,44,-44
19,179,19,177,42,0,42
19,179,29,21,32,0,32
19,181,19,1,26,0,26
19,181,19,39,68,64,4
19,181,19,49,117,184,-67
19,181,19,99,46,52,-6
19,181,19,103,0,29,-29
19,181,19,113,34,0,34
19,181,19,117,97,62,35
19,181,19,121,117,117,0
19,181,19,125,109,109,0
19,181,19,153,1951,1666,285
19,181,19,169,86,85,1
19,181,19,175,38,0,38
19,183,19,57,34,0,34
19,183,19,87,90,135,-45
19,183,19,95,42,31,11
19,183,19,101,37,44,-7
19,183,19,103,361,408,-47
19,183,19,107,95,79,16
19,183,19,113,62,90,-28
19,183,19,115,87,33,54
19,183,19,153,28,46,-18
19,183,19,163,35,27,8
19,185,19,7,65,42,23
19,185,19,117,80,48,32
19,185,19,153,37,45,-8
19,187,4,13,40,31,9
19,187,19,13,38,85,-47
19,187,19,15,49,48,1
19,187,19,25,183,146,37
19,187,19,27,22,0,22
19,187,19,33,0,29,-29
19,187,19,41,0,25,-25
19,187,19,49,0,50,-50
19,187,19,73,30,35,-5
19,187,19,79,126,159,-33
19,187,19,91,130,98,32
19,187,19,103,26,54,-28
19,187,19,105,40,0,40
19,187,19,109,25,0,25
19,187,19,113,0,38,-38
19,187,19,151,42,0,42
19,187,19,153,121,232,-111
19,187,19,163,23,0,23
19,187,19,169,55,114,-59
19,187,19,197,70,79,-9
19,189,19,33,100,121,-21
19,189,19,81,61,89,-28
19,189,19,109,45,0,45
19,189,19,153,37,36,1
19,189,19,195,46,76,-30
19,189,27,43,0,30,-30
19,189,27,47,70,44,26
19,189,27,53,0,20,-20
19,191,19,5,149,111,38
19,191,19,13,45,62,-17
19,191,19,65,53,38,15
19,191,19,89,60,107,-47
19,191,19,103,25,40,-15
19,191,19,113,26,51,-25
19,191,19,153,0,43,-43
19,191,19,169,0,27,-27
19,191,27,45,102,31,71
19,191,27,53,0,36,-36
19,193,4,13,81,73,8
19,193,6,19,0,36,-36
19,193,6,37,46,49,-3
19,193,6,73,31,0,31
19,193,8,41,0,33,-33
19,193,17,31,52,44,8
19,193,19,13,0,41,-41
19,193,19,21,59,29,30
19,193,19,35,101,51,50
19,193,19,41,0,37,-37
19,193,19,47,37,0,37
19,193,19,59,0,32,-32
19,193,19,93,89,65,24
19,193,19,103,43,71,-28
19,193,19,113,0,39,-39
19,193,19,133,166,160,6
19,193,19,141,39,34,5
19,193,19,149,476,456,20
19,193,19,153,131,203,-72
19,193,19,155,62,49,13
19,193,19,167,75,62,13
19,193,19,169,49,92,-43
19,193,20,91,0,31,-31
19,193,27,53,49,37,12
19,193,31,43,908,760,148
19,193,31,51,59,58,1
19,193,31,55,140,301,-161
19,193,31,109,61,61,0
19,193,31,119,0,34,-34
19,193,31,153,32,85,-53
19,193,31,173,157,60,97
19,193,46,27,60,50,10
19,193,46,83,0,50,-50
19,193,46,99,134,201,-67
19,193,46,127,325,518,-193
19,193,48,201,0,56,-56
19,193,48,439,0,29,-29
19,195,19,13,0,34,-34
19,195,19,33,183,124,59
19,195,19,131,30,0,30
19,195,19,189,76,46,30
19,195,27,47,28,35,-7
19,197,19,33,51,71,-20
19,197,19,69,0,24,-24
19,197,19,79,67,93,-26
19,197,19,81,69,59,10
19,197,19,91,40,28,12
19,197,19,153,32,60,-28
19,197,19,169,0,49,-49
19,197,19,187,79,70,9
20,1,20,3,45,71,-26
20,1,20,11,61,34,27
20,1,20,31,0,44,-44
20,1,20,37,39,35,4
20,1,20,45,0,40,-40
20,1,20,91,0,54,-54
20,1,20,133,145,157,-12
20,1,20,173,40,38,2
20,1,20,177,0,32,-32
20,1,20,205,0,34,-34
20,1,20,207,61,65,-4
20,3,20,1,71,45,26
20,3,20,59,86,120,-34
20,3,20,91,78,47,31
20,3,20,121,49,50,-1
20,5,20,13,64,68,-4
20,5,20,43,41,40,1
20,5,20,45,0,43,-43
20,5,20,87,0,40,-40
20,5,20,91,43,99,-56
20,5,20,103,76,114,-38
20,5,20,177,30,59,-29
20,5,29,21,103,107,-4
20,5,29,95,37,33,4
20,5,29,165,28,30,-2
20,7,20,151,31,26,5
20,7,20,173,0,59,-59
20,7,40,151,0,43,-43
20,9,20,45,28,27,1
20,9,20,51,73,82,-9
20,9,20,53,22,48,-26
20,9,20,55,38,36,2
20,9,20,91,32,64,-32
20,9,20,113,0,40,-40
20,9,20,145,72,106,-34
20,9,20,151,0,32,-32
20,9,20,155,52,83,-31
20,9,20,159,58,91,-33
20,9,20,161,38,31,7
20,9,20,165,40,44,-4
20,9,20,167,32,0,32
20,9,20,169,57,38,19
20,9,20,173,95,149,-54
20,9,20,177,0,28,-28
20,9,20,185,58,43,15
20,11,20,1,34,61,-27
20,11,20,37,120,186,-66
20,11,20,91,56,61,-5
20,11,20,107,150,33,117
20,11,29,217,52,52,0
20,13,20,5,68,64,4
20,13,20,43,47,36,11
20,13,20,45,0,22,-22
20,13,20,85,60,38,22
20,13,20,91,0,28,-28
20,13,20,131,49,84,-35
20,13,20,177,44,67,-23
20,13,29,21,31,37,-6
20,13,31,147,55,38,17
20,15,4,13,42,31,11
20,15,20,35,103,101,2
20,15,20,45,49,0,49
20,15,20,57,29,0,29
20,15,20,73,74,53,21
20,15,20,79,95,101,-6
20,15,20,91,76,109,-33
20,15,20,103,0,41,-41
20,15,20,111,55,27,28
20,15,20,113,53,0,53
20,15,20,115,0,46,-46
20,15,20,125,28,0,28
20,15,20,155,42,43,-1
20,15,20,161,43,50,-7
20,15,20,173,2510,2529,-19
20,15,20,177,42,56,-14
20,15,20,191,67,79,-12
20,15,29,95,0,27,-27
20,15,40,109,0,26,-26
20,17,20,111,78,80,-2
20,19,20,35,28,0,28
20,19,20,125,58,106,-48
20,19,40,147,28,0,28
20,21,20,37,227,318,-91
20,21,20,99,63,76,-13
20,21,29,97,382,502,-120
20,21,29,145,87,104,-17
20,21,40,115,183,147,36
20,21,40,143,0,24,-24
20,25,20,57,41,41,0
20,27,20,29,37,45,-8
20,27,20,41,49,42,7
20,27,20,61,76,59,17
20,27,20,91,0,26,-26
20,27,20,161,105,92,13
20,27,20,169,0,45,-45
20,27,20,201,26,0,26
20,29,20,27,45,37,8
20,29,20,123,28,0,28
20,29,20,143,0,33,-33
20,29,20,157,86,63,23
20,29,20,161,0,42,-42
20,29,20,169,44,63,-19
20,31,20,1,44,0,44
20,31,20,45,0,32,-32
20,31,20,59,73,31,42
20,31,20,111,127,100,27
20,31,20,177,0,45,-45
20,33,20,97,47,0,47
20,35,4,13,36,0,36
20,35,20,15,101,103,-2
20,35,20,19,0,28,-28
20,35,20,45,0,32,-32
20,35,20,91,0,44,-44
20,35,20,111,43,0,43
20,35,20,125,0,29,-29
20,35,20,155,0,50,-50
20,35,20,161,0,32,-32
20,35,20,173,498,627,-129
20,35,20,177,0,40,-40
20,35,20,191,209,135,74
20,35,35,9,45,0,45
20,35,40,71,130,165,-35
20,35,40,119,26,0,26
20,35,40,143,0,51,-51
20,37,5,7,0,27,-27
20,37,20,1,35,39,-4
20,37,20,11,186,120,66
20,37,20,21,318,227,91
20,37,20,45,27,59,-32
20,37,20,91,104,219,-115
20,37,20,99,122,102,20
20,37,20,107,34,0,34
20,37,20,121,27,0,27
20,37,20,125,74,72,2
20,37,20,133,78,62,16
20,37,20,173,88,113,-25
20,37,20,177,37,42,-5
20,37,20,205,42,0,42
20,37,20,209,0,32,-32
20,37,29,11,104,85,19
20,37,29,77,0,49,-49
20,37,29,95,42,71,-29
20,37,29,97,143,311,-168
20,37,29,145,33,0,33
20,37,29,217,33,0,33
20,37,40,115,53,0,53
20,37,40,143,0,51,-51
20,39,31,145,33,0,33
20,41,20,27,42,49,-7
20,41,20,45,0,24,-24
20,41,20,61,285,239,46
20,41,20,79,0,38,-38
20,41,20,91,0,44,-44
20,41,20,113,0,23,-23
20,41,20,115,0,32,-32
20,41,20,127,34,0,34
20,41,20,143,28,0,28
20,41,20,149,26,0,26
20,41,20,161,144,126,18
20,41,20,169,207,319,-112
20,41,20,173,50,58,-8
20,41,20,177,33,31,2
20,43,20,5,40,41,-1
20,43,20,13,36,47,-11
20,43,20,91,0,29,-29
20,43,29,3,57,45,12
20,43,29,21,238,185,53
20,45,4,13,75,85,-10
20,45,4,19,0,34,-34
20,45,6,37,61,87,-26
20,45,6,59,0,33,-33
20,45,6,73,44,34,10
20,45,6,75,0,21,-21
20,45,6,85,0,45,-45
20,45,8,5,0,29,-29
20,45,8,31,0,62,-62
20,45,8,41,29,45,-16
20,45,8,59,0,25,-25
20,45,11,1,0,25,-25
20,45,17,31,67,117,-50
20,45,19,169,0,74,-74
20,45,20,1,40,0,40
20,45,20,5,43,0,43
20,45,20,9,27,28,-1
20,45,20,13,22,0,22
20,45,20,15,0,49,-49
20,45,20,31,32,0,32
20,45,20,35,32,0,32
20,45,20,37,59,27,32
20,45,20,41,24,0,24
20,45,20,51,70,38,32
20,45,20,55,43,0,43
20,45,20,57,43,0,43
20,45,20,59,248,190,58
20,45,20,79,43,0,43
20,45,20,85,52,0,52
20,45,20,87,317,274,43
20,45,20,91,1426,2003,-577
20,45,20,103,235,243,-8
20,45,20,111,124,41,83
20,45,20,113,26,0,26
20,45,20,121,79,48,31
20,45,20,125,38,0,38
20,45,20,133,30,0,30
20,45,20,139,69,52,17
20,45,20,149,28,0,28
20,45,20,155,86,48,38
20,45,20,161,159,83,76
20,45,20,169,90,60,30
20,45,20,173,284,260,24
20,45,20,177,781,712,69
20,45,20,209,167,235,-68
20,45,24,31,0,28,-28
20,45,27,53,53,51,2
20,45,29,19,36,0,36
20,45,29,47,62,97,-35
20,45,29,77,26,29,-3
20,45,29,95,280,501,-221
20,45,29,165,57,50,7
20,45,29,189,37,55,-18
20,45,31,55,23,41,-18
20,45,31,109,31,26,5
20,45,32,3,0,49,-49
20,45,35,1,0,33,-33
20,45,36,61,35,38,-3
20,45,37,119,0,27,-27
20,45,40,27,34,0,34
20,45,40,109,43,57,-14
20,45,40,143,34,46,-12
20,45,41,51,0,44,-44
20,45,48,29,0,30,-30
20,45,48,113,42,41,1
20,45,48,201,38,71,-33
20,45,48,439,34,46,-12
20,45,48,453,0,29,-29
20,45,53,33,0,69,-69
20,45,55,25,0,25,-25
20,47,20,97,84,0,84
20,49,20,125,51,0,51
20,49,20,173,25,29,-4
20,51,8,59,0,20,-20
20,51,20,9,82,73,9
20,51,20,45,38,70,-32
20,51,20,55,36,22,14
20,51,20,57,47,29,18
20,51,20,63,36,0,36
20,51,20,65,31,0,31
20,51,20,91,64,144,-80
20,51,20,135,32,0,32
20,51,20,137,35,0,35
20,51,20,141,38,0,38
20,51,20,147,31,24,7
20,51,20,151,28,34,-6
20,51,20,155,32,0,32
20,51,20,161,30,66,-36
20,51,20,163,115,75,40
20,51,20,165,56,30,26
20,51,20,167,65,84,-19
20,51,20,169,61,60,1
20,51,20,173,79,144,-65
20,51,20,177,36,73,-37
20,51,20,193,42,0,42
20,51,20,195,42,53,-11
20,51,29,95,0,23,-23
20,53,20,9,48,22,26
20,53,20,159,0,32,-32
20,53,20,167,34,0,34
20,53,20,169,54,79,-25
20,55,4,13,36,39,-3
20,55,6,37,54,0,54
20,55,8,41,0,44,-44
20,55,20,9,36,38,-2
20,55,20,45,0,43,-43
20,55,20,51,22,36,-14
20,55,20,57,169,281,-112
20,55,20,67,80,112,-32
20,55,20,69,75,48,27
20,55,20,75,0,44,-44
20,55,20,81,63,49,14
20,55,20,91,32,97,-65
20,55,20,93,103,112,-9
20,55,20,111,34,0,34
20,55,20,155,0,55,-55
20,55,20,161,0,69,-69
20,55,20,171,72,67,5
20,55,20,173,102,175,-73
20,55,20,175,56,61,-5
20,55,20,177,0,38,-38
20,55,27,53,0,44,-44
20,55,48,113,0,29,-29
20,55,48,141,149,71,78
20,55,48,341,0,43,-43
20,57,6,37,71,0,71
20,57,20,15,0,29,-29
20,57,20,25,41,41,0
20,57,20,45,0,43,-43
20,57,20,51,29,47,-18
20,57,20,55,281,169,112
20,57,20,69,140,122,18
20,57,20,83,34,50,-16
20,57,20,91,40,57,-17
20,57,20,97,80,0,80
20,57,20,111,30,0,30
20,57,20,119,26,0,26
20,57,20,155,0,45,-45
20,57,20,161,0,55,-55
20,57,20,169,29,49,-20
20,57,20,173,70,245,-175
20,57,20,175,77,50,27
20,57,20,177,42,41,1
20,57,48,141,43,72,-29
20,59,20,3,120,86,34
20,59,20,31,31,73,-42
20,59,20,45,190,248,-58
20,59,20,91,446,454,-8
20,59,20,103,0,31,-31
20,59,20,107,41,0,41
20,59,20,111,58,0,58
20,59,20,121,170,79,91
20,59,20,139,112,91,21
20,59,20,161,0,26,-26
20,59,20,173,28,32,-4
20,59,20,177,0,75,-75
20,59,20,209,74,55,19
20,59,29,95,74,56,18
20,61,1,45,0,35,-35
20,61,1,89,33,0,33
20,61,2,20,36,0,36
20,61,2,90,80,0,80
20,61,4,3,90,0,90
20,61,4,13,61,49,12
20,61,6,37,105,58,47
20,61,6,59,22,0,22
20,61,6,71,152,80,72
20,61,6,73,38,40,-2
20,61,8,41,182,85,97
20,61,12,11,28,0,28
20,61,12,31,23,0,23
20,61,12,57,39,0,39
20,61,12,86,42,0,42
20,61,12,91,38,0,38
20,61,13,53,44,49,-5
20,61,13,215,104,39,65
20,61,13,245,72,39,33
20,61,15,3,105,65,40
20,61,17,31,59,39,20
20,61,20,27,59,76,-17
20,61,20,41,239,285,-46
20,61,20,91,58,88,-30
20,61,20,103,96,84,12
20,61,20,127,0,56,-56
20,61,20,149,54,35,19
20,61,20,161,1031,904,127
20,61,20,169,62,79,-17
20,61,20,173,97,97,0
20,61,20,177,84,108,-24
20,61,21,47,49,0,49
20,61,21,93,207,0,207
20,61,21,163,57,0,57
20,61,22,115,99,0,99
20,61,24,25,43,0,43
20,61,26,163,28,29,-1
20,61,29,95,42,27,15
20,61,29,169,127,39,88
20,61,32,3,33,0,33
20,61,36,45,66,0,66
20,61,37,51,177,70,107
20,61,40,31,207,67,140
20,61,45,79,112,37,75
20,61,47,125,86,71,15
20,61,47,157,35,0,35
20,61,48,27,94,148,-54
20,61,48,29,108,114,-6
20,61,48,113,45,46,-1
20,61,48,141,107,90,17
20,61,48,201,59,76,-17
20,61,48,439,0,37,-37
20,61,51,59,38,45,-7
20,61,51,700,42,0,42
20,61,53,53,133,99,34
20,63,20,51,0,36,-36
20,65,20,51,0,31,-31
20,67,20,55,112,80,32
20,67,20,81,35,0,35
20,67,20,175,0,33,-33
20,67,20,189,0,40,-40
20,69,20,55,48,75,-27
20,69,20,57,122,140,-18
20,69,20,91,0,21,-21
20,69,20,173,0,28,-28
20,73,20,15,53,74,-21
20,73,20,111,54,103,-49
20,73,20,173,86,117,-31
20,75,20,55,44,0,44
20,77,20,95,52,0,52
20,77,20,173,125,136,-11
20,77,20,191,32,42,-10
20,79,20,15,101,95,6
20,79,20,41,38,0,38
20,79,20,45,0,43,-43
20,79,20,91,49,49,0
20,79,20,113,117,108,9
20,79,20,115,192,134,58
20,79,20,155,147,198,-51
20,79,20,161,0,35,-35
20,79,20,169,40,32,8
20,79,20,173,706,794,-88
20,79,20,177,31,46,-15
20,79,29,95,0,27,-27
20,81,20,55,49,63,-14
20,81,20,67,0,35,-35
20,81,20,175,0,41,-41
20,83,20,57,50,34,16
20,85,20,13,38,60,-22
20,85,20,45,0,52,-52
20,85,20,87,31,26,5
20,85,20,91,0,36,-36
20,85,20,131,50,36,14
20,85,20,149,0,34,-34
20,85,20,173,0,37,-37
20,85,20,177,346,506,-160
20,87,20,5,40,0,40
20,87,20,45,274,317,-43
20,87,20,85,26,31,-5
20,87,20,91,72,56,16
20,87,20,103,124,127,-3
20,87,20,177,324,381,-57
20,87,20,209,50,38,12
20,89,20,123,0,42,-42
20,91,1,73,35,0,35
20,91,4,13,467,517,-50
20,91,4,19,82,76,6
20,91,4,21,0,30,-30
20,91,5,7,100,115,-15
20,91,5,119,70,37,33
20,91,5,143,65,45,20
20,91,6,1,64,79,-15
20,91,6,13,43,33,10
20,91,6,37,434,363,71
20,91,6,53,38,29,9
20,91,6,59,255,125,130
20,91,6,61,0,37,-37
20,91,6,65,70,76,-6
20,91,6,67,44,45,-1
20,91,6,71,71,72,-1
20,91,6,73,264,298,-34
20,91,6,75,36,63,-27
20,91,6,81,0,50,-50
20,91,6,85,61,112,-51
20,91,6,111,46,0,46
20,91,8,1,91,64,27
20,91,8,5,86,139,-53
20,91,8,13,60,60,0
20,91,8,14,0,31,-31
20,91,8,31,101,164,-63
20,91,8,35,84,192,-108
20,91,8,41,125,178,-53
20,91,8,59,53,89,-36
20,91,8,69,40,61,-21
20,91,9,1,0,30,-30
20,91,9,3,0,51,-51
20,91,9,9,0,31,-31
20,91,11,1,36,63,-27
20,91,12,9,0,44,-44
20,91,12,11,120,73,47
20,91,12,21,40,48,-8
20,91,12,31,50,68,-18
20,91,12,57,91,113,-22
20,91,12,69,0,28,-28
20,91,12,71,64,54,10
20,91,12,73,30,0,30
20,91,12,81,0,38,-38
20,91,12,86,95,45,50
20,91,12,95,91,83,8
20,91,12,99,68,80,-12
20,91,12,103,78,34,44
20,91,12,109,0,37,-37
20,91,12,115,42,39,3
20,91,12,117,42,0,42
20,91,12,127,26,0,26
20,91,13,57,0,33,-33
20,91,13,67,74,60,14
20,91,13,73,0,28,-28
20,91,13,89,36,29,7
20,91,13,117,0,45,-45
20,91,13,121,67,83,-16
20,91,13,135,52,45,7
20,91,15,3,42,48,-6
20,91,16,1,0,45,-45
20,91,17,31,381,539,-158
20,91,17,43,90,110,-20
20,91,17,89,84,58,26
20,91,17,97,84,66,18
20,91,17,119,36,0,36
20,91,17,143,40,0,40
20,91,17,163,48,0,48
20,91,17,167,43,0,43
20,91,17,197,82,44,38
20,91,18,57,55,60,-5
20,91,18,97,55,38,17
20,91,18,157,37,27,10
20,91,19,13,48,0,48
20,91,19,49,32,58,-26
20,91,19,103,38,65,-27
20,91,19,113,48,90,-42
20,91,19,139,43,0,43
20,91,19,153,208,192,16
20,91,19,163,67,89,-22
20,91,19,169,70,0,70
20,91,19,193,31,0,31
20,91,20,1,54,0,54
20,91,20,3,47,78,-31
20,91,20,5,99,43,56
20,91,20,9,64,32,32
20,91,20,11,61,56,5
20,91,20,13,28,0,28
20,91,20,15,109,76,33
20,91,20,27,26,0,26
20,91,20,35,44,0,44
20,91,20,37,219,104,115
20,91,20,41,44,0,44
20,91,20,43,29,0,29
20,91,20,45,2003,1426,577
20,91,20,51,144,64,80
20,91,20,55,97,32,65
20,91,20,57,57,40,17
20,91,20,59,454,446,8
20,91,20,61,88,58,30
20,91,20,69,21,0,21
20,91,20,79,49,49,0
20,91,20,85,36,0,36
20,91,20,87,56,72,-16
20,91,20,99,37,0,37
20,91,20,103,735,782,-47
20,91,20,107,114,148,-34
20,91,20,111,217,118,99
20,91,20,113,49,27,22
20,91,20,117,28,0,28
20,91,20,121,977,1007,-30
20,91,20,125,69,45,24
20,91,20,131,37,0,37
20,91,20,133,49,29,20
20,91,20,139,47,53,-6
20,91,20,149,69,42,27
20,91,20,155,103,66,37
20,91,20,161,626,350,276
20,91,20,169,221,113,108
20,91,20,173,953,708,245
20,91,20,177,765,419,346
20,91,20,209,4794,4166,628
20,91,21,67,0,29,-29
20,91,21,111,52,70,-18
20,91,24,31,63,50,13
20,91,25,17,62,65,-3
20,91,25,21,28,30,-2
20,91,25,25,0,31,-31
20,91,26,81,49,0,49
20,91,26,99,44,0,44
20,91,26,125,115,73,42
20,91,26,161,54,0,54
20,91,26,163,68,38,30
20,91,27,3,34,0,34
20,91,27,37,59,33,26
20,91,27,53,117,163,-46
20,91,27,123,36,0,36
20,91,29,3,23,0,23
20,91,29,13,60,32,28
20,91,29,15,0,60,-60
20,91,29,19,218,164,54
20,91,29,21,181,104,77
20,91,29,29,46,76,-30
20,91,29,37,733,936,-203
20,91,29,43,40,68,-28
20,91,29,47,1260,1164,96
20,91,29,49,33,30,3
20,91,29,51,61,32,29
20,91,29,77,276,195,81
20,91,29,83,32,0,32
20,91,29,95,7470,6437,1033
20,91,29,97,93,70,23
20,91,29,99,27,0,27
20,91,29,101,117,68,49
20,91,29,107,39,0,39
20,91,29,117,32,0,32
20,91,29,141,0,50,-50
20,91,29,147,59,0,59
20,91,29,159,37,42,-5
20,91,29,161,78,0,78
20,91,29,165,690,715,-25
20,91,29,177,0,31,-31
20,91,29,183,155,159,-4
20,91,29,189,442,327,115
20,91,29,195,25,0,25
20,91,29,209,30,33,-3
20,91,29,213,0,38,-38
20,91,29,217,32,0,32
20,91,29,510,71,76,-5
20,91,31,1,35,0,35
20,91,31,19,51,0,51
20,91,31,53,24,0,24
20,91,31,55,395,287,108
20,91,31,109,229,124,105
20,91,31,153,115,93,22
20,91,32,3,159,203,-44
20,91,34,3,33,0,33
20,91,34,17,0,26,-26
20,91,34,23,0,80,-80
20,91,34,27,0,45,-45
20,91,35,1,47,64,-17
20,91,36,29,38,0,38
20,91,36,47,40,71,-31
20,91,36,55,27,0,27
20,91,36,61,51,142,-91
20,91,36,81,32,40,-8
20,91,36,103,0,33,-33
20,91,36,119,0,32,-32
20,91,37,51,35,27,8
20,91,37,119,64,67,-3
20,91,37,133,41,0,41
20,91,37,183,47,106,-59
20,91,39,17,38,0,38
20,91,39,35,37,45,-8
20,91,39,49,100,66,34
20,91,39,61,41,41,0
20,91,40,27,78,31,47
20,91,40,109,129,215,-86
20,91,40,119,47,0,47
20,91,40,143,216,182,34
20,91,41,51,37,54,-17
20,91,41,67,0,74,-74
20,91,42,3,63,43,20
20,91,42,29,42,0,42
20,91,42,91,29,0,29
20,91,42,101,0,37,-37
20,91,46,99,54,63,-9
20,91,46,103,28,0,28
20,91,47,37,63,68,-5
20,91,47,65,34,0,34
20,91,47,93,0,30,-30
20,91,47,157,78,69,9
20,91,48,27,29,37,-8
20,91,48,29,121,145,-24
20,91,48,85,135,272,-137
20,91,48,113,266,352,-86
20,91,48,121,121,196,-75
20,91,48,141,59,65,-6
20,91,48,157,61,100,-39
20,91,48,201,218,290,-72
20,91,48,215,0,48,-48
20,91,48,303,31,0,31
20,91,48,339,36,38,-2
20,91,48,439,163,270,-107
20,91,48,453,90,140,-50
20,91,48,491,41,71,-30
20,91,49,35,62,72,-10
20,91,49,49,0,41,-41
20,91,51,13,24,29,-5
20,91,51,59,83,165,-82
20,91,51,87,45,0,45
20,91,51,107,44,92,-48
20,91,51,153,46,36,10
20,91,51,510,0,34,-34
20,91,51,810,39,0,39
20,91,53,11,0,45,-45
20,91,53,33,99,198,-99
20,91,53,53,41,37,4
20,91,53,61,45,51,-6
20,91,53,67,0,31,-31
20,91,55,25,63,57,6
20,91,55,79,60,33,27
20,93,20,55,112,103,9
20,95,20,77,0,52,-52
20,95,20,151,38,0,38
20,95,20,155,52,52,0
20,95,20,173,201,244,-43
20,97,20,33,0,47,-47
20,97,20,47,0,84,-84
20,97,20,57,0,80,-80
20,97,20,151,27,229,-202
20,97,20,155,0,66,-66
20,97,20,173,0,44,-44
20,99,20,21,76,63,13
20,99,20,37,102,122,-20
20,99,20,91,0,37,-37
20,99,20,125,192,206,-14
20,99,20,133,113,146,-33
20,99,20,173,41,48,-7
20,99,20,205,0,34,-34
20,99,29,97,46,87,-41
20,99,40,143,0,34,-34
20,103,2,90,52,0,52
20,103,4,3,39,0,39
20,103,4,13,0,36,-36
20,103,6,71,131,0,131
20,103,6,73,63,60,3
20,103,8,41,57,183,-126
20,103,12,57,0,46,-46
20,103,15,3,111,190,-79
20,103,20,5,114,76,38
20,103,20,15,41,0,41
20,103,20,45,243,235,8
20,103,20,59,31,0,31
20,103,20,61,84,96,-12
20,103,20,87,127,124,3
20,103,20,91,782,735,47
20,103,20,121,39,0,39
20,103,20,149,0,59,-59
20,103,20,155,32,0,32
20,103,20,161,59,94,-35
20,103,20,169,0,34,-34
20,103,20,173,132,49,83
20,103,20,177,142,99,43
20,103,20,209,836,703,133
20,103,21,93,103,62,41
20,103,22,115,133,51,82
20,103,29,21,51,38,13
20,103,29,37,47,0,47
20,103,29,47,94,135,-41
20,103,29,95,235,167,68
20,103,29,165,206,239,-33
20,103,29,169,77,55,22
20,103,32,3,47,34,13
20,103,36,45,108,163,-55
20,103,36,71,153,0,153
20,103,37,51,209,207,2
20,103,37,85,0,48,-48
20,103,40,31,62,55,7
20,103,47,125,135,289,-154
20,103,48,27,115,336,-221
20,103,48,29,78,59,19
20,103,48,141,61,79,-18
20,103,48,201,0,38,-38
20,103,48,439,38,0,38
20,103,51,59,120,147,-27
20,103,51,153,75,111,-36
20,103,53,53,146,141,5
20,103,53,67,51,123,-72
20,105,20,169,48,69,-21
20,107,20,11,33,150,-117
20,107,20,37,0,34,-34
20,107,20,59,0,41,-41
20,107,20,91,148,114,34
20,107,20,121,143,111,32
20,107,29,13,0,31,-31
20,109,20,193,72,0,72
20,111,4,13,0,41,-41
20,111,6,37,0,34,-34
20,111,20,15,27,55,-28
20,111,20,17,80,78,2
20,111,20,31,100,127,-27
20,111,20,35,0,43,-43
20,111,20,45,41,124,-83
20,111,20,55,0,34,-34
20,111,20,57,0,30,-30
20,111,20,59,0,58,-58
20,111,20,73,103,54,49
20,111,20,91,118,217,-99
20,111,20,113,23,23,0
20,111,20,127,46,55,-9
20,111,20,139,73,73,0
20,111,20,161,0,61,-61
20,111,20,169,0,32,-32
20,111,20,173,107,271,-164
20,111,20,177,88,226,-138
20,111,20,209,0,42,-42
20,111,27,53,32,128,-96
20,111,29,95,0,90,-90
20,111,31,43,0,29,-29
20,111,31,79,0,56,-56
20,111,53,33,0,50,-50
20,113,4,13,0,30,-30
20,113,20,9,40,0,40
20,113,20,15,0,53,-53
20,113,20,41,23,0,23
20,113,20,45,0,26,-26
20,113,20,79,108,117,-9
20,113,20,91,27,49,-22
20,113,20,111,23,23,0
20,113,20,115,75,77,-2
20,113,20,155,196,250,-54
20,113,20,159,43,74,-31
20,113,20,161,40,58,-18
20,113,20,169,195,157,38
20,113,20,173,123,232,-109
20,113,20,177,0,35,-35
20,115,20,15,46,0,46
20,115,20,41,32,0,32
20,115,20,79,134,192,-58
20,115,20,113,77,75,2
20,115,20,173,74,147,-73
20,117,20,91,0,28,-28
20,117,20,131,51,35,16
20,117,20,149,35,0,35
20,117,20,161,39,68,-29
20,117,20,169,0,24,-24
20,117,20,201,48,29,19
20,117,31,67,0,47,-47
20,117,31,109,25,0,25
20,119,20,57,0,26,-26
20,119,20,175,67,41,26
20,121,20,3,50,49,1
20,121,20,37,0,27,-27
20,121,20,45,48,79,-31
20,121,20,59,79,170,-91
20,121,20,91,1007,977,30
20,121,20,103,0,39,-39
20,121,20,107,111,143,-32
20,121,20,173,0,24,-24
20,121,20,177,0,40,-40
20,121,20,209,78,71,7
20,121,29,13,45,43,2
20,121,29,37,83,91,-8
20,121,29,47,0,25,-25
20,121,29,95,139,79,60
20,123,20,29,0,28,-28
20,123,20,89,42,0,42
20,123,20,141,29,0,29
20,123,20,169,46,59,-13
20,123,20,173,0,36,-36
20,125,20,15,0,28,-28
20,125,20,19,106,58,48
20,125,20,35,29,0,29
20,125,20,37,72,74,-2
20,125,20,45,0,38,-38
20,125,20,49,0,51,-51
20,125,20,91,45,69,-24
20,125,20,99,206,192,14
20,125,20,133,42,58,-16
20,125,20,161,0,31,-31
20,125,20,173,93,190,-97
20,125,20,177,34,41,-7
20,125,20,205,229,144,85
20,125,29,95,0,38,-38
20,125,29,97,36,35,1
20,125,40,105,99,179,-80
20,125,40,113,36,0,36
20,125,40,143,61,129,-68
20,125,40,147,133,173,-40
20,125,48,439,0,29,-29
20,127,20,41,0,34,-34
20,127,20,61,56,0,56
20,127,20,111,55,46,9
20,127,20,161,54,44,10
20,127,20,173,0,29,-29
20,127,20,177,42,0,42
20,127,20,197,28,0,28
20,129,20,189,0,36,-36
20,129,40,139,45,0,45
20,131,20,13,84,49,35
20,131,20,85,36,50,-14
20,131,20,91,0,37,-37
20,131,20,117,35,51,-16
20,131,20,161,26,48,-22
20,131,20,177,55,74,-19
20,133,20,1,157,145,12
20,133,20,37,62,78,-16
20,133,20,45,0,30,-30
20,133,20,91,29,49,-20
20,133,20,99,146,113,33
20,133,20,125,58,42,16
20,133,20,173,41,51,-10
20,133,20,205,76,85,-9
20,135,20,51,0,32,-32
20,137,20,51,0,35,-35
20,137,20,147,42,0,42
20,139,20,45,52,69,-17
20,139,20,59,91,112,-21
20,139,20,91,53,47,6
20,139,20,111,73,73,0
20,139,20,173,0,23,-23
20,139,20,177,464,530,-66
20,139,20,197,0,31,-31
20,141,20,51,0,38,-38
20,141,20,123,0,29,-29
20,143,20,29,33,0,33
20,143,20,41,0,28,-28
20,143,20,169,295,222,73
20,145,20,9,106,72,34
20,145,20,173,0,37,-37
20,147,20,51,24,31,-7
20,147,20,137,0,42,-42
20,149,20,41,0,26,-26
20,149,20,45,0,28,-28
20,149,20,61,35,54,-19
20,149,20,85,34,0,34
20,149,20,91,42,69,-27
20,149,20,103,59,0,59
20,149,20,117,0,35,-35
20,149,20,161,524,440,84
20,149,20,173,40,52,-12
20,149,20,177,97,167,-70
20,149,20,197,59,114,-55
20,151,20,7,26,31,-5
20,151,20,9,32,0,32
20,151,20,51,34,28,6
20,151,20,95,0,38,-38
20,151,20,97,229,27,202
20,151,20,155,29,80,-51
20,151,20,173,43,142,-99
20,151,20,185,34,0,34
20,153,20,193,0,34,-34
20,155,4,13,0,40,-40
20,155,17,31,0,23,-23
20,155,20,9,83,52,31
20,155,20,15,43,42,1
20,155,20,35,50,0,50
20,155,20,45,48,86,-38
20,155,20,51,0,32,-32
20,155,20,55,55,0,55
20,155,20,57,45,0,45
20,155,20,79,198,147,51
20,155,20,91,66,103,-37
20,155,20,95,52,52,0
20,155,20,97,66,0,66
20,155,20,103,0,32,-32
20,155,20,113,250,196,54
20,155,20,151,80,29,51
20,155,20,159,232,137,95
20,155,20,161,43,88,-45
20,155,20,169,61,87,-26
20,155,20,173,555,813,-258
20,155,20,177,69,40,29
20,155,20,185,53,0,53
20,155,29,95,43,38,5
20,155,40,143,0,26,-26
20,157,20,29,63,86,-23
20,157,20,161,0,23,-23
20,159,20,9,91,58,33
20,159,20,53,32,0,32
20,159,20,113,74,43,31
20,159,20,155,137,232,-95
20,159,20,173,57,57,0
20,161,2,90,58,0,58
20,161,4,3,85,0,85
20,161,4,13,77,69,8
20,161,6,37,40,60,-20
20,161,6,71,65,0,65
20,161,6,73,30,49,-19
20,161,8,31,0,36,-36
20,161,8,41,126,48,78
20,161,8,69,0,30,-30
20,161,12,86,46,0,46
20,161,13,53,59,0,59
20,161,13,215,71,0,71
20,161,15,3,54,42,12
20,161,17,31,24,65,-41
20,161,20,9,31,38,-7
20,161,20,15,50,43,7
20,161,20,27,92,105,-13
20,161,20,29,42,0,42
20,161,20,35,32,0,32
20,161,20,41,126,144,-18
20,161,20,45,83,159,-76
20,161,20,51,66,30,36
20,161,20,55,69,0,69
20,161,20,57,55,0,55
20,161,20,59,26,0,26
20,161,20,61,904,1031,-127
20,161,20,79,35,0,35
20,161,20,91,350,626,-276
20,161,20,103,94,59,35
20,161,20,111,61,0,61
20,161,20,113,58,40,18
20,161,20,117,68,39,29
20,161,20,125,31,0,31
20,161,20,127,44,54,-10
20,161,20,131,48,26,22
20,161,20,149,440,524,-84
20,161,20,155,88,43,45
20,161,20,157,23,0,23
20,161,20,169,142,98,44
20,161,20,173,261,383,-122
20,161,20,177,187,244,-57
20,161,20,191,26,0,26
20,161,20,197,0,49,-49
20,161,20,209,34,62,-28
20,161,21,93,122,0,122
20,161,21,163,45,0,45
20,161,29,19,0,31,-31
20,161,29,47,39,54,-15
20,161,29,77,38,0,38
20,161,29,95,59,112,-53
20,161,29,169,69,0,69
20,161,29,189,30,0,30
20,161,31,55,28,48,-20
20,161,31,109,41,48,-7
20,161,32,3,0,58,-58
20,161,36,45,40,0,40
20,161,36,71,28,0,28
20,161,37,51,57,65,-8
20,161,40,31,86,53,33
20,161,40,109,35,33,2
20,161,40,143,0,38,-38
20,161,45,79,68,0,68
20,161,47,37,0,29,-29
20,161,47,125,56,0,56
20,161,48,27,60,61,-1
20,161,48,29,47,78,-31
20,161,48,113,0,62,-62
20,161,48,121,0,40,-40
20,161,48,141,80,39,41
20,161,48,201,40,61,-21
20,161,48,439,0,30,-30
20,161,48,453,0,33,-33
20,161,51,59,31,38,-7
20,161,53,33,0,26,-26
20,161,53,53,86,50,36
20,163,20,51,75,115,-40
20,165,20,9,44,40,4
20,165,20,51,30,56,-26
20,167,20,9,0,32,-32
20,167,20,51,84,65,19
20,167,20,53,0,34,-34
20,167,20,169,0,42,-42
20,169,4,13,29,34,-5
20,169,20,9,38,57,-19
20,169,20,27,45,0,45
20,169,20,29,63,44,19
20,169,20,41,319,207,112
20,169,20,45,60,90,-30
20,169,20,51,60,61,-1
20,169,20,53,79,54,25
20,169,20,57,49,29,20
20,169,20,61,79,62,17
20,169,20,79,32,40,-8
20,169,20,91,113,221,-108
20,169,20,103,34,0,34
20,169,20,105,69,48,21
20,169,20,111,32,0,32
20,169,20,113,157,195,-38
20,169,20,117,24,0,24
20,169,20,123,59,46,13
20,169,20,143,222,295,-73
20,169,20,155,87,61,26
20,169,20,161,98,142,-44
20,169,20,167,42,0,42
20,169,20,173,187,377,-190
20,169,20,177,98,108,-10
20,169,20,209,29,38,-9
20,169,29,95,34,66,-32
20,169,40,109,0,28,-28
20,169,48,201,0,31,-31
20,171,20,55,67,72,-5
20,171,20,203,39,0,39
20,173,1,89,0,35,-35
20,173,2,20,55,40,15
20,173,2,90,33,30,3
20,173,4,13,279,296,-17
20,173,4,19,68,75,-7
20,173,5,7,65,83,-18
20,173,5,119,53,76,-23
20,173,5,131,29,0,29
20,173,5,143,71,48,23
20,173,6,1,0,38,-38
20,173,6,29,58,0,58
20,173,6,37,309,193,116
20,173,6,59,70,68,2
20,173,6,65,93,52,41
20,173,6,67,0,42,-42
20,173,6,71,148,76,72
20,173,6,73,193,136,57
20,173,6,83,36,0,36
20,173,6,85,0,113,-113
20,173,6,95,51,0,51
20,173,8,1,48,46,2
20,173,8,5,113,92,21
20,173,8,13,0,31,-31
20,173,8,31,82,62,20
20,173,8,35,42,82,-40
20,173,8,41,159,171,-12
20,173,8,59,31,64,-33
20,173,8,69,33,25,8
20,173,8,123,41,0,41
20,173,12,9,34,45,-11
20,173,12,11,46,35,11
20,173,12,31,52,32,20
20,173,12,57,58,57,1
20,173,12,91,43,0,43
20,173,12,95,41,61,-20
20,173,12,103,41,28,13
20,173,12,105,27,0,27
20,173,12,127,31,0,31
20,173,13,51,0,38,-38
20,173,13,67,61,38,23
20,173,13,121,44,26,18
20,173,13,135,35,32,3
20,173,15,3,74,58,16
20,173,17,31,178,128,50
20,173,17,119,0,36,-36
20,173,17,163,54,43,11
20,173,17,197,42,0,42
20,173,18,97,51,0,51
20,173,19,153,78,28,50
20,173,20,1,38,40,-2
20,173,20,7,59,0,59
20,173,20,9,149,95,54
20,173,20,15,2529,2510,19
20,173,20,35,627,498,129
20,173,20,37,113,88,25
20,173,20,41,58,50,8
20,173,20,45,260,284,-24
20,173,20,49,29,25,4
20,173,20,51,144,79,65
20,173,20,55,175,102,73
20,173,20,57,245,70,175
20,173,20,59,32,28,4
20,173,20,61,97,97,0
20,173,20,69,28,0,28
20,173,20,73,117,86,31
20,173,20,77,136,125,11
20,173,20,79,794,706,88
20,173,20,85,37,0,37
20,173,20,91,708,953,-245
20,173,20,95,244,201,43
20,173,20,97,44,0,44
20,173,20,99,48,41,7
20,173,20,103,49,132,-83
20,173,20,111,271,107,164
20,173,20,113,232,123,109
20,173,20,115,147,74,73
20,173,20,121,24,0,24
20,173,20,123,36,0,36
20,173,20,125,190,93,97
20,173,20,127,29,0,29
20,173,20,133,51,41,10
20,173,20,139,23,0,23
20,173,20,145,37,0,37
20,173,20,149,52,40,12
20,173,20,151,142,43,99
20,173,20,155,813,555,258
20,173,20,159,57,57,0
20,173,20,161,383,261,122
20,173,20,169,377,187,190
20,173,20,175,107,63,44
20,173,20,177,382,354,28
20,173,20,185,38,0,38
20,173,20,191,898,940,-42
20,173,20,193,25,0,25
20,173,20,205,81,36,45
20,173,20,209,151,76,75
20,173,21,67,0,25,-25
20,173,22,17,34,0,34
20,173,24,31,26,36,-10
20,173,25,17,37,46,-9
20,173,26,99,32,0,32
20,173,26,125,49,0,49
20,173,26,163,87,0,87
20,173,27,53,51,65,-14
20,173,28,47,28,0,28
20,173,29,9,0,33,-33
20,173,29,19,54,0,54
20,173,29,21,26,58,-32
20,173,29,37,37,32,5
20,173,29,43,0,36,-36
20,173,29,47,73,128,-55
20,173,29,77,124,91,33
20,173,29,95,256,357,-101
20,173,29,97,70,56,14
20,173,29,101,0,44,-44
20,173,29,165,31,49,-18
20,173,29,183,54,56,-2
20,173,29,189,109,108,1
20,173,29,209,0,33,-33
20,173,29,217,30,0,30
20,173,29,510,0,42,-42
20,173,31,55,115,117,-2
20,173,31,109,93,73,20
20,173,31,153,70,0,70
20,173,32,3,145,144,1
20,173,35,1,92,103,-11
20,173,36,47,0,22,-22
20,173,36,59,35,0,35
20,173,36,61,28,39,-11
20,173,37,81,0,37,-37
20,173,37,133,32,0,32
20,173,37,183,0,41,-41
20,173,38,35,39,0,39
20,173,39,49,0,35,-35
20,173,39,61,37,0,37
20,173,40,17,45,0,45
20,173,40,27,87,120,-33
20,173,40,31,33,39,-6
20,173,40,41,0,33,-33
20,173,40,47,77,47,30
20,173,40,65,46,47,-1
20,173,40,71,89,85,4
20,173,40,109,352,336,16
20,173,40,119,32,35,-3
20,173,40,143,285,313,-28
20,173,40,147,63,0,63
20,173,41,51,0,49,-49
20,173,41,67,0,25,-25
20,173,42,3,29,25,4
20,173,46,99,34,38,-4
20,173,47,37,48,36,12
20,173,47,65,32,36,-4
20,173,47,125,34,0,34
20,173,47,157,65,25,40
20,173,48,27,0,76,-76
20,173,48,29,131,195,-64
20,173,48,41,0,43,-43
20,173,48,85,66,162,-96
20,173,48,113,179,259,-80
20,173,48,121,106,123,-17
20,173,48,141,81,81,0
20,173,48,157,0,52,-52
20,173,48,167,0,37,-37
20,173,48,201,150,361,-211
20,173,48,215,0,34,-34
20,173,48,245,41,0,41
20,173,48,309,0,31,-31
20,173,48,339,0,78,-78
20,173,48,355,42,30,12
20,173,48,381,0,33,-33
20,173,48,439,279,333,-54
20,173,48,453,26,95,-69
20,173,48,485,56,0,56
20,173,48,491,0,35,-35
20,173,49,35,0,53,-53
20,173,49,49,49,32,17
20,173,51,59,49,51,-2
20,173,51,810,40,0,40
20,173,53,33,115,133,-18
20,173,53,53,67,41,26
20,173,53,61,63,141,-78
20,173,53,63,29,38,-9
20,173,55,25,34,0,34
20,173,55,79,33,0,33
20,175,20,55,61,56,5
20,175,20,57,50,77,-27
20,175,20,67,33,0,33
20,175,20,81,41,0,41
20,175,20,119,41,67,-26
20,175,20,173,63,107,-44
20,175,20,189,69,41,28
20,175,40,7,91,67,24
20,175,40,109,34,74,-40
20,175,40,139,222,237,-15
20,175,48,141,0,131,-131
20,175,48,201,0,42,-42
20,175,48,341,0,47,-47
20,177,4,13,64,123,-59
20,177,5,7,0,26,-26
20,177,6,37,99,29,70
20,177,6,65,28,0,28
20,177,6,73,36,54,-18
20,177,8,5,0,31,-31
20,177,8,31,35,37,-2
20,177,8,41,22,29,-7
20,177,17,31,35,68,-33
20,177,19,153,0,31,-31
20,177,20,1,32,0,32
20,177,20,5,59,30,29
20,177,20,9,28,0,28
20,177,20,13,67,44,23
20,177,20,15,56,42,14
20,177,20,31,45,0,45
20,177,20,35,40,0,40
20,177,20,37,42,37,5
20,177,20,41,31,33,-2
20,177,20,45,712,781,-69
20,177,20,51,73,36,37
20,177,20,55,38,0,38
20,177,20,57,41,42,-1
20,177,20,59,75,0,75
20,177,20,61,108,84,24
20,177,20,79,46,31,15
20,177,20,85,506,346,160
20,177,20,87,381,324,57
20,177,20,91,419,765,-346
20,177,20,103,99,142,-43
20,177,20,111,226,88,138
20,177,20,113,35,0,35
20,177,20,121,40,0,40
20,177,20,125,41,34,7
20,177,20,127,0,42,-42
20,177,20,131,74,55,19
20,177,20,139,530,464,66
20,177,20,149,167,97,70
20,177,20,155,40,69,-29
20,177,20,161,244,187,57
20,177,20,169,108,98,10
20,177,20,173,354,382,-28
20,177,20,193,35,0,35
20,177,20,197,230,189,41
20,177,20,209,93,147,-54
20,177,29,47,70,65,5
20,177,29,77,40,31,9
20,177,29,95,193,277,-84
20,177,29,97,37,0,37
20,177,29,165,42,63,-21
20,177,29,189,32,30,2
20,177,31,55,71,70,1
20,177,31,109,49,49,0
20,177,32,3,71,41,30
20,177,36,61,0,21,-21
20,177,37,183,0,32,-32
20,177,40,109,40,49,-9
20,177,40,143,58,59,-1
20,177,47,157,27,0,27
20,177,48,29,0,42,-42
20,177,48,113,32,68,-36
20,177,48,121,0,56,-56
20,177,48,201,41,73,-32
20,177,48,439,71,89,-18
20,177,48,453,0,43,-43
20,181,8,63,36,0,36
20,181,20,193,0,37,-37
20,185,20,9,43,58,-15
20,185,20,151,0,34,-34
20,185,20,155,0,53,-53
20,185,20,173,0,38,-38
20,189,20,67,40,0,40
20,189,20,129,36,0,36
20,189,20,175,41,69,-28
20,191,20,15,79,67,12
20,191,20,35,135,209,-74
20,191,20,77,42,32,10
20,191,20,161,0,26,-26
20,191,20,173,940,898,42
20,191,40,71,0,22,-22
20,193,20,51,0,42,-42
20,193,20,109,0,72,-72
20,193,20,153,34,0,34
20,193,20,173,0,25,-25
20,193,20,177,0,35,-35
20,193,20,181,37,0,37
20,195,20,51,53,42,11
20,197,20,127,0,28,-28
20,197,20,139,31,0,31
20,197,20,149,114,59,55
20,197,20,161,49,0,49
20,197,20,177,189,230,-41
20,201,20,27,0,26,-26
20,201,20,117,29,48,-19
20,203,20,171,0,39,-39
20,205,20,1,34,0,34
20,205,20,37,0,42,-42
20,205,20,99,34,0,34
20,205,20,125,144,229,-85
20,205,20,133,85,76,9
20,205,20,173,36,81,-45
20,207,20,1,65,61,4
20,209,4,13,54,100,-46
20,209,6,37,132,55,77
20,209,6,65,37,0,37
20,209,6,67,34,0,34
20,209,6,73,38,0,38
20,209,17,31,55,41,14
20,209,19,153,0,24,-24
20,209,20,37,32,0,32
20,209,20,45,235,167,68
20,209,20,59,55,74,-19
20,209,20,87,38,50,-12
20,209,20,91,4166,4794,-628
20,209,20,103,703,836,-133
20,209,20,111,42,0,42
20,209,20,121,71,78,-7
20,209,20,161,62,34,28
20,209,20,169,38,29,9
20,209,20,173,76,151,-75
20,209,20,177,147,93,54
20,209,27,53,33,0,33
20,209,29,19,28,0,28
20,209,29,21,43,71,-28
20,209,29,37,72,107,-35
20,209,29,47,500,709,-209
20,209,29,77,40,27,13
20,209,29,95,2395,2479,-84
20,209,29,101,0,41,-41
20,209,29,165,289,383,-94
20,209,29,189,0,35,-35
20,209,31,55,39,56,-17
20,209,32,3,43,26,17
20,209,40,143,41,25,16
20,209,48,113,33,45,-12
20,209,48,141,58,60,-2
20,209,48,201,33,50,-17
20,209,48,439,38,41,-3
21,1,21,45,0,43,-43
21,1,21,87,53,39,14
21,1,21,111,27,28,-1
21,1,21,169,0,36,-36
21,1,21,207,119,160,-41
21,1,21,217,119,161,-42
21,3,21,9,90,83,7
21,3,21,141,47,35,12
21,3,21,213,83,85,-2
21,3,21,227,267,362,-95
21,3,47,111,35,53,-18
21,3,47,165,103,72,31
21,5,21,67,246,187,59
21,5,21,73,459,490,-31
21,5,21,111,53,57,-4
21,5,21,113,43,43,0
21,5,21,167,143,111,32
21,5,21,209,41,28,13
21,5,21,211,74,76,-2
21,5,21,239,134,115,19
21,7,21,39,0,31,-31
21,7,21,145,277,242,35
21,9,21,3,83,90,-7
21,9,21,57,36,0,36
21,9,21,61,51,44,7
21,9,21,67,0,30,-30
21,9,21,93,39,39,0
21,9,21,99,287,275,12
21,9,21,111,67,52,15
21,9,21,169,298,196,102
21,9,21,171,165,92,73
21,9,21,227,290,410,-120
21,9,47,37,0,27,-27
21,11,21,49,0,27,-27
21,11,21,67,0,51,-51
21,11,21,69,54,28,26
21,11,21,165,59,0,59
21,11,21,173,267,244,23
21,11,21,181,54,0,54
21,11,21,205,92,70,22
21,13,21,67,43,44,-1
21,13,21,95,105,50,55
21,13,21,121,69,140,-71
21,13,21,125,42,42,0
21,13,21,151,32,29,3
21,13,21,235,0,35,-35
21,13,47,25,372,369,3
21,13,47,93,0,33,-33
21,13,51,105,74,58,16
21,15,4,13,42,38,4
21,15,6,37,46,0,46
21,15,6,59,39,0,39
21,15,6,73,0,45,-45
21,15,12,31,0,35,-35
21,15,12,57,35,0,35
21,15,12,71,27,0,27
21,15,12,95,30,41,-11
21,15,12,101,0,29,-29
21,15,12,103,0,36,-36
21,15,13,135,42,0,42
21,15,17,31,51,26,25
21,15,17,43,0,37,-37
21,15,18,29,177,130,47
21,15,18,57,0,32,-32
21,15,18,97,44,59,-15
21,15,18,115,53,0,53
21,15,18,137,36,27,9
21,15,18,155,47,0,47
21,15,18,163,35,0,35
21,15,21,23,0,50,-50
21,15,21,37,897,734,163
21,15,21,41,27,29,-2
21,15,21,59,39,0,39
21,15,21,67,193,144,49
21,15,21,77,229,157,72
21,15,21,81,624,698,-74
21,15,21,111,155,179,-24
21,15,21,117,4951,4267,684
21,15,21,151,57,42,15
21,15,21,161,39,0,39
21,15,21,185,0,32,-32
21,15,21,187,52,79,-27
21,15,21,191,116,116,0
21,15,21,209,46,40,6
21,15,25,27,29,0,29
21,15,26,125,57,0,57
21,15,26,163,27,0,27
21,15,32,3,46,0,46
21,15,37,119,0,28,-28
21,15,39,17,252,168,84
21,15,39,25,217,150,67
21,15,39,35,28,28,0
21,15,39,49,102,102,0
21,15,39,61,1214,778,436
21,15,39,113,65,44,21
21,15,39,165,115,108,7
21,15,47,157,34,29,5
21,15,48,201,0,37,-37
21,15,48,439,38,0,38
21,15,53,33,0,27,-27
21,17,21,49,63,115,-52
21,17,21,67,557,468,89
21,17,21,73,0,33,-33
21,17,21,97,145,120,25
21,17,21,113,53,34,19
21,17,21,151,41,0,41
21,17,21,173,50,67,-17
21,17,21,181,116,120,-4
21,17,21,209,120,198,-78
21,17,21,239,69,29,40
21,19,21,43,179,209,-30
21,19,21,67,134,164,-30
21,19,21,89,703,723,-20
21,19,21,111,26,38,-12
21,19,21,127,87,57,30
21,19,21,151,0,30,-30
21,19,21,205,52,26,26
21,19,39,49,51,34,17
21,19,39,87,305,243,62
21,19,39,145,33,0,33
21,19,54,11,155,120,35
21,19,54,99,117,116,1
21,21,21,45,84,92,-8
21,21,21,67,144,186,-42
21,21,21,79,164,122,42
21,21,21,111,47,57,-10
21,21,21,113,43,101,-58
21,21,21,137,540,449,91
21,21,21,151,41,46,-5
21,21,21,155,63,0,63
21,21,21,167,248,239,9
21,23,21,15,50,0,50
21,23,21,37,87,83,4
21,23,21,117,67,41,26
21,23,21,161,88,87,1
21,23,21,191,53,77,-24
21,23,39,25,28,0,28
21,25,21,67,30,44,-14
21,25,21,193,49,84,-35
21,25,21,237,43,46,-3
21,27,21,29,40,38,2
21,27,21,59,42,38,4
21,27,21,85,76,110,-34
21,27,21,91,53,48,5
21,27,21,93,193,118,75
21,27,21,111,237,175,62
21,27,21,163,195,214,-19
21,27,21,227,0,25,-25
21,29,18,19,96,88,8
21,29,18,43,41,102,-61
21,29,18,61,37,0,37
21,29,21,27,38,40,-2
21,29,21,67,46,29,17
21,29,21,85,57,0,57
21,29,21,93,228,221,7
21,29,21,99,0,48,-48
21,29,21,111,4099,3047,1052
21,29,21,123,34,0,34
21,29,21,163,74,75,-1
21,29,21,179,254,360,-106
21,29,21,185,57,60,-3
21,29,21,211,77,83,-6
21,29,21,215,188,205,-17
21,29,21,227,0,39,-39
21,31,21,61,0,37,-37
21,31,21,85,32,0,32
21,31,21,141,58,43,15
21,31,21,177,0,29,-29
21,31,21,183,47,63,-16
21,31,21,227,320,387,-67
21,33,21,47,58,38,20
21,33,21,55,39,53,-14
21,33,21,107,100,79,21
21,33,21,111,0,26,-26
21,33,21,143,158,111,47
21,33,21,145,0,33,-33
21,33,21,221,45,68,-23
21,35,21,47,39,48,-9
21,35,21,67,0,34,-34
21,35,21,83,206,162,44
21,35,21,111,82,111,-29
21,35,21,145,141,191,-50
21,35,21,157,299,245,54
21,35,21,221,21,0,21
21,35,21,227,0,40,-40
21,35,47,37,40,56,-16
21,35,47,79,118,100,18
21,35,47,125,0,45,-45
21,35,47,157,29,23,6
21,37,18,29,34,29,5
21,37,21,15,734,897,-163
21,37,21,23,83,87,-4
21,37,21,67,105,81,24
21,37,21,81,65,81,-16
21,37,21,111,84,93,-9
21,37,21,117,2049,2378,-329
21,37,21,151,33,0,33
21,37,21,161,0,28,-28
21,37,21,191,274,296,-22
21,37,39,15,27,0,27
21,37,39,17,132,137,-5
21,37,39,25,299,235,64
21,37,39,49,36,40,-4
21,37,39,61,1382,1065,317
21,37,39,113,48,35,13
21,37,39,165,77,84,-7
21,39,21,7,31,0,31
21,39,21,83,53,49,4
21,39,21,105,44,47,-3
21,39,21,145,42,67,-25
21,41,18,77,87,49,38
21,41,21,15,29,27,2
21,41,21,77,103,92,11
21,41,21,103,37,83,-46
21,41,21,111,75,45,30
21,41,21,117,46,41,5
21,41,21,187,58,109,-51
21,41,21,223,140,134,6
21,43,21,19,209,179,30
21,43,21,63,63,42,21
21,43,21,67,27,57,-30
21,43,21,89,118,122,-4
21,43,21,127,37,0,37
21,43,21,135,80,37,43
21,43,21,205,146,181,-35
21,43,39,49,0,34,-34
21,43,39,87,32,0,32
21,45,21,1,43,0,43
21,45,21,21,92,84,8
21,45,21,111,0,28,-28
21,45,21,137,151,98,53
21,45,21,151,0,29,-29
21,45,21,155,32,0,32
21,45,21,199,79,82,-3
21,45,21,207,37,59,-22
21,45,21,217,29,60,-31
21,47,1,45,0,61,-61
21,47,1,89,0,80,-80
21,47,2,20,39,45,-6
21,47,2,90,43,114,-71
21,47,4,3,42,106,-64
21,47,4,13,63,85,-22
21,47,4,19,0,36,-36
21,47,6,37,34,72,-38
21,47,6,65,0,36,-36
21,47,6,71,97,132,-35
21,47,6,73,35,41,-6
21,47,8,41,108,121,-13
21,47,12,31,0,35,-35
21,47,12,57,27,48,-21
21,47,12,86,32,0,32
21,47,12,91,44,68,-24
21,47,13,51,0,63,-63
21,47,13,53,47,66,-19
21,47,13,179,47,69,-22
21,47,13,215,0,85,-85
21,47,13,245,104,67,37
21,47,15,3,99,179,-80
21,47,17,31,80,52,28
21,47,18,97,42,51,-9
21,47,18,163,0,39,-39
21,47,20,61,0,49,-49
21,47,21,33,38,58,-20
21,47,21,35,48,39,9
21,47,21,67,32,61,-29
21,47,21,93,75,123,-48
21,47,21,107,154,198,-44
21,47,21,111,52,125,-73
21,47,21,141,44,33,11
21,47,21,143,24,0,24
21,47,21,145,28,38,-10
21,47,21,177,25,28,-3
21,47,21,219,162,199,-37
21,47,21,221,247,287,-40
21,47,21,227,56,63,-7
21,47,22,115,104,85,19
21,47,24,3,0,33,-33
21,47,24,21,0,35,-35
21,47,29,169,67,79,-12
21,47,32,3,0,42,-42
21,47,36,45,100,61,39
21,47,36,47,33,0,33
21,47,37,51,198,251,-53
21,47,39,113,32,0,32
21,47,40,31,117,135,-18
21,47,45,79,54,155,-101
21,47,47,37,78,162,-84
21,47,47,125,2510,3713,-1203
21,47,47,147,0,40,-40
21,47,47,149,39,37,2
21,47,47,157,35,0,35
21,47,47,161,48,81,-33
21,47,47,165,0,45,-45
21,47,48,27,162,198,-36
21,47,48,29,143,113,30
21,47,48,99,45,53,-8
21,47,48,141,121,183,-62
21,47,48,201,68,62,6
21,47,48,439,0,53,-53
21,47,51,59,0,92,-92
21,47,51,149,0,56,-56
21,47,51,700,75,95,-20
21,47,51,810,0,33,-33
21,47,53,53,113,225,-112
21,47,53,67,0,77,-77
21,49,21,11,27,0,27
21,49,21,17,115,63,52
21,49,21,65,52,64,-12
21,49,21,67,742,643,99
21,49,21,111,28,24,4
21,49,21,113,41,45,-4
21,49,21,151,171,212,-41
21,49,21,173,160,260,-100
21,49,21,197,185,167,18
21,49,21,205,36,30,6
21,49,21,209,80,57,23
21,49,21,237,37,0,37
21,49,21,239,32,0,32
21,51,21,67,0,30,-30
21,51,21,109,56,69,-13
21,51,21,121,44,0,44
21,51,21,125,455,476,-21
21,51,21,131,46,58,-12
21,51,21,151,0,35,-35
21,51,21,235,36,0,36
21,53,21,57,48,0,48
21,53,21,231,123,90,33
21,53,47,137,0,42,-42
21,55,21,33,53,39,14
21,55,21,139,45,54,-9
21,55,21,143,28,26,2
21,55,21,145,0,52,-52
21,55,21,225,46,44,2
21,55,21,233,0,38,-38
21,57,21,9,0,36,-36
21,57,21,53,0,48,-48
21,57,21,227,0,36,-36
21,59,18,97,0,27,-27
21,59,18,123,50,49,1
21,59,18,147,111,75,36
21,59,18,163,137,145,-8
21,59,18,173,67,52,15
21,59,21,15,0,39,-39
21,59,21,27,38,42,-4
21,59,21,67,95,165,-70
21,59,21,91,235,242,-7
21,59,21,101,172,117,55
21,59,21,107,80,60,20
21,59,21,111,198,232,-34
21,59,21,149,310,219,91
21,59,21,177,213,64,149
21,59,21,183,445,399,46
21,59,21,225,37,0,37
21,59,21,227,120,181,-61
21,59,21,233,34,0,34
21,59,47,37,45,45,0
21,61,21,9,44,51,-7
21,61,21,31,37,0,37
21,61,21,85,45,44,1
21,61,21,111,46,25,21
21,61,21,227,395,300,95
21,63,21,43,42,63,-21
21,63,21,175,42,34,8
21,63,21,205,0,39,-39
21,65,21,49,64,52,12
21,65,21,67,41,48,-7
21,65,21,151,232,324,-92
21,65,21,197,71,38,33
21,67,1,73,49,48,1
21,67,1,81,29,0,29
21,67,1,89,0,30,-30
21,67,4,13,71,92,-21
21,67,6,1,24,31,-7
21,67,6,37,144,108,36
21,67,6,59,74,37,37
21,67,6,67,28,0,28
21,67,6,71,30,0,30
21,67,6,73,105,68,37
21,67,6,85,0,81,-81
21,67,8,13,0,32,-32
21,67,8,31,0,28,-28
21,67,9,9,24,0,24
21,67,11,1,33,48,-15
21,67,12,9,45,0,45
21,67,12,11,64,71,-7
21,67,12,31,55,35,20
21,67,12,33,24,28,-4
21,67,12,57,86,63,23
21,67,12,69,0,27,-27
21,67,12,71,51,82,-31
21,67,12,83,30,0,30
21,67,12,86,81,58,23
21,67,12,91,35,0,35
21,67,12,95,51,91,-40
21,67,12,99,73,48,25
21,67,12,101,35,0,35
21,67,12,103,55,63,-8
21,67,12,105,28,0,28
21,67,12,115,34,36,-2
21,67,12,127,28,28,0
21,67,13,67,49,65,-16
21,67,13,89,35,45,-10
21,67,13,121,69,89,-20
21,67,13,135,37,58,-21
21,67,17,19,22,0,22
21,67,17,31,135,186,-51
21,67,17,43,45,43,2
21,67,17,97,28,0,28
21,67,17,111,0,22,-22
21,67,18,3,66,0,66
21,67,18,5,0,23,-23
21,67,18,19,35,38,-3
21,67,18,43,0,31,-31
21,67,18,57,40,39,1
21,67,18,97,98,94,4
21,67,18,157,30,0,30
21,67,18,163,31,26,5
21,67,20,91,29,0,29
21,67,20,173,25,0,25
21,67,21,5,187,246,-59
21,67,21,9,30,0,30
21,67,21,11,51,0,51
21,67,21,13,44,43,1
21,67,21,15,144,193,-49
21,67,21,17,468,557,-89
21,67,21,19,164,134,30
21,67,21,21,186,144,42
21,67,21,25,44,30,14
21,67,21,29,29,46,-17
21,67,21,35,34,0,34
21,67,21,37,81,105,-24
21,67,21,43,57,27,30
21,67,21,47,61,32,29
21,67,21,49,643,742,-99
21,67,21,51,30,0,30
21,67,21,59,165,95,70
21,67,21,65,48,41,7
21,67,21,69,33,38,-5
21,67,21,71,98,86,12
21,67,21,73,495,462,33
21,67,21,79,199,208,-9
21,67,21,81,50,42,8
21,67,21,89,74,57,17
21,67,21,93,161,102,59
21,67,21,95,43,33,10
21,67,21,97,167,126,41
21,67,21,101,48,0,48
21,67,21,107,62,29,33
21,67,21,109,26,0,26
21,67,21,111,877,1163,-286
21,67,21,113,1372,2023,-651
21,67,21,115,82,37,45
21,67,21,117,198,171,27
21,67,21,119,0,33,-33
21,67,21,121,28,27,1
21,67,21,125,140,99,41
21,67,21,133,42,51,-9
21,67,21,137,80,53,27
21,67,21,145,92,68,24
21,67,21,151,1135,921,214
21,67,21,153,29,0,29
21,67,21,155,53,36,17
21,67,21,161,69,67,2
21,67,21,163,38,0,38
21,67,21,167,205,220,-15
21,67,21,173,146,178,-32
21,67,21,179,55,64,-9
21,67,21,181,68,41,27
21,67,21,185,80,88,-8
21,67,21,187,28,0,28
21,67,21,191,0,24,-24
21,67,21,193,84,77,7
21,67,21,195,203,109,94
21,67,21,197,75,66,9
21,67,21,199,237,134,103
21,67,21,203,30,0,30
21,67,21,205,102,96,6
21,67,21,209,975,1434,-459
21,67,21,211,88,101,-13
21,67,21,217,78,30,48
21,67,21,227,159,100,59
21,67,21,229,63,39,24
21,67,21,231,40,0,40
21,67,21,235,96,38,58
21,67,21,237,36,0,36
21,67,21,239,590,729,-139
21,67,24,31,26,32,-6
21,67,24,33,0,22,-22
21,67,25,17,35,41,-6
21,67,26,65,37,0,37
21,67,26,77,22,0,22
21,67,26,81,48,0,48
21,67,26,99,34,0,34
21,67,26,125,101,38,63
21,67,26,163,124,34,90
21,67,27,53,0,56,-56
21,67,29,183,0,33,-33
21,67,29,189,36,52,-16
21,67,32,3,44,55,-11
21,67,34,23,0,25,-25
21,67,36,47,41,43,-2
21,67,36,55,35,0,35
21,67,36,61,0,57,-57
21,67,36,81,29,24,5
21,67,37,51,0,25,-25
21,67,37,81,0,31,-31
21,67,37,119,34,87,-53
21,67,37,133,42,31,11
21,67,37,183,55,77,-22
21,67,39,17,110,81,29
21,67,39,25,37,42,-5
21,67,39,35,43,36,7
21,67,39,41,0,28,-28
21,67,39,49,160,189,-29
21,67,39,57,27,0,27
21,67,39,61,229,207,22
21,67,39,87,28,0,28
21,67,39,109,25,0,25
21,67,39,113,62,65,-3
21,67,39,145,21,0,21
21,67,39,153,44,0,44
21,67,39,165,57,37,20
21,67,40,109,0,27,-27
21,67,41,51,0,31,-31
21,67,42,3,26,31,-5
21,67,42,101,0,35,-35
21,67,45,13,39,0,39
21,67,45,19,27,62,-35
21,67,45,45,0,46,-46
21,67,45,79,0,27,-27
21,67,47,37,98,163,-65
21,67,47,65,0,30,-30
21,67,47,93,77,93,-16
21,67,47,125,77,36,41
21,67,47,149,43,45,-2
21,67,47,157,72,81,-9
21,67,47,187,27,36,-9
21,67,48,27,27,0,27
21,67,48,29,0,38,-38
21,67,48,85,30,0,30
21,67,48,113,46,72,-26
21,67,48,121,32,0,32
21,67,48,157,0,38,-38
21,67,48,201,59,75,-16
21,67,48,439,37,34,3
21,67,48,453,0,55,-55
21,67,49,35,34,0,34
21,67,51,59,53,60,-7
21,67,51,810,32,0,32
21,67,53,33,36,90,-54
21,67,53,53,0,34,-34
21,67,54,11,48,0,48
21,67,54,39,33,55,-22
21,67,55,25,35,29,6
21,67,55,79,0,25,-25
21,69,21,11,28,54,-26
21,69,21,67,38,33,5
21,69,21,135,61,45,16
21,69,21,161,147,153,-6
21,69,21,173,42,0,42
21,69,21,205,140,166,-26
21,71,21,67,86,98,-12
21,71,21,115,217,264,-47
21,71,21,119,85,82,3
21,71,21,151,0,58,-58
21,71,21,153,80,51,29
21,71,21,159,32,24,8
21,71,21,195,342,434,-92
21,71,21,205,0,32,-32
21,73,17,31,30,0,30
21,73,21,5,490,459,31
21,73,21,17,33,0,33
21,73,21,67,462,495,-33
21,73,21,103,50,47,3
21,73,21,111,202,246,-44
21,73,21,113,37,0,37
21,73,21,117,26,0,26
21,73,21,151,52,40,12
21,73,21,167,51,36,15
21,73,21,187,99,76,23
21,73,21,209,149,142,7
21,73,21,211,168,208,-40
21,73,21,239,157,162,-5
21,73,26,163,29,0,29
21,73,39,61,0,27,-27
21,75,21,83,46,53,-7
21,75,21,105,31,32,-1
21,75,47,131,274,207,67
21,75,47,183,50,46,4
21,77,21,15,157,229,-72
21,77,21,41,92,103,-11
21,77,21,81,104,59,45
21,77,21,117,120,77,43
21,77,21,187,64,56,8
21,79,21,21,122,164,-42
21,79,21,67,208,199,9
21,79,21,113,284,282,2
21,79,21,137,140,190,-50
21,79,21,151,166,117,49
21,79,21,167,55,45,10
21,79,21,199,30,40,-10
21,79,21,203,0,36,-36
21,81,21,15,698,624,74
21,81,21,37,81,65,16
21,81,21,67,42,50,-8
21,81,21,77,59,104,-45
21,81,21,97,46,55,-9
21,81,21,117,578,467,111
21,81,21,187,123,94,29
21,81,21,191,169,130,39
21,81,21,209,0,65,-65
21,81,39,17,38,0,38
21,81,39,25,0,27,-27
21,81,39,61,83,64,19
21,83,17,127,35,0,35
21,83,21,35,162,206,-44
21,83,21,39,49,53,-4
21,83,21,75,53,46,7
21,83,21,105,66,73,-7
21,83,21,111,0,35,-35
21,83,21,145,334,372,-38
21,83,21,157,107,151,-44
21,83,47,37,0,48,-48
21,83,47,131,56,80,-24
21,83,47,183,0,37,-37
21,85,21,27,110,76,34
21,85,21,29,0,57,-57
21,85,21,31,0,32,-32
21,85,21,61,44,45,-1
21,85,21,93,196,153,43
21,85,21,111,211,118,93
21,85,21,183,56,66,-10
21,85,21,227,38,69,-31
21,87,21,1,39,53,-14
21,87,21,99,38,0,38
21,87,21,111,0,25,-25
21,87,21,123,54,37,17
21,87,21,155,0,34,-34
21,87,21,169,0,27,-27
21,87,21,217,155,193,-38
21,89,21,19,723,703,20
21,89,21,43,122,118,4
21,89,21,67,57,74,-17
21,89,21,111,30,34,-4
21,89,21,127,0,42,-42
21,89,21,135,79,55,24
21,89,21,205,34,0,34
21,89,39,49,43,34,9
21,89,39,87,183,192,-9
21,89,39,145,185,200,-15
21,89,54,11,0,33,-33
21,91,18,123,74,61,13
21,91,21,27,48,53,-5
21,91,21,59,242,235,7
21,93,2,90,85,64,21
21,93,4,13,40,46,-6
21,93,6,37,38,29,9
21,93,6,71,120,96,24
21,93,6,73,55,39,16
21,93,8,41,178,125,53
21,93,12,57,33,39,-6
21,93,13,51,0,39,-39
21,93,13,179,84,138,-54
21,93,13,215,0,55,-55
21,93,13,245,0,52,-52
21,93,15,3,120,101,19
21,93,17,31,41,0,41
21,93,18,19,35,67,-32
21,93,18,43,29,49,-20
21,93,18,97,33,28,5
21,93,20,61,0,207,-207
21,93,20,103,62,103,-41
21,93,20,161,0,122,-122
21,93,21,9,39,39,0
21,93,21,27,118,193,-75
21,93,21,29,221,228,-7
21,93,21,47,123,75,48
21,93,21,67,102,161,-59
21,93,21,85,153,196,-43
21,93,21,99,90,135,-45
21,93,21,111,923,1047,-124
21,93,21,123,422,493,-71
21,93,21,151,46,36,10
21,93,21,163,699,630,69
21,93,21,179,153,169,-16
21,93,21,185,33,28,5
21,93,21,217,48,72,-24
21,93,21,227,88,116,-28
21,93,22,115,57,0,57
21,93,24,3,32,0,32
21,93,26,125,44,0,44
21,93,26,163,42,0,42
21,93,29,169,54,63,-9
21,93,32,3,42,0,42
21,93,36,45,92,76,16
21,93,36,71,34,0,34
21,93,37,51,99,176,-77
21,93,37,133,51,76,-25
21,93,39,49,38,22,16
21,93,40,31,78,0,78
21,93,45,79,57,32,25
21,93,47,37,30,46,-16
21,93,47,93,0,29,-29
21,93,47,125,234,157,77
21,93,48,27,307,379,-72
21,93,48,29,86,81,5
21,93,48,99,138,105,33
21,93,48,113,0,35,-35
21,93,48,141,67,136,-69
21,93,48,201,59,0,59
21,93,48,439,39,0,39
21,93,51,59,51,0,51
21,93,51,700,47,0,47
21,93,53,53,130,126,4
21,93,53,67,0,62,-62
21,95,21,13,50,105,-55
21,95,21,67,33,43,-10
21,95,21,125,0,42,-42
21,95,21,131,47,0,47
21,95,21,133,49,59,-10
21,95,21,151,0,53,-53
21,95,47,25,0,46,-46
21,95,51,105,34,0,34
21,97,21,17,120,145,-25
21,97,21,67,126,167,-41
21,97,21,81,55,46,9
21,97,21,111,0,25,-25
21,97,21,113,0,35,-35
21,97,21,151,0,34,-34
21,97,21,181,50,50,0
21,97,21,191,60,41,19
21,97,21,209,225,198,27
21,99,21,9,275,287,-12
21,99,21,29,48,0,48
21,99,21,87,0,38,-38
21,99,21,93,135,90,45
21,99,21,111,79,86,-7
21,99,21,123,94,86,8
21,99,21,169,52,49,3
21,99,21,227,37,66,-29
21,101,18,51,28,0,28
21,101,18,97,0,23,-23
21,101,18,163,568,502,66
21,101,18,173,91,132,-41
21,101,21,59,117,172,-55
21,101,21,67,0,48,-48
21,101,21,107,85,121,-36
21,101,21,111,34,54,-20
21,101,21,177,23,0,23
21,101,21,225,251,178,73
21,101,21,227,0,23,-23
21,101,21,233,256,118,138
21,103,21,41,83,37,46
21,103,21,73,47,50,-3
21,103,21,111,236,206,30
21,103,21,185,264,228,36
21,103,21,211,225,198,27
21,103,21,223,81,117,-36
21,105,21,39,47,44,3
21,105,21,75,32,31,1
21,105,21,83,73,66,7
21,105,21,145,26,0,26
21,105,47,131,0,50,-50
21,107,18,163,66,83,-17
21,107,21,33,79,100,-21
21,107,21,47,198,154,44
21,107,21,59,60,80,-20
21,107,21,67,29,62,-33
21,107,21,101,121,85,36
21,107,21,111,41,55,-14
21,107,21,143,32,0,32
21,107,21,145,37,0,37
21,107,21,149,48,52,-4
21,107,21,177,150,175,-25
21,107,21,221,0,42,-42
21,107,21,225,47,65,-18
21,107,21,227,37,58,-21
21,107,21,233,381,254,127
21,107,47,125,36,43,-7
21,109,21,51,69,56,13
21,109,21,67,0,26,-26
21,109,21,125,90,79,11
21,109,21,151,132,188,-56
21,111,1,73,50,64,-14
21,111,1,89,0,61,-61
21,111,1,97,32,0,32
21,111,1,101,35,0,35
21,111,1,125,40,0,40
21,111,2,20,34,53,-19
21,111,4,13,159,211,-52
21,111,4,19,86,56,30
21,111,5,119,50,34,16
21,111,6,1,0,55,-55
21,111,6,13,27,46,-19
21,111,6,37,183,224,-41
21,111,6,59,134,66,68
21,111,6,65,31,27,4
21,111,6,67,47,46,1
21,111,6,71,53,55,-2
21,111,6,73,171,132,39
21,111,6,75,48,41,7
21,111,6,85,40,31,9
21,111,8,5,0,41,-41
21,111,8,13,0,36,-36
21,111,8,31,31,47,-16
21,111,8,41,58,55,3
21,111,8,59,0,39,-39
21,111,9,3,52,0,52
21,111,9,9,45,26,19
21,111,10,3,34,0,34
21,111,11,1,50,70,-20
21,111,12,1,46,36,10
21,111,12,5,0,27,-27
21,111,12,9,49,40,9
21,111,12,11,170,127,43
21,111,12,19,32,0,32
21,111,12,21,34,46,-12
21,111,12,31,111,180,-69
21,111,12,33,33,37,-4
21,111,12,57,166,211,-45
21,111,12,71,117,111,6
21,111,12,73,26,26,0
21,111,12,81,37,75,-38
21,111,12,83,0,42,-42
21,111,12,86,271,186,85
21,111,12,95,153,117,36
21,111,12,99,107,116,-9
21,111,12,101,64,27,37
21,111,12,103,115,152,-37
21,111,12,105,35,52,-17
21,111,12,109,0,24,-24
21,111,12,111,40,0,40
21,111,12,113,0,29,-29
21,111,12,115,67,65,2
21,111,12,117,41,32,9
21,111,12,127,77,26,51
21,111,13,51,39,43,-4
21,111,13,57,0,34,-34
21,111,13,63,52,51,1
21,111,13,67,110,107,3
21,111,13,89,119,94,25
21,111,13,97,34,0,34
21,111,13,121,152,176,-24
21,111,13,135,68,87,-19
21,111,15,3,50,37,13
21,111,17,19,44,0,44
21,111,17,31,435,363,72
21,111,17,43,96,78,18
21,111,17,77,39,0,39
21,111,17,89,39,37,2
21,111,17,97,60,56,4
21,111,17,113,37,0,37
21,111,17,163,29,0,29
21,111,17,167,33,0,33
21,111,17,197,30,34,-4
21,111,17,201,38,0,38
21,111,18,3,94,38,56
21,111,18,5,47,22,25
21,111,18,19,1858,2447,-589
21,111,18,25,44,40,4
21,111,18,35,24,0,24
21,111,18,37,27,0,27
21,111,18,43,1110,1411,-301
21,111,18,57,104,101,3
21,111,18,61,288,308,-20
21,111,18,63,48,0,48
21,111,18,71,29,36,-7
21,111,18,77,56,42,14
21,111,18,81,43,50,-7
21,111,18,89,28,43,-15
21,111,18,97,362,341,21
21,111,18,105,106,67,39
21,111,18,123,32,0,32
21,111,18,141,36,52,-16
21,111,18,143,90,82,8
21,111,18,157,40,29,11
21,111,18,163,191,84,107
21,111,18,167,47,0,47
21,111,18,173,51,37,14
21,111,18,175,102,104,-2
21,111,19,113,30,0,30
21,111,20,91,70,52,18
21,111,21,1,28,27,1
21,111,21,5,57,53,4
21,111,21,9,52,67,-15
21,111,21,15,179,155,24
21,111,21,19,38,26,12
21,111,21,21,57,47,10
21,111,21,27,175,237,-62
21,111,21,29,3047,4099,-1052
21,111,21,33,26,0,26
21,111,21,35,111,82,29
21,111,21,37,93,84,9
21,111,21,41,45,75,-30
21,111,21,45,28,0,28
21,111,21,47,125,52,73
21,111,21,49,24,28,-4
21,111,21,59,232,198,34
21,111,21,61,25,46,-21
21,111,21,67,1163,877,286
21,111,21,73,246,202,44
21,111,21,83,35,0,35
21,111,21,85,118,211,-93
21,111,21,87,25,0,25
21,111,21,89,34,30,4
21,111,21,93,1047,923,124
21,111,21,97,25,0,25
21,111,21,99,86,79,7
21,111,21,101,54,34,20
21,111,21,103,206,236,-30
21,111,21,107,55,41,14
21,111,21,113,49,49,0
21,111,21,117,150,188,-38
21,111,21,123,101,66,35
21,111,21,125,39,50,-11
21,111,21,141,22,22,0
21,111,21,145,137,107,30
21,111,21,151,165,99,66
21,111,21,155,87,80,7
21,111,21,157,37,0,37
21,111,21,163,451,519,-68
21,111,21,167,0,41,-41
21,111,21,177,37,28,9
21,111,21,179,502,648,-146
21,111,21,183,25,31,-6
21,111,21,185,1775,2324,-549
21,111,21,195,29,0,29
21,111,21,199,50,71,-21
21,111,21,205,33,0,33
21,111,21,209,101,119,-18
21,111,21,211,936,1006,-70
21,111,21,213,28,0,28
21,111,21,215,478,820,-342
21,111,21,217,95,68,27
21,111,21,221,36,0,36
21,111,21,223,67,58,9
21,111,21,227,356,216,140
21,111,21,229,85,48,37
21,111,21,239,60,32,28
21,111,22,33,0,27,-27
21,111,22,51,25,63,-38
21,111,22,71,30,57,-27
21,111,24,3,0,32,-32
21,111,24,5,45,58,-13
21,111,24,27,29,0,29
21,111,24,31,70,50,20
21,111,24,510,31,29,2
21,111,25,17,76,40,36
21,111,25,25,28,37,-9
21,111,26,49,51,29,22
21,111,26,65,60,0,60
21,111,26,81,64,0,64
21,111,26,99,41,0,41
21,111,26,125,117,49,68
21,111,26,161,49,43,6
21,111,26,163,163,75,88
21,111,27,53,88,64,24
21,111,27,123,41,24,17
21,111,29,19,35,0,35
21,111,29,95,44,0,44
21,111,29,183,49,27,22
21,111,29,189,101,117,-16
21,111,29,510,40,76,-36
21,111,31,55,35,0,35
21,111,32,3,175,138,37
21,111,33,11,49,30,19
21,111,34,17,0,22,-22
21,111,34,23,49,0,49
21,111,34,25,24,0,24
21,111,36,5,30,21,9
21,111,36,29,51,33,18
21,111,36,47,89,68,21
21,111,36,59,30,0,30
21,111,36,61,80,106,-26
21,111,36,67,59,0,59
21,111,36,81,35,37,-2
21,111,36,103,35,0,35
21,111,37,21,25,26,-1
21,111,37,25,47,0,47
21,111,37,51,39,56,-17
21,111,37,63,36,37,-1
21,111,37,67,38,30,8
21,111,37,81,36,0,36
21,111,37,119,102,120,-18
21,111,37,133,55,42,13
21,111,37,183,52,89,-37
21,111,39,17,96,89,7
21,111,39,25,32,44,-12
21,111,39,35,161,123,38
21,111,39,49,277,231,46
21,111,39,57,38,32,6
21,111,39,61,342,251,91
21,111,39,93,52,58,-6
21,111,39,95,67,0,67
21,111,39,113,86,69,17
21,111,39,153,45,60,-15
21,111,39,165,63,50,13
21,111,40,109,47,41,6
21,111,40,143,44,34,10
21,111,41,51,0,53,-53
21,111,42,3,82,72,10
21,111,42,29,0,32,-32
21,111,42,91,38,33,5
21,111,42,101,57,43,14
21,111,44,7,0,36,-36
21,111,45,19,56,49,7
21,111,45,45,41,74,-33
21,111,45,51,26,0,26
21,111,45,79,43,38,5
21,111,47,37,341,348,-7
21,111,47,65,48,35,13
21,111,47,93,73,88,-15
21,111,47,125,127,58,69
21,111,47,149,49,78,-29
21,111,47,157,167,160,7
21,111,47,165,79,75,4
21,111,47,187,62,104,-42
21,111,48,27,70,32,38
21,111,48,29,97,80,17
21,111,48,85,0,56,-56
21,111,48,113,125,142,-17
21,111,48,121,45,28,17
21,111,48,141,0,58,-58
21,111,48,157,0,60,-60
21,111,48,201,164,245,-81
21,111,48,339,0,26,-26
21,111,48,439,55,77,-22
21,111,48,453,69,42,27
21,111,48,491,0,31,-31
21,111,49,35,65,54,11
21,111,51,13,23,25,-2
21,111,51,59,108,104,4
21,111,51,87,36,0,36
21,111,51,107,38,0,38
21,111,51,153,50,0,50
21,111,51,510,29,31,-2
21,111,51,710,41,26,15
21,111,51,760,0,27,-27
21,111,51,810,77,55,22
21,111,53,33,64,78,-14
21,111,53,53,36,38,-2
21,111,54,39,42,0,42
21,111,54,79,25,0,25
21,111,55,25,0,23,-23
21,111,55,79,87,51,36
21,111,55,133,0,44,-44
21,113,21,5,43,43,0
21,113,21,17,34,53,-19
21,113,21,21,101,43,58
21,113,21,49,45,41,4
21,113,21,67,2023,1372,651
21,113,21,73,0,37,-37
21,113,21,79,282,284,-2
21,113,21,97,35,0,35
21,113,21,111,49,49,0
21,113,21,137,61,51,10
21,113,21,151,134,126,8
21,113,21,167,57,86,-29
21,113,21,199,39,46,-7
21,113,21,209,99,134,-35
21,113,21,239,118,100,18
21,113,39,61,30,0,30
21,115,21,67,37,82,-45
21,115,21,71,264,217,47
21,115,21,127,122,117,5
21,115,21,153,78,65,13
21,115,21,159,53,44,9
21,115,21,195,38,39,-1
21,117,4,13,32,56,-24
21,117,6,37,24,51,-27
21,117,6,73,45,27,18
21,117,12,11,41,0,41
21,117,12,57,0,25,-25
21,117,12,71,27,26,1
21,117,12,86,0,27,-27
21,117,12,103,43,49,-6
21,117,17,31,58,53,5
21,117,18,29,152,104,48
21,117,18,97,29,31,-2
21,117,18,137,38,0,38
21,117,21,15,4267,4951,-684
21,117,21,23,41,67,-26
21,117,21,37,2378,2049,329
21,117,21,41,41,46,-5
21,117,21,67,171,198,-27
21,117,21,73,0,26,-26
21,117,21,77,77,120,-43
21,117,21,81,467,578,-111
21,117,21,111,188,150,38
21,117,21,151,54,26,28
21,117,21,161,0,35,-35
21,117,21,187,45,69,-24
21,117,21,191,154,229,-75
21,117,21,209,41,0,41
21,117,26,125,62,0,62
21,117,32,3,28,38,-10
21,117,36,61,24,0,24
21,117,37,119,0,37,-37
21,117,39,15,29,36,-7
21,117,39,17,289,254,35
21,117,39,25,430,326,104
21,117,39,35,28,0,28
21,117,39,49,120,104,16
21,117,39,57,35,0,35
21,117,39,61,2543,1886,657
21,117,39,95,25,0,25
21,117,39,113,106,75,31
21,117,39,165,135,123,12
21,117,47,37,31,30,1
21,117,48,201,0,28,-28
21,117,48,439,0,28,-28
21,117,53,33,29,30,-1
21,119,21,67,33,0,33
21,119,21,71,82,85,-3
21,119,21,133,78,34,44
21,119,21,193,261,264,-3
21,121,21,13,140,69,71
21,121,21,51,0,44,-44
21,121,21,67,27,28,-1
21,121,21,125,379,346,33
21,121,21,151,45,24,21
21,121,21,235,378,436,-58
21,121,39,61,32,0,32
21,123,21,29,0,34,-34
21,123,21,87,37,54,-17
21,123,21,93,493,422,71
21,123,21,99,86,94,-8
21,123,21,111,66,101,-35
21,123,21,179,86,66,20
21,123,21,217,49,32,17
21,123,21,227,0,28,-28
21,125,18,97,38,0,38
21,125,21,13,42,42,0
21,125,21,51,476,455,21
21,125,21,67,99,140,-41
21,125,21,95,42,0,42
21,125,21,109,79,90,-11
21,125,21,111,50,39,11
21,125,21,121,346,379,-33
21,125,21,131,65,27,38
21,125,21,151,119,122,-3
21,125,21,193,54,43,11
21,125,21,199,57,99,-42
21,125,21,203,73,53,20
21,125,21,209,0,35,-35
21,125,21,235,400,442,-42
21,125,39,17,31,0,31
21,125,47,93,34,0,34
21,127,21,19,57,87,-30
21,127,21,43,0,37,-37
21,127,21,89,42,0,42
21,127,21,115,117,122,-5
21,127,21,159,106,45,61
21,127,54,99,99,79,20
21,129,21,151,0,52,-52
21,129,21,189,0,52,-52
21,131,21,51,58,46,12
21,131,21,95,0,47,-47
21,131,21,125,27,65,-38
21,131,21,193,52,106,-54
21,133,21,67,51,42,9
21,133,21,95,59,49,10
21,133,21,119,34,78,-44
21,133,21,193,92,105,-13
21,133,21,195,65,100,-35
21,133,51,195,48,58,-10
21,135,21,43,37,80,-43
21,135,21,69,45,61,-16
21,135,21,89,55,79,-24
21,135,21,161,114,156,-42
21,135,39,145,47,44,3
21,137,21,21,449,540,-91
21,137,21,45,98,151,-53
21,137,21,67,53,80,-27
21,137,21,79,190,140,50
21,137,21,113,51,61,-10
21,137,21,151,51,44,7
21,137,21,167,79,82,-3
21,137,21,199,131,193,-62
21,137,21,203,46,58,-12
21,139,21,55,54,45,9
21,139,21,143,0,33,-33
21,139,21,145,240,243,-3
21,139,21,157,119,146,-27
21,141,21,3,35,47,-12
21,141,21,31,43,58,-15
21,141,21,47,33,44,-11
21,141,21,111,22,22,0
21,141,21,177,75,95,-20
21,141,21,213,98,84,14
21,141,21,219,112,88,24
21,141,21,227,329,388,-59
21,141,47,37,43,23,20
21,141,47,125,53,62,-9
21,141,47,147,110,92,18
21,141,47,165,44,65,-21
21,143,21,33,111,158,-47
21,143,21,47,0,24,-24
21,143,21,55,26,28,-2
21,143,21,107,0,32,-32
21,143,21,139,33,0,33
21,143,21,145,33,39,-6
21,143,21,157,59,59,0
21,143,21,221,34,0,34
21,145,17,31,39,36,3
21,145,17,87,24,34,-10
21,145,17,127,317,209,108
21,145,17,199,29,34,-5
21,145,18,163,0,43,-43
21,145,21,7,242,277,-35
21,145,21,33,33,0,33
21,145,21,35,191,141,50
21,145,21,39,67,42,25
21,145,21,47,38,28,10
21,145,21,55,52,0,52
21,145,21,67,68,92,-24
21,145,21,83,372,334,38
21,145,21,105,0,26,-26
21,145,21,107,0,37,-37
21,145,21,111,107,137,-30
21,145,21,139,243,240,3
21,145,21,143,39,33,6
21,145,21,157,499,398,101
21,145,29,189,40,0,40
21,145,47,37,72,116,-44
21,145,47,125,35,0,35
21,145,47,131,36,0,36
21,145,47,149,0,38,-38
21,145,47,157,0,22,-22
21,147,21,199,104,119,-15
21,147,21,235,39,37,2
21,147,47,151,109,92,17
21,149,21,59,219,310,-91
21,149,21,107,52,48,4
21,149,21,177,78,67,11
21,149,21,183,46,29,17
21,151,6,73,28,0,28
21,151,18,97,0,39,-39
21,151,21,13,29,32,-3
21,151,21,15,42,57,-15
21,151,21,17,0,41,-41
21,151,21,19,30,0,30
21,151,21,21,46,41,5
21,151,21,37,0,33,-33
21,151,21,45,29,0,29
21,151,21,49,212,171,41
21,151,21,51,35,0,35
21,151,21,65,324,232,92
21,151,21,67,921,1135,-214
21,151,21,71,58,0,58
21,151,21,73,40,52,-12
21,151,21,79,117,166,-49
21,151,21,93,36,46,-10
21,151,21,95,53,0,53
21,151,21,97,34,0,34
21,151,21,109,188,132,56
21,151,21,111,99,165,-66
21,151,21,113,126,134,-8
21,151,21,117,26,54,-28
21,151,21,121,24,45,-21
21,151,21,125,122,119,3
21,151,21,129,52,0,52
21,151,21,137,44,51,-7
21,151,21,173,44,40,4
21,151,21,193,38,0,38
21,151,21,195,0,34,-34
21,151,21,197,41,0,41
21,151,21,199,82,94,-12
21,151,21,203,293,249,44
21,151,21,209,46,121,-75
21,151,21,227,0,28,-28
21,151,21,235,43,44,-1
21,151,39,17,46,32,14
21,151,39,61,48,35,13
21,151,39,113,41,0,41
21,151,39,165,31,0,31
21,151,47,37,0,27,-27
21,153,21,67,0,29,-29
21,153,21,71,51,80,-29
21,153,21,115,65,78,-13
21,153,21,175,0,42,-42
21,155,21,21,0,63,-63
21,155,21,45,0,32,-32
21,155,21,67,36,53,-17
21,155,21,87,34,0,34
21,155,21,111,80,87,-7
21,155,21,179,142,119,23
21,155,21,217,127,101,26
21,155,21,229,120,101,19
21,157,21,35,245,299,-54
21,157,21,83,151,107,44
21,157,21,111,0,37,-37
21,157,21,139,146,119,27
21,157,21,143,59,59,0
21,157,21,145,398,499,-101
21,159,21,71,24,32,-8
21,159,21,115,44,53,-9
21,159,21,127,45,106,-61
21,159,39,49,28,0,28
21,159,54,59,53,51,2
21,161,21,15,0,39,-39
21,161,21,23,87,88,-1
21,161,21,37,28,0,28
21,161,21,67,67,69,-2
21,161,21,69,153,147,6
21,161,21,117,35,0,35
21,161,21,135,156,114,42
21,161,39,1,63,0,63
21,161,39,15,115,114,1
21,161,39,25,41,30,11
21,163,2,90,43,0,43
21,163,6,71,47,0,47
21,163,8,41,55,67,-12
21,163,18,61,38,46,-8
21,163,20,61,0,57,-57
21,163,20,161,0,45,-45
21,163,21,27,214,195,19
21,163,21,29,75,74,1
21,163,21,67,0,38,-38
21,163,21,93,630,699,-69
21,163,21,111,519,451,68
21,163,36,45,57,0,57
21,163,47,125,42,0,42
21,163,48,27,165,112,53
21,163,48,99,56,0,56
21,163,53,53,0,79,-79
21,163,53,67,0,47,-47
21,165,21,11,0,59,-59
21,165,21,173,114,126,-12
21,165,21,175,44,0,44
21,165,21,205,0,51,-51
21,167,21,5,111,143,-32
21,167,21,21,239,248,-9
21,167,21,67,220,205,15
21,167,21,73,36,51,-15
21,167,21,79,45,55,-10
21,167,21,111,41,0,41
21,167,21,113,86,57,29
21,167,21,137,82,79,3
21,167,21,209,36,0,36
21,167,21,229,39,37,2
21,167,21,239,49,46,3
21,169,21,1,36,0,36
21,169,21,9,196,298,-102
21,169,21,87,27,0,27
21,169,21,99,49,52,-3
21,169,21,171,35,46,-11
21,169,21,227,0,25,-25
21,171,21,9,92,165,-73
21,171,21,169,46,35,11
21,171,21,227,0,78,-78
21,171,47,27,33,27,6
21,171,47,111,63,105,-42
21,173,21,11,244,267,-23
21,173,21,17,67,50,17
21,173,21,49,260,160,100
21,173,21,67,178,146,32
21,173,21,69,0,42,-42
21,173,21,151,40,44,-4
21,173,21,165,126,114,12
21,173,21,197,159,125,34
21,173,21,205,89,83,6
21,173,21,209,0,34,-34
21,175,21,63,34,42,-8
21,175,21,153,42,0,42
21,175,21,165,0,44,-44
21,175,21,205,69,85,-16
21,177,21,31,29,0,29
21,177,21,47,28,25,3
21,177,21,59,64,213,-149
21,177,21,101,0,23,-23
21,177,21,107,175,150,25
21,177,21,111,28,37,-9
21,177,21,141,95,75,20
21,177,21,149,67,78,-11
21,177,21,183,55,62,-7
21,177,21,227,55,103,-48
21,179,18,19,38,32,6
21,179,21,29,360,254,106
21,179,21,67,64,55,9
21,179,21,93,169,153,16
21,179,21,111,648,502,146
21,179,21,123,66,86,-20
21,179,21,155,119,142,-23
21,179,21,185,46,0,46
21,179,21,211,42,0,42
21,179,21,215,82,83,-1
21,179,21,217,0,31,-31
21,179,21,229,126,149,-23
21,181,21,11,0,54,-54
21,181,21,17,120,116,4
21,181,21,67,41,68,-27
21,181,21,97,50,50,0
21,183,21,31,63,47,16
21,183,21,59,399,445,-46
21,183,21,85,66,56,10
21,183,21,111,31,25,6
21,183,21,149,29,46,-17
21,183,21,177,62,55,7
21,183,21,227,42,84,-42
21,185,18,19,67,40,27
21,185,18,43,0,32,-32
21,185,21,15,32,0,32
21,185,21,29,60,57,3
21,185,21,67,88,80,8
21,185,21,93,28,33,-5
21,185,21,103,228,264,-36
21,185,21,111,2324,1775,549
21,185,21,179,0,46,-46
21,185,21,211,104,178,-74
21,185,21,223,52,127,-75
21,185,39,61,30,0,30
21,187,21,15,79,52,27
21,187,21,41,109,58,51
21,187,21,67,0,28,-28
21,187,21,73,76,99,-23
21,187,21,77,56,64,-8
21,187,21,81,94,123,-29
21,187,21,117,69,45,24
21,187,21,209,40,52,-12
21,189,21,129,52,0,52
21,191,21,15,116,116,0
21,191,21,23,77,53,24
21,191,21,37,296,274,22
21,191,21,67,24,0,24
21,191,21,81,130,169,-39
21,191,21,97,41,60,-19
21,191,21,117,229,154,75
21,191,39,61,43,34,9
21,193,21,25,84,49,35
21,193,21,67,77,84,-7
21,193,21,119,264,261,3
21,193,21,125,43,54,-11
21,193,21,131,106,52,54
21,193,21,133,105,92,13
21,193,21,151,0,38,-38
21,195,21,67,109,203,-94
21,195,21,71,434,342,92
21,195,21,111,0,29,-29
21,195,21,115,39,38,1
21,195,21,133,100,65,35
21,195,21,151,34,0,34
21,195,21,205,32,39,-7
21,195,47,89,0,34,-34
21,195,51,27,46,41,5
21,195,54,59,258,181,77
21,197,21,49,167,185,-18
21,197,21,65,38,71,-33
21,197,21,67,66,75,-9
21,197,21,151,0,41,-41
21,197,21,173,125,159,-34
21,197,21,237,41,33,8
21,199,21,45,82,79,3
21,199,21,67,134,237,-103
21,199,21,79,40,30,10
21,199,21,111,71,50,21
21,199,21,113,46,39,7
21,199,21,125,99,57,42
21,199,21,137,193,131,62
21,199,21,147,119,104,15
21,199,21,151,94,82,12
21,199,21,203,66,48,18
21,199,21,207,104,58,46
21,199,21,217,0,26,-26
21,199,21,227,0,48,-48
21,199,21,231,207,166,41
21,199,21,235,53,0,53
21,199,39,61,40,31,9
21,199,47,93,0,31,-31
21,203,21,67,0,30,-30
21,203,21,79,36,0,36
21,203,21,125,53,73,-20
21,203,21,137,58,46,12
21,203,21,151,249,293,-44
21,203,21,199,48,66,-18
21,203,39,17,30,0,30
21,205,21,11,70,92,-22
21,205,21,19,26,52,-26
21,205,21,43,181,146,35
21,205,21,49,30,36,-6
21,205,21,63,39,0,39
21,205,21,67,96,102,-6
21,205,21,69,166,140,26
21,205,21,71,32,0,32
21,205,21,89,0,34,-34
21,205,21,111,0,33,-33
21,205,21,165,51,0,51
21,205,21,173,83,89,-6
21,205,21,175,85,69,16
21,205,21,195,39,32,7
21,207,21,1,160,119,41
21,207,21,45,59,37,22
21,207,21,199,58,104,-46
21,207,21,217,0,36,-36
21,209,21,5,28,41,-13
21,209,21,15,40,46,-6
21,209,21,17,198,120,78
21,209,21,49,57,80,-23
21,209,21,67,1434,975,459
21,209,21,73,142,149,-7
21,209,21,81,65,0,65
21,209,21,97,198,225,-27
21,209,21,111,119,101,18
21,209,21,113,134,99,35
21,209,21,117,0,41,-41
21,209,21,125,35,0,35
21,209,21,151,121,46,75
21,209,21,167,0,36,-36
21,209,21,173,34,0,34
21,209,21,187,52,40,12
21,209,21,211,28,0,28
21,209,21,239,89,63,26
21,211,18,19,44,58,-14
21,211,21,5,76,74,2
21,211,21,29,83,77,6
21,211,21,67,101,88,13
21,211,21,73,208,168,40
21,211,21,103,198,225,-27
21,211,21,111,1006,936,70
21,211,21,179,0,42,-42
21,211,21,185,178,104,74
21,211,21,209,0,28,-28
21,211,21,215,160,138,22
21,213,21,3,85,83,2
21,213,21,111,0,28,-28
21,213,21,141,84,98,-14
21,213,21,227,290,368,-78
21,213,47,37,42,49,-7
21,213,47,147,62,72,-10
21,213,47,165,161,136,25
21,215,21,29,205,188,17
21,215,21,111,820,478,342
21,215,21,179,83,82,1
21,215,21,211,138,160,-22
21,217,21,1,161,119,42
21,217,21,45,60,29,31
21,217,21,67,30,78,-48
21,217,21,87,193,155,38
21,217,21,93,72,48,24
21,217,21,111,68,95,-27
21,217,21,123,32,49,-17
21,217,21,155,101,127,-26
21,217,21,179,31,0,31
21,217,21,199,26,0,26
21,217,21,207,36,0,36
21,217,21,227,0,37,-37
21,219,21,47,199,162,37
21,219,21,141,88,112,-24
21,219,47,125,174,114,60
21,221,18,163,30,0,30
21,221,21,33,68,45,23
21,221,21,35,0,21,-21
21,221,21,47,287,247,40
21,221,21,107,42,0,42
21,221,21,111,0,36,-36
21,221,21,143,0,34,-34
21,221,47,125,56,42,14
21,223,18,77,132,149,-17
21,223,21,41,134,140,-6
21,223,21,103,117,81,36
21,223,21,111,58,67,-9
21,223,21,185,127,52,75
21,225,18,163,49,50,-1
21,225,21,55,44,46,-2
21,225,21,59,0,37,-37
21,225,21,101,178,251,-73
21,225,21,107,65,47,18
21,225,21,233,43,78,-35
21,227,6,37,40,32,8
21,227,12,31,34,0,34
21,227,12,103,27,0,27
21,227,13,121,0,23,-23
21,227,17,31,0,46,-46
21,227,18,97,42,37,5
21,227,18,163,0,27,-27
21,227,21,3,362,267,95
21,227,21,9,410,290,120
21,227,21,27,25,0,25
21,227,21,29,39,0,39
21,227,21,31,387,320,67
21,227,21,35,40,0,40
21,227,21,47,63,56,7
21,227,21,57,36,0,36
21,227,21,59,181,120,61
21,227,21,61,300,395,-95
21,227,21,67,100,159,-59
21,227,21,85,69,38,31
21,227,21,93,116,88,28
21,227,21,99,66,37,29
21,227,21,101,23,0,23
21,227,21,107,58,37,21
21,227,21,111,216,356,-140
21,227,21,123,28,0,28
21,227,21,141,388,329,59
21,227,21,151,28,0,28
21,227,21,169,25,0,25
21,227,21,171,78,0,78
21,227,21,177,103,55,48
21,227,21,183,84,42,42
21,227,21,199,48,0,48
21,227,21,213,368,290,78
21,227,21,217,37,0,37
21,227,34,23,0,38,-38
21,227,39,49,0,23,-23
21,227,47,37,178,308,-130
21,227,47,65,24,0,24
21,227,47,93,0,24,-24
21,227,47,125,89,45,44
21,227,47,147,32,29,3
21,227,47,149,80,49,31
21,227,47,157,25,0,25
21,227,47,165,145,125,20
21,227,47,187,29,45,-16
21,227,47,189,0,26,-26
21,229,21,67,39,63,-24
21,229,21,111,48,85,-37
21,229,21,155,101,120,-19
21,229,21,167,37,39,-2
21,229,21,179,149,126,23
21,231,21,53,90,123,-33
21,231,21,67,0,40,-40
21,231,21,199,166,207,-41
21,233,18,163,40,47,-7
21,233,21,55,38,0,38
21,233,21,59,0,34,-34
21,233,21,101,118,256,-138
21,233,21,107,254,381,-127
21,233,21,225,78,43,35
21,235,21,13,35,0,35
21,235,21,51,0,36,-36
21,235,21,67,38,96,-58
21,235,21,121,436,378,58
21,235,21,125,442,400,42
21,235,21,147,37,39,-2
21,235,21,151,44,43,1
21,235,21,199,0,53,-53
21,235,47,13,146,102,44
21,235,47,25,29,0,29
21,235,47,93,24,35,-11
21,237,21,25,46,43,3
21,237,21,49,0,37,-37
21,237,21,67,0,36,-36
21,237,21,197,33,41,-8
21,239,21,5,115,134,-19
21,239,21,17,29,69,-40
21,239,21,49,0,32,-32
21,239,21,67,729,590,139
21,239,21,73,162,157,5
21,239,21,111,32,60,-28
21,239,21,113,100,118,-18
21,239,21,167,46,49,-3
21,239,21,209,63,89,-26
22,1,22,19,147,206,-59
22,1,22,33,91,76,15
22,1,22,39,106,87,19
22,1,22,45,41,0,41
22,1,22,51,27,33,-6
22,1,22,53,265,204,61
22,1,22,55,1033,1020,13
22,1,22,71,0,43,-43
22,1,22,79,32,33,-1
22,1,22,97,333,341,-8
22,1,22,99,77,76,1
22,1,22,113,204,202,2
22,1,48,201,72,116,-44
22,3,22,11,92,100,-8
22,3,22,19,221,324,-103
22,3,22,33,0,32,-32
22,3,22,39,129,56,73
22,3,22,53,120,96,24
22,3,22,55,0,45,-45
22,3,22,79,186,150,36
22,3,22,97,60,83,-23
22,3,22,115,74,61,13
22,3,48,201,54,35,19
22,5,6,37,0,30,-30
22,5,22,7,307,218,89
22,5,22,19,71,56,15
22,5,22,33,2968,2065,903
22,5,22,37,48,64,-16
22,5,22,47,217,176,41
22,5,22,51,523,230,293
22,5,22,55,110,117,-7
22,5,22,57,100,51,49
22,5,22,63,684,842,-158
22,5,22,71,251,323,-72
22,5,22,73,36,0,36
22,5,22,75,85,0,85
22,5,22,77,66,39,27
22,5,22,79,40,0,40
22,5,22,87,0,74,-74
22,5,22,89,126,45,81
22,5,22,93,325,143,182
22,5,22,95,281,109,172
22,5,22,97,37,24,13
22,5,22,103,85,159,-74
22,5,22,105,96,89,7
22,5,22,109,54,47,7
22,5,22,121,89,35,54
22,5,47,157,38,0,38
22,5,48,113,41,0,41
22,5,48,201,198,230,-32
22,5,48,245,0,47,-47
22,5,48,339,0,51,-51
22,7,22,5,218,307,-89
22,7,22,33,81,131,-50
22,7,22,47,33,32,1
22,7,22,51,33,36,-3
22,7,22,57,322,304,18
22,7,22,71,0,70,-70
22,7,22,89,27,0,27
22,7,22,101,195,216,-21
22,7,22,109,215,205,10
22,9,22,33,95,99,-4
22,9,22,39,87,45,42
22,9,22,43,57,62,-5
22,9,22,51,58,49,9
22,9,22,55,60,136,-76
22,9,22,71,0,36,-36
22,9,22,77,78,72,6
22,9,22,79,596,658,-62
22,9,22,97,93,73,20
22,9,48,201,55,54,1
22,9,48,245,0,44,-44
22,11,22,3,100,92,8
22,11,22,19,699,749,-50
22,11,22,33,32,46,-14
22,11,22,55,32,0,32
22,11,22,79,38,34,4
22,11,22,115,583,484,99
22,11,48,201,60,62,-2
22,11,48,351,28,0,28
22,11,48,439,0,35,-35
22,13,22,15,77,145,-68
22,13,22,17,82,112,-30
22,13,22,27,36,59,-23
22,13,22,49,99,95,4
22,13,22,61,142,116,26
22,13,22,69,0,41,-41
22,13,22,81,36,0,36
22,13,22,119,158,183,-25
22,15,1,101,0,61,-61
22,15,2,20,42,0,42
22,15,4,13,32,40,-8
22,15,5,51,0,30,-30
22,15,5,119,34,33,1
22,15,6,37,74,41,33
22,15,6,73,0,37,-37
22,15,8,41,71,53,18
22,15,12,31,0,29,-29
22,15,12,57,0,30,-30
22,15,12,91,61,0,61
22,15,13,153,41,0,41
22,15,15,3,34,45,-11
22,15,17,31,30,28,2
22,15,22,13,145,77,68
22,15,22,17,5211,5225,-14
22,15,22,19,71,55,16
22,15,22,27,86,80,6
22,15,22,31,151,188,-37
22,15,22,33,125,113,12
22,15,22,51,53,60,-7
22,15,22,55,42,62,-20
22,15,22,61,120,65,55
22,15,22,69,78,67,11
22,15,22,71,0,122,-122
22,15,22,73,259,146,113
22,15,22,79,85,50,35
22,15,22,81,97,50,47
22,15,22,85,45,0,45
22,15,22,103,39,51,-12
22,15,22,115,31,0,31
22,15,22,119,625,491,134
22,15,28,47,46,27,19
22,15,32,3,64,71,-7
22,15,34,5,37,0,37
22,15,37,51,0,36,-36
22,15,38,101,48,58,-10
22,15,40,109,39,0,39
22,15,45,85,42,0,42
22,15,47,157,39,26,13
22,15,48,27,0,45,-45
22,15,48,29,134,143,-9
22,15,48,37,53,0,53
22,15,48,39,0,39,-39
22,15,48,67,0,31,-31
22,15,48,85,44,95,-51
22,15,48,113,167,152,15
22,15,48,121,69,55,14
22,15,48,157,0,44,-44
22,15,48,167,0,35,-35
22,15,48,183,85,52,33
22,15,48,201,120,165,-45
22,15,48,203,73,99,-26
22,15,48,339,0,41,-41
22,15,48,365,66,44,22
22,15,48,423,61,32,29
22,15,48,439,122,148,-26
22,15,48,441,30,0,30
22,15,48,453,26,36,-10
22,15,48,485,73,35,38
22,15,51,59,0,57,-57
22,15,51,650,0,34,-34
22,17,4,13,60,49,11
22,17,5,27,27,0,27
22,17,5,91,0,42,-42
22,17,5,119,51,52,-1
22,17,6,37,133,96,37
22,17,6,65,28,48,-20
22,17,6,71,32,0,32
22,17,6,73,48,52,-4
22,17,8,41,30,0,30
22,17,12,11,0,26,-26
22,17,12,31,42,27,15
22,17,12,57,30,35,-5
22,17,12,91,0,31,-31
22,17,12,103,26,0,26
22,17,13,67,0,29,-29
22,17,13,89,49,37,12
22,17,13,121,0,42,-42
22,17,13,135,0,34,-34
22,17,15,3,27,0,27
22,17,17,31,49,39,10
22,17,20,173,0,34,-34
22,17,22,13,112,82,30
22,17,22,15,5225,5211,14
22,17,22,19,81,91,-10
22,17,22,27,75,60,15
22,17,22,31,991,941,50
22,17,22,33,270,271,-1
22,17,22,49,33,57,-24
22,17,22,51,130,163,-33
22,17,22,55,101,99,2
22,17,22,61,195,167,28
22,17,22,63,47,37,10
22,17,22,69,218,127,91
22,17,22,71,112,281,-169
22,17,22,73,375,203,172
22,17,22,79,159,132,27
22,17,22,81,114,103,11
22,17,22,85,97,56,41
22,17,22,103,48,58,-10
22,17,22,105,25,0,25
22,17,22,111,32,0,32
22,17,22,115,71,51,20
22,17,22,119,442,339,103
22,17,22,127,31,0,31
22,17,26,125,37,0,37
22,17,26,163,44,0,44
22,17,28,47,0,25,-25
22,17,28,49,35,34,1
22,17,32,3,52,57,-5
22,17,36,61,0,28,-28
22,17,40,109,0,29,-29
22,17,47,37,24,0,24
22,17,47,157,52,86,-34
22,17,48,27,62,82,-20
22,17,48,29,78,122,-44
22,17,48,37,62,64,-2
22,17,48,67,85,78,7
22,17,48,85,107,138,-31
22,17,48,113,474,584,-110
22,17,48,121,63,121,-58
22,17,48,157,0,64,-64
22,17,48,167,32,31,1
22,17,48,183,132,129,3
22,17,48,201,327,512,-185
22,17,48,203,220,294,-74
22,17,48,209,0,30,-30
22,17,48,245,0,37,-37
22,17,48,315,0,42,-42
22,17,48,339,37,50,-13
22,17,48,347,27,0,27
22,17,48,365,80,110,-30
22,17,48,423,100,118,-18
22,17,48,439,203,370,-167
22,17,48,453,42,73,-31
22,17,48,485,37,0,37
22,17,53,33,24,0,24
22,19,1,97,39,26,13
22,19,4,13,40,28,12
22,19,6,37,40,0,40
22,19,6,73,50,35,15
22,19,13,121,0,34,-34
22,19,22,1,206,147,59
22,19,22,3,324,221,103
22,19,22,5,56,71,-15
22,19,22,11,749,699,50
22,19,22,15,55,71,-16
22,19,22,17,91,81,10
22,19,22,23,428,311,117
22,19,22,33,301,331,-30
22,19,22,39,139,99,40
22,19,22,45,79,50,29
22,19,22,51,74,161,-87
22,19,22,53,696,499,197
22,19,22,55,298,380,-82
22,19,22,57,32,0,32
22,19,22,63,40,34,6
22,19,22,69,52,0,52
22,19,22,71,54,174,-120
22,19,22,73,63,83,-20
22,19,22,79,98,116,-18
22,19,22,85,57,47,10
22,19,22,97,175,120,55
22,19,22,99,0,39,-39
22,19,22,101,54,41,13
22,19,22,103,60,63,-3
22,19,22,105,0,40,-40
22,19,22,109,145,49,96
22,19,22,113,48,74,-26
22,19,22,115,186,92,94
22,19,32,3,39,42,-3
22,19,37,133,22,43,-21
22,19,47,157,34,0,34
22,19,48,27,0,31,-31
22,19,48,29,50,51,-1
22,19,48,39,70,45,25
22,19,48,85,31,39,-8
22,19,48,113,86,111,-25
22,19,48,121,0,49,-49
22,19,48,157,87,91,-4
22,19,48,167,52,120,-68
22,19,48,199,28,0,28
22,19,48,201,705,819,-114
22,19,48,241,0,28,-28
22,19,48,245,168,229,-61
22,19,48,339,75,85,-10
22,19,48,351,0,39,-39
22,19,48,355,0,23,-23
22,19,48,361,246,287,-41
22,19,48,439,126,89,37
22,19,48,453,47,86,-39
22,19,48,491,39,39,0
22,21,22,41,36,33,3
22,21,22,59,69,50,19
22,21,22,73,169,205,-36
22,21,22,79,38,0,38
22,21,22,83,0,35,-35
22,23,22,19,311,428,-117
22,23,22,53,0,60,-60
22,23,48,245,70,0,70
22,25,22,29,136,101,35
22,25,22,33,0,31,-31
22,25,22,41,58,32,26
22,25,22,59,66,91,-25
22,25,22,73,31,40,-9
22,25,22,79,48,30,18
22,27,5,27,0,46,-46
22,27,5,139,0,44,-44
22,27,22,13,59,36,23
22,27,22,15,80,86,-6
22,27,22,17,60,75,-15
22,27,22,61,90,106,-16
22,27,22,73,32,31,1
22,27,22,111,46,40,6
22,27,22,119,190,263,-73
22,29,22,25,101,136,-35
22,29,22,33,56,84,-28
22,29,22,71,0,48,-48
22,29,22,73,34,63,-29
22,29,22,79,0,53,-53
22,29,22,107,50,32,18
22,29,28,1,302,285,17
22,31,22,15,188,151,37
22,31,22,17,941,991,-50
22,31,22,69,40,34,6
22,31,22,81,54,0,54
22,31,22,85,144,94,50
22,31,22,119,0,35,-35
22,31,48,113,0,40,-40
22,31,48,201,37,0,37
22,31,48,419,83,117,-34
22,33,1,3,50,53,-3
22,33,1,73,60,57,3
22,33,1,89,33,47,-14
22,33,1,97,78,100,-22
22,33,4,13,83,112,-29
22,33,4,19,29,34,-5
22,33,5,119,66,30,36
22,33,5,143,25,0,25
22,33,6,1,36,39,-3
22,33,6,13,25,30,-5
22,33,6,37,181,144,37
22,33,6,59,50,38,12
22,33,6,67,0,32,-32
22,33,6,71,56,0,56
22,33,6,73,81,71,10
22,33,6,75,26,26,0
22,33,6,85,0,28,-28
22,33,8,5,0,38,-38
22,33,8,31,0,43,-43
22,33,8,41,0,25,-25
22,33,11,1,45,43,2
22,33,12,1,30,0,30
22,33,12,11,61,82,-21
22,33,12,31,84,68,16
22,33,12,33,76,38,38
22,33,12,57,56,48,8
22,33,12,71,34,0,34
22,33,12,73,59,30,29
22,33,12,86,52,39,13
22,33,12,91,49,31,18
22,33,12,95,59,51,8
22,33,12,99,32,30,2
22,33,12,113,0,36,-36
22,33,12,117,38,0,38
22,33,13,63,37,44,-7
22,33,13,67,79,91,-12
22,33,13,89,133,114,19
22,33,13,121,139,120,19
22,33,13,135,130,64,66
22,33,13,151,0,35,-35
22,33,15,3,43,0,43
22,33,17,31,106,102,4
22,33,21,111,27,0,27
22,33,22,1,76,91,-15
22,33,22,3,32,0,32
22,33,22,5,2065,2968,-903
22,33,22,7,131,81,50
22,33,22,9,99,95,4
22,33,22,11,46,32,14
22,33,22,15,113,125,-12
22,33,22,17,271,270,1
22,33,22,19,331,301,30
22,33,22,25,31,0,31
22,33,22,29,84,56,28
22,33,22,37,719,890,-171
22,33,22,39,73,56,17
22,33,22,41,0,42,-42
22,33,22,43,30,0,30
22,33,22,45,106,118,-12
22,33,22,47,701,807,-106
22,33,22,51,1132,1348,-216
22,33,22,53,36,0,36
22,33,22,55,591,670,-79
22,33,22,57,180,135,45
22,33,22,61,74,61,13
22,33,22,63,2341,4420,-2079
22,33,22,67,35,0,35
22,33,22,69,62,90,-28
22,33,22,71,1170,3347,-2177
22,33,22,73,278,191,87
22,33,22,75,31,66,-35
22,33,22,77,494,365,129
22,33,22,79,313,242,71
22,33,22,83,0,33,-33
22,33,22,87,52,194,-142
22,33,22,89,139,78,61
22,33,22,91,109,145,-36
22,33,22,93,142,120,22
22,33,22,95,155,166,-11
22,33,22,97,210,224,-14
22,33,22,99,77,92,-15
22,33,22,101,118,94,24
22,33,22,103,565,522,43
22,33,22,105,475,445,30
22,33,22,107,41,0,41
22,33,22,109,221,191,30
22,33,22,113,58,72,-14
22,33,22,115,56,44,12
22,33,22,117,108,107,1
22,33,22,121,971,1060,-89
22,33,22,125,313,285,28
22,33,24,5,25,0,25
22,33,25,17,0,30,-30
22,33,26,125,38,32,6
22,33,26,163,59,0,59
22,33,27,53,35,0,35
22,33,28,1,76,49,27
22,33,28,5,59,45,14
22,33,28,35,60,45,15
22,33,28,47,92,136,-44
22,33,28,49,123,99,24
22,33,28,59,25,70,-45
22,33,28,73,33,0,33
22,33,28,89,60,52,8
22,33,28,105,22,0,22
22,33,28,109,0,34,-34
22,33,28,113,79,29,50
22,33,28,121,58,35,23
22,33,28,147,0,30,-30
22,33,28,149,36,0,36
22,33,28,157,135,87,48
22,33,29,19,0,28,-28
22,33,29,189,59,57,2
22,33,32,3,51,108,-57
22,33,36,47,0,53,-53
22,33,36,61,41,67,-26
22,33,36,81,0,25,-25
22,33,37,51,28,0,28
22,33,37,119,59,62,-3
22,33,37,133,24,30,-6
22,33,37,183,0,47,-47
22,33,39,35,28,0,28
22,33,39,49,37,0,37
22,33,39,61,35,0,35
22,33,39,153,28,0,28
22,33,40,109,44,30,14
22,33,40,143,48,28,20
22,33,41,51,0,29,-29
22,33,42,3,0,27,-27
22,33,42,101,0,25,-25
22,33,45,79,34,0,34
22,33,47,37,59,55,4
22,33,47,93,40,0,40
22,33,47,157,117,79,38
22,33,48,27,61,57,4
22,33,48,29,120,124,-4
22,33,48,39,52,133,-81
22,33,48,41,32,0,32
22,33,48,85,83,138,-55
22,33,48,113,327,363,-36
22,33,48,121,75,97,-22
22,33,48,157,70,230,-160
22,33,48,167,51,77,-26
22,33,48,201,925,1244,-319
22,33,48,245,91,81,10
22,33,48,339,54,109,-55
22,33,48,355,38,0,38
22,33,48,361,0,35,-35
22,33,48,439,233,258,-25
22,33,48,453,118,188,-70
22,33,48,491,0,77,-77
22,33,49,35,0,34,-34
22,33,51,13,25,20,5
22,33,51,59,0,68,-68
22,33,51,760,25,0,25
22,33,51,810,32,22,10
22,33,53,33,29,71,-42
22,33,55,25,31,0,31
22,33,55,79,25,0,25
22,35,22,73,42,63,-21
22,35,22,123,92,89,3
22,35,48,439,0,38,-38
22,37,22,5,64,48,16
22,37,22,33,890,719,171
22,37,22,63,79,91,-12
22,37,22,125,99,126,-27
22,37,28,157,35,0,35
22,39,22,1,87,106,-19
22,39,22,3,56,129,-73
22,39,22,9,45,87,-42
22,39,22,19,99,139,-40
22,39,22,33,56,73,-17
22,39,22,51,0,43,-43
22,39,22,53,0,66,-66
22,39,22,55,161,212,-51
22,39,22,79,76,94,-18
22,39,22,97,428,552,-124
22,39,22,113,29,0,29
22,39,48,201,44,41,3
22,41,22,21,33,36,-3
22,41,22,25,32,58,-26
22,41,22,33,42,0,42
22,41,22,73,192,290,-98
22,41,22,83,123,140,-17
22,41,48,113,37,0,37
22,43,22,9,62,57,5
22,43,22,33,0,30,-30
22,43,22,55,0,39,-39
22,43,22,59,49,54,-5
22,43,22,69,43,67,-24
22,43,22,79,1059,842,217
22,43,22,127,61,49,12
22,45,22,1,0,41,-41
22,45,22,19,50,79,-29
22,45,22,33,118,106,12
22,45,22,51,52,68,-16
22,45,22,55,851,1323,-472
22,45,22,57,41,29,12
22,45,22,71,36,84,-48
22,45,22,73,0,36,-36
22,45,22,97,85,65,20
22,45,22,99,459,457,2
22,45,22,101,412,331,81
22,45,22,109,75,25,50
22,45,22,113,328,477,-149
22,45,48,113,44,0,44
22,45,48,201,108,133,-25
22,47,22,5,176,217,-41
22,47,22,7,32,33,-1
22,47,22,33,807,701,106
22,47,22,51,35,27,8
22,47,22,55,45,27,18
22,47,22,63,93,131,-38
22,47,22,71,44,90,-46
22,47,22,77,76,87,-11
22,47,22,121,336,312,24
22,49,22,13,95,99,-4
22,49,22,17,57,33,24
22,49,22,61,226,226,0
22,49,22,73,166,256,-90
22,49,22,79,34,0,34
22,49,22,111,44,38,6
22,49,22,119,30,0,30
22,49,22,127,118,86,32
22,49,48,201,0,43,-43
22,51,1,3,55,61,-6
22,51,1,73,65,76,-11
22,51,1,89,40,34,6
22,51,1,97,116,166,-50
22,51,1,101,25,0,25
22,51,1,117,46,40,6
22,51,1,125,50,0,50
22,51,4,13,89,122,-33
22,51,5,119,70,92,-22
22,51,5,143,29,0,29
22,51,6,1,50,36,14
22,51,6,37,213,124,89
22,51,6,59,53,41,12
22,51,6,65,40,0,40
22,51,6,71,49,0,49
22,51,6,73,146,153,-7
22,51,6,75,0,24,-24
22,51,6,85,35,25,10
22,51,8,5,42,0,42
22,51,8,31,31,32,-1
22,51,8,41,37,28,9
22,51,11,1,30,25,5
22,51,12,5,23,0,23
22,51,12,11,102,80,22
22,51,12,19,26,0,26
22,51,12,31,157,30,127
22,51,12,33,94,70,24
22,51,12,57,115,56,59
22,51,12,71,34,0,34
22,51,12,73,30,0,30
22,51,12,81,36,0,36
22,51,12,86,221,153,68
22,51,12,91,28,48,-20
22,51,12,95,133,83,50
22,51,12,99,47,33,14
22,51,12,101,33,0,33
22,51,12,103,44,26,18
22,51,12,105,40,26,14
22,51,12,113,0,38,-38
22,51,12,117,40,0,40
22,51,13,63,81,50,31
22,51,13,67,195,91,104
22,51,13,89,121,132,-11
22,51,13,97,0,37,-37
22,51,13,121,219,107,112
22,51,13,135,150,123,27
22,51,15,3,46,31,15
22,51,17,31,140,127,13
22,51,17,97,36,0,36
22,51,18,97,0,39,-39
22,51,21,111,63,25,38
22,51,22,1,33,27,6
22,51,22,5,230,523,-293
22,51,22,7,36,33,3
22,51,22,9,49,58,-9
22,51,22,15,60,53,7
22,51,22,17,163,130,33
22,51,22,19,161,74,87
22,51,22,33,1348,1132,216
22,51,22,39,43,0,43
22,51,22,45,68,52,16
22,51,22,47,27,35,-8
22,51,22,53,28,0,28
22,51,22,55,309,358,-49
22,51,22,57,301,238,63
22,51,22,61,43,29,14
22,51,22,63,165,343,-178
22,51,22,69,55,35,20
22,51,22,71,8808,12811,-4003
22,51,22,73,135,80,55
22,51,22,75,794,695,99
22,51,22,77,0,31,-31
22,51,22,79,114,118,-4
22,51,22,87,263,1432,-1169
22,51,22,89,1490,1906,-416
22,51,22,93,59,95,-36
22,51,22,95,993,1011,-18
22,51,22,97,86,72,14
22,51,22,99,31,0,31
22,51,22,101,148,50,98
22,51,22,103,1263,3115,-1852
22,51,22,105,471,962,-491
22,51,22,109,326,305,21
22,51,22,113,38,32,6
22,51,22,117,70,189,-119
22,51,22,121,0,53,-53
22,51,24,5,0,27,-27
22,51,24,31,34,27,7
22,51,24,33,32,0,32
22,51,25,9,27,0,27
22,51,25,17,46,31,15
22,51,25,25,44,0,44
22,51,26,99,33,0,33
22,51,26,125,28,0,28
22,51,26,163,67,0,67
22,51,28,5,38,42,-4
22,51,28,35,61,78,-17
22,51,28,45,65,122,-57
22,51,28,47,112,195,-83
22,51,28,49,135,86,49
22,51,28,59,83,106,-23
22,51,28,73,28,64,-36
22,51,28,85,34,0,34
22,51,28,89,36,46,-10
22,51,28,109,122,389,-267
22,51,28,113,68,96,-28
22,51,28,121,49,33,16
22,51,28,147,0,33,-33
22,51,29,95,38,29,9
22,51,29,189,36,0,36
22,51,29,510,33,0,33
22,51,32,3,122,87,35
22,51,34,7,29,0,29
22,51,34,17,41,0,41
22,51,34,23,29,0,29
22,51,35,1,33,0,33
22,51,36,5,57,41,16
22,51,36,47,85,33,52
22,51,36,61,58,62,-4
22,51,36,81,78,46,32
22,51,37,119,68,67,1
22,51,37,133,40,0,40
22,51,37,183,31,49,-18
22,51,39,35,42,0,42
22,51,39,49,36,30,6
22,51,39,61,0,27,-27
22,51,40,109,28,42,-14
22,51,42,3,27,0,27
22,51,42,101,57,0,57
22,51,44,7,29,0,29
22,51,47,37,61,57,4
22,51,47,93,27,66,-39
22,51,47,149,0,31,-31
22,51,47,157,215,99,116
22,51,48,27,54,56,-2
22,51,48,29,127,191,-64
22,51,48,39,38,71,-33
22,51,48,61,44,48,-4
22,51,48,85,111,160,-49
22,51,48,113,526,333,193
22,51,48,121,110,100,10
22,51,48,141,45,0,45
22,51,48,157,109,196,-87
22,51,48,167,55,46,9
22,51,48,201,1902,1422,480
22,51,48,215,40,0,40
22,51,48,245,48,71,-23
22,51,48,339,97,132,-35
22,51,48,355,45,42,3
22,51,48,439,287,230,57
22,51,48,453,105,172,-67
22,51,48,491,0,75,-75
22,51,49,35,0,29,-29
22,51,51,13,24,20,4
22,51,51,59,61,55,6
22,51,51,810,28,43,-15
22,51,53,33,41,52,-11
22,51,53,61,25,0,25
22,53,22,1,204,265,-61
22,53,22,3,96,120,-24
22,53,22,19,499,696,-197
22,53,22,23,60,0,60
22,53,22,33,0,36,-36
22,53,22,39,66,0,66
22,53,22,51,0,28,-28
22,53,22,55,98,86,12
22,53,22,97,41,48,-7
22,53,22,113,75,91,-16
22,53,48,201,46,36,10
22,55,4,13,65,30,35
22,55,5,119,0,35,-35
22,55,6,37,104,59,45
22,55,6,73,68,54,14
22,55,6,85,0,32,-32
22,55,8,41,0,29,-29
22,55,12,11,34,0,34
22,55,12,31,49,46,3
22,55,12,57,27,26,1
22,55,12,86,28,0,28
22,55,12,99,0,30,-30
22,55,13,67,0,27,-27
22,55,13,89,28,35,-7
22,55,13,121,0,51,-51
22,55,13,135,34,0,34
22,55,17,31,0,47,-47
22,55,22,1,1020,1033,-13
22,55,22,3,45,0,45
22,55,22,5,117,110,7
22,55,22,9,136,60,76
22,55,22,11,0,32,-32
22,55,22,15,62,42,20
22,55,22,17,99,101,-2
22,55,22,19,380,298,82
22,55,22,33,670,591,79
22,55,22,39,212,161,51
22,55,22,43,39,0,39
22,55,22,45,1323,851,472
22,55,22,47,27,45,-18
22,55,22,51,358,309,49
22,55,22,53,86,98,-12
22,55,22,57,142,63,79
22,55,22,61,42,37,5
22,55,22,63,122,63,59
22,55,22,69,30,0,30
22,55,22,71,196,447,-251
22,55,22,73,111,71,40
22,55,22,75,42,0,42
22,55,22,77,37,0,37
22,55,22,79,263,185,78
22,55,22,87,0,57,-57
22,55,22,89,51,35,16
22,55,22,95,27,0,27
22,55,22,97,1296,1273,23
22,55,22,99,1465,1652,-187
22,55,22,101,432,263,169
22,55,22,103,197,154,43
22,55,22,105,53,64,-11
22,55,22,109,229,186,43
22,55,22,113,1194,1051,143
22,55,22,115,87,50,37
22,55,22,121,29,0,29
22,55,28,47,38,39,-1
22,55,32,3,45,40,5
22,55,36,61,101,66,35
22,55,40,109,45,32,13
22,55,47,157,0,26,-26
22,55,48,27,30,28,2
22,55,48,29,61,52,9
22,55,48,39,42,33,9
22,55,48,85,66,66,0
22,55,48,113,131,117,14
22,55,48,121,46,53,-7
22,55,48,157,71,175,-104
22,55,48,167,47,52,-5
22,55,48,201,540,1110,-570
22,55,48,245,93,85,8
22,55,48,339,70,160,-90
22,55,48,355,40,0,40
22,55,48,439,44,124,-80
22,55,48,453,42,104,-62
22,55,53,33,37,0,37
22,57,13,135,0,50,-50
22,57,22,5,51,100,-49
22,57,22,7,304,322,-18
22,57,22,19,0,32,-32
22,57,22,33,135,180,-45
22,57,22,45,29,41,-12
22,57,22,51,238,301,-63
22,57,22,55,63,142,-79
22,57,22,63,0,63,-63
22,57,22,71,74,172,-98
22,57,22,87,0,66,-66
22,57,22,89,147,164,-17
22,57,22,93,85,36,49
22,57,22,95,53,40,13
22,57,22,101,137,109,28
22,57,22,103,49,74,-25
22,57,22,105,0,60,-60
22,57,22,109,1829,1814,15
22,57,48,201,92,70,22
22,59,22,21,50,69,-19
22,59,22,25,91,66,25
22,59,22,43,54,49,5
22,59,22,73,50,50,0
22,59,22,79,40,110,-70
22,59,22,127,0,46,-46
22,61,6,37,36,0,36
22,61,22,13,116,142,-26
22,61,22,15,65,120,-55
22,61,22,17,167,195,-28
22,61,22,27,106,90,16
22,61,22,33,61,74,-13
22,61,22,49,226,226,0
22,61,22,51,29,43,-14
22,61,22,55,37,42,-5
22,61,22,67,49,0,49
22,61,22,69,36,0,36
22,61,22,71,0,55,-55
22,61,22,73,373,355,18
22,61,22,79,75,56,19
22,61,22,111,204,140,64
22,61,22,119,57,52,5
22,61,48,85,0,34,-34
22,61,48,113,66,85,-19
22,61,48,121,32,35,-3
22,61,48,201,42,120,-78
22,61,48,439,46,64,-18
22,61,48,453,0,35,-35
22,63,1,97,33,0,33
22,63,8,41,42,0,42
22,63,22,5,842,684,158
22,63,22,17,37,47,-10
22,63,22,19,34,40,-6
22,63,22,33,4420,2341,2079
22,63,22,37,91,79,12
22,63,22,47,131,93,38
22,63,22,51,343,165,178
22,63,22,55,63,122,-59
22,63,22,57,63,0,63
22,63,22,71,80,110,-30
22,63,22,73,52,63,-11
22,63,22,75,41,0,41
22,63,22,77,72,49,23
22,63,22,79,74,50,24
22,63,22,87,31,101,-70
22,63,22,89,33,0,33
22,63,22,91,114,141,-27
22,63,22,93,31,0,31
22,63,22,95,92,0,92
22,63,22,97,0,46,-46
22,63,22,101,30,0,30
22,63,22,103,268,242,26
22,63,22,105,1333,1105,228
22,63,22,109,77,0,77
22,63,22,117,56,51,5
22,63,22,121,105,98,7
22,63,22,125,40,0,40
22,63,28,47,38,57,-19
22,63,28,109,0,34,-34
22,63,28,113,32,28,4
22,63,48,113,39,0,39
22,63,48,201,110,124,-14
22,65,22,73,81,96,-15
22,65,22,83,36,33,3
22,65,22,107,36,0,36
22,65,28,149,110,113,-3
22,67,5,3,84,98,-14
22,67,22,33,0,35,-35
22,67,22,61,0,49,-49
22,67,22,73,524,598,-74
22,67,22,83,48,51,-3
22,67,22,111,38,53,-15
22,67,22,123,73,53,20
22,67,48,113,79,51,28
22,67,48,201,0,27,-27
22,69,22,13,41,0,41
22,69,22,15,67,78,-11
22,69,22,17,127,218,-91
22,69,22,19,0,52,-52
22,69,22,31,34,40,-6
22,69,22,33,90,62,28
22,69,22,43,67,43,24
22,69,22,51,35,55,-20
22,69,22,55,0,30,-30
22,69,22,61,0,36,-36
22,69,22,71,0,79,-79
22,69,22,73,38,39,-1
22,69,22,79,186,257,-71
22,69,22,81,115,111,4
22,69,22,85,146,123,23
22,69,22,115,54,40,14
22,69,22,127,124,122,2
22,69,48,113,66,52,14
22,69,48,201,104,66,38
22,69,48,439,0,41,-41
22,71,1,3,40,32,8
22,71,1,73,187,49,138
22,71,1,89,48,0,48
22,71,1,97,130,106,24
22,71,1,101,94,45,49
22,71,1,117,48,0,48
22,71,1,125,69,0,69
22,71,4,13,107,78,29
22,71,4,19,33,0,33
22,71,5,119,135,48,87
22,71,5,131,50,0,50
22,71,6,1,86,57,29
22,71,6,13,39,39,0
22,71,6,37,299,166,133
22,71,6,59,59,0,59
22,71,6,65,42,0,42
22,71,6,67,28,0,28
22,71,6,71,34,0,34
22,71,6,73,171,94,77
22,71,6,75,62,52,10
22,71,6,81,31,0,31
22,71,6,85,42,38,4
22,71,8,5,0,29,-29
22,71,8,13,24,0,24
22,71,8,31,108,75,33
22,71,8,41,50,0,50
22,71,10,3,33,0,33
22,71,11,1,139,120,19
22,71,12,1,41,0,41
22,71,12,9,42,0,42
22,71,12,11,83,27,56
22,71,12,31,117,59,58
22,71,12,33,101,58,43
22,71,12,57,74,42,32
22,71,12,73,51,34,17
22,71,12,86,105,91,14
22,71,12,87,30,0,30
22,71,12,91,44,0,44
22,71,12,95,114,35,79
22,71,12,99,69,0,69
22,71,12,103,60,44,16
22,71,12,127,27,0,27
22,71,13,51,50,0,50
22,71,13,59,34,0,34
22,71,13,63,206,37,169
22,71,13,67,277,74,203
22,71,13,89,416,184,232
22,71,13,97,50,0,50
22,71,13,121,494,219,275
22,71,13,135,278,84,194
22,71,13,151,54,0,54
22,71,13,215,39,0,39
22,71,13,223,39,0,39
22,71,15,3,51,43,8
22,71,17,31,293,144,149
22,71,18,97,59,0,59
22,71,19,153,31,0,31
22,71,21,111,57,30,27
22,71,22,1,43,0,43
22,71,22,5,323,251,72
22,71,22,7,70,0,70
22,71,22,9,36,0,36
22,71,22,15,122,0,122
22,71,22,17,281,112,169
22,71,22,19,174,54,120
22,71,22,29,48,0,48
22,71,22,33,3347,1170,2177
22,71,22,45,84,36,48
22,71,22,47,90,44,46
22,71,22,51,12811,8808,4003
22,71,22,55,447,196,251
22,71,22,57,172,74,98
22,71,22,61,55,0,55
22,71,22,63,110,80,30
22,71,22,69,79,0,79
22,71,22,73,115,31,84
22,71,22,75,277,250,27
22,71,22,77,45,39,6
22,71,22,79,158,85,73
22,71,22,87,202,555,-353
22,71,22,89,416,273,143
22,71,22,91,46,0,46
22,71,22,93,129,43,86
22,71,22,95,605,352,253
22,71,22,97,109,41,68
22,71,22,99,39,0,39
22,71,22,101,93,0,93
22,71,22,103,1371,1257,114
22,71,22,105,329,220,109
22,71,22,109,232,84,148
22,71,22,115,33,0,33
22,71,22,117,85,0,85
22,71,22,121,67,0,67
22,71,24,3,36,0,36
22,71,24,5,29,0,29
22,71,24,31,93,51,42
22,71,24,33,65,24,41
22,71,24,510,41,31,10
22,71,25,17,79,46,33
22,71,25,25,63,25,38
22,71,26,65,23,0,23
22,71,26,125,47,0,47
22,71,26,161,21,23,-2
22,71,26,163,75,0,75
22,71,27,53,41,28,13
22,71,28,1,63,0,63
22,71,28,5,30,43,-13
22,71,28,33,31,0,31
22,71,28,35,59,0,59
22,71,28,45,66,61,5
22,71,28,47,128,78,50
22,71,28,49,196,52,144
22,71,28,59,43,33,10
22,71,28,71,26,0,26
22,71,28,73,53,0,53
22,71,28,85,40,0,40
22,71,28,89,38,0,38
22,71,28,109,81,88,-7
22,71,28,113,110,35,75
22,71,28,121,67,29,38
22,71,28,147,38,0,38
22,71,28,157,32,0,32
22,71,29,95,74,24,50
22,71,29,189,129,0,129
22,71,29,510,29,0,29
22,71,31,55,37,0,37
22,71,32,3,97,62,35
22,71,35,1,59,0,59
22,71,36,5,29,0,29
22,71,36,29,33,0,33
22,71,36,47,142,83,59
22,71,36,55,28,0,28
22,71,36,59,21,0,21
22,71,36,61,217,128,89
22,71,36,81,55,27,28
22,71,36,103,33,0,33
22,71,36,119,25,0,25
22,71,37,21,0,26,-26
22,71,37,63,0,22,-22
22,71,37,119,77,53,24
22,71,37,133,52,38,14
22,71,37,183,65,37,28
22,71,39,35,36,0,36
22,71,39,49,71,0,71
22,71,40,27,33,0,33
22,71,40,109,67,0,67
22,71,40,143,32,0,32
22,71,41,39,27,0,27
22,71,41,51,41,36,5
22,71,42,3,53,28,25
22,71,42,91,39,27,12
22,71,42,101,64,23,41
22,71,45,19,32,33,-1
22,71,45,79,29,0,29
22,71,47,37,111,41,70
22,71,47,65,38,0,38
22,71,47,93,62,0,62
22,71,47,157,327,107,220
22,71,48,27,98,0,98
22,71,48,29,401,130,271
22,71,48,39,81,0,81
22,71,48,41,36,0,36
22,71,48,85,181,100,81
22,71,48,113,1146,370,776
22,71,48,121,188,50,138
22,71,48,141,41,34,7
22,71,48,157,202,126,76
22,71,48,167,115,0,115
22,71,48,201,4562,1403,3159
22,71,48,245,87,0,87
22,71,48,339,141,67,74
22,71,48,355,58,0,58
22,71,48,423,38,0,38
22,71,48,439,542,190,352
22,71,48,453,310,199,111
22,71,48,491,41,0,41
22,71,49,35,40,0,40
22,71,51,13,23,0,23
22,71,51,59,83,64,19
22,71,51,510,0,36,-36
22,71,51,710,46,0,46
22,71,51,810,34,39,-5
22,71,53,33,78,95,-17
22,71,53,53,33,0,33
22,71,55,25,35,0,35
22,71,55,79,48,0,48
22,73,1,73,0,40,-40
22,73,4,13,0,42,-42
22,73,5,3,63,50,13
22,73,5,119,0,74,-74
22,73,5,139,53,48,5
22,73,6,37,39,42,-3
22,73,6,73,36,0,36
22,73,12,31,32,0,32
22,73,13,89,46,0,46
22,73,13,121,0,38,-38
22,73,17,31,36,0,36
22,73,22,5,0,36,-36
22,73,22,15,146,259,-113
22,73,22,17,203,375,-172
22,73,22,19,83,63,20
22,73,22,21,205,169,36
22,73,22,25,40,31,9
22,73,22,27,31,32,-1
22,73,22,29,63,34,29
22,73,22,33,191,278,-87
22,73,22,35,63,42,21
22,73,22,41,290,192,98
22,73,22,45,36,0,36
22,73,22,49,256,166,90
22,73,22,51,80,135,-55
22,73,22,55,71,111,-40
22,73,22,59,50,50,0
22,73,22,61,355,373,-18
22,73,22,63,63,52,11
22,73,22,65,96,81,15
22,73,22,67,598,524,74
22,73,22,69,39,38,1
22,73,22,71,31,115,-84
22,73,22,79,114,157,-43
22,73,22,83,586,471,115
22,73,22,103,56,69,-13
22,73,22,105,33,0,33
22,73,22,107,54,0,54
22,73,22,109,31,0,31
22,73,22,111,525,527,-2
22,73,22,115,48,0,48
22,73,22,119,46,55,-9
22,73,22,123,183,86,97
22,73,28,47,33,0,33
22,73,28,49,57,65,-8
22,73,28,89,0,63,-63
22,73,28,121,34,44,-10
22,73,28,149,30,0,30
22,73,32,3,47,0,47
22,73,40,143,0,56,-56
22,73,47,157,31,47,-16
22,73,48,29,0,42,-42
22,73,48,85,36,63,-27
22,73,48,113,161,329,-168
22,73,48,121,0,100,-100
22,73,48,157,0,36,-36
22,73,48,201,152,218,-66
22,73,48,423,0,57,-57
22,73,48,439,106,226,-120
22,73,48,453,0,45,-45
22,73,48,491,0,30,-30
22,75,1,97,43,0,43
22,75,6,73,48,54,-6
22,75,12,31,43,0,43
22,75,22,5,0,85,-85
22,75,22,33,66,31,35
22,75,22,51,695,794,-99
22,75,22,55,0,42,-42
22,75,22,63,0,41,-41
22,75,22,71,250,277,-27
22,75,22,87,0,154,-154
22,75,22,103,60,145,-85
22,75,22,105,40,94,-54
22,75,22,113,85,0,85
22,75,28,109,0,22,-22
22,75,48,201,55,75,-20
22,75,48,439,65,76,-11
22,77,22,5,39,66,-27
22,77,22,9,72,78,-6
22,77,22,33,365,494,-129
22,77,22,47,87,76,11
22,77,22,51,31,0,31
22,77,22,55,0,37,-37
22,77,22,63,49,72,-23
22,77,22,71,39,45,-6
22,77,22,97,48,0,48
22,77,22,121,150,131,19
22,77,48,201,58,0,58
22,79,5,119,0,36,-36
22,79,6,37,32,0,32
22,79,6,73,0,33,-33
22,79,22,1,33,32,1
22,79,22,3,150,186,-36
22,79,22,5,0,40,-40
22,79,22,9,658,596,62
22,79,22,11,34,38,-4
22,79,22,15,50,85,-35
22,79,22,17,132,159,-27
22,79,22,19,116,98,18
22,79,22,21,0,38,-38
22,79,22,25,30,48,-18
22,79,22,29,53,0,53
22,79,22,33,242,313,-71
22,79,22,39,94,76,18
22,79,22,43,842,1059,-217
22,79,22,49,0,34,-34
22,79,22,51,118,114,4
22,79,22,55,185,263,-78
22,79,22,59,110,40,70
22,79,22,61,56,75,-19
22,79,22,63,50,74,-24
22,79,22,69,257,186,71
22,79,22,71,85,158,-73
22,79,22,73,157,114,43
22,79,22,85,28,45,-17
22,79,22,97,82,107,-25
22,79,22,101,40,0,40
22,79,22,103,61,52,9
22,79,22,115,245,164,81
22,79,22,127,62,61,1
22,79,48,27,34,43,-9
22,79,48,29,40,37,3
22,79,48,85,0,38,-38
22,79,48,113,56,99,-43
22,79,48,157,0,41,-41
22,79,48,201,166,277,-111
22,79,48,245,0,48,-48
22,79,48,439,83,65,18
22,81,22,13,0,36,-36
22,81,22,15,50,97,-47
22,81,22,17,103,114,-11
22,81,22,31,0,54,-54
22,81,22,69,111,115,-4
22,83,22,21,35,0,35
22,83,22,33,33,0,33
22,83,22,41,140,123,17
22,83,22,65,33,36,-3
22,83,22,67,51,48,3
22,83,22,73,471,586,-115
22,83,22,123,119,78,41
22,85,22,15,0,45,-45
22,85,22,17,56,97,-41
22,85,22,19,47,57,-10
22,85,22,31,94,144,-50
22,85,22,69,123,146,-23
22,85,22,79,45,28,17
22,85,22,115,80,74,6
22,87,1,125,26,0,26
22,87,22,5,74,0,74
22,87,22,33,194,52,142
22,87,22,51,1432,263,1169
22,87,22,55,57,0,57
22,87,22,57,66,0,66
22,87,22,63,101,31,70
22,87,22,71,555,202,353
22,87,22,75,154,0,154
22,87,22,89,108,0,108
22,87,22,95,69,0,69
22,87,22,103,864,348,516
22,87,22,105,198,79,119
22,87,22,109,47,0,47
22,87,22,117,0,41,-41
22,87,28,45,45,0,45
22,87,28,47,34,0,34
22,87,28,109,247,102,145
22,87,48,201,172,36,136
22,89,17,31,0,25,-25
22,89,22,5,45,126,-81
22,89,22,7,0,27,-27
22,89,22,33,78,139,-61
22,89,22,51,1906,1490,416
22,89,22,55,35,51,-16
22,89,22,57,164,147,17
22,89,22,63,0,33,-33
22,89,22,71,273,416,-143
22,89,22,87,0,108,-108
22,89,22,93,117,86,31
22,89,22,95,596,618,-22
22,89,22,103,66,182,-116
22,89,22,105,61,170,-109
22,89,22,109,62,70,-8
22,89,48,113,33,0,33
22,89,48,201,137,141,-4
22,91,22,33,145,109,36
22,91,22,63,141,114,27
22,91,22,71,0,46,-46
22,91,22,105,343,397,-54
22,91,48,201,0,37,-37
22,93,22,5,143,325,-182
22,93,22,33,120,142,-22
22,93,22,51,95,59,36
22,93,22,57,36,85,-49
22,93,22,63,0,31,-31
22,93,22,71,43,129,-86
22,93,22,89,86,117,-31
22,93,22,95,351,215,136
22,93,22,109,0,36,-36
22,95,22,5,109,281,-172
22,95,22,33,166,155,11
22,95,22,51,1011,993,18
22,95,22,55,0,27,-27
22,95,22,57,40,53,-13
22,95,22,63,0,92,-92
22,95,22,71,352,605,-253
22,95,22,87,0,69,-69
22,95,22,89,618,596,22
22,95,22,93,215,351,-136
22,95,22,103,41,106,-65
22,95,22,105,79,199,-120
22,95,22,109,37,0,37
22,95,48,113,49,29,20
22,95,48,201,142,95,47
22,97,6,37,35,0,35
22,97,22,1,341,333,8
22,97,22,3,83,60,23
22,97,22,5,24,37,-13
22,97,22,9,73,93,-20
22,97,22,19,120,175,-55
22,97,22,33,224,210,14
22,97,22,39,552,428,124
22,97,22,45,65,85,-20
22,97,22,51,72,86,-14
22,97,22,53,48,41,7
22,97,22,55,1273,1296,-23
22,97,22,63,46,0,46
22,97,22,71,41,109,-68
22,97,22,77,0,48,-48
22,97,22,79,107,82,25
22,97,22,99,201,201,0
22,97,22,101,59,0,59
22,97,22,103,0,33,-33
22,97,22,109,46,31,15
22,97,22,113,77,59,18
22,97,48,201,186,182,4
22,97,48,245,46,37,9
22,99,22,1,76,77,-1
22,99,22,19,39,0,39
22,99,22,33,92,77,15
22,99,22,45,457,459,-2
22,99,22,51,0,31,-31
22,99,22,55,1652,1465,187
22,99,22,71,0,39,-39
22,99,22,97,201,201,0
22,99,22,101,46,53,-7
22,99,22,113,67,89,-22
22,99,48,201,97,72,25
22,101,6,37,29,0,29
22,101,22,7,216,195,21
22,101,22,19,41,54,-13
22,101,22,33,94,118,-24
22,101,22,45,331,412,-81
22,101,22,51,50,148,-98
22,101,22,55,263,432,-169
22,101,22,57,109,137,-28
22,101,22,63,0,30,-30
22,101,22,71,0,93,-93
22,101,22,79,0,40,-40
22,101,22,97,0,59,-59
22,101,22,99,53,46,7
22,101,22,109,245,228,17
22,101,22,113,47,69,-22
22,101,48,113,29,0,29
22,101,48,201,156,412,-256
22,101,48,245,0,33,-33
22,101,48,355,0,88,-88
22,103,1,3,75,77,-2
22,103,1,73,35,33,2
22,103,1,89,44,35,9
22,103,1,97,95,91,4
22,103,4,13,39,93,-54
22,103,5,119,34,44,-10
22,103,6,1,0,42,-42
22,103,6,37,88,29,59
22,103,6,59,61,0,61
22,103,6,73,133,60,73
22,103,12,5,0,35,-35
22,103,12,9,46,35,11
22,103,12,11,43,41,2
22,103,12,31,63,44,19
22,103,12,33,83,57,26
22,103,12,57,68,54,14
22,103,12,73,43,0,43
22,103,12,86,0,28,-28
22,103,12,91,57,37,20
22,103,12,95,85,0,85
22,103,12,99,0,30,-30
22,103,12,103,35,0,35
22,103,12,113,26,36,-10
22,103,13,67,46,77,-31
22,103,13,89,57,0,57
22,103,13,97,42,0,42
22,103,13,121,66,47,19
22,103,13,135,77,48,29
22,103,15,3,43,31,12
22,103,17,31,34,59,-25
22,103,22,5,159,85,74
22,103,22,15,51,39,12
22,103,22,17,58,48,10
22,103,22,19,63,60,3
22,103,22,33,522,565,-43
22,103,22,51,3115,1263,1852
22,103,22,55,154,197,-43
22,103,22,57,74,49,25
22,103,22,63,242,268,-26
22,103,22,71,1257,1371,-114
22,103,22,73,69,56,13
22,103,22,75,145,60,85
22,103,22,79,52,61,-9
22,103,22,87,348,864,-516
22,103,22,89,182,66,116
22,103,22,95,106,41,65
22,103,22,97,33,0,33
22,103,22,105,813,1139,-326
22,103,22,109,52,78,-26
22,103,22,117,431,571,-140
22,103,26,125,26,0,26
22,103,28,35,45,44,1
22,103,28,45,196,221,-25
22,103,28,47,194,154,40
22,103,28,59,53,62,-9
22,103,28,73,73,32,41
22,103,28,109,538,662,-124
22,103,28,121,52,48,4
22,103,32,3,38,54,-16
22,103,36,61,0,22,-22
22,103,37,133,44,32,12
22,103,40,109,43,0,43
22,103,47,37,54,32,22
22,103,47,93,0,37,-37
22,103,47,157,85,55,30
22,103,48,27,41,0,41
22,103,48,29,67,44,23
22,103,48,39,0,38,-38
22,103,48,85,36,87,-51
22,103,48,113,94,75,19
22,103,48,121,44,59,-15
22,103,48,157,87,141,-54
22,103,48,167,33,45,-12
22,103,48,201,439,379,60
22,103,48,339,63,133,-70
22,103,48,439,108,154,-46
22,103,48,453,48,41,7
22,103,48,491,0,32,-32
22,103,51,59,42,54,-12
22,103,51,153,47,0,47
22,103,51,810,28,0,28
22,105,1,3,0,32,-32
22,105,6,37,46,0,46
22,105,22,5,89,96,-7
22,105,22,17,0,25,-25
22,105,22,19,40,0,40
22,105,22,33,445,475,-30
22,105,22,51,962,471,491
22,105,22,55,64,53,11
22,105,22,57,60,0,60
22,105,22,63,1105,1333,-228
22,105,22,71,220,329,-109
22,105,22,73,0,33,-33
22,105,22,75,94,40,54
22,105,22,87,79,198,-119
22,105,22,89,170,61,109
22,105,22,91,397,343,54
22,105,22,95,199,79,120
22,105,22,103,1139,813,326
22,105,22,109,58,29,29
22,105,22,117,290,222,68
22,105,28,5,46,0,46
22,105,28,109,49,37,12
22,105,28,113,150,113,37
22,105,47,157,0,33,-33
22,105,48,113,49,34,15
22,105,48,201,98,160,-62
22,105,48,339,31,0,31
22,107,22,29,32,50,-18
22,107,22,33,0,41,-41
22,107,22,65,0,36,-36
22,107,22,73,0,54,-54
22,109,6,37,0,37,-37
22,109,13,135,0,75,-75
22,109,22,5,47,54,-7
22,109,22,7,205,215,-10
22,109,22,19,49,145,-96
22,109,22,33,191,221,-30
22,109,22,45,25,75,-50
22,109,22,51,305,326,-21
22,109,22,55,186,229,-43
22,109,22,57,1814,1829,-15
22,109,22,63,0,77,-77
22,109,22,71,84,232,-148
22,109,22,73,0,31,-31
22,109,22,87,0,47,-47
22,109,22,89,70,62,8
22,109,22,93,36,0,36
22,109,22,95,0,37,-37
22,109,22,97,31,46,-15
22,109,22,101,228,245,-17
22,109,22,103,78,52,26
22,109,22,105,29,58,-29
22,109,22,113,0,27,-27
22,109,28,47,34,33,1
22,109,28,59,0,45,-45
22,109,37,133,39,0,39
22,109,48,39,0,36,-36
22,109,48,157,0,53,-53
22,109,48,201,140,259,-119
22,109,48,245,33,0,33
22,109,48,439,0,36,-36
22,111,5,139,125,103,22
22,111,22,17,0,32,-32
22,111,22,27,40,46,-6
22,111,22,49,38,44,-6
22,111,22,61,140,204,-64
22,111,22,67,53,38,15
22,111,22,73,527,525,2
22,113,22,1,202,204,-2
22,113,22,19,74,48,26
22,113,22,33,72,58,14
22,113,22,39,0,29,-29
22,113,22,45,477,328,149
22,113,22,51,32,38,-6
22,113,22,53,91,75,16
22,113,22,55,1051,1194,-143
22,113,22,75,0,85,-85
22,113,22,97,59,77,-18
22,113,22,99,89,67,22
22,113,22,101,69,47,22
22,113,22,109,27,0,27
22,113,48,201,44,80,-36
22,115,1,31,0,34,-34
22,115,1,45,0,36,-36
22,115,2,20,62,43,19
22,115,2,90,119,0,119
22,115,4,3,62,69,-7
22,115,4,13,42,62,-20
22,115,4,19,0,48,-48
22,115,6,37,0,39,-39
22,115,6,71,34,84,-50
22,115,8,41,74,143,-69
22,115,12,57,0,40,-40
22,115,12,86,0,40,-40
22,115,13,53,0,53,-53
22,115,13,179,0,62,-62
22,115,13,215,54,94,-40
22,115,13,245,57,50,7
22,115,15,3,91,143,-52
22,115,17,31,28,0,28
22,115,20,61,0,99,-99
22,115,20,103,51,133,-82
22,115,21,47,85,104,-19
22,115,21,93,0,57,-57
22,115,22,3,61,74,-13
22,115,22,11,484,583,-99
22,115,22,15,0,31,-31
22,115,22,17,51,71,-20
22,115,22,19,92,186,-94
22,115,22,33,44,56,-12
22,115,22,55,50,87,-37
22,115,22,69,40,54,-14
22,115,22,71,0,33,-33
22,115,22,73,0,48,-48
22,115,22,79,164,245,-81
22,115,22,85,74,80,-6
22,115,26,163,0,24,-24
22,115,29,169,95,133,-38
22,115,32,3,0,33,-33
22,115,36,45,74,37,37
22,115,36,47,0,26,-26
22,115,37,51,104,177,-73
22,115,40,31,69,141,-72
22,115,45,79,0,136,-136
22,115,47,125,154,213,-59
22,115,48,27,105,214,-109
22,115,48,29,108,242,-134
22,115,48,85,0,35,-35
22,115,48,99,49,49,0
22,115,48,113,50,58,-8
22,115,48,121,0,32,-32
22,115,48,141,107,132,-25
22,115,48,201,71,227,-156
22,115,48,361,0,34,-34
22,115,48,439,0,49,-49
22,115,48,453,0,28,-28
22,115,51,59,48,73,-25
22,115,51,700,0,37,-37
22,115,53,53,87,144,-57
22,115,53,67,0,49,-49
22,117,22,33,107,108,-1
22,117,22,51,189,70,119
22,117,22,63,51,56,-5
22,117,22,71,0,85,-85
22,117,22,87,41,0,41
22,117,22,103,571,431,140
22,117,22,105,222,290,-68
22,117,28,91,33,39,-6
22,117,28,109,68,75,-7
22,117,28,147,43,61,-18
22,117,48,113,47,0,47
22,117,48,201,55,32,23
22,119,5,27,95,88,7
22,119,5,73,0,64,-64
22,119,5,139,32,0,32
22,119,22,13,183,158,25
22,119,22,15,491,625,-134
22,119,22,17,339,442,-103
22,119,22,27,263,190,73
22,119,22,31,35,0,35
22,119,22,49,0,30,-30
22,119,22,61,52,57,-5
22,119,22,73,55,46,9
22,119,48,113,33,0,33
22,119,48,201,35,30,5
22,121,22,5,35,89,-54
22,121,22,33,1060,971,89
22,121,22,47,312,336,-24
22,121,22,51,53,0,53
22,121,22,55,0,29,-29
22,121,22,63,98,105,-7
22,121,22,71,0,67,-67
22,121,22,77,131,150,-19
22,123,22,35,89,92,-3
22,123,22,67,53,73,-20
22,123,22,73,86,183,-97
22,123,22,83,78,119,-41
22,125,22,33,285,313,-28
22,125,22,37,126,99,27
22,125,22,63,0,40,-40
22,125,28,157,0,38,-38
22,127,22,17,0,31,-31
22,127,22,43,49,61,-12
22,127,22,49,86,118,-32
22,127,22,59,46,0,46
22,127,22,69,122,124,-2
22,127,22,79,61,62,-1
23,1,4,13,0,49,-49
23,1,6,73,0,22,-22
23,1,9,3,44,20,24
23,1,12,9,29,0,29
23,1,12,11,25,0,25
23,1,12,57,0,25,-25
23,1,12,105,34,0,34
23,1,12,127,30,0,30
23,1,13,89,32,0,32
23,1,17,31,0,25,-25
23,1,23,3,66,77,-11
23,1,23,5,1497,1350,147
23,1,23,7,341,320,21
23,1,23,11,684,765,-81
23,1,23,13,43,35,8
23,1,23,15,64,95,-31
23,1,23,17,661,809,-148
23,1,23,19,142,191,-49
23,1,23,21,0,33,-33
23,1,23,23,381,305,76
23,1,23,25,94,55,39
23,1,23,27,0,28,-28
23,1,23,31,233,167,66
23,1,25,9,33,32,1
23,1,25,13,33,0,33
23,1,25,17,82,64,18
23,1,25,21,0,37,-37
23,1,25,25,69,68,1
23,1,25,27,0,46,-46
23,1,33,11,56,45,11
23,1,33,15,47,30,17
23,1,33,17,26,0,26
23,1,36,61,0,22,-22
23,1,37,133,37,0,37
23,1,47,37,32,0,32
23,3,9,3,54,0,54
23,3,23,1,77,66,11
23,3,23,5,137,206,-69
23,3,23,9,58,61,-3
23,3,23,11,112,94,18
23,3,23,13,0,49,-49
23,3,23,17,0,26,-26
23,3,23,19,311,462,-151
23,3,23,23,0,33,-33
23,3,23,25,49,45,4
23,3,23,27,46,33,13
23,3,23,29,81,65,16
23,3,23,31,127,113,14
23,3,25,9,44,0,44
23,3,25,25,0,21,-21
23,3,25,27,40,0,40
23,3,33,11,25,0,25
23,3,33,15,0,25,-25
23,3,33,17,35,0,35
23,5,4,13,115,140,-25
23,5,4,19,0,44,-44
23,5,6,1,50,39,11
23,5,6,37,118,130,-12
23,5,6,59,33,35,-2
23,5,6,73,97,187,-90
23,5,6,75,34,58,-24
23,5,6,81,0,34,-34
23,5,6,85,0,53,-53
23,5,8,13,28,52,-24
23,5,8,31,20,51,-31
23,5,8,41,0,51,-51
23,5,9,1,74,49,25
23,5,9,3,107,69,38
23,5,9,5,33,0,33
23,5,9,7,23,0,23
23,5,9,9,71,78,-7
23,5,9,11,49,26,23
23,5,9,13,39,0,39
23,5,9,15,28,0,28
23,5,11,1,77,60,17
23,5,12,9,38,41,-3
23,5,12,11,52,41,11
23,5,12,19,79,0,79
23,5,12,21,37,59,-22
23,5,12,31,176,108,68
23,5,12,33,62,60,2
23,5,12,57,55,82,-27
23,5,12,69,26,23,3
23,5,12,71,51,56,-5
23,5,12,81,36,62,-26
23,5,12,83,0,32,-32
23,5,12,86,55,27,28
23,5,12,87,0,27,-27
23,5,12,95,43,45,-2
23,5,12,99,41,50,-9
23,5,12,101,0,51,-51
23,5,12,103,85,62,23
23,5,12,105,41,25,16
23,5,12,109,0,37,-37
23,5,12,111,0,32,-32
23,5,12,115,40,90,-50
23,5,12,119,0,31,-31
23,5,12,127,39,35,4
23,5,13,67,30,0,30
23,5,13,121,0,29,-29
23,5,15,3,62,68,-6
23,5,17,31,79,71,8
23,5,23,1,1350,1497,-147
23,5,23,3,206,137,69
23,5,23,7,176,116,60
23,5,23,9,198,132,66
23,5,23,11,651,620,31
23,5,23,13,177,125,52
23,5,23,15,274,188,86
23,5,23,17,542,509,33
23,5,23,19,693,451,242
23,5,23,23,1205,1218,-13
23,5,23,25,180,128,52
23,5,23,27,127,75,52
23,5,23,29,96,76,20
23,5,23,31,3153,3215,-62
23,5,24,3,0,28,-28
23,5,24,5,0,30,-30
23,5,24,31,35,36,-1
23,5,24,37,61,77,-16
23,5,25,1,64,56,8
23,5,25,3,32,0,32
23,5,25,5,83,31,52
23,5,25,9,237,169,68
23,5,25,13,54,50,4
23,5,25,15,36,65,-29
23,5,25,17,561,496,65
23,5,25,21,175,150,25
23,5,25,23,109,72,37
23,5,25,25,257,341,-84
23,5,25,27,168,88,80
23,5,26,81,0,26,-26
23,5,27,53,25,34,-9
23,5,30,31,0,21,-21
23,5,30,63,23,0,23
23,5,32,3,53,57,-4
23,5,33,1,47,22,25
23,5,33,3,98,83,15
23,5,33,5,47,42,5
23,5,33,7,47,28,19
23,5,33,9,89,54,35
23,5,33,11,182,151,31
23,5,33,13,48,73,-25
23,5,33,15,192,242,-50
23,5,33,17,123,116,7
23,5,33,19,27,0,27
23,5,34,17,32,0,32
23,5,34,21,26,0,26
23,5,34,23,0,42,-42
23,5,36,1,22,28,-6
23,5,36,47,85,122,-37
23,5,36,55,45,37,8
23,5,36,59,44,0,44
23,5,36,61,138,121,17
23,5,36,67,54,0,54
23,5,36,81,72,36,36
23,5,36,91,0,30,-30
23,5,36,103,75,0,75
23,5,36,119,61,0,61
23,5,37,21,26,0,26
23,5,37,51,0,27,-27
23,5,37,63,0,24,-24
23,5,37,119,34,63,-29
23,5,37,183,37,58,-21
23,5,39,35,26,0,26
23,5,39,49,28,77,-49
23,5,41,51,36,55,-19
23,5,42,3,33,0,33
23,5,42,17,26,47,-21
23,5,42,91,0,34,-34
23,5,42,101,48,39,9
23,5,44,3,29,26,3
23,5,44,5,35,46,-11
23,5,44,7,69,60,9
23,5,44,9,0,21,-21
23,5,45,13,0,40,-40
23,5,47,37,33,45,-12
23,5,47,157,29,0,29
23,5,48,113,30,0,30
23,5,48,201,0,77,-77
23,5,48,439,0,56,-56
23,5,48,453,0,58,-58
23,5,49,35,0,28,-28
23,5,50,7,139,94,45
23,5,50,11,25,0,25
23,5,50,21,39,0,39
23,5,50,23,30,0,30
23,5,50,25,25,40,-15
23,5,50,27,28,20,8
23,5,51,13,0,34,-34
23,5,51,59,54,68,-14
23,5,51,510,0,37,-37
23,5,51,550,28,0,28
23,5,51,710,58,53,5
23,5,51,810,78,107,-29
23,5,53,33,79,81,-2
23,5,53,53,0,33,-33
23,5,55,25,0,35,-35
23,7,23,1,320,341,-21
23,7,23,5,116,176,-60
23,7,23,11,159,217,-58
23,7,23,17,116,127,-11
23,7,23,19,54,50,4
23,7,23,23,31,0,31
23,7,23,25,134,108,26
23,7,23,31,36,51,-15
23,7,25,25,0,33,-33
23,9,23,1,32,0,32
23,9,23,3,61,58,3
23,9,23,5,132,198,-66
23,9,23,11,65,75,-10
23,9,23,13,0,38,-38
23,9,23,19,653,725,-72
23,9,23,21,28,0,28
23,9,23,25,32,30,2
23,9,23,27,115,117,-2
23,9,23,29,220,142,78
23,9,23,31,60,61,-1
23,9,25,17,51,36,15
23,9,25,21,0,22,-22
23,9,25,25,0,35,-35
23,9,25,27,34,26,8
23,11,4,13,28,44,-16
23,11,6,37,0,28,-28
23,11,9,3,31,0,31
23,11,9,9,27,0,27
23,11,12,99,0,24,-24
23,11,12,101,30,0,30
23,11,12,103,39,28,11
23,11,23,1,765,684,81
23,11,23,3,94,112,-18
23,11,23,5,620,651,-31
23,11,23,7,217,159,58
23,11,23,9,75,65,10
23,11,23,13,103,82,21
23,11,23,15,382,300,82
23,11,23,17,81,87,-6
23,11,23,19,464,353,111
23,11,23,21,60,0,60
23,11,23,23,255,218,37
23,11,23,25,1101,1001,100
23,11,23,27,286,248,38
23,11,23,31,168,179,-11
23,11,25,5,36,0,36
23,11,25,9,75,30,45
23,11,25,17,58,78,-20
23,11,25,21,36,67,-31
23,11,25,23,0,30,-30
23,11,25,25,24,73,-49
23,11,25,27,61,57,4
23,11,33,9,0,24,-24
23,11,33,11,41,45,-4
23,11,33,13,42,0,42
23,11,33,15,51,31,20
23,11,33,17,0,35,-35
23,13,23,1,35,43,-8
23,13,23,3,49,0,49
23,13,23,5,125,177,-52
23,13,23,9,38,0,38
23,13,23,11,82,103,-21
23,13,23,15,260,350,-90
23,13,23,17,26,0,26
23,13,23,19,115,88,27
23,13,23,23,0,52,-52
23,13,23,25,0,36,-36
23,13,23,27,334,329,5
23,13,23,29,0,26,-26
23,13,23,31,65,52,13
23,13,25,17,39,37,2
23,13,25,25,28,20,8
23,13,25,27,32,0,32
23,13,33,15,0,37,-37
23,15,23,1,95,64,31
23,15,23,5,188,274,-86
23,15,23,11,300,382,-82
23,15,23,13,350,260,90
23,15,23,19,49,56,-7
23,15,23,23,247,265,-18
23,15,23,25,42,0,42
23,15,23,27,43,0,43
23,15,23,31,51,59,-8
23,15,25,9,28,0,28
23,15,25,17,65,0,65
23,15,25,21,28,0,28
23,17,23,1,809,661,148
23,17,23,3,26,0,26
23,17,23,5,509,542,-33
23,17,23,7,127,116,11
23,17,23,11,87,81,6
23,17,23,13,0,26,-26
23,17,23,19,51,68,-17
23,17,23,25,26,47,-21
23,17,23,29,33,0,33
23,17,23,31,261,207,54
23,17,25,5,45,0,45
23,17,25,9,63,28,35
23,17,25,17,58,47,11
23,17,25,25,26,26,0
23,17,33,3,136,172,-36
23,17,33,7,37,29,8
23,17,33,11,26,36,-10
23,17,33,15,39,21,18
23,17,33,17,0,27,-27
23,19,4,13,65,50,15
23,19,5,7,0,53,-53
23,19,6,37,0,33,-33
23,19,6,73,46,67,-21
23,19,8,59,0,23,-23
23,19,9,3,76,28,48
23,19,9,9,72,0,72
23,19,11,1,0,21,-21
23,19,12,9,0,23,-23
23,19,12,71,0,33,-33
23,19,12,95,29,29,0
23,19,12,99,0,40,-40
23,19,12,101,52,30,22
23,19,12,103,26,25,1
23,19,12,105,37,43,-6
23,19,23,1,191,142,49
23,19,23,3,462,311,151
23,19,23,5,451,693,-242
23,19,23,7,50,54,-4
23,19,23,9,725,653,72
23,19,23,11,353,464,-111
23,19,23,13,88,115,-27
23,19,23,15,56,0,56
23,19,23,17,68,51,17
23,19,23,21,440,400,40
23,19,23,23,0,79,-79
23,19,23,25,606,462,144
23,19,23,27,492,486,6
23,19,23,29,310,191,119
23,19,23,31,236,330,-94
23,19,25,5,41,36,5
23,19,25,9,74,50,24
23,19,25,17,94,126,-32
23,19,25,21,25,66,-41
23,19,25,23,46,0,46
23,19,25,25,25,75,-50
23,19,25,27,41,26,15
23,19,32,3,0,29,-29
23,19,33,11,95,87,8
23,19,33,13,50,0,50
23,19,33,15,77,82,-5
23,19,33,17,46,48,-2
23,19,36,61,23,0,23
23,19,37,183,0,29,-29
23,19,44,7,35,0,35
23,19,51,810,0,25,-25
23,19,53,33,0,27,-27
23,21,23,1,33,0,33
23,21,23,5,38,65,-27
23,21,23,9,0,28,-28
23,21,23,11,0,60,-60
23,21,23,19,400,440,-40
23,21,23,25,96,95,1
23,21,23,31,33,40,-7
23,23,6,73,42,60,-18
23,23,12,31,44,0,44
23,23,23,1,305,381,-76
23,23,23,3,33,0,33
23,23,23,5,1218,1205,13
23,23,23,7,0,31,-31
23,23,23,11,218,255,-37
23,23,23,13,52,0,52
23,23,23,15,265,247,18
23,23,23,19,79,33,46
23,23,23,31,79,49,30
23,23,24,37,0,40,-40
23,23,25,9,36,0,36
23,23,25,17,29,30,-1
23,23,51,810,48,0,48
23,25,23,1,55,94,-39
23,25,23,3,45,49,-4
23,25,23,5,128,180,-52
23,25,23,7,108,134,-26
23,25,23,9,30,32,-2
23,25,23,11,1001,1101,-100
23,25,23,13,36,0,36
23,25,23,15,0,42,-42
23,25,23,17,47,26,21
23,25,23,19,462,606,-144
23,25,23,21,95,96,-1
23,25,23,27,112,97,15
23,25,23,31,53,63,-10
23,25,25,5,42,0,42
23,25,25,27,41,0,41
23,25,33,15,35,29,6
23,27,23,1,28,0,28
23,27,23,3,33,46,-13
23,27,23,5,75,127,-52
23,27,23,9,117,115,2
23,27,23,11,248,286,-38
23,27,23,13,329,334,-5
23,27,23,15,0,43,-43
23,27,23,19,486,492,-6
23,27,23,25,97,112,-15
23,27,23,31,34,33,1
23,27,25,17,33,0,33
23,29,23,3,65,81,-16
23,29,23,5,76,96,-20
23,29,23,9,142,220,-78
23,29,23,11,30,39,-9
23,29,23,13,26,0,26
23,29,23,17,0,33,-33
23,29,23,19,191,310,-119
23,29,23,31,26,46,-20
23,31,4,13,63,57,6
23,31,4,19,0,31,-31
23,31,6,37,71,23,48
23,31,6,73,55,68,-13
23,31,8,31,0,24,-24
23,31,9,1,31,37,-6
23,31,9,3,67,22,45
23,31,9,9,54,26,28
23,31,9,11,116,113,3
23,31,12,9,26,44,-18
23,31,12,11,42,45,-3
23,31,12,21,27,38,-11
23,31,12,57,0,34,-34
23,31,12,71,34,60,-26
23,31,12,81,0,25,-25
23,31,12,83,24,0,24
23,31,12,86,27,30,-3
23,31,12,95,0,37,-37
23,31,12,99,38,78,-40
23,31,12,101,0,35,-35
23,31,12,103,42,58,-16
23,31,12,115,0,49,-49
23,31,12,127,25,45,-20
23,31,15,3,106,96,10
23,31,17,31,21,0,21
23,31,23,1,167,233,-66
23,31,23,3,113,127,-14
23,31,23,5,3215,3153,62
23,31,23,7,51,36,15
23,31,23,9,61,60,1
23,31,23,11,179,168,11
23,31,23,13,52,65,-13
23,31,23,15,59,51,8
23,31,23,17,207,261,-54
23,31,23,19,330,236,94
23,31,23,21,40,0,40
23,31,23,23,49,79,-30
23,31,23,25,63,53,10
23,31,23,27,0,34,-34
23,31,23,29,46,26,20
23,31,25,1,30,48,-18
23,31,25,5,55,26,29
23,31,25,9,351,247,104
23,31,25,13,58,31,27
23,31,25,17,468,327,141
23,31,25,21,111,74,37
23,31,25,23,97,38,59
23,31,25,25,133,157,-24
23,31,25,27,152,117,35
23,31,32,3,0,42,-42
23,31,33,1,49,35,14
23,31,33,3,137,97,40
23,31,33,5,41,41,0
23,31,33,9,30,28,2
23,31,33,11,233,126,107
23,31,33,13,86,64,22
23,31,33,15,919,669,250
23,31,33,17,1237,1097,140
23,31,36,47,0,42,-42
23,31,36,55,0,25,-25
23,31,36,61,25,41,-16
23,31,36,103,0,30,-30
23,31,37,119,0,38,-38
23,31,44,7,52,43,9
23,31,45,19,28,0,28
23,31,50,7,36,23,13
23,31,50,27,26,0,26
23,31,51,13,0,25,-25
23,31,51,59,29,0,29
23,31,51,810,29,31,-2
23,31,53,33,0,31,-31
24,1,24,3,68,62,6
24,1,24,5,88,71,17
24,1,24,13,24,25,-1
24,1,24,21,60,44,16
24,1,24,23,139,205,-66
24,1,24,31,73,44,29
24,1,24,33,67,46,21
24,1,24,43,128,182,-54
24,1,24,45,0,23,-23
24,1,24,510,69,30,39
24,1,42,3,0,35,-35
24,1,42,9,122,111,11
24,1,42,55,0,37,-37
24,1,42,111,85,70,15
24,1,54,3,42,53,-11
24,1,54,27,56,0,56
24,1,54,57,418,546,-128
24,1,54,61,0,29,-29
24,3,1,89,0,66,-66
24,3,2,20,109,40,69
24,3,2,90,56,0,56
24,3,4,3,61,40,21
24,3,4,13,134,188,-54
24,3,4,19,80,55,25
24,3,5,119,38,0,38
24,3,6,1,29,53,-24
24,3,6,13,22,50,-28
24,3,6,37,206,196,10
24,3,6,53,333,116,217
24,3,6,59,45,88,-43
24,3,6,65,38,43,-5
24,3,6,67,29,31,-2
24,3,6,71,76,67,9
24,3,6,73,296,454,-158
24,3,6,75,0,34,-34
24,3,6,85,43,54,-11
24,3,8,5,82,76,6
24,3,8,13,0,37,-37
24,3,8,31,0,44,-44
24,3,8,35,30,42,-12
24,3,8,41,132,154,-22
24,3,8,59,0,45,-45
24,3,9,1,59,40,19
24,3,9,3,52,45,7
24,3,9,9,52,46,6
24,3,9,11,45,45,0
24,3,10,1,90,196,-106
24,3,10,3,115,154,-39
24,3,10,5,142,385,-243
24,3,11,1,656,632,24
24,3,12,1,0,42,-42
24,3,12,9,87,141,-54
24,3,12,11,160,132,28
24,3,12,15,50,37,13
24,3,12,17,0,30,-30
24,3,12,19,34,69,-35
24,3,12,21,28,31,-3
24,3,12,31,180,182,-2
24,3,12,33,117,219,-102
24,3,12,57,126,247,-121
24,3,12,61,0,49,-49
24,3,12,69,35,56,-21
24,3,12,71,76,100,-24
24,3,12,73,22,0,22
24,3,12,81,40,87,-47
24,3,12,83,0,28,-28
24,3,12,85,0,36,-36
24,3,12,86,111,83,28
24,3,12,87,0,45,-45
24,3,12,91,0,48,-48
24,3,12,95,105,106,-1
24,3,12,97,26,36,-10
24,3,12,99,135,121,14
24,3,12,101,58,87,-29
24,3,12,103,97,108,-11
24,3,12,105,63,52,11
24,3,12,109,0,65,-65
24,3,12,111,0,40,-40
24,3,12,113,0,89,-89
24,3,12,115,49,66,-17
24,3,12,117,31,51,-20
24,3,12,119,0,41,-41
24,3,12,127,46,70,-24
24,3,13,51,59,50,9
24,3,13,67,54,83,-29
24,3,13,73,48,172,-124
24,3,13,89,38,69,-31
24,3,13,121,78,137,-59
24,3,13,135,76,86,-10
24,3,13,215,39,0,39
24,3,13,245,95,82,13
24,3,15,3,457,330,127
24,3,17,31,152,157,-5
24,3,17,43,0,29,-29
24,3,17,97,0,39,-39
24,3,17,163,0,33,-33
24,3,17,197,0,50,-50
24,3,18,97,45,28,17
24,3,21,47,33,0,33
24,3,21,93,0,32,-32
24,3,21,111,32,0,32
24,3,22,71,0,36,-36
24,3,23,5,28,0,28
24,3,24,1,62,68,-6
24,3,24,5,4015,4171,-156
24,3,24,9,739,722,17
24,3,24,11,178,405,-227
24,3,24,13,339,606,-267
24,3,24,15,68,105,-37
24,3,24,17,444,354,90
24,3,24,19,95,133,-38
24,3,24,21,259,313,-54
24,3,24,25,462,774,-312
24,3,24,27,3263,2794,469
24,3,24,29,43,137,-94
24,3,24,31,2047,1407,640
24,3,24,33,7114,3610,3504
24,3,24,35,547,1196,-649
24,3,24,37,253,220,33
24,3,24,39,47,57,-10
24,3,24,41,176,225,-49
24,3,24,43,77,163,-86
24,3,24,45,159,165,-6
24,3,24,47,136,208,-72
24,3,24,510,3425,3334,91
24,3,25,5,27,0,27
24,3,25,9,31,42,-11
24,3,25,17,114,94,20
24,3,25,21,36,45,-9
24,3,25,25,52,39,13
24,3,25,27,35,35,0
24,3,26,65,37,0,37
24,3,26,81,52,0,52
24,3,26,125,39,32,7
24,3,26,163,78,0,78
24,3,28,47,33,0,33
24,3,29,183,0,36,-36
24,3,29,189,52,50,2
24,3,31,153,48,0,48
24,3,32,3,103,162,-59
24,3,33,11,0,53,-53
24,3,33,15,25,0,25
24,3,34,1,0,21,-21
24,3,34,3,46,0,46
24,3,34,5,125,78,47
24,3,34,7,36,0,36
24,3,34,9,34,0,34
24,3,34,13,59,43,16
24,3,34,15,25,0,25
24,3,34,17,33,45,-12
24,3,34,21,21,0,21
24,3,34,23,51,49,2
24,3,34,25,75,52,23
24,3,34,27,50,35,15
24,3,34,29,0,34,-34
24,3,34,31,27,0,27
24,3,34,35,32,26,6
24,3,34,39,28,0,28
24,3,35,1,34,42,-8
24,3,36,5,59,30,29
24,3,36,29,79,58,21
24,3,36,45,83,33,50
24,3,36,47,124,85,39
24,3,36,55,63,42,21
24,3,36,59,57,62,-5
24,3,36,61,86,138,-52
24,3,36,67,58,41,17
24,3,36,71,53,37,16
24,3,36,81,140,87,53
24,3,36,85,0,35,-35
24,3,36,91,0,32,-32
24,3,36,103,62,54,8
24,3,36,119,31,0,31
24,3,37,19,0,69,-69
24,3,37,21,22,0,22
24,3,37,49,0,51,-51
24,3,37,51,141,150,-9
24,3,37,63,33,44,-11
24,3,37,67,44,39,5
24,3,37,81,35,62,-27
24,3,37,85,0,41,-41
24,3,37,97,0,34,-34
24,3,37,101,0,44,-44
24,3,37,119,91,215,-124
24,3,37,129,56,54,2
24,3,37,133,104,148,-44
24,3,37,147,0,32,-32
24,3,37,179,0,45,-45
24,3,37,183,82,284,-202
24,3,39,35,74,37,37
24,3,39,49,76,73,3
24,3,39,57,36,0,36
24,3,39,61,31,30,1
24,3,39,95,0,28,-28
24,3,40,31,32,41,-9
24,3,40,143,23,0,23
24,3,41,51,30,28,2
24,3,42,1,49,92,-43
24,3,42,3,126,128,-2
24,3,42,11,48,0,48
24,3,42,17,79,41,38
24,3,42,29,69,65,4
24,3,42,41,74,43,31
24,3,42,43,45,46,-1
24,3,42,45,68,68,0
24,3,42,51,0,27,-27
24,3,42,55,29,79,-50
24,3,42,71,39,96,-57
24,3,42,77,0,32,-32
24,3,42,79,52,0,52
24,3,42,91,140,77,63
24,3,42,95,34,0,34
24,3,42,101,102,226,-124
24,3,42,129,33,36,-3
24,3,42,133,169,602,-433
24,3,44,5,115,0,115
24,3,44,7,27,0,27
24,3,45,13,0,72,-72
24,3,45,15,33,54,-21
24,3,45,19,54,127,-73
24,3,45,35,0,63,-63
24,3,45,43,0,33,-33
24,3,45,45,0,39,-39
24,3,45,51,38,147,-109
24,3,45,63,0,56,-56
24,3,45,79,77,94,-17
24,3,45,91,0,46,-46
24,3,47,37,49,36,13
24,3,47,93,33,0,33
24,3,47,125,73,65,8
24,3,47,157,74,38,36
24,3,48,27,190,113,77
24,3,48,29,277,250,27
24,3,48,85,36,74,-38
24,3,48,113,76,93,-17
24,3,48,121,40,54,-14
24,3,48,141,76,55,21
24,3,48,157,0,30,-30
24,3,48,201,115,190,-75
24,3,48,355,0,170,-170
24,3,48,439,96,115,-19
24,3,48,451,75,63,12
24,3,48,453,24,94,-70
24,3,49,35,0,52,-52
24,3,51,1,0,31,-31
24,3,51,3,0,59,-59
24,3,51,13,257,219,38
24,3,51,41,50,83,-33
24,3,51,59,774,662,112
24,3,51,61,0,46,-46
24,3,51,87,68,63,5
24,3,51,107,149,258,-109
24,3,51,121,25,0,25
24,3,51,153,233,281,-48
24,3,51,177,44,49,-5
24,3,51,179,56,131,-75
24,3,51,199,0,38,-38
24,3,51,510,217,167,50
24,3,51,550,100,120,-20
24,3,51,650,71,45,26
24,3,51,700,65,44,21
24,3,51,710,138,156,-18
24,3,51,760,39,38,1
24,3,51,800,0,37,-37
24,3,51,810,276,248,28
24,3,53,33,76,100,-24
24,3,53,35,46,25,21
24,3,53,53,68,71,-3
24,3,54,3,40,105,-65
24,3,54,27,0,26,-26
24,3,54,37,0,116,-116
24,3,54,61,29,0,29
24,3,54,65,0,30,-30
24,3,55,25,25,0,25
24,5,1,89,0,40,-40
24,5,4,13,119,220,-101
24,5,4,19,46,80,-34
24,5,4,21,0,40,-40
24,5,6,1,38,65,-27
24,5,6,13,0,34,-34
24,5,6,37,223,298,-75
24,5,6,53,36,0,36
24,5,6,59,79,82,-3
24,5,6,65,0,41,-41
24,5,6,67,0,42,-42
24,5,6,71,29,48,-19
24,5,6,73,130,195,-65
24,5,6,75,41,62,-21
24,5,6,85,48,87,-39
24,5,8,5,0,42,-42
24,5,8,13,0,26,-26
24,5,8,31,33,43,-10
24,5,8,35,0,29,-29
24,5,8,41,0,55,-55
24,5,8,59,0,41,-41
24,5,9,1,67,81,-14
24,5,9,3,81,61,20
24,5,9,9,53,75,-22
24,5,9,11,0,42,-42
24,5,10,1,73,110,-37
24,5,10,3,195,231,-36
24,5,10,5,77,296,-219
24,5,11,1,315,404,-89
24,5,12,9,45,68,-23
24,5,12,11,165,207,-42
24,5,12,21,0,58,-58
24,5,12,31,61,132,-71
24,5,12,33,41,0,41
24,5,12,35,0,32,-32
24,5,12,57,113,176,-63
24,5,12,69,0,53,-53
24,5,12,71,69,100,-31
24,5,12,73,47,0,47
24,5,12,81,0,62,-62
24,5,12,83,0,42,-42
24,5,12,86,100,129,-29
24,5,12,87,0,25,-25
24,5,12,95,120,119,1
24,5,12,97,0,43,-43
24,5,12,99,122,214,-92
24,5,12,101,0,67,-67
24,5,12,103,80,101,-21
24,5,12,105,37,77,-40
24,5,12,109,0,34,-34
24,5,12,111,0,27,-27
24,5,12,115,33,77,-44
24,5,12,117,33,43,-10
24,5,12,119,0,46,-46
24,5,12,127,54,36,18
24,5,13,51,37,47,-10
24,5,13,63,42,102,-60
24,5,13,67,88,125,-37
24,5,13,89,77,163,-86
24,5,13,117,0,43,-43
24,5,13,121,112,170,-58
24,5,13,135,58,164,-106
24,5,13,151,0,36,-36
24,5,15,3,53,50,3
24,5,17,19,25,0,25
24,5,17,31,198,241,-43
24,5,17,43,32,43,-11
24,5,17,97,34,44,-10
24,5,18,97,40,51,-11
24,5,21,111,58,45,13
24,5,22,33,0,25,-25
24,5,22,51,27,0,27
24,5,22,71,0,29,-29
24,5,23,5,30,0,30
24,5,24,1,71,88,-17
24,5,24,3,4171,4015,156
24,5,24,9,153,102,51
24,5,24,11,32,61,-29
24,5,24,13,1586,2553,-967
24,5,24,15,299,449,-150
24,5,24,17,144,142,2
24,5,24,19,53,60,-7
24,5,24,21,375,431,-56
24,5,24,23,30,47,-17
24,5,24,25,3917,5777,-1860
24,5,24,27,3910,3749,161
24,5,24,31,1330,1326,4
24,5,24,33,1900,1355,545
24,5,24,35,90,126,-36
24,5,24,37,129,60,69
24,5,24,39,43,47,-4
24,5,24,41,62,110,-48
24,5,24,43,126,148,-22
24,5,24,45,183,199,-16
24,5,24,47,185,233,-48
24,5,24,510,24768,19024,5744
24,5,25,1,0,63,-63
24,5,25,9,35,35,0
24,5,25,13,37,0,37
24,5,25,17,91,137,-46
24,5,25,21,49,65,-16
24,5,25,25,98,76,22
24,5,25,27,43,42,1
24,5,26,65,37,0,37
24,5,26,81,22,0,22
24,5,26,99,32,0,32
24,5,26,125,86,78,8
24,5,26,161,45,38,7
24,5,26,163,101,31,70
24,5,27,53,65,25,40
24,5,29,189,71,47,24
24,5,32,3,60,140,-80
24,5,33,11,29,0,29
24,5,34,1,38,53,-15
24,5,34,3,63,81,-18
24,5,34,5,80,74,6
24,5,34,7,75,80,-5
24,5,34,13,103,77,26
24,5,34,15,33,0,33
24,5,34,17,60,68,-8
24,5,34,21,47,32,15
24,5,34,23,104,93,11
24,5,34,25,63,41,22
24,5,34,27,66,38,28
24,5,34,29,25,0,25
24,5,34,31,32,46,-14
24,5,34,35,41,46,-5
24,5,34,39,56,47,9
24,5,35,1,36,50,-14
24,5,36,1,38,43,-5
24,5,36,5,189,119,70
24,5,36,29,115,78,37
24,5,36,45,35,22,13
24,5,36,47,341,286,55
24,5,36,55,72,74,-2
24,5,36,59,129,104,25
24,5,36,61,188,356,-168
24,5,36,67,52,54,-2
24,5,36,81,275,230,45
24,5,36,85,31,0,31
24,5,36,103,127,74,53
24,5,36,119,101,48,53
24,5,37,25,0,61,-61
24,5,37,51,67,89,-22
24,5,37,63,0,82,-82
24,5,37,67,0,69,-69
24,5,37,77,0,41,-41
24,5,37,81,67,90,-23
24,5,37,101,0,36,-36
24,5,37,119,99,346,-247
24,5,37,129,30,37,-7
24,5,37,133,58,63,-5
24,5,37,135,0,38,-38
24,5,37,179,0,38,-38
24,5,37,183,96,388,-292
24,5,39,35,94,84,10
24,5,39,49,93,79,14
24,5,39,61,57,0,57
24,5,39,113,28,0,28
24,5,39,153,38,0,38
24,5,41,51,0,50,-50
24,5,41,67,0,35,-35
24,5,42,1,100,184,-84
24,5,42,3,200,161,39
24,5,42,11,45,76,-31
24,5,42,17,102,70,32
24,5,42,27,24,0,24
24,5,42,29,106,83,23
24,5,42,41,74,87,-13
24,5,42,43,79,95,-16
24,5,42,45,131,104,27
24,5,42,49,39,0,39
24,5,42,55,32,62,-30
24,5,42,71,133,125,8
24,5,42,75,27,0,27
24,5,42,77,62,60,2
24,5,42,79,42,29,13
24,5,42,91,164,161,3
24,5,42,95,24,0,24
24,5,42,101,255,305,-50
24,5,42,125,0,31,-31
24,5,42,129,49,0,49
24,5,42,133,801,2981,-2180
24,5,44,7,41,31,10
24,5,45,13,0,44,-44
24,5,45,19,47,87,-40
24,5,45,35,26,0,26
24,5,45,45,0,39,-39
24,5,45,51,29,122,-93
24,5,45,63,0,35,-35
24,5,45,79,46,45,1
24,5,47,37,52,43,9
24,5,47,93,0,29,-29
24,5,47,157,30,0,30
24,5,48,27,0,63,-63
24,5,48,29,32,100,-68
24,5,48,85,0,57,-57
24,5,48,113,72,163,-91
24,5,48,121,0,31,-31
24,5,48,157,0,37,-37
24,5,48,201,152,264,-112
24,5,48,439,83,98,-15
24,5,48,453,0,81,-81
24,5,49,35,0,62,-62
24,5,50,7,0,23,-23
24,5,51,3,0,42,-42
24,5,51,13,105,197,-92
24,5,51,41,82,77,5
24,5,51,59,368,473,-105
24,5,51,69,0,34,-34
24,5,51,87,110,87,23
24,5,51,107,61,167,-106
24,5,51,153,136,162,-26
24,5,51,179,0,33,-33
24,5,51,510,49,84,-35
24,5,51,550,34,40,-6
24,5,51,650,49,30,19
24,5,51,700,44,49,-5
24,5,51,710,99,62,37
24,5,51,760,42,40,2
24,5,51,810,98,147,-49
24,5,53,33,56,131,-75
24,5,53,53,30,36,-6
24,5,54,3,39,139,-100
24,5,54,37,33,63,-30
24,5,54,39,0,25,-25
24,5,54,61,30,0,30
24,5,55,79,0,49,-49
24,9,6,73,30,35,-5
24,9,10,5,0,55,-55
24,9,11,1,88,51,37
24,9,24,3,722,739,-17
24,9,24,5,102,153,-51
24,9,24,17,582,267,315
24,9,24,21,0,37,-37
24,9,24,25,0,25,-25
24,9,24,27,39,71,-32
24,9,24,31,184,131,53
24,9,24,33,1164,520,644
24,9,24,35,34,35,-1
24,9,24,37,695,840,-145
24,9,24,510,55,74,-19
24,9,45,51,0,47,-47
24,9,51,13,25,40,-15
24,9,51,59,138,74,64
24,9,51,99,0,45,-45
24,9,51,153,0,39,-39
24,9,51,510,30,59,-29
24,9,51,810,58,43,15
24,11,10,1,136,185,-49
24,11,10,3,42,28,14
24,11,10,5,122,216,-94
24,11,24,3,405,178,227
24,11,24,5,61,32,29
24,11,24,19,274,345,-71
24,11,24,27,61,0,61
24,11,24,29,33,38,-5
24,11,24,33,104,28,76
24,11,24,35,404,282,122
24,11,24,41,516,433,83
24,11,24,45,61,87,-26
24,11,24,510,50,35,15
24,13,4,13,0,39,-39
24,13,6,37,32,26,6
24,13,10,5,26,71,-45
24,13,11,1,37,25,12
24,13,12,9,0,40,-40
24,13,12,99,0,36,-36
24,13,24,1,25,24,1
24,13,24,3,606,339,267
24,13,24,5,2553,1586,967
24,13,24,15,24,0,24
24,13,24,21,671,770,-99
24,13,24,25,134,169,-35
24,13,24,27,1144,516,628
24,13,24,31,569,272,297
24,13,24,33,203,90,113
24,13,24,35,0,38,-38
24,13,24,43,83,175,-92
24,13,24,45,33,33,0
24,13,24,47,44,53,-9
24,13,24,510,408,372,36
24,13,37,133,30,36,-6
24,13,37,183,0,51,-51
24,13,42,1,213,651,-438
24,13,42,55,30,68,-38
24,13,42,71,30,26,4
24,13,42,101,0,28,-28
24,13,42,133,353,960,-607
24,13,45,51,0,60,-60
24,13,51,59,42,52,-10
24,13,51,107,0,43,-43
24,13,54,3,0,56,-56
24,13,54,37,0,50,-50
24,15,4,13,0,42,-42
24,15,10,1,84,189,-105
24,15,10,3,1500,1582,-82
24,15,10,5,51,79,-28
24,15,11,1,0,25,-25
24,15,24,3,105,68,37
24,15,24,5,449,299,150
24,15,24,13,0,24,-24
24,15,24,25,1470,916,554
24,15,24,27,46,47,-1
24,15,24,29,97,102,-5
24,15,24,31,41,0,41
24,15,24,33,43,39,4
24,15,24,35,40,0,40
24,15,24,45,0,27,-27
24,15,24,510,122,90,32
24,15,34,15,24,0,24
24,15,42,17,37,0,37
24,15,42,29,283,310,-27
24,15,42,45,121,88,33
24,15,42,71,130,130,0
24,15,42,91,47,44,3
24,15,42,101,68,46,22
24,15,42,133,70,105,-35
24,15,51,59,33,0,33
24,17,1,89,0,32,-32
24,17,4,13,0,48,-48
24,17,6,71,33,0,33
24,17,6,73,63,86,-23
24,17,10,5,0,53,-53
24,17,11,1,598,318,280
24,17,12,9,34,0,34
24,17,12,31,43,41,2
24,17,12,57,32,42,-10
24,17,12,95,35,31,4
24,17,13,121,0,52,-52
24,17,15,3,83,49,34
24,17,24,3,354,444,-90
24,17,24,5,142,144,-2
24,17,24,9,267,582,-315
24,17,24,21,44,49,-5
24,17,24,25,31,0,31
24,17,24,27,83,84,-1
24,17,24,31,341,288,53
24,17,24,33,5927,2747,3180
24,17,24,37,821,1441,-620
24,17,24,43,0,51,-51
24,17,24,45,43,36,7
24,17,24,510,78,113,-35
24,17,32,3,0,45,-45
24,17,36,47,32,30,2
24,17,37,19,0,32,-32
24,17,37,51,39,30,9
24,17,37,119,0,53,-53
24,17,37,133,124,72,52
24,17,37,183,0,86,-86
24,17,39,35,24,0,24
24,17,42,3,39,53,-14
24,17,42,91,27,0,27
24,17,42,101,34,0,34
24,17,42,133,0,49,-49
24,17,45,51,0,85,-85
24,17,48,29,40,43,-3
24,17,48,201,0,25,-25
24,17,48,439,0,37,-37
24,17,51,13,55,108,-53
24,17,51,59,306,397,-91
24,17,51,69,0,40,-40
24,17,51,99,91,389,-298
24,17,51,107,40,94,-54
24,17,51,153,153,140,13
24,17,51,177,0,34,-34
24,17,51,179,26,50,-24
24,17,51,193,30,148,-118
24,17,51,510,151,136,15
24,17,51,650,32,0,32
24,17,51,700,36,0,36
24,17,51,810,53,56,-3
24,17,54,3,0,52,-52
24,19,10,1,0,36,-36
24,19,10,5,96,175,-79
24,19,24,3,133,95,38
24,19,24,5,60,53,7
24,19,24,11,345,274,71
24,19,24,25,27,0,27
24,19,24,31,33,0,33
24,19,24,33,60,41,19
24,19,24,35,63,42,21
24,19,24,41,484,298,186
24,19,24,45,191,243,-52
24,19,24,47,0,32,-32
24,19,24,510,51,46,5
24,21,4,13,69,82,-13
24,21,4,19,0,33,-33
24,21,6,37,83,63,20
24,21,6,59,43,0,43
24,21,6,73,81,85,-4
24,21,8,31,0,23,-23
24,21,8,41,55,53,2
24,21,10,3,46,0,46
24,21,10,5,35,91,-56
24,21,11,1,167,135,32
24,21,12,9,41,55,-14
24,21,12,11,37,39,-2
24,21,12,31,0,51,-51
24,21,12,57,32,51,-19
24,21,12,86,31,33,-2
24,21,12,95,44,42,2
24,21,12,99,32,30,2
24,21,12,103,25,0,25
24,21,12,127,0,25,-25
24,21,13,51,0,27,-27
24,21,13,67,0,55,-55
24,21,13,121,45,32,13
24,21,13,135,0,40,-40
24,21,13,245,51,0,51
24,21,15,3,58,42,16
24,21,17,31,48,43,5
24,21,21,47,35,0,35
24,21,24,1,44,60,-16
24,21,24,3,313,259,54
24,21,24,5,431,375,56
24,21,24,9,37,0,37
24,21,24,13,770,671,99
24,21,24,17,49,44,5
24,21,24,23,32,41,-9
24,21,24,25,82,57,25
24,21,24,27,607,305,302
24,21,24,31,5150,2586,2564
24,21,24,33,641,338,303
24,21,24,35,0,29,-29
24,21,24,37,42,34,8
24,21,24,43,1432,2557,-1125
24,21,24,45,42,54,-12
24,21,24,47,25,65,-40
24,21,24,510,180,229,-49
24,21,25,17,37,40,-3
24,21,25,27,25,0,25
24,21,29,189,29,0,29
24,21,32,3,44,46,-2
24,21,34,17,29,0,29
24,21,36,47,39,69,-30
24,21,36,59,27,0,27
24,21,36,61,34,36,-2
24,21,36,71,27,0,27
24,21,36,81,0,27,-27
24,21,36,103,44,0,44
24,21,37,19,0,45,-45
24,21,37,51,58,42,16
24,21,37,81,0,30,-30
24,21,37,119,0,96,-96
24,21,37,129,0,26,-26
24,21,37,133,25,37,-12
24,21,37,183,46,111,-65
24,21,39,35,28,0,28
24,21,39,49,42,35,7
24,21,42,1,178,459,-281
24,21,42,3,85,70,15
24,21,42,21,0,32,-32
24,21,42,27,30,0,30
24,21,42,29,22,40,-18
24,21,42,41,35,40,-5
24,21,42,43,36,0,36
24,21,42,45,0,27,-27
24,21,42,55,222,517,-295
24,21,42,71,28,44,-16
24,21,42,91,35,32,3
24,21,42,101,42,59,-17
24,21,42,129,0,37,-37
24,21,42,133,84,129,-45
24,21,45,51,26,52,-26
24,21,45,79,33,0,33
24,21,47,93,0,60,-60
24,21,48,27,0,51,-51
24,21,48,29,64,68,-4
24,21,48,85,0,28,-28
24,21,48,201,0,74,-74
24,21,48,439,0,41,-41
24,21,48,453,0,33,-33
24,21,48,491,0,33,-33
24,21,51,13,50,81,-31
24,21,51,59,235,264,-29
24,21,51,69,26,76,-50
24,21,51,87,31,0,31
24,21,51,107,178,300,-122
24,21,51,153,86,73,13
24,21,51,510,80,32,48
24,21,51,810,55,47,8
24,21,54,3,191,505,-314
24,21,54,37,165,406,-241
24,21,54,65,0,35,-35
24,21,55,79,0,33,-33
24,23,24,1,205,139,66
24,23,24,3,37,23,14
24,23,24,5,47,30,17
24,23,24,21,41,32,9
24,23,24,31,53,33,20
24,23,24,43,0,35,-35
24,23,42,3,0,32,-32
24,23,42,111,50,65,-15
24,23,54,57,35,49,-14
24,23,54,61,0,42,-42
24,23,54,77,75,104,-29
24,25,4,13,43,82,-39
24,25,4,19,0,36,-36
24,25,6,37,44,57,-13
24,25,6,71,70,77,-7
24,25,6,73,50,75,-25
24,25,8,41,79,84,-5
24,25,10,1,29,42,-13
24,25,10,3,151,165,-14
24,25,10,5,44,142,-98
24,25,11,1,58,64,-6
24,25,12,11,33,50,-17
24,25,12,31,0,27,-27
24,25,12,57,44,35,9
24,25,12,95,49,31,18
24,25,12,99,0,48,-48
24,25,12,103,34,69,-35
24,25,12,115,0,26,-26
24,25,12,127,0,46,-46
24,25,13,67,41,40,1
24,25,13,121,0,28,-28
24,25,13,215,0,58,-58
24,25,15,3,98,80,18
24,25,17,31,31,45,-14
24,25,20,61,0,43,-43
24,25,24,3,774,462,312
24,25,24,5,5777,3917,1860
24,25,24,9,25,0,25
24,25,24,13,169,134,35
24,25,24,15,916,1470,-554
24,25,24,17,0,31,-31
24,25,24,19,0,27,-27
24,25,24,21,57,82,-25
24,25,24,27,319,221,98
24,25,24,31,163,101,62
24,25,24,33,308,176,132
24,25,24,37,0,34,-34
24,25,24,43,0,28,-28
24,25,24,45,56,46,10
24,25,24,47,46,82,-36
24,25,24,510,1688,1222,466
24,25,25,17,0,32,-32
24,25,29,169,62,0,62
24,25,32,3,33,53,-20
24,25,34,5,26,0,26
24,25,34,7,31,0,31
24,25,34,25,62,0,62
24,25,34,29,28,0,28
24,25,36,5,46,0,46
24,25,36,29,46,0,46
24,25,36,45,44,0,44
24,25,36,47,37,29,8
24,25,36,61,40,43,-3
24,25,36,81,36,42,-6
24,25,36,103,33,0,33
24,25,37,51,71,114,-43
24,25,37,81,0,39,-39
24,25,37,97,0,34,-34
24,25,37,119,0,67,-67
24,25,37,133,49,68,-19
24,25,37,183,0,82,-82
24,25,40,31,43,0,43
24,25,42,3,61,45,16
24,25,42,17,0,47,-47
24,25,42,29,74,87,-13
24,25,42,41,0,46,-46
24,25,42,43,0,38,-38
24,25,42,45,57,52,5
24,25,42,55,0,37,-37
24,25,42,71,33,99,-66
24,25,42,91,52,47,5
24,25,42,101,59,57,2
24,25,42,133,463,1077,-614
24,25,45,51,32,52,-20
24,25,45,79,45,38,7
24,25,47,125,51,38,13
24,25,48,27,114,124,-10
24,25,48,29,0,53,-53
24,25,48,99,55,0,55
24,25,48,141,0,48,-48
24,25,48,439,0,54,-54
24,25,51,13,0,34,-34
24,25,51,41,0,68,-68
24,25,51,59,83,71,12
24,25,51,107,0,43,-43
24,25,51,153,58,64,-6
24,25,51,510,0,22,-22
24,25,51,700,0,36,-36
24,25,51,710,34,0,34
24,25,51,810,36,59,-23
24,25,53,53,52,44,8
24,25,54,3,0,32,-32
24,27,1,89,0,44,-44
24,27,2,20,30,0,30
24,27,4,13,142,171,-29
24,27,4,19,0,30,-30
24,27,6,1,53,27,26
24,27,6,37,158,156,2
24,27,6,53,42,0,42
24,27,6,59,45,28,17
24,27,6,73,88,140,-52
24,27,6,75,0,24,-24
24,27,6,85,62,62,0
24,27,8,13,0,34,-34
24,27,8,35,0,46,-46
24,27,8,41,37,44,-7
24,27,9,1,36,38,-2
24,27,9,3,40,0,40
24,27,9,9,31,0,31
24,27,10,1,0,41,-41
24,27,10,3,98,59,39
24,27,10,5,51,141,-90
24,27,11,1,341,348,-7
24,27,12,1,0,29,-29
24,27,12,9,43,50,-7
24,27,12,11,99,70,29
24,27,12,31,27,30,-3
24,27,12,57,65,80,-15
24,27,12,86,93,44,49
24,27,12,95,44,69,-25
24,27,12,99,53,71,-18
24,27,12,101,0,35,-35
24,27,12,103,42,38,4
24,27,12,115,27,39,-12
24,27,12,117,0,33,-33
24,27,12,127,0,33,-33
24,27,13,67,50,37,13
24,27,13,73,41,0,41
24,27,13,89,38,46,-8
24,27,13,121,71,100,-29
24,27,13,135,34,82,-48
24,27,13,245,33,0,33
24,27,15,3,111,97,14
24,27,17,31,85,96,-11
24,27,17,43,0,42,-42
24,27,21,111,0,29,-29
24,27,24,3,2794,3263,-469
24,27,24,5,3749,3910,-161
24,27,24,9,71,39,32
24,27,24,11,0,61,-61
24,27,24,13,516,1144,-628
24,27,24,15,47,46,1
24,27,24,17,84,83,1
24,27,24,21,305,607,-302
24,27,24,25,221,319,-98
24,27,24,29,0,30,-30
24,27,24,31,2909,2017,892
24,27,24,33,3667,2048,1619
24,27,24,35,31,73,-42
24,27,24,37,44,71,-27
24,27,24,41,0,41,-41
24,27,24,43,68,114,-46
24,27,24,45,85,68,17
24,27,24,47,54,85,-31
24,27,24,510,1715,1915,-200
24,27,25,9,0,32,-32
24,27,25,17,109,66,43
24,27,25,21,51,0,51
24,27,25,25,30,38,-8
24,27,25,27,42,0,42
24,27,26,125,95,26,69
24,27,26,163,41,0,41
24,27,27,53,36,0,36
24,27,29,189,34,50,-16
24,27,32,3,40,89,-49
24,27,34,3,48,64,-16
24,27,34,5,35,28,7
24,27,34,7,36,0,36
24,27,34,13,55,0,55
24,27,34,17,33,56,-23
24,27,34,21,50,0,50
24,27,34,23,102,89,13
24,27,34,25,52,0,52
24,27,34,39,54,0,54
24,27,36,1,39,0,39
24,27,36,5,30,39,-9
24,27,36,29,32,0,32
24,27,36,47,75,86,-11
24,27,36,55,0,47,-47
24,27,36,59,68,0,68
24,27,36,61,67,128,-61
24,27,36,67,41,0,41
24,27,36,81,134,62,72
24,27,36,103,41,36,5
24,27,36,119,38,0,38
24,27,37,51,40,35,5
24,27,37,63,0,25,-25
24,27,37,81,41,45,-4
24,27,37,119,108,118,-10
24,27,37,179,0,47,-47
24,27,37,183,73,175,-102
24,27,39,35,63,0,63
24,27,39,49,80,57,23
24,27,39,61,27,0,27
24,27,41,67,0,44,-44
24,27,42,1,0,38,-38
24,27,42,3,105,89,16
24,27,42,17,39,80,-41
24,27,42,27,0,26,-26
24,27,42,29,53,75,-22
24,27,42,41,0,24,-24
24,27,42,43,24,45,-21
24,27,42,45,58,26,32
24,27,42,55,0,33,-33
24,27,42,71,27,0,27
24,27,42,91,73,66,7
24,27,42,101,68,67,1
24,27,42,129,20,0,20
24,27,42,133,131,294,-163
24,27,45,19,28,32,-4
24,27,45,45,0,27,-27
24,27,45,51,0,56,-56
24,27,45,79,0,48,-48
24,27,45,91,0,29,-29
24,27,47,37,24,30,-6
24,27,47,157,33,44,-11
24,27,48,27,31,0,31
24,27,48,29,58,122,-64
24,27,48,85,43,70,-27
24,27,48,113,69,68,1
24,27,48,201,72,130,-58
24,27,48,439,41,42,-1
24,27,48,453,0,52,-52
24,27,51,13,102,199,-97
24,27,51,41,57,0,57
24,27,51,59,476,497,-21
24,27,51,87,35,51,-16
24,27,51,107,109,182,-73
24,27,51,121,32,0,32
24,27,51,153,93,105,-12
24,27,51,510,84,57,27
24,27,51,710,35,0,35
24,27,51,810,84,54,30
24,27,53,33,53,67,-14
24,27,53,53,0,31,-31
24,27,54,3,0,48,-48
24,27,54,37,0,79,-79
24,27,54,65,0,45,-45
24,29,10,1,71,64,7
24,29,10,3,109,37,72
24,29,24,3,137,43,94
24,29,24,5,30,27,3
24,29,24,11,38,33,5
24,29,24,15,102,97,5
24,29,24,27,30,0,30
24,29,24,31,31,0,31
24,29,24,33,58,0,58
24,29,24,35,186,227,-41
24,29,24,41,36,0,36
24,31,1,73,35,44,-9
24,31,1,89,27,69,-42
24,31,1,97,32,0,32
24,31,2,20,35,42,-7
24,31,2,90,30,0,30
24,31,4,3,0,35,-35
24,31,4,13,272,367,-95
24,31,4,19,102,102,0
24,31,4,25,0,24,-24
24,31,6,1,179,209,-30
24,31,6,13,99,92,7
24,31,6,37,782,750,32
24,31,6,41,31,0,31
24,31,6,53,62,39,23
24,31,6,59,192,212,-20
24,31,6,61,0,27,-27
24,31,6,65,70,96,-26
24,31,6,67,74,83,-9
24,31,6,71,118,94,24
24,31,6,73,411,548,-137
24,31,6,75,137,196,-59
24,31,6,81,94,97,-3
24,31,6,83,35,0,35
24,31,6,85,183,280,-97
24,31,6,95,28,40,-12
24,31,6,97,22,37,-15
24,31,6,111,32,47,-15
24,31,6,113,29,46,-17
24,31,8,5,51,60,-9
24,31,8,13,73,77,-4
24,31,8,31,100,122,-22
24,31,8,41,118,100,18
24,31,8,59,0,54,-54
24,31,8,69,35,46,-11
24,31,9,1,166,107,59
24,31,9,3,106,99,7
24,31,9,9,128,111,17
24,31,9,11,0,48,-48
24,31,10,1,27,44,-17
24,31,10,3,196,173,23
24,31,10,5,83,315,-232
24,31,11,1,7349,5882,1467
24,31,12,1,83,70,13
24,31,12,9,76,98,-22
24,31,12,11,372,382,-10
24,31,12,15,0,30,-30
24,31,12,19,0,51,-51
24,31,12,21,57,69,-12
24,31,12,31,153,197,-44
24,31,12,33,32,53,-21
24,31,12,57,214,190,24
24,31,12,61,0,31,-31
24,31,12,69,0,30,-30
24,31,12,71,88,106,-18
24,31,12,73,63,0,63
24,31,12,81,35,37,-2
24,31,12,83,0,32,-32
24,31,12,86,461,327,134
24,31,12,87,0,26,-26
24,31,12,89,0,35,-35
24,31,12,95,233,247,-14
24,31,12,97,0,90,-90
24,31,12,99,263,391,-128
24,31,12,101,51,45,6
24,31,12,103,119,160,-41
24,31,12,105,52,72,-20
24,31,12,109,33,64,-31
24,31,12,111,0,32,-32
24,31,12,115,65,110,-45
24,31,12,117,62,58,4
24,31,12,119,0,29,-29
24,31,12,127,50,65,-15
24,31,13,51,61,40,21
24,31,13,59,34,0,34
24,31,13,63,44,0,44
24,31,13,67,147,170,-23
24,31,13,73,35,62,-27
24,31,13,89,141,188,-47
24,31,13,121,233,316,-83
24,31,13,135,130,198,-68
24,31,13,245,39,36,3
24,31,15,3,250,233,17
24,31,16,1,0,33,-33
24,31,17,19,73,28,45
24,31,17,31,522,532,-10
24,31,17,43,78,61,17
24,31,17,97,109,79,30
24,31,17,197,41,54,-13
24,31,18,57,0,33,-33
24,31,18,97,72,83,-11
24,31,18,105,23,45,-22
24,31,18,141,0,23,-23
24,31,18,157,40,0,40
24,31,19,103,34,0,34
24,31,19,153,38,0,38
24,31,20,45,28,0,28
24,31,20,91,50,63,-13
24,31,20,173,36,26,10
24,31,21,67,32,26,6
24,31,21,111,50,70,-20
24,31,22,51,27,34,-7
24,31,22,71,51,93,-42
24,31,23,5,36,35,1
24,31,24,1,44,73,-29
24,31,24,3,1407,2047,-640
24,31,24,5,1326,1330,-4
24,31,24,9,131,184,-53
24,31,24,13,272,569,-297
24,31,24,15,0,41,-41
24,31,24,17,288,341,-53
24,31,24,21,2586,5150,-2564
24,31,24,23,33,53,-20
24,31,24,25,101,163,-62
24,31,24,27,2017,2909,-892
24,31,24,29,0,31,-31
24,31,24,33,12363,10416,1947
24,31,24,35,54,99,-45
24,31,24,37,123,137,-14
24,31,24,39,24,28,-4
24,31,24,41,48,71,-23
24,31,24,43,399,846,-447
24,31,24,45,81,131,-50
24,31,24,47,80,149,-69
24,31,24,510,1010,1307,-297
24,31,25,1,31,70,-39
24,31,25,5,35,33,2
24,31,25,9,69,76,-7
24,31,25,13,41,0,41
24,31,25,15,0,36,-36
24,31,25,17,487,457,30
24,31,25,21,182,109,73
24,31,25,23,0,34,-34
24,31,25,25,232,214,18
24,31,25,27,91,72,19
24,31,26,65,56,27,29
24,31,26,77,0,25,-25
24,31,26,81,54,0,54
24,31,26,99,44,0,44
24,31,26,125,200,77,123
24,31,26,161,160,71,89
24,31,26,163,135,49,86
24,31,27,53,169,114,55
24,31,27,123,50,31,19
24,31,29,19,36,31,5
24,31,29,95,40,0,40
24,31,29,189,92,45,47
24,31,29,510,71,30,41
24,31,31,55,57,39,18
24,31,32,3,114,281,-167
24,31,32,31,45,0,45
24,31,33,9,23,0,23
24,31,33,11,58,52,6
24,31,33,15,44,33,11
24,31,34,1,46,0,46
24,31,34,3,194,103,91
24,31,34,5,96,62,34
24,31,34,7,117,40,77
24,31,34,13,161,122,39
24,31,34,15,36,39,-3
24,31,34,17,152,224,-72
24,31,34,19,38,0,38
24,31,34,21,89,102,-13
24,31,34,23,244,183,61
24,31,34,25,99,61,38
24,31,34,27,95,76,19
24,31,34,29,50,46,4
24,31,34,31,47,39,8
24,31,34,35,116,73,43
24,31,34,39,94,59,35
24,31,35,1,101,114,-13
24,31,35,49,0,33,-33
24,31,36,1,69,39,30
24,31,36,5,199,139,60
24,31,36,7,26,32,-6
24,31,36,27,46,0,46
24,31,36,29,134,87,47
24,31,36,45,39,0,39
24,31,36,47,369,479,-110
24,31,36,55,130,96,34
24,31,36,59,195,135,60
24,31,36,61,670,1002,-332
24,31,36,67,105,71,34
24,31,36,71,49,52,-3
24,31,36,81,401,292,109
24,31,36,83,24,0,24
24,31,36,85,76,0,76
24,31,36,87,30,0,30
24,31,36,91,32,0,32
24,31,36,93,27,0,27
24,31,36,103,193,113,80
24,31,36,109,58,60,-2
24,31,36,119,161,208,-47
24,31,37,13,0,26,-26
24,31,37,19,0,48,-48
24,31,37,21,31,79,-48
24,31,37,25,0,37,-37
24,31,37,37,0,30,-30
24,31,37,49,0,46,-46
24,31,37,51,84,95,-11
24,31,37,63,136,164,-28
24,31,37,67,84,51,33
24,31,37,71,35,0,35
24,31,37,81,77,122,-45
24,31,37,101,0,35,-35
24,31,37,119,248,452,-204
24,31,37,129,31,96,-65
24,31,37,133,118,106,12
24,31,37,135,94,61,33
24,31,37,147,38,28,10
24,31,37,179,0,90,-90
24,31,37,183,235,567,-332
24,31,39,17,33,0,33
24,31,39,35,230,108,122
24,31,39,41,36,0,36
24,31,39,49,218,177,41
24,31,39,57,0,45,-45
24,31,39,61,102,78,24
24,31,39,93,30,0,30
24,31,39,95,31,0,31
24,31,39,113,73,49,24
24,31,39,153,64,34,30
24,31,39,173,39,0,39
24,31,40,31,41,0,41
24,31,40,109,31,35,-4
24,31,40,143,0,30,-30
24,31,41,51,74,119,-45
24,31,41,67,35,45,-10
24,31,42,1,54,120,-66
24,31,42,3,358,304,54
24,31,42,11,70,57,13
24,31,42,13,22,0,22
24,31,42,17,142,93,49
24,31,42,19,23,0,23
24,31,42,27,88,60,28
24,31,42,29,162,175,-13
24,31,42,41,80,44,36
24,31,42,43,67,62,5
24,31,42,45,146,111,35
24,31,42,49,28,0,28
24,31,42,55,59,122,-63
24,31,42,69,32,0,32
24,31,42,71,86,41,45
24,31,42,77,88,52,36
24,31,42,79,24,0,24
24,31,42,81,28,0,28
24,31,42,89,24,0,24
24,31,42,91,250,218,32
24,31,42,95,32,30,2
24,31,42,101,407,394,13
24,31,42,125,49,0,49
24,31,42,129,56,66,-10
24,31,42,133,73,144,-71
24,31,44,3,23,0,23
24,31,44,7,79,39,40
24,31,45,13,38,94,-56
24,31,45,15,29,36,-7
24,31,45,19,75,119,-44
24,31,45,45,27,61,-34
24,31,45,51,29,118,-89
24,31,45,63,0,35,-35
24,31,45,77,29,0,29
24,31,45,79,84,80,4
24,31,45,91,0,65,-65
24,31,47,37,110,68,42
24,31,47,65,0,29,-29
24,31,47,93,40,42,-2
24,31,47,125,81,65,16
24,31,47,149,0,34,-34
24,31,47,157,63,81,-18
24,31,48,27,75,72,3
24,31,48,29,250,370,-120
24,31,48,85,100,92,8
24,31,48,113,277,255,22
24,31,48,121,37,73,-36
24,31,48,141,93,73,20
24,31,48,157,51,61,-10
24,31,48,167,0,29,-29
24,31,48,187,0,39,-39
24,31,48,201,296,487,-191
24,31,48,339,0,41,-41
24,31,48,439,111,181,-70
24,31,48,453,142,214,-72
24,31,48,491,0,55,-55
24,31,49,35,79,97,-18
24,31,49,49,63,51,12
24,31,50,7,54,55,-1
24,31,51,3,61,106,-45
24,31,51,13,1375,1617,-242
24,31,51,41,81,110,-29
24,31,51,47,0,38,-38
24,31,51,59,3036,3926,-890
24,31,51,61,34,60,-26
24,31,51,69,0,29,-29
24,31,51,87,156,142,14
24,31,51,95,44,35,9
24,31,51,107,512,1230,-718
24,31,51,121,64,47,17
24,31,51,153,745,686,59
24,31,51,177,57,78,-21
24,31,51,179,99,113,-14
24,31,51,187,0,40,-40
24,31,51,510,782,822,-40
24,31,51,540,37,35,2
24,31,51,550,94,59,35
24,31,51,600,87,85,2
24,31,51,610,0,48,-48
24,31,51,650,58,41,17
24,31,51,680,0,28,-28
24,31,51,683,103,44,59
24,31,51,685,52,0,52
24,31,51,700,80,28,52
24,31,51,710,135,90,45
24,31,51,740,76,47,29
24,31,51,760,71,75,-4
24,31,51,800,0,61,-61
24,31,51,810,203,154,49
24,31,51,840,0,28,-28
24,31,53,33,221,320,-99
24,31,53,35,38,45,-7
24,31,53,53,114,82,32
24,31,53,61,51,36,15
24,31,53,63,30,0,30
24,31,53,67,0,44,-44
24,31,54,3,154,384,-230
24,31,54,37,51,306,-255
24,31,54,39,0,29,-29
24,31,54,61,79,22,57
24,31,54,65,0,30,-30
24,31,55,25,90,58,32
24,31,55,79,70,61,9
24,33,1,73,31,0,31
24,33,1,89,31,68,-37
24,33,1,101,32,0,32
24,33,2,20,53,26,27
24,33,4,13,104,190,-86
24,33,4,19,58,40,18
24,33,5,119,0,30,-30
24,33,6,1,58,132,-74
24,33,6,13,28,41,-13
24,33,6,37,274,352,-78
24,33,6,53,64,0,64
24,33,6,59,53,73,-20
24,33,6,65,36,48,-12
24,33,6,67,0,45,-45
24,33,6,71,41,53,-12
24,33,6,73,165,205,-40
24,33,6,75,28,27,1
24,33,6,85,34,116,-82
24,33,6,95,24,34,-10
24,33,6,111,0,46,-46
24,33,8,5,0,47,-47
24,33,8,13,0,42,-42
24,33,8,31,42,32,10
24,33,8,41,77,82,-5
24,33,9,1,48,53,-5
24,33,9,3,69,49,20
24,33,9,9,71,56,15
24,33,9,11,31,28,3
24,33,10,1,69,163,-94
24,33,10,3,127,167,-40
24,33,10,5,44,160,-116
24,33,11,1,15586,10859,4727
24,33,12,1,0,21,-21
24,33,12,9,0,49,-49
24,33,12,11,161,218,-57
24,33,12,31,159,111,48
24,33,12,33,53,36,17
24,33,12,35,0,36,-36
24,33,12,57,175,186,-11
24,33,12,71,29,44,-15
24,33,12,73,64,25,39
24,33,12,83,0,45,-45
24,33,12,86,210,194,16
24,33,12,91,47,37,10
24,33,12,95,131,155,-24
24,33,12,97,29,52,-23
24,33,12,99,48,133,-85
24,33,12,101,0,44,-44
24,33,12,103,70,84,-14
24,33,12,105,50,64,-14
24,33,12,111,35,0,35
24,33,12,115,0,49,-49
24,33,12,117,36,43,-7
24,33,12,127,0,71,-71
24,33,13,51,49,60,-11
24,33,13,63,70,147,-77
24,33,13,67,91,183,-92
24,33,13,73,26,31,-5
24,33,13,89,164,281,-117
24,33,13,97,0,81,-81
24,33,13,113,0,38,-38
24,33,13,121,170,351,-181
24,33,13,135,127,313,-186
24,33,13,151,0,107,-107
24,33,13,215,0,36,-36
24,33,13,217,0,47,-47
24,33,13,245,39,29,10
24,33,13,247,0,49,-49
24,33,15,3,155,129,26
24,33,17,19,0,26,-26
24,33,17,31,234,142,92
24,33,17,43,0,33,-33
24,33,17,163,36,26,10
24,33,18,97,49,82,-33
24,33,21,67,22,0,22
24,33,22,51,0,32,-32
24,33,22,71,24,65,-41
24,33,24,1,46,67,-21
24,33,24,3,3610,7114,-3504
24,33,24,5,1355,1900,-545
24,33,24,9,520,1164,-644
24,33,24,11,28,104,-76
24,33,24,13,90,203,-113
24,33,24,15,39,43,-4
24,33,24,17,2747,5927,-3180
24,33,24,19,41,60,-19
24,33,24,21,338,641,-303
24,33,24,25,176,308,-132
24,33,24,27,2048,3667,-1619
24,33,24,29,0,58,-58
24,33,24,31,10416,12363,-1947
24,33,24,35,61,227,-166
24,33,24,37,350,784,-434
24,33,24,39,53,41,12
24,33,24,43,92,254,-162
24,33,24,45,111,86,25
24,33,24,47,36,65,-29
24,33,24,510,1004,1549,-545
24,33,25,1,35,0,35
24,33,25,5,21,0,21
24,33,25,17,92,109,-17
24,33,25,21,26,0,26
24,33,25,25,84,84,0
24,33,25,27,44,47,-3
24,33,26,97,52,0,52
24,33,26,125,62,27,35
24,33,26,161,38,40,-2
24,33,26,163,116,79,37
24,33,27,53,48,52,-4
24,33,28,47,33,0,33
24,33,28,49,0,34,-34
24,33,29,95,37,27,10
24,33,29,189,35,79,-44
24,33,31,55,36,0,36
24,33,32,3,89,163,-74
24,33,34,1,29,0,29
24,33,34,3,58,36,22
24,33,34,5,85,49,36
24,33,34,7,42,58,-16
24,33,34,13,138,85,53
24,33,34,17,85,63,22
24,33,34,21,39,49,-10
24,33,34,23,109,84,25
24,33,34,25,47,32,15
24,33,34,27,28,0,28
24,33,34,31,50,0,50
24,33,34,35,27,24,3
24,33,34,39,64,42,22
24,33,35,1,31,0,31
24,33,36,5,350,193,157
24,33,36,29,77,39,38
24,33,36,45,0,40,-40
24,33,36,47,456,367,89
24,33,36,55,39,33,6
24,33,36,59,120,87,33
24,33,36,61,230,210,20
24,33,36,67,0,40,-40
24,33,36,71,27,30,-3
24,33,36,81,294,203,91
24,33,36,85,29,0,29
24,33,36,87,26,0,26
24,33,36,103,104,81,23
24,33,36,119,91,40,51
24,33,37,1,0,25,-25
24,33,37,19,0,31,-31
24,33,37,21,0,33,-33
24,33,37,25,0,117,-117
24,33,37,49,0,54,-54
24,33,37,51,137,200,-63
24,33,37,63,101,143,-42
24,33,37,65,0,45,-45
24,33,37,67,36,52,-16
24,33,37,69,0,30,-30
24,33,37,71,0,48,-48
24,33,37,81,75,179,-104
24,33,37,83,0,57,-57
24,33,37,85,0,30,-30
24,33,37,101,0,74,-74
24,33,37,107,31,0,31
24,33,37,119,172,457,-285
24,33,37,127,38,91,-53
24,33,37,133,87,108,-21
24,33,37,135,0,42,-42
24,33,37,139,35,0,35
24,33,37,147,0,60,-60
24,33,37,159,0,38,-38
24,33,37,179,0,98,-98
24,33,37,183,172,522,-350
24,33,37,191,29,30,-1
24,33,37,195,0,53,-53
24,33,39,17,28,0,28
24,33,39,35,84,67,17
24,33,39,49,140,97,43
24,33,39,61,85,35,50
24,33,39,113,0,29,-29
24,33,40,31,41,0,41
24,33,40,109,49,54,-5
24,33,41,51,0,48,-48
24,33,42,1,22,36,-14
24,33,42,3,109,173,-64
24,33,42,11,35,39,-4
24,33,42,17,57,46,11
24,33,42,27,34,0,34
24,33,42,29,61,63,-2
24,33,42,41,31,0,31
24,33,42,43,35,68,-33
24,33,42,45,72,73,-1
24,33,42,55,0,68,-68
24,33,42,71,31,32,-1
24,33,42,79,25,0,25
24,33,42,91,68,86,-18
24,33,42,101,283,238,45
24,33,42,133,88,212,-124
24,33,44,7,49,36,13
24,33,45,13,0,42,-42
24,33,45,15,0,38,-38
24,33,45,19,60,72,-12
24,33,45,35,39,43,-4
24,33,45,41,0,29,-29
24,33,45,45,0,49,-49
24,33,45,51,0,87,-87
24,33,45,63,0,49,-49
24,33,45,79,59,149,-90
24,33,45,85,35,39,-4
24,33,45,91,0,56,-56
24,33,47,37,60,57,3
24,33,47,125,36,0,36
24,33,47,157,98,74,24
24,33,48,27,60,88,-28
24,33,48,29,111,184,-73
24,33,48,39,0,35,-35
24,33,48,41,0,33,-33
24,33,48,85,53,79,-26
24,33,48,113,130,193,-63
24,33,48,121,0,49,-49
24,33,48,141,0,53,-53
24,33,48,157,0,86,-86
24,33,48,201,233,349,-116
24,33,48,439,115,122,-7
24,33,48,453,66,64,2
24,33,48,491,0,39,-39
24,33,51,3,0,32,-32
24,33,51,13,784,828,-44
24,33,51,33,0,38,-38
24,33,51,41,76,164,-88
24,33,51,47,0,39,-39
24,33,51,59,2543,3033,-490
24,33,51,61,0,35,-35
24,33,51,69,0,37,-37
24,33,51,87,91,156,-65
24,33,51,99,52,105,-53
24,33,51,107,252,562,-310
24,33,51,117,0,25,-25
24,33,51,121,0,27,-27
24,33,51,137,0,46,-46
24,33,51,153,1124,1148,-24
24,33,51,177,75,128,-53
24,33,51,179,104,201,-97
24,33,51,187,0,44,-44
24,33,51,193,0,63,-63
24,33,51,510,1038,1178,-140
24,33,51,550,100,93,7
24,33,51,600,0,51,-51
24,33,51,630,32,61,-29
24,33,51,650,158,79,79
24,33,51,680,0,31,-31
24,33,51,683,127,57,70
24,33,51,685,55,42,13
24,33,51,700,109,117,-8
24,33,51,710,150,103,47
24,33,51,730,38,35,3
24,33,51,740,70,55,15
24,33,51,760,112,96,16
24,33,51,800,43,42,1
24,33,51,810,247,154,93
24,33,53,33,52,98,-46
24,33,53,53,51,52,-1
24,33,54,3,75,209,-134
24,33,54,37,31,66,-35
24,33,54,75,48,0,48
24,33,55,25,26,40,-14
24,33,55,79,40,0,40
24,35,10,1,72,92,-20
24,35,10,3,47,37,10
24,35,10,5,41,70,-29
24,35,24,3,1196,547,649
24,35,24,5,126,90,36
24,35,24,9,35,34,1
24,35,24,11,282,404,-122
24,35,24,13,38,0,38
24,35,24,15,0,40,-40
24,35,24,19,42,63,-21
24,35,24,21,29,0,29
24,35,24,27,73,31,42
24,35,24,29,227,186,41
24,35,24,31,99,54,45
24,35,24,33,227,61,166
24,35,24,41,149,233,-84
24,35,24,45,42,48,-6
24,35,24,47,0,43,-43
24,35,24,510,51,75,-24
24,35,51,59,0,41,-41
24,37,4,13,0,29,-29
24,37,6,29,48,67,-19
24,37,6,31,84,36,48
24,37,6,37,47,0,47
24,37,6,73,193,174,19
24,37,10,3,0,26,-26
24,37,11,1,72,53,19
24,37,12,9,28,33,-5
24,37,12,19,76,87,-11
24,37,12,31,245,164,81
24,37,12,33,56,34,22
24,37,12,95,0,26,-26
24,37,12,109,0,38,-38
24,37,15,3,44,79,-35
24,37,23,5,77,61,16
24,37,23,23,40,0,40
24,37,24,3,220,253,-33
24,37,24,5,60,129,-69
24,37,24,9,840,695,145
24,37,24,17,1441,821,620
24,37,24,21,34,42,-8
24,37,24,25,34,0,34
24,37,24,27,71,44,27
24,37,24,31,137,123,14
24,37,24,33,784,350,434
24,37,24,43,0,36,-36
24,37,24,510,52,63,-11
24,37,37,49,63,0,63
24,37,37,119,0,43,-43
24,37,37,133,0,75,-75
24,37,37,183,0,38,-38
24,37,42,3,58,0,58
24,37,42,91,0,35,-35
24,37,45,13,34,58,-24
24,37,45,51,0,41,-41
24,37,48,201,0,36,-36
24,37,48,439,37,0,37
24,37,51,13,28,52,-24
24,37,51,59,98,91,7
24,37,51,99,0,31,-31
24,37,51,153,30,50,-20
24,37,51,510,32,45,-13
24,37,51,550,64,49,15
24,37,51,650,70,41,29
24,37,51,700,40,23,17
24,37,51,710,118,121,-3
24,37,51,810,287,279,8
24,37,53,29,98,70,28
24,39,10,5,55,49,6
24,39,24,3,57,47,10
24,39,24,5,47,43,4
24,39,24,31,28,24,4
24,39,24,33,41,53,-12
24,39,24,45,511,642,-131
24,39,24,47,184,170,14
24,39,24,510,45,0,45
24,39,34,23,0,24,-24
24,39,51,1,48,49,-1
24,41,10,1,34,42,-8
24,41,10,3,28,0,28
24,41,10,5,52,47,5
24,41,24,3,225,176,49
24,41,24,5,110,62,48
24,41,24,11,433,516,-83
24,41,24,19,298,484,-186
24,41,24,27,41,0,41
24,41,24,29,0,36,-36
24,41,24,31,71,48,23
24,41,24,33,32,0,32
24,41,24,35,233,149,84
24,41,24,45,71,39,32
24,41,24,510,56,58,-2
24,41,51,59,32,27,5
24,43,6,37,0,31,-31
24,43,11,1,40,41,-1
24,43,12,86,29,0,29
24,43,12,95,27,0,27
24,43,12,103,0,30,-30
24,43,24,1,182,128,54
24,43,24,3,163,77,86
24,43,24,5,148,126,22
24,43,24,13,175,83,92
24,43,24,17,51,0,51
24,43,24,21,2557,1432,1125
24,43,24,23,35,0,35
24,43,24,25,28,0,28
24,43,24,27,114,68,46
24,43,24,31,846,399,447
24,43,24,33,254,92,162
24,43,24,37,36,0,36
24,43,24,45,31,36,-5
24,43,24,510,87,109,-22
24,43,36,47,39,29,10
24,43,36,61,0,29,-29
24,43,37,119,0,23,-23
24,43,37,133,29,35,-6
24,43,37,183,0,32,-32
24,43,42,1,39,54,-15
24,43,42,3,30,56,-26
24,43,42,9,0,51,-51
24,43,42,41,50,48,2
24,43,42,43,29,0,29
24,43,42,55,835,1545,-710
24,43,42,57,115,133,-18
24,43,42,133,0,60,-60
24,43,45,51,0,85,-85
24,43,51,59,83,50,33
24,43,51,69,32,50,-18
24,43,51,107,31,79,-48
24,43,51,840,24,29,-5
24,43,54,3,639,1033,-394
24,43,54,37,134,111,23
24,43,54,65,117,144,-27
24,45,6,73,31,0,31
24,45,10,1,50,77,-27
24,45,10,3,34,58,-24
24,45,10,5,788,830,-42
24,45,12,103,0,21,-21
24,45,24,1,23,0,23
24,45,24,3,165,159,6
24,45,24,5,199,183,16
24,45,24,11,87,61,26
24,45,24,13,33,33,0
24,45,24,15,27,0,27
24,45,24,17,36,43,-7
24,45,24,19,243,191,52
24,45,24,21,54,42,12
24,45,24,25,46,56,-10
24,45,24,27,68,85,-17
24,45,24,31,131,81,50
24,45,24,33,86,111,-25
24,45,24,35,48,42,6
24,45,24,39,642,511,131
24,45,24,41,39,71,-32
24,45,24,43,36,31,5
24,45,24,47,1051,907,144
24,45,24,510,103,112,-9
24,45,36,103,33,0,33
24,45,37,19,0,40,-40
24,45,37,119,0,29,-29
24,45,37,183,0,71,-71
24,45,42,3,0,37,-37
24,45,42,45,31,0,31
24,45,42,101,0,24,-24
24,45,42,133,33,37,-4
24,45,51,1,113,99,14
24,45,51,59,39,41,-2
24,45,51,153,24,0,24
24,45,51,710,36,0,36
24,45,51,810,0,33,-33
24,47,10,1,28,40,-12
24,47,10,3,64,32,32
24,47,10,5,279,373,-94
24,47,12,95,0,25,-25
24,47,13,57,42,0,42
24,47,17,31,26,24,2
24,47,24,3,208,136,72
24,47,24,5,233,185,48
24,47,24,13,53,44,9
24,47,24,19,32,0,32
24,47,24,21,65,25,40
24,47,24,25,82,46,36
24,47,24,27,85,54,31
24,47,24,31,149,80,69
24,47,24,33,65,36,29
24,47,24,35,43,0,43
24,47,24,39,170,184,-14
24,47,24,45,907,1051,-144
24,47,24,510,74,113,-39
24,47,36,47,0,23,-23
24,47,42,3,23,0,23
24,47,42,91,32,0,32
24,47,42,133,32,28,4
24,47,51,1,106,109,-3
24,47,51,59,37,0,37
24,510,4,13,87,174,-87
24,510,4,19,30,55,-25
24,510,6,1,60,70,-10
24,510,6,37,227,266,-39
24,510,6,59,41,38,3
24,510,6,65,0,26,-26
24,510,6,67,21,44,-23
24,510,6,71,33,25,8
24,510,6,73,95,118,-23
24,510,6,75,70,101,-31
24,510,6,81,0,29,-29
24,510,6,85,34,69,-35
24,510,8,5,0,40,-40
24,510,8,13,0,29,-29
24,510,8,31,76,54,22
24,510,8,41,0,39,-39
24,510,9,1,61,62,-1
24,510,9,3,60,65,-5
24,510,9,9,71,62,9
24,510,10,1,33,57,-24
24,510,10,3,138,168,-30
24,510,10,5,59,97,-38
24,510,11,1,826,752,74
24,510,12,9,24,0,24
24,510,12,11,103,133,-30
24,510,12,31,48,52,-4
24,510,12,57,54,64,-10
24,510,12,71,38,0,38
24,510,12,86,97,142,-45
24,510,12,95,46,74,-28
24,510,12,99,56,77,-21
24,510,12,103,0,78,-78
24,510,12,105,0,38,-38
24,510,12,117,0,29,-29
24,510,12,127,20,0,20
24,510,13,51,22,0,22
24,510,13,63,0,47,-47
24,510,13,67,57,59,-2
24,510,13,89,84,126,-42
24,510,13,121,131,174,-43
24,510,13,135,66,96,-30
24,510,13,245,52,23,29
24,510,15,3,35,29,6
24,510,17,31,220,322,-102
24,510,17,43,29,0,29
24,510,18,97,28,29,-1
24,510,21,111,29,31,-2
24,510,22,71,31,41,-10
24,510,24,1,30,69,-39
24,510,24,3,3334,3425,-91
24,510,24,5,19024,24768,-5744
24,510,24,9,74,55,19
24,510,24,11,35,50,-15
24,510,24,13,372,408,-36
24,510,24,15,90,122,-32
24,510,24,17,113,78,35
24,510,24,19,46,51,-5
24,510,24,21,229,180,49
24,510,24,25,1222,1688,-466
24,510,24,27,1915,1715,200
24,510,24,31,1307,1010,297
24,510,24,33,1549,1004,545
24,510,24,35,75,51,24
24,510,24,37,63,52,11
24,510,24,39,0,45,-45
24,510,24,41,58,56,2
24,510,24,43,109,87,22
24,510,24,45,112,103,9
24,510,24,47,113,74,39
24,510,25,9,32,0,32
24,510,25,17,191,150,41
24,510,25,21,38,56,-18
24,510,25,25,125,152,-27
24,510,25,27,40,0,40
24,510,26,81,24,0,24
24,510,26,125,94,0,94
24,510,26,161,63,28,35
24,510,26,163,48,27,21
24,510,27,53,65,54,11
24,510,29,189,40,36,4
24,510,29,510,0,34,-34
24,510,32,3,41,64,-23
24,510,34,1,34,31,3
24,510,34,3,43,49,-6
24,510,34,5,46,46,0
24,510,34,7,78,31,47
24,510,34,13,64,79,-15
24,510,34,15,24,0,24
24,510,34,17,58,75,-17
24,510,34,21,41,32,9
24,510,34,23,73,58,15
24,510,34,25,64,43,21
24,510,34,27,45,42,3
24,510,34,29,38,48,-10
24,510,34,35,27,0,27
24,510,34,39,38,29,9
24,510,35,1,27,33,-6
24,510,36,1,30,0,30
24,510,36,5,137,87,50
24,510,36,7,23,0,23
24,510,36,27,31,0,31
24,510,36,29,95,66,29
24,510,36,47,287,279,8
24,510,36,55,69,64,5
24,510,36,59,131,86,45
24,510,36,61,275,443,-168
24,510,36,65,22,0,22
24,510,36,67,51,42,9
24,510,36,81,204,144,60
24,510,36,87,27,0,27
24,510,36,91,31,0,31
24,510,36,103,82,53,29
24,510,36,109,22,30,-8
24,510,36,119,75,47,28
24,510,37,21,0,31,-31
24,510,37,51,38,63,-25
24,510,37,63,88,78,10
24,510,37,67,22,28,-6
24,510,37,81,64,66,-2
24,510,37,119,81,238,-157
24,510,37,129,0,32,-32
24,510,37,133,0,30,-30
24,510,37,135,36,38,-2
24,510,37,147,0,30,-30
24,510,37,183,56,134,-78
24,510,39,35,98,68,30
24,510,39,49,84,61,23
24,510,39,61,91,53,38
24,510,41,51,54,85,-31
24,510,42,1,20,40,-20
24,510,42,3,206,139,67
24,510,42,11,42,28,14
24,510,42,17,55,53,2
24,510,42,27,50,0,50
24,510,42,29,124,62,62
24,510,42,41,40,35,5
24,510,42,43,80,80,0
24,510,42,45,74,89,-15
24,510,42,55,25,45,-20
24,510,42,71,75,95,-20
24,510,42,75,32,0,32
24,510,42,77,62,31,31
24,510,42,79,29,0,29
24,510,42,91,104,102,2
24,510,42,95,21,0,21
24,510,42,101,410,343,67
24,510,42,129,41,0,41
24,510,42,133,311,1036,-725
24,510,44,7,50,27,23
24,510,45,15,0,26,-26
24,510,45,19,35,32,3
24,510,45,45,0,32,-32
24,510,45,51,0,33,-33
24,510,45,79,28,48,-20
24,510,47,37,50,66,-16
24,510,47,157,24,34,-10
24,510,48,29,34,45,-11
24,510,48,85,24,39,-15
24,510,48,113,75,84,-9
24,510,48,121,0,32,-32
24,510,48,201,94,125,-31
24,510,48,439,47,43,4
24,510,48,453,52,71,-19
24,510,49,35,27,0,27
24,510,50,7,0,33,-33
24,510,51,3,33,29,4
24,510,51,13,192,203,-11
24,510,51,41,43,24,19
24,510,51,59,309,254,55
24,510,51,87,53,47,6
24,510,51,107,47,77,-30
24,510,51,153,86,70,16
24,510,51,177,20,0,20
24,510,51,510,94,110,-16
24,510,51,540,32,0,32
24,510,51,650,0,49,-49
24,510,51,700,46,49,-3
24,510,51,710,66,63,3
24,510,51,740,29,0,29
24,510,51,760,73,153,-80
24,510,51,810,43,56,-13
24,510,53,33,95,159,-64
24,510,54,3,25,53,-28
24,510,55,25,35,33,2
24,510,55,79,31,24,7
25,1,4,13,45,90,-45
25,1,4,19,25,41,-16
25,1,6,37,75,72,3
25,1,6,73,57,90,-33
25,1,6,75,27,28,-1
25,1,6,85,0,24,-24
25,1,8,31,0,27,-27
25,1,8,41,0,38,-38
25,1,9,1,156,40,116
25,1,9,3,152,84,68
25,1,9,5,40,20,20
25,1,9,7,23,27,-4
25,1,9,9,72,52,20
25,1,9,11,58,41,17
25,1,9,13,50,0,50
25,1,11,1,40,31,9
25,1,12,9,49,49,0
25,1,12,11,73,148,-75
25,1,12,15,0,71,-71
25,1,12,21,76,144,-68
25,1,12,57,32,56,-24
25,1,12,61,0,49,-49
25,1,12,69,0,38,-38
25,1,12,71,86,152,-66
25,1,12,81,33,38,-5
25,1,12,83,0,34,-34
25,1,12,85,26,42,-16
25,1,12,86,28,37,-9
25,1,12,87,0,38,-38
25,1,12,95,47,38,9
25,1,12,99,84,174,-90
25,1,12,101,0,34,-34
25,1,12,103,90,80,10
25,1,12,111,54,56,-2
25,1,12,115,58,111,-53
25,1,12,119,0,42,-42
25,1,12,127,0,41,-41
25,1,15,3,0,44,-44
25,1,17,31,49,48,1
25,1,23,5,56,64,-8
25,1,23,31,48,30,18
25,1,24,5,63,0,63
25,1,24,31,70,31,39
25,1,24,33,0,35,-35
25,1,25,3,0,46,-46
25,1,25,5,640,566,74
25,1,25,7,64,41,23
25,1,25,9,191,257,-66
25,1,25,11,48,0,48
25,1,25,13,151,125,26
25,1,25,15,113,103,10
25,1,25,17,1003,884,119
25,1,25,19,120,108,12
25,1,25,21,930,732,198
25,1,25,23,1256,1358,-102
25,1,25,25,531,711,-180
25,1,25,27,509,344,165
25,1,32,3,0,38,-38
25,1,33,3,0,29,-29
25,1,33,9,54,36,18
25,1,33,11,89,93,-4
25,1,33,13,23,36,-13
25,1,33,15,39,84,-45
25,1,33,17,29,31,-2
25,1,34,13,40,0,40
25,1,36,1,22,0,22
25,1,36,5,39,26,13
25,1,36,47,27,56,-29
25,1,36,59,34,0,34
25,1,36,61,86,117,-31
25,1,36,67,26,0,26
25,1,36,71,0,22,-22
25,1,36,81,30,63,-33
25,1,36,103,35,0,35
25,1,36,119,70,34,36
25,1,37,119,0,49,-49
25,1,37,183,0,83,-83
25,1,41,51,21,23,-2
25,1,42,29,31,0,31
25,1,42,101,26,23,3
25,1,44,3,27,0,27
25,1,44,5,28,34,-6
25,1,44,7,201,98,103
25,1,45,13,0,32,-32
25,1,45,51,0,33,-33
25,1,48,201,25,31,-6
25,1,50,7,57,54,3
25,1,50,21,37,0,37
25,1,51,59,41,0,41
25,1,51,810,0,27,-27
25,1,53,33,38,48,-10
25,3,4,13,0,56,-56
25,3,6,1,0,22,-22
25,3,6,37,0,43,-43
25,3,6,73,26,36,-10
25,3,6,75,0,20,-20
25,3,9,1,0,70,-70
25,3,9,3,85,50,35
25,3,9,5,141,141,0
25,3,9,9,25,49,-24
25,3,11,1,0,25,-25
25,3,12,11,31,22,9
25,3,12,71,26,44,-18
25,3,12,81,0,32,-32
25,3,12,99,57,54,3
25,3,12,103,26,34,-8
25,3,12,127,41,26,15
25,3,17,31,29,26,3
25,3,23,5,0,32,-32
25,3,25,1,46,0,46
25,3,25,5,0,38,-38
25,3,25,9,52,82,-30
25,3,25,11,89,101,-12
25,3,25,13,303,350,-47
25,3,25,15,138,202,-64
25,3,25,17,212,238,-26
25,3,25,21,75,72,3
25,3,25,23,44,41,3
25,3,25,25,95,197,-102
25,3,25,27,133,95,38
25,3,32,3,0,31,-31
25,3,33,11,0,32,-32
25,3,33,15,0,27,-27
25,3,36,1,70,73,-3
25,3,36,21,189,91,98
25,3,36,27,28,0,28
25,3,36,47,76,60,16
25,3,36,55,0,25,-25
25,3,36,59,33,0,33
25,3,36,61,87,94,-7
25,3,36,81,0,40,-40
25,3,36,83,79,129,-50
25,3,36,91,0,32,-32
25,3,36,103,0,24,-24
25,3,36,119,42,0,42
25,3,37,119,0,27,-27
25,3,39,49,0,23,-23
25,3,41,51,0,24,-24
25,3,44,7,0,28,-28
25,3,48,453,0,29,-29
25,3,50,3,181,143,38
25,3,50,7,0,25,-25
25,3,50,25,22,0,22
25,5,4,13,83,91,-8
25,5,6,37,55,159,-104
25,5,6,59,0,35,-35
25,5,6,67,25,0,25
25,5,6,73,67,97,-30
25,5,6,75,24,0,24
25,5,6,85,0,50,-50
25,5,9,1,74,57,17
25,5,9,3,113,119,-6
25,5,9,5,24,0,24
25,5,9,7,0,30,-30
25,5,9,9,86,107,-21
25,5,9,11,42,76,-34
25,5,9,13,0,26,-26
25,5,9,15,39,57,-18
25,5,11,1,0,27,-27
25,5,12,9,55,78,-23
25,5,12,11,88,124,-36
25,5,12,15,38,58,-20
25,5,12,17,0,32,-32
25,5,12,21,0,63,-63
25,5,12,31,47,41,6
25,5,12,35,0,42,-42
25,5,12,53,34,109,-75
25,5,12,57,88,143,-55
25,5,12,61,0,25,-25
25,5,12,69,0,51,-51
25,5,12,71,65,149,-84
25,5,12,81,0,47,-47
25,5,12,83,31,47,-16
25,5,12,86,62,63,-1
25,5,12,95,86,129,-43
25,5,12,97,49,64,-15
25,5,12,99,95,121,-26
25,5,12,101,45,82,-37
25,5,12,103,87,116,-29
25,5,12,105,41,77,-36
25,5,12,111,48,31,17
25,5,12,115,55,69,-14
25,5,12,117,0,40,-40
25,5,12,119,0,31,-31
25,5,12,127,41,53,-12
25,5,13,67,0,44,-44
25,5,17,31,49,74,-25
25,5,23,5,31,83,-52
25,5,23,11,0,36,-36
25,5,23,17,0,45,-45
25,5,23,19,36,41,-5
25,5,23,25,0,42,-42
25,5,23,31,26,55,-29
25,5,24,3,0,27,-27
25,5,24,31,33,35,-2
25,5,24,33,0,21,-21
25,5,25,1,566,640,-74
25,5,25,3,38,0,38
25,5,25,7,29,38,-9
25,5,25,9,329,291,38
25,5,25,11,0,35,-35
25,5,25,13,163,121,42
25,5,25,15,55,76,-21
25,5,25,17,1068,1110,-42
25,5,25,21,3414,3192,222
25,5,25,23,4481,4203,278
25,5,25,25,1232,1229,3
25,5,25,27,564,741,-177
25,5,32,3,28,78,-50
25,5,33,3,25,29,-4
25,5,33,5,0,24,-24
25,5,33,9,56,61,-5
25,5,33,11,103,161,-58
25,5,33,13,36,41,-5
25,5,33,15,98,93,5
25,5,33,17,0,38,-38
25,5,34,3,34,0,34
25,5,34,17,41,0,41
25,5,36,5,82,35,47
25,5,36,29,39,0,39
25,5,36,47,38,62,-24
25,5,36,59,25,0,25
25,5,36,61,58,111,-53
25,5,36,81,36,65,-29
25,5,36,91,0,25,-25
25,5,36,103,28,0,28
25,5,36,119,42,0,42
25,5,37,51,0,37,-37
25,5,37,119,31,96,-65
25,5,37,133,24,55,-31
25,5,37,183,0,121,-121
25,5,39,35,38,0,38
25,5,42,3,23,0,23
25,5,42,101,0,29,-29
25,5,44,1,437,316,121
25,5,44,3,416,333,83
25,5,44,5,847,658,189
25,5,44,7,3147,2668,479
25,5,44,9,84,109,-25
25,5,45,51,0,41,-41
25,5,48,113,0,38,-38
25,5,48,201,0,68,-68
25,5,48,439,0,107,-107
25,5,48,453,28,0,28
25,5,50,7,20,48,-28
25,5,51,13,0,25,-25
25,5,51,59,25,37,-12
25,5,51,710,0,22,-22
25,5,53,33,0,38,-38
25,7,9,1,31,0,31
25,7,25,1,41,64,-23
25,7,25,5,38,29,9
25,7,25,9,27,0,27
25,7,25,17,68,71,-3
25,7,25,21,45,43,2
25,7,25,23,38,42,-4
25,7,25,25,41,60,-19
25,7,25,27,39,29,10
25,7,36,81,0,24,-24
25,9,4,13,130,195,-65
25,9,4,19,31,37,-6
25,9,6,1,58,61,-3
25,9,6,13,33,0,33
25,9,6,37,165,279,-114
25,9,6,59,80,144,-64
25,9,6,65,30,45,-15
25,9,6,67,0,32,-32
25,9,6,71,49,33,16
25,9,6,73,157,193,-36
25,9,6,75,64,75,-11
25,9,6,81,0,37,-37
25,9,6,85,49,98,-49
25,9,8,5,0,25,-25
25,9,8,13,36,31,5
25,9,8,31,0,49,-49
25,9,8,41,25,0,25
25,9,9,1,124,106,18
25,9,9,3,191,135,56
25,9,9,5,33,0,33
25,9,9,7,26,0,26
25,9,9,9,128,138,-10
25,9,9,11,36,53,-17
25,9,10,3,0,39,-39
25,9,11,1,47,102,-55
25,9,12,9,84,88,-4
25,9,12,11,174,217,-43
25,9,12,15,39,65,-26
25,9,12,17,0,41,-41
25,9,12,21,62,141,-79
25,9,12,31,28,78,-50
25,9,12,53,0,44,-44
25,9,12,57,158,176,-18
25,9,12,61,0,47,-47
25,9,12,69,35,62,-27
25,9,12,71,146,196,-50
25,9,12,81,51,55,-4
25,9,12,83,0,32,-32
25,9,12,85,0,29,-29
25,9,12,86,193,227,-34
25,9,12,87,0,22,-22
25,9,12,95,233,277,-44
25,9,12,97,132,121,11
25,9,12,99,263,237,26
25,9,12,101,45,67,-22
25,9,12,103,126,175,-49
25,9,12,105,53,87,-34
25,9,12,109,0,36,-36
25,9,12,111,29,39,-10
25,9,12,115,75,116,-41
25,9,12,117,47,45,2
25,9,12,119,0,49,-49
25,9,12,127,79,122,-43
25,9,13,67,38,0,38
25,9,13,89,27,29,-2
25,9,13,121,69,76,-7
25,9,13,135,39,70,-31
25,9,15,3,40,46,-6
25,9,17,31,141,190,-49
25,9,17,43,48,0,48
25,9,22,51,0,27,-27
25,9,23,1,32,33,-1
25,9,23,3,0,44,-44
25,9,23,5,169,237,-68
25,9,23,11,30,75,-45
25,9,23,15,0,28,-28
25,9,23,17,28,63,-35
25,9,23,19,50,74,-24
25,9,23,23,0,36,-36
25,9,23,31,247,351,-104
25,9,24,3,42,31,11
25,9,24,5,35,35,0
25,9,24,27,32,0,32
25,9,24,31,76,69,7
25,9,24,510,0,32,-32
25,9,25,1,257,191,66
25,9,25,3,82,52,30
25,9,25,5,291,329,-38
25,9,25,11,41,68,-27
25,9,25,13,268,209,59
25,9,25,15,118,110,8
25,9,25,17,10355,9260,1095
25,9,25,21,1015,967,48
25,9,25,23,336,390,-54
25,9,25,25,5084,4214,870
25,9,25,27,825,764,61
25,9,26,161,34,0,34
25,9,27,53,45,38,7
25,9,29,189,29,0,29
25,9,32,3,73,143,-70
25,9,33,1,77,131,-54
25,9,33,3,82,178,-96
25,9,33,5,85,37,48
25,9,33,9,58,92,-34
25,9,33,11,890,1041,-151
25,9,33,13,131,184,-53
25,9,33,15,2692,4127,-1435
25,9,33,17,283,321,-38
25,9,33,19,43,22,21
25,9,34,3,74,36,38
25,9,34,7,30,48,-18
25,9,34,13,40,31,9
25,9,34,17,78,67,11
25,9,34,21,24,0,24
25,9,34,23,58,68,-10
25,9,34,25,38,34,4
25,9,34,27,27,0,27
25,9,34,31,54,47,7
25,9,34,39,0,36,-36
25,9,36,1,47,0,47
25,9,36,5,505,322,183
25,9,36,29,62,28,34
25,9,36,45,32,0,32
25,9,36,47,182,222,-40
25,9,36,55,69,70,-1
25,9,36,59,64,50,14
25,9,36,61,438,468,-30
25,9,36,67,34,30,4
25,9,36,71,33,0,33
25,9,36,81,132,125,7
25,9,36,83,25,0,25
25,9,36,91,44,34,10
25,9,36,103,69,52,17
25,9,36,119,88,57,31
25,9,37,51,34,37,-3
25,9,37,63,0,38,-38
25,9,37,67,0,35,-35
25,9,37,119,55,179,-124
25,9,37,133,30,50,-20
25,9,37,183,66,180,-114
25,9,39,35,31,54,-23
25,9,39,49,38,43,-5
25,9,39,61,37,0,37
25,9,41,51,39,57,-18
25,9,42,3,28,0,28
25,9,42,11,47,33,14
25,9,42,17,45,0,45
25,9,42,45,49,25,24
25,9,42,71,33,0,33
25,9,42,77,35,70,-35
25,9,42,79,43,37,6
25,9,42,91,50,35,15
25,9,42,101,101,87,14
25,9,44,3,54,29,25
25,9,44,5,0,36,-36
25,9,44,7,280,231,49
25,9,44,9,22,0,22
25,9,45,13,27,44,-17
25,9,45,19,0,38,-38
25,9,45,45,0,44,-44
25,9,45,51,0,36,-36
25,9,47,37,24,35,-11
25,9,47,157,0,36,-36
25,9,48,29,0,29,-29
25,9,48,113,69,41,28
25,9,48,121,0,31,-31
25,9,48,157,0,43,-43
25,9,48,201,57,186,-129
25,9,48,439,51,74,-23
25,9,48,453,0,64,-64
25,9,49,35,27,41,-14
25,9,50,7,99,83,16
25,9,50,15,0,26,-26
25,9,50,21,22,0,22
25,9,50,23,35,33,2
25,9,50,27,27,26,1
25,9,51,13,0,52,-52
25,9,51,59,81,109,-28
25,9,51,510,0,25,-25
25,9,51,810,37,34,3
25,9,53,33,99,80,19
25,9,53,53,35,26,9
25,9,55,25,33,0,33
25,11,6,75,0,23,-23
25,11,9,3,33,58,-25
25,11,9,9,0,22,-22
25,11,25,1,0,48,-48
25,11,25,3,101,89,12
25,11,25,5,35,0,35
25,11,25,9,68,41,27
25,11,25,13,333,349,-16
25,11,25,15,1131,1139,-8
25,11,25,17,144,147,-3
25,11,25,21,64,49,15
25,11,25,23,46,27,19
25,11,25,25,62,69,-7
25,11,25,27,715,611,104
25,11,33,5,118,136,-18
25,11,33,11,0,23,-23
25,11,36,47,25,29,-4
25,11,36,61,0,36,-36
25,11,44,7,0,27,-27
25,11,50,25,93,96,-3
25,13,4,13,56,128,-72
25,13,4,19,26,0,26
25,13,6,37,62,113,-51
25,13,6,59,0,38,-38
25,13,6,65,0,37,-37
25,13,6,73,106,74,32
25,13,6,75,0,30,-30
25,13,9,1,107,133,-26
25,13,9,3,1507,1775,-268
25,13,9,5,44,58,-14
25,13,9,7,62,59,3
25,13,9,9,194,205,-11
25,13,9,11,74,98,-24
25,13,9,13,221,329,-108
25,13,9,15,39,38,1
25,13,11,1,0,45,-45
25,13,12,9,41,78,-37
25,13,12,11,70,146,-76
25,13,12,15,0,45,-45
25,13,12,21,24,42,-18
25,13,12,31,33,57,-24
25,13,12,35,0,33,-33
25,13,12,57,135,137,-2
25,13,12,69,28,37,-9
25,13,12,71,41,102,-61
25,13,12,81,37,35,2
25,13,12,83,30,33,-3
25,13,12,86,50,69,-19
25,13,12,95,187,199,-12
25,13,12,97,81,76,5
25,13,12,99,108,109,-1
25,13,12,101,42,50,-8
25,13,12,103,67,134,-67
25,13,12,105,61,80,-19
25,13,12,111,32,32,0
25,13,12,115,0,55,-55
25,13,12,117,64,47,17
25,13,12,127,78,70,8
25,13,13,67,0,47,-47
25,13,13,89,0,55,-55
25,13,13,121,0,70,-70
25,13,13,135,33,46,-13
25,13,17,31,42,50,-8
25,13,23,1,0,33,-33
25,13,23,5,50,54,-4
25,13,23,31,31,58,-27
25,13,24,5,0,37,-37
25,13,24,31,0,41,-41
25,13,25,1,125,151,-26
25,13,25,3,350,303,47
25,13,25,5,121,163,-42
25,13,25,9,209,268,-59
25,13,25,11,349,333,16
25,13,25,15,3391,3608,-217
25,13,25,17,406,668,-262
25,13,25,21,160,237,-77
25,13,25,23,0,116,-116
25,13,25,25,245,538,-293
25,13,25,27,1168,1137,31
25,13,26,163,37,0,37
25,13,32,3,24,35,-11
25,13,33,5,28,40,-12
25,13,33,9,0,31,-31
25,13,33,11,94,123,-29
25,13,33,13,0,32,-32
25,13,33,15,47,51,-4
25,13,33,17,0,24,-24
25,13,34,3,41,0,41
25,13,34,13,0,33,-33
25,13,34,17,50,50,0
25,13,34,23,40,42,-2
25,13,34,27,35,0,35
25,13,34,31,44,0,44
25,13,36,1,33,29,4
25,13,36,5,210,108,102
25,13,36,29,31,50,-19
25,13,36,47,152,165,-13
25,13,36,55,0,49,-49
25,13,36,59,40,34,6
25,13,36,61,141,151,-10
25,13,36,67,70,39,31
25,13,36,81,126,120,6
25,13,36,83,0,38,-38
25,13,36,91,39,44,-5
25,13,36,103,39,64,-25
25,13,36,119,0,47,-47
25,13,37,51,0,38,-38
25,13,37,81,0,40,-40
25,13,37,119,54,123,-69
25,13,37,129,0,34,-34
25,13,37,133,39,63,-24
25,13,37,179,0,41,-41
25,13,37,183,0,63,-63
25,13,39,49,0,25,-25
25,13,42,77,0,43,-43
25,13,42,91,32,0,32
25,13,42,101,56,73,-17
25,13,44,3,23,29,-6
25,13,44,5,27,25,2
25,13,44,7,126,129,-3
25,13,44,9,0,36,-36
25,13,45,45,0,34,-34
25,13,45,51,0,53,-53
25,13,45,91,0,35,-35
25,13,47,37,26,0,26
25,13,48,27,0,41,-41
25,13,48,29,0,35,-35
25,13,48,201,31,57,-26
25,13,48,453,0,34,-34
25,13,49,35,0,33,-33
25,13,50,7,0,32,-32
25,13,50,25,37,37,0
25,13,51,13,0,26,-26
25,13,51,59,29,27,2
25,13,51,810,30,43,-13
25,13,53,33,39,40,-1
25,13,53,53,0,28,-28
25,15,4,13,0,28,-28
25,15,4,19,27,0,27
25,15,6,1,40,53,-13
25,15,6,37,54,89,-35
25,15,6,73,39,45,-6
25,15,6,75,0,78,-78
25,15,6,85,23,61,-38
25,15,9,1,77,47,30
25,15,9,3,196,289,-93
25,15,9,7,0,22,-22
25,15,9,9,81,66,15
25,15,9,11,32,23,9
25,15,9,13,55,43,12
25,15,11,1,21,55,-34
25,15,12,11,0,28,-28
25,15,12,57,0,26,-26
25,15,12,86,0,27,-27
25,15,12,99,0,28,-28
25,15,12,103,31,28,3
25,15,17,31,29,61,-32
25,15,23,5,65,36,29
25,15,24,31,36,0,36
25,15,25,1,103,113,-10
25,15,25,3,202,138,64
25,15,25,5,76,0,76
25,15,25,9,110,118,-8
25,15,25,11,1139,1131,8
25,15,25,13,3608,3391,217
25,15,25,17,475,618,-143
25,15,25,21,155,143,12
25,15,25,23,0,66,-66
25,15,25,25,212,320,-108
25,15,25,27,613,651,-38
25,15,33,5,51,28,23
25,15,33,9,27,30,-3
25,15,33,11,39,43,-4
25,15,33,15,32,40,-8
25,15,36,1,26,0,26
25,15,36,47,102,126,-24
25,15,36,55,0,46,-46
25,15,36,59,30,0,30
25,15,36,61,118,149,-31
25,15,36,81,41,61,-20
25,15,36,103,37,0,37
25,15,36,119,47,28,19
25,15,41,51,0,49,-49
25,15,42,101,0,27,-27
25,15,44,7,105,63,42
25,15,48,201,0,31,-31
25,15,50,7,42,30,12
25,15,50,25,61,46,15
25,15,50,27,24,28,-4
25,15,51,59,0,25,-25
25,15,53,33,40,50,-10
25,17,1,73,60,37,23
25,17,1,89,0,50,-50
25,17,1,101,0,38,-38
25,17,2,20,41,50,-9
25,17,4,3,21,0,21
25,17,4,13,377,522,-145
25,17,4,19,156,156,0
25,17,4,21,0,34,-34
25,17,6,1,392,572,-180
25,17,6,13,133,166,-33
25,17,6,19,0,26,-26
25,17,6,37,1069,1418,-349
25,17,6,41,77,54,23
25,17,6,53,0,55,-55
25,17,6,59,279,317,-38
25,17,6,61,0,26,-26
25,17,6,65,88,105,-17
25,17,6,67,98,106,-8
25,17,6,71,86,76,10
25,17,6,73,582,812,-230
25,17,6,75,416,775,-359
25,17,6,77,42,0,42
25,17,6,79,0,37,-37
25,17,6,81,182,260,-78
25,17,6,83,104,62,42
25,17,6,85,482,769,-287
25,17,6,87,32,31,1
25,17,6,95,0,25,-25
25,17,6,97,35,48,-13
25,17,6,111,89,58,31
25,17,6,113,39,36,3
25,17,8,1,29,32,-3
25,17,8,5,54,102,-48
25,17,8,13,130,231,-101
25,17,8,31,160,173,-13
25,17,8,35,0,39,-39
25,17,8,41,126,118,8
25,17,8,59,57,57,0
25,17,8,69,51,52,-1
25,17,8,117,0,22,-22
25,17,9,1,635,446,189
25,17,9,3,701,438,263
25,17,9,5,91,58,33
25,17,9,7,119,102,17
25,17,9,9,619,476,143
25,17,9,11,238,119,119
25,17,9,13,113,123,-10
25,17,9,15,99,73,26
25,17,10,3,132,63,69
25,17,11,1,534,619,-85
25,17,12,1,101,53,48
25,17,12,9,88,111,-23
25,17,12,11,342,479,-137
25,17,12,15,31,51,-20
25,17,12,17,0,41,-41
25,17,12,21,87,138,-51
25,17,12,31,125,77,48
25,17,12,53,0,39,-39
25,17,12,57,250,281,-31
25,17,12,61,34,36,-2
25,17,12,69,32,47,-15
25,17,12,71,167,242,-75
25,17,12,73,0,34,-34
25,17,12,81,51,90,-39
25,17,12,83,32,50,-18
25,17,12,85,35,28,7
25,17,12,86,303,361,-58
25,17,12,91,47,0,47
25,17,12,95,286,261,25
25,17,12,97,43,68,-25
25,17,12,99,377,465,-88
25,17,12,101,56,116,-60
25,17,12,103,202,244,-42
25,17,12,105,36,98,-62
25,17,12,109,39,34,5
25,17,12,111,55,105,-50
25,17,12,115,83,218,-135
25,17,12,117,109,80,29
25,17,12,119,0,48,-48
25,17,12,127,69,92,-23
25,17,13,51,28,46,-18
25,17,13,59,34,0,34
25,17,13,63,0,30,-30
25,17,13,67,109,194,-85
25,17,13,89,151,141,10
25,17,13,121,255,303,-48
25,17,13,135,83,124,-41
25,17,15,3,176,150,26
25,17,15,9,0,22,-22
25,17,16,1,40,31,9
25,17,17,19,106,65,41
25,17,17,31,917,849,68
25,17,17,43,108,98,10
25,17,17,89,32,0,32
25,17,17,97,99,97,2
25,17,17,197,0,38,-38
25,17,18,3,25,0,25
25,17,18,97,109,80,29
25,17,18,105,38,40,-2
25,17,18,141,23,0,23
25,17,18,157,48,34,14
25,17,19,103,30,44,-14
25,17,19,163,0,78,-78
25,17,19,169,30,0,30
25,17,20,91,65,62,3
25,17,20,173,46,37,9
25,17,21,67,41,35,6
25,17,21,111,40,76,-36
25,17,22,33,30,0,30
25,17,22,51,31,46,-15
25,17,22,71,46,79,-33
25,17,23,1,64,82,-18
25,17,23,5,496,561,-65
25,17,23,9,36,51,-15
25,17,23,11,78,58,20
25,17,23,13,37,39,-2
25,17,23,15,0,65,-65
25,17,23,17,47,58,-11
25,17,23,19,126,94,32
25,17,23,23,30,29,1
25,17,23,27,0,33,-33
25,17,23,31,327,468,-141
25,17,24,3,94,114,-20
25,17,24,5,137,91,46
25,17,24,21,40,37,3
25,17,24,25,32,0,32
25,17,24,27,66,109,-43
25,17,24,31,457,487,-30
25,17,24,33,109,92,17
25,17,24,510,150,191,-41
25,17,25,1,884,1003,-119
25,17,25,3,238,212,26
25,17,25,5,1110,1068,42
25,17,25,7,71,68,3
25,17,25,9,9260,10355,-1095
25,17,25,11,147,144,3
25,17,25,13,668,406,262
25,17,25,15,618,475,143
25,17,25,21,8196,8329,-133
25,17,25,23,1608,1697,-89
25,17,25,25,20902,16670,4232
25,17,25,27,7678,8310,-632
25,17,26,65,43,44,-1
25,17,26,77,24,0,24
25,17,26,81,51,31,20
25,17,26,99,49,0,49
25,17,26,125,223,84,139
25,17,26,139,22,0,22
25,17,26,161,313,160,153
25,17,26,163,93,51,42
25,17,27,37,51,38,13
25,17,27,53,346,219,127
25,17,27,109,0,27,-27
25,17,27,123,80,36,44
25,17,29,95,64,36,28
25,17,29,189,127,75,52
25,17,29,510,52,47,5
25,17,30,31,0,32,-32
25,17,31,55,45,38,7
25,17,32,3,182,236,-54
25,17,32,31,42,0,42
25,17,33,1,137,198,-61
25,17,33,3,105,246,-141
25,17,33,5,162,171,-9
25,17,33,7,42,0,42
25,17,33,9,248,241,7
25,17,33,11,2803,3640,-837
25,17,33,13,244,213,31
25,17,33,15,1435,1905,-470
25,17,33,17,218,234,-16
25,17,33,19,44,59,-15
25,17,34,1,44,0,44
25,17,34,3,306,189,117
25,17,34,5,66,65,1
25,17,34,7,46,47,-1
25,17,34,13,144,160,-16
25,17,34,15,27,0,27
25,17,34,17,279,313,-34
25,17,34,19,50,0,50
25,17,34,21,193,152,41
25,17,34,23,250,248,2
25,17,34,25,114,71,43
25,17,34,27,201,149,52
25,17,34,29,49,30,19
25,17,34,31,54,36,18
25,17,34,35,114,94,20
25,17,34,37,42,0,42
25,17,34,39,107,102,5
25,17,35,1,97,69,28
25,17,35,49,46,29,17
25,17,36,1,176,105,71
25,17,36,5,171,159,12
25,17,36,7,71,28,43
25,17,36,27,98,60,38
25,17,36,29,181,114,67
25,17,36,45,34,0,34
25,17,36,47,575,928,-353
25,17,36,53,27,0,27
25,17,36,55,285,225,60
25,17,36,59,278,177,101
25,17,36,61,1284,2151,-867
25,17,36,63,29,0,29
25,17,36,65,78,68,10
25,17,36,67,155,147,8
25,17,36,71,56,77,-21
25,17,36,79,36,0,36
25,17,36,81,438,493,-55
25,17,36,83,85,52,33
25,17,36,85,40,23,17
25,17,36,87,54,60,-6
25,17,36,89,30,28,2
25,17,36,91,114,52,62
25,17,36,93,67,52,15
25,17,36,103,283,192,91
25,17,36,109,166,146,20
25,17,36,111,40,40,0
25,17,36,113,35,0,35
25,17,36,119,295,321,-26
25,17,37,19,0,42,-42
25,17,37,21,22,32,-10
25,17,37,25,0,36,-36
25,17,37,49,0,39,-39
25,17,37,51,60,56,4
25,17,37,63,164,237,-73
25,17,37,67,54,46,8
25,17,37,81,64,77,-13
25,17,37,101,0,39,-39
25,17,37,119,156,267,-111
25,17,37,129,31,0,31
25,17,37,133,115,103,12
25,17,37,135,89,119,-30
25,17,37,179,0,54,-54
25,17,37,183,193,776,-583
25,17,39,35,188,188,0
25,17,39,49,227,132,95
25,17,39,57,70,41,29
25,17,39,61,133,107,26
25,17,39,93,0,29,-29
25,17,39,95,37,0,37
25,17,39,113,60,40,20
25,17,39,153,88,0,88
25,17,40,27,41,0,41
25,17,40,109,73,39,34
25,17,40,143,38,0,38
25,17,41,5,34,0,34
25,17,41,39,0,53,-53
25,17,41,51,133,231,-98
25,17,41,67,66,106,-40
25,17,42,3,285,216,69
25,17,42,11,46,0,46
25,17,42,17,159,75,84
25,17,42,27,76,39,37
25,17,42,29,108,128,-20
25,17,42,41,25,0,25
25,17,42,43,33,33,0
25,17,42,45,148,97,51
25,17,42,49,62,0,62
25,17,42,69,28,0,28
25,17,42,71,41,0,41
25,17,42,77,39,36,3
25,17,42,91,278,191,87
25,17,42,95,48,37,11
25,17,42,101,361,417,-56
25,17,42,129,25,0,25
25,17,42,133,31,0,31
25,17,44,1,58,59,-1
25,17,44,3,159,134,25
25,17,44,5,118,101,17
25,17,44,7,1075,717,358
25,17,44,9,117,77,40
25,17,45,13,0,33,-33
25,17,45,15,0,41,-41
25,17,45,19,46,90,-44
25,17,45,45,32,35,-3
25,17,45,51,31,70,-39
25,17,45,63,0,33,-33
25,17,45,79,29,43,-14
25,17,45,91,0,39,-39
25,17,47,37,97,112,-15
25,17,47,93,41,0,41
25,17,47,125,37,36,1
25,17,47,157,53,47,6
25,17,48,27,0,61,-61
25,17,48,29,125,143,-18
25,17,48,41,28,0,28
25,17,48,85,144,174,-30
25,17,48,113,265,323,-58
25,17,48,121,69,101,-32
25,17,48,141,54,50,4
25,17,48,157,0,61,-61
25,17,48,201,247,423,-176
25,17,48,215,29,0,29
25,17,48,439,154,130,24
25,17,48,453,240,360,-120
25,17,48,491,43,78,-35
25,17,49,11,0,38,-38
25,17,49,35,118,115,3
25,17,49,49,136,58,78
25,17,50,1,37,27,10
25,17,50,3,36,22,14
25,17,50,7,238,238,0
25,17,50,15,26,0,26
25,17,50,17,26,33,-7
25,17,50,21,56,33,23
25,17,50,23,47,73,-26
25,17,50,25,70,63,7
25,17,50,27,88,47,41
25,17,51,3,50,46,4
25,17,51,13,240,261,-21
25,17,51,41,39,35,4
25,17,51,59,435,476,-41
25,17,51,87,70,50,20
25,17,51,107,66,98,-32
25,17,51,121,32,0,32
25,17,51,153,69,79,-10
25,17,51,510,93,138,-45
25,17,51,540,37,34,3
25,17,51,700,39,0,39
25,17,51,710,45,45,0
25,17,51,760,51,34,17
25,17,51,810,77,71,6
25,17,53,33,437,692,-255
25,17,53,53,33,57,-24
25,17,53,61,70,53,17
25,17,55,25,121,123,-2
25,17,55,79,109,86,23
25,17,55,133,39,40,-1
25,17,56,39,0,23,-23
25,19,9,1,32,0,32
25,19,12,11,0,31,-31
25,19,25,1,108,120,-12
25,19,25,5,27,0,27
25,19,25,9,0,26,-26
25,19,25,17,37,37,0
25,19,25,21,35,31,4
25,19,25,23,30,35,-5
25,19,25,25,43,32,11
25,19,36,47,0,28,-28
25,19,36,81,0,34,-34
25,19,50,21,23,0,23
25,21,4,13,121,230,-109
25,21,4,19,52,44,8
25,21,6,1,116,120,-4
25,21,6,13,69,61,8
25,21,6,37,382,429,-47
25,21,6,41,0,47,-47
25,21,6,59,106,166,-60
25,21,6,65,32,42,-10
25,21,6,67,40,27,13
25,21,6,71,28,0,28
25,21,6,73,242,274,-32
25,21,6,75,113,170,-57
25,21,6,81,51,81,-30
25,21,6,83,23,29,-6
25,21,6,85,90,167,-77
25,21,6,111,0,22,-22
25,21,6,113,0,29,-29
25,21,8,5,0,39,-39
25,21,8,13,33,58,-25
25,21,8,31,36,109,-73
25,21,8,41,0,43,-43
25,21,8,59,0,38,-38
25,21,9,1,332,211,121
25,21,9,3,328,262,66
25,21,9,5,37,24,13
25,21,9,7,43,39,4
25,21,9,9,199,176,23
25,21,9,11,97,65,32
25,21,9,13,46,40,6
25,21,9,15,35,38,-3
25,21,10,3,37,52,-15
25,21,11,1,134,222,-88
25,21,12,9,44,50,-6
25,21,12,11,179,234,-55
25,21,12,15,0,43,-43
25,21,12,21,36,82,-46
25,21,12,31,51,37,14
25,21,12,57,99,103,-4
25,21,12,69,39,0,39
25,21,12,71,57,130,-73
25,21,12,81,0,27,-27
25,21,12,86,65,108,-43
25,21,12,95,94,74,20
25,21,12,97,0,32,-32
25,21,12,99,180,219,-39
25,21,12,101,44,43,1
25,21,12,103,68,113,-45
25,21,12,105,0,34,-34
25,21,12,111,26,0,26
25,21,12,115,22,66,-44
25,21,12,117,0,30,-30
25,21,12,119,0,28,-28
25,21,12,127,25,51,-26
25,21,13,67,45,73,-28
25,21,13,89,51,72,-21
25,21,13,121,59,98,-39
25,21,13,135,32,84,-52
25,21,15,3,48,47,1
25,21,17,31,269,333,-64
25,21,17,43,39,43,-4
25,21,17,97,36,33,3
25,21,19,163,0,66,-66
25,21,20,91,30,28,2
25,21,23,1,37,0,37
25,21,23,5,150,175,-25
25,21,23,9,22,0,22
25,21,23,11,67,36,31
25,21,23,15,0,28,-28
25,21,23,19,66,25,41
25,21,23,31,74,111,-37
25,21,24,3,45,36,9
25,21,24,5,65,49,16
25,21,24,27,0,51,-51
25,21,24,31,109,182,-73
25,21,24,33,0,26,-26
25,21,24,510,56,38,18
25,21,25,1,732,930,-198
25,21,25,3,72,75,-3
25,21,25,5,3192,3414,-222
25,21,25,7,43,45,-2
25,21,25,9,967,1015,-48
25,21,25,11,49,64,-15
25,21,25,13,237,160,77
25,21,25,15,143,155,-12
25,21,25,17,8329,8196,133
25,21,25,23,5861,7034,-1173
25,21,25,25,14318,9369,4949
25,21,25,27,2026,2152,-126
25,21,26,125,75,54,21
25,21,26,161,97,41,56
25,21,27,53,66,69,-3
25,21,27,123,35,25,10
25,21,29,95,26,0,26
25,21,29,189,39,38,1
25,21,29,510,34,28,6
25,21,32,3,77,100,-23
25,21,33,1,47,42,5
25,21,33,3,44,68,-24
25,21,33,5,33,40,-7
25,21,33,9,80,92,-12
25,21,33,11,302,296,6
25,21,33,13,89,76,13
25,21,33,15,185,216,-31
25,21,33,17,53,84,-31
25,21,34,3,104,119,-15
25,21,34,7,30,38,-8
25,21,34,13,64,38,26
25,21,34,17,89,146,-57
25,21,34,21,52,54,-2
25,21,34,23,122,112,10
25,21,34,25,45,0,45
25,21,34,27,78,49,29
25,21,34,29,35,0,35
25,21,34,31,30,0,30
25,21,34,35,42,40,2
25,21,34,39,40,36,4
25,21,35,1,0,32,-32
25,21,36,1,79,43,36
25,21,36,5,68,44,24
25,21,36,7,27,0,27
25,21,36,27,40,0,40
25,21,36,29,74,39,35
25,21,36,47,165,336,-171
25,21,36,55,129,55,74
25,21,36,59,134,86,48
25,21,36,61,484,757,-273
25,21,36,67,63,29,34
25,21,36,69,26,0,26
25,21,36,71,31,0,31
25,21,36,81,198,195,3
25,21,36,83,41,0,41
25,21,36,87,25,0,25
25,21,36,91,43,43,0
25,21,36,93,21,0,21
25,21,36,103,127,92,35
25,21,36,109,38,32,6
25,21,36,119,114,120,-6
25,21,37,21,0,30,-30
25,21,37,63,48,73,-25
25,21,37,119,76,137,-61
25,21,37,133,29,0,29
25,21,37,135,28,45,-17
25,21,37,179,0,26,-26
25,21,37,183,50,278,-228
25,21,39,35,86,52,34
25,21,39,49,84,61,23
25,21,39,61,82,47,35
25,21,39,165,0,39,-39
25,21,41,51,42,65,-23
25,21,42,3,93,70,23
25,21,42,17,39,0,39
25,21,42,29,38,49,-11
25,21,42,45,34,46,-12
25,21,42,91,60,71,-11
25,21,42,101,126,162,-36
25,21,44,1,41,0,41
25,21,44,3,151,72,79
25,21,44,5,70,75,-5
25,21,44,7,976,843,133
25,21,44,9,49,48,1
25,21,45,13,0,46,-46
25,21,45,19,0,33,-33
25,21,45,45,0,37,-37
25,21,47,37,39,60,-21
25,21,47,157,54,0,54
25,21,48,29,0,53,-53
25,21,48,85,0,54,-54
25,21,48,113,76,120,-44
25,21,48,201,97,166,-69
25,21,48,439,54,69,-15
25,21,48,453,49,77,-28
25,21,48,491,0,42,-42
25,21,49,35,0,34,-34
25,21,50,7,79,77,2
25,21,50,21,29,0,29
25,21,51,13,85,97,-12
25,21,51,59,142,162,-20
25,21,51,87,33,0,33
25,21,51,107,45,43,2
25,21,51,510,26,55,-29
25,21,51,810,26,46,-20
25,21,53,33,98,182,-84
25,21,53,53,24,0,24
25,21,55,25,34,0,34
25,21,55,79,0,32,-32
25,23,4,13,58,118,-60
25,23,6,1,0,27,-27
25,23,6,37,98,126,-28
25,23,6,59,40,55,-15
25,23,6,73,98,164,-66
25,23,6,75,36,46,-10
25,23,8,31,0,30,-30
25,23,9,1,93,76,17
25,23,9,3,90,91,-1
25,23,9,7,31,0,31
25,23,9,9,44,49,-5
25,23,9,11,32,57,-25
25,23,11,1,26,52,-26
25,23,12,9,68,67,1
25,23,12,11,101,170,-69
25,23,12,15,38,68,-30
25,23,12,17,0,28,-28
25,23,12,21,35,98,-63
25,23,12,31,28,29,-1
25,23,12,35,0,35,-35
25,23,12,57,57,58,-1
25,23,12,69,0,55,-55
25,23,12,71,80,143,-63
25,23,12,81,30,58,-28
25,23,12,83,0,40,-40
25,23,12,85,0,31,-31
25,23,12,86,47,69,-22
25,23,12,95,50,97,-47
25,23,12,97,49,57,-8
25,23,12,99,142,107,35
25,23,12,101,42,52,-10
25,23,12,103,82,93,-11
25,23,12,105,35,74,-39
25,23,12,111,0,33,-33
25,23,12,115,49,104,-55
25,23,12,117,0,34,-34
25,23,12,127,64,60,4
25,23,13,67,0,42,-42
25,23,13,89,0,35,-35
25,23,13,121,0,50,-50
25,23,13,135,0,41,-41
25,23,13,151,0,45,-45
25,23,15,3,28,38,-10
25,23,17,31,53,66,-13
25,23,23,5,72,109,-37
25,23,23,11,30,0,30
25,23,23,19,0,46,-46
25,23,23,31,38,97,-59
25,23,24,31,34,0,34
25,23,25,1,1358,1256,102
25,23,25,3,41,44,-3
25,23,25,5,4203,4481,-278
25,23,25,7,42,38,4
25,23,25,9,390,336,54
25,23,25,11,0,46,-46
25,23,25,13,116,93,23
25,23,25,15,66,63,3
25,23,25,17,1697,1608,89
25,23,25,19,35,0,35
25,23,25,21,7034,5861,1173
25,23,25,25,3448,2797,651
25,23,25,27,407,481,-74
25,23,32,3,79,78,1
25,23,33,1,33,35,-2
25,23,33,3,22,54,-32
25,23,33,5,0,31,-31
25,23,33,9,30,47,-17
25,23,33,11,159,140,19
25,23,33,13,33,61,-28
25,23,33,15,108,159,-51
25,23,33,17,32,0,32
25,23,34,17,0,36,-36
25,23,34,27,38,0,38
25,23,36,1,0,28,-28
25,23,36,29,0,26,-26
25,23,36,47,57,60,-3
25,23,36,59,49,0,49
25,23,36,61,111,138,-27
25,23,36,67,27,0,27
25,23,36,81,76,77,-1
25,23,36,103,48,42,6
25,23,36,119,32,27,5
25,23,37,51,0,32,-32
25,23,37,63,0,30,-30
25,23,37,101,0,36,-36
25,23,37,119,0,95,-95
25,23,37,133,51,61,-10
25,23,37,183,0,122,-122
25,23,41,51,0,26,-26
25,23,42,3,27,39,-12
25,23,42,17,31,0,31
25,23,42,45,35,0,35
25,23,42,101,48,40,8
25,23,44,1,0,27,-27
25,23,44,3,52,52,0
25,23,44,5,63,51,12
25,23,44,7,363,325,38
25,23,44,9,24,0,24
25,23,45,13,0,45,-45
25,23,45,19,0,24,-24
25,23,45,51,0,78,-78
25,23,48,113,0,43,-43
25,23,48,121,0,36,-36
25,23,48,201,0,50,-50
25,23,48,439,0,40,-40
25,23,50,7,25,60,-35
25,23,51,13,0,40,-40
25,23,51,59,0,46,-46
25,23,51,810,0,24,-24
25,23,53,33,32,0,32
25,25,1,73,24,41,-17
25,25,1,101,27,0,27
25,25,2,20,26,0,26
25,25,4,13,189,204,-15
25,25,4,19,44,81,-37
25,25,5,119,0,29,-29
25,25,6,1,123,220,-97
25,25,6,13,57,46,11
25,25,6,37,604,985,-381
25,25,6,41,23,47,-24
25,25,6,59,319,231,88
25,25,6,65,51,55,-4
25,25,6,67,44,69,-25
25,25,6,71,42,39,3
25,25,6,73,332,389,-57
25,25,6,75,353,689,-336
25,25,6,81,85,150,-65
25,25,6,83,37,24,13
25,25,6,85,163,206,-43
25,25,6,97,0,29,-29
25,25,6,111,38,0,38
25,25,6,113,22,0,22
25,25,8,5,53,36,17
25,25,8,13,48,63,-15
25,25,8,31,110,131,-21
25,25,8,41,43,22,21
25,25,8,59,0,34,-34
25,25,8,69,23,0,23
25,25,9,1,448,300,148
25,25,9,3,576,322,254
25,25,9,5,99,22,77
25,25,9,7,90,48,42
25,25,9,9,470,245,225
25,25,9,11,153,85,68
25,25,9,13,84,50,34
25,25,9,15,51,0,51
25,25,10,3,44,55,-11
25,25,11,1,405,435,-30
25,25,12,1,28,31,-3
25,25,12,9,45,46,-1
25,25,12,11,328,374,-46
25,25,12,15,39,0,39
25,25,12,21,48,67,-19
25,25,12,31,71,97,-26
25,25,12,57,177,152,25
25,25,12,69,31,24,7
25,25,12,71,82,87,-5
25,25,12,73,33,0,33
25,25,12,81,27,0,27
25,25,12,83,0,26,-26
25,25,12,86,355,389,-34
25,25,12,95,193,262,-69
25,25,12,97,90,86,4
25,25,12,99,161,223,-62
25,25,12,101,39,44,-5
25,25,12,103,99,137,-38
25,25,12,105,34,48,-14
25,25,12,111,38,45,-7
25,25,12,115,26,23,3
25,25,12,117,41,51,-10
25,25,12,119,0,25,-25
25,25,12,127,42,45,-3
25,25,13,63,0,53,-53
25,25,13,67,63,104,-41
25,25,13,89,147,121,26
25,25,13,97,0,45,-45
25,25,13,121,165,200,-35
25,25,13,135,58,108,-50
25,25,13,151,0,42,-42
25,25,13,245,0,23,-23
25,25,15,3,74,69,5
25,25,17,19,40,26,14
25,25,17,31,579,779,-200
25,25,17,43,52,55,-3
25,25,17,97,35,0,35
25,25,18,97,33,39,-6
25,25,18,105,24,0,24
25,25,18,141,23,0,23
25,25,18,157,0,22,-22
25,25,19,103,26,0,26
25,25,20,91,31,0,31
25,25,21,111,37,28,9
25,25,22,51,0,44,-44
25,25,22,71,25,63,-38
25,25,23,1,68,69,-1
25,25,23,3,21,0,21
25,25,23,5,341,257,84
25,25,23,7,33,0,33
25,25,23,9,35,0,35
25,25,23,11,73,24,49
25,25,23,13,20,28,-8
25,25,23,17,26,26,0
25,25,23,19,75,25,50
25,25,23,31,157,133,24
25,25,24,3,39,52,-13
25,25,24,5,76,98,-22
25,25,24,27,38,30,8
25,25,24,31,214,232,-18
25,25,24,33,84,84,0
25,25,24,510,152,125,27
25,25,25,1,711,531,180
25,25,25,3,197,95,102
25,25,25,5,1229,1232,-3
25,25,25,7,60,0,60
25,25,25,9,4214,5084,-870
25,25,25,11,69,62,7
25,25,25,13,538,245,293
25,25,25,15,320,212,108
25,25,25,17,16670,20902,-4232
25,25,25,19,0,43,-43
25,25,25,21,9369,14318,-4949
25,25,25,23,2797,3448,-651
25,25,25,27,1473,1201,272
25,25,26,65,0,23,-23
25,25,26,81,27,0,27
25,25,26,99,29,0,29
25,25,26,125,108,55,53
25,25,26,161,107,89,18
25,25,26,163,98,40,58
25,25,27,53,183,159,24
25,25,27,109,35,0,35
25,25,27,123,38,36,2
25,25,29,19,0,24,-24
25,25,29,95,31,0,31
25,25,29,189,80,56,24
25,25,29,510,53,31,22
25,25,31,55,37,0,37
25,25,32,3,84,137,-53
25,25,32,31,25,0,25
25,25,33,1,44,42,2
25,25,33,3,84,43,41
25,25,33,5,85,32,53
25,25,33,7,30,0,30
25,25,33,9,143,103,40
25,25,33,11,615,436,179
25,25,33,13,136,79,57
25,25,33,15,527,422,105
25,25,33,17,137,81,56
25,25,33,19,22,0,22
25,25,34,1,37,0,37
25,25,34,3,139,124,15
25,25,34,5,35,0,35
25,25,34,7,45,25,20
25,25,34,13,105,115,-10
25,25,34,17,216,279,-63
25,25,34,19,28,0,28
25,25,34,21,77,94,-17
25,25,34,23,152,90,62
25,25,34,25,88,52,36
25,25,34,27,140,69,71
25,25,34,29,44,0,44
25,25,34,31,60,64,-4
25,25,34,35,60,39,21
25,25,34,37,23,0,23
25,25,34,39,68,52,16
25,25,35,1,45,38,7
25,25,36,1,155,74,81
25,25,36,5,297,193,104
25,25,36,7,33,0,33
25,25,36,27,93,27,66
25,25,36,29,138,56,82
25,25,36,47,483,736,-253
25,25,36,55,162,96,66
25,25,36,59,194,125,69
25,25,36,61,1408,1915,-507
25,25,36,63,34,0,34
25,25,36,65,43,34,9
25,25,36,67,132,66,66
25,25,36,71,58,27,31
25,25,36,79,32,0,32
25,25,36,81,270,454,-184
25,25,36,83,37,26,11
25,25,36,85,33,31,2
25,25,36,87,45,0,45
25,25,36,91,78,43,35
25,25,36,93,40,0,40
25,25,36,103,244,134,110
25,25,36,109,97,57,40
25,25,36,111,34,0,34
25,25,36,113,20,0,20
25,25,36,119,206,198,8
25,25,37,21,23,0,23
25,25,37,51,0,33,-33
25,25,37,63,131,145,-14
25,25,37,67,0,45,-45
25,25,37,81,43,31,12
25,25,37,119,133,293,-160
25,25,37,129,22,25,-3
25,25,37,133,29,0,29
25,25,37,135,85,47,38
25,25,37,183,103,204,-101
25,25,39,35,129,63,66
25,25,39,49,121,90,31
25,25,39,61,129,48,81
25,25,39,95,36,0,36
25,25,39,153,42,0,42
25,25,41,51,92,160,-68
25,25,41,67,35,26,9
25,25,42,3,148,112,36
25,25,42,11,25,35,-10
25,25,42,17,81,24,57
25,25,42,27,28,31,-3
25,25,42,29,72,47,25
25,25,42,41,21,0,21
25,25,42,43,0,29,-29
25,25,42,45,69,65,4
25,25,42,69,21,0,21
25,25,42,71,37,0,37
25,25,42,77,35,0,35
25,25,42,79,24,0,24
25,25,42,89,20,0,20
25,25,42,91,136,104,32
25,25,42,95,24,0,24
25,25,42,101,374,388,-14
25,25,42,133,28,0,28
25,25,44,1,75,0,75
25,25,44,3,107,75,32
25,25,44,5,104,78,26
25,25,44,7,884,747,137
25,25,44,9,92,49,43
25,25,45,13,0,23,-23
25,25,45,19,49,56,-7
25,25,45,45,0,38,-38
25,25,45,79,28,0,28
25,25,47,37,77,79,-2
25,25,47,93,22,28,-6
25,25,47,157,51,26,25
25,25,48,29,61,50,11
25,25,48,85,59,81,-22
25,25,48,113,143,182,-39
25,25,48,121,0,34,-34
25,25,48,157,28,46,-18
25,25,48,201,173,330,-157
25,25,48,439,62,93,-31
25,25,48,453,113,163,-50
25,25,49,35,69,49,20
25,25,50,1,32,0,32
25,25,50,7,176,119,57
25,25,50,23,42,24,18
25,25,50,25,39,31,8
25,25,50,27,82,42,40
25,25,51,3,25,0,25
25,25,51,13,146,207,-61
25,25,51,59,180,147,33
25,25,51,107,40,27,13
25,25,51,153,44,30,14
25,25,51,510,37,76,-39
25,25,51,540,25,0,25
25,25,51,710,29,32,-3
25,25,51,760,31,0,31
25,25,51,810,29,33,-4
25,25,53,33,335,360,-25
25,25,53,53,0,41,-41
25,25,53,61,0,36,-36
25,25,55,25,58,44,14
25,25,55,79,64,76,-12
25,25,55,133,20,0,20
25,27,4,13,167,269,-102
25,27,4,19,27,100,-73
25,27,4,25,0,23,-23
25,27,6,1,39,96,-57
25,27,6,13,0,48,-48
25,27,6,37,183,275,-92
25,27,6,59,102,103,-1
25,27,6,65,44,36,8
25,27,6,67,44,37,7
25,27,6,71,48,52,-4
25,27,6,73,120,223,-103
25,27,6,75,42,78,-36
25,27,6,81,23,34,-11
25,27,6,85,48,113,-65
25,27,8,5,37,0,37
25,27,8,13,26,24,2
25,27,8,31,0,59,-59
25,27,8,41,38,42,-4
25,27,9,1,139,179,-40
25,27,9,3,423,344,79
25,27,9,5,31,0,31
25,27,9,7,85,39,46
25,27,9,9,183,176,7
25,27,9,11,94,137,-43
25,27,9,13,150,141,9
25,27,9,15,569,683,-114
25,27,10,3,34,56,-22
25,27,10,5,0,23,-23
25,27,11,1,23,82,-59
25,27,12,1,29,0,29
25,27,12,9,70,138,-68
25,27,12,11,122,171,-49
25,27,12,15,0,38,-38
25,27,12,17,0,44,-44
25,27,12,21,57,77,-20
25,27,12,31,36,84,-48
25,27,12,35,0,40,-40
25,27,12,53,0,36,-36
25,27,12,57,102,167,-65
25,27,12,61,25,26,-1
25,27,12,69,36,44,-8
25,27,12,71,135,173,-38
25,27,12,81,38,67,-29
25,27,12,83,47,69,-22
25,27,12,86,73,81,-8
25,27,12,95,158,185,-27
25,27,12,97,34,104,-70
25,27,12,99,110,221,-111
25,27,12,101,69,100,-31
25,27,12,103,145,198,-53
25,27,12,105,89,145,-56
25,27,12,111,61,80,-19
25,27,12,115,65,144,-79
25,27,12,117,61,49,12
25,27,12,119,0,38,-38
25,27,12,127,95,140,-45
25,27,13,67,0,60,-60
25,27,13,89,56,30,26
25,27,13,121,0,84,-84
25,27,13,135,41,78,-37
25,27,15,3,51,70,-19
25,27,17,31,113,157,-44
25,27,17,43,0,38,-38
25,27,21,15,0,29,-29
25,27,23,1,46,0,46
25,27,23,3,0,40,-40
25,27,23,5,88,168,-80
25,27,23,9,26,34,-8
25,27,23,11,57,61,-4
25,27,23,13,0,32,-32
25,27,23,19,26,41,-15
25,27,23,25,0,41,-41
25,27,23,31,117,152,-35
25,27,24,3,35,35,0
25,27,24,5,42,43,-1
25,27,24,21,0,25,-25
25,27,24,27,0,42,-42
25,27,24,31,72,91,-19
25,27,24,33,47,44,3
25,27,24,510,0,40,-40
25,27,25,1,344,509,-165
25,27,25,3,95,133,-38
25,27,25,5,741,564,177
25,27,25,9,764,825,-61
25,27,25,11,611,715,-104
25,27,25,13,1137,1168,-31
25,27,25,15,651,613,38
25,27,25,17,8310,7678,632
25,27,25,21,2152,2026,126
25,27,25,23,481,407,74
25,27,25,25,1201,1473,-272
25,27,26,125,42,33,9
25,27,26,161,0,28,-28
25,27,26,163,45,0,45
25,27,27,53,45,57,-12
25,27,32,3,91,117,-26
25,27,33,1,31,73,-42
25,27,33,3,23,53,-30
25,27,33,5,223,338,-115
25,27,33,9,61,64,-3
25,27,33,11,365,637,-272
25,27,33,13,63,66,-3
25,27,33,15,162,235,-73
25,27,33,17,74,69,5
25,27,33,19,0,39,-39
25,27,34,3,46,105,-59
25,27,34,5,35,0,35
25,27,34,7,0,31,-31
25,27,34,13,58,43,15
25,27,34,17,76,69,7
25,27,34,21,30,35,-5
25,27,34,23,82,63,19
25,27,34,25,29,37,-8
25,27,34,27,46,0,46
25,27,34,31,43,0,43
25,27,34,35,0,33,-33
25,27,34,39,46,26,20
25,27,35,1,0,26,-26
25,27,36,1,40,36,4
25,27,36,5,274,270,4
25,27,36,29,34,50,-16
25,27,36,33,0,35,-35
25,27,36,47,139,143,-4
25,27,36,55,85,57,28
25,27,36,59,58,39,19
25,27,36,61,168,317,-149
25,27,36,67,80,52,28
25,27,36,71,29,0,29
25,27,36,81,127,151,-24
25,27,36,91,57,47,10
25,27,36,103,92,86,6
25,27,36,109,0,25,-25
25,27,36,119,81,73,8
25,27,37,51,43,41,2
25,27,37,63,0,38,-38
25,27,37,67,0,42,-42
25,27,37,81,0,55,-55
25,27,37,97,0,45,-45
25,27,37,101,0,35,-35
25,27,37,119,64,167,-103
25,27,37,133,72,59,13
25,27,37,135,0,51,-51
25,27,37,183,101,520,-419
25,27,39,35,39,0,39
25,27,39,49,60,51,9
25,27,39,61,0,41,-41
25,27,40,143,0,43,-43
25,27,41,51,0,40,-40
25,27,41,67,0,51,-51
25,27,42,3,57,60,-3
25,27,42,17,45,0,45
25,27,42,29,39,93,-54
25,27,42,71,34,42,-8
25,27,42,77,0,29,-29
25,27,42,91,49,53,-4
25,27,42,101,86,82,4
25,27,44,1,0,31,-31
25,27,44,3,128,113,15
25,27,44,5,67,68,-1
25,27,44,7,1297,986,311
25,27,44,9,65,51,14
25,27,45,15,0,36,-36
25,27,45,19,30,40,-10
25,27,45,45,0,35,-35
25,27,45,51,27,79,-52
25,27,45,79,0,63,-63
25,27,45,83,0,48,-48
25,27,47,37,0,31,-31
25,27,47,157,0,38,-38
25,27,48,29,38,54,-16
25,27,48,85,53,70,-17
25,27,48,113,54,91,-37
25,27,48,121,0,68,-68
25,27,48,201,66,172,-106
25,27,48,439,40,145,-105
25,27,48,453,38,55,-17
25,27,48,491,0,35,-35
25,27,49,35,0,52,-52
25,27,50,7,41,70,-29
25,27,50,21,25,0,25
25,27,50,23,0,25,-25
25,27,50,25,0,32,-32
25,27,50,27,0,30,-30
25,27,51,13,0,41,-41
25,27,51,59,81,116,-35
25,27,51,107,39,23,16
25,27,51,153,39,53,-14
25,27,51,510,0,32,-32
25,27,51,810,39,39,0
25,27,53,33,57,116,-59
25,27,55,79,0,40,-40
26,1,26,7,91,131,-40
26,1,26,49,63,0,63
26,1,26,69,138,149,-11
26,1,26,99,41,0,41
26,1,26,125,58,28,30
26,1,26,145,0,23,-23
26,1,26,163,50,39,11
26,3,26,41,29,31,-2
26,3,26,103,113,155,-42
26,5,4,13,46,43,3
26,5,6,37,23,22,1
26,5,6,73,0,31,-31
26,5,17,31,180,80,100
26,5,18,141,30,0,30
26,5,26,15,443,341,102
26,5,26,21,51,91,-40
26,5,26,25,77,66,11
26,5,26,49,50,0,50
26,5,26,65,37,63,-26
26,5,26,67,33,35,-2
26,5,26,77,1021,1150,-129
26,5,26,81,1353,1354,-1
26,5,26,99,33,0,33
26,5,26,121,99,110,-11
26,5,26,123,32,0,32
26,5,26,125,83,85,-2
26,5,26,139,1924,1871,53
26,5,26,149,51,0,51
26,5,26,159,569,474,95
26,5,26,161,35,50,-15
26,5,26,163,51,49,2
26,5,48,215,46,60,-14
26,7,4,13,0,32,-32
26,7,26,1,131,91,40
26,7,26,31,27,0,27
26,7,26,49,46,0,46
26,7,26,55,0,54,-54
26,7,26,65,0,27,-27
26,7,26,69,27,44,-17
26,7,26,81,0,54,-54
26,7,26,99,41,32,9
26,7,26,119,72,50,22
26,7,26,125,72,67,5
26,7,26,137,0,40,-40
26,7,26,141,135,119,16
26,7,26,161,0,36,-36
26,7,26,163,70,50,20
26,9,26,29,165,151,14
26,9,26,47,42,40,2
26,9,26,49,0,28,-28
26,9,26,55,236,361,-125
26,9,26,79,209,196,13
26,9,26,81,48,44,4
26,9,26,99,32,0,32
26,9,26,125,85,52,33
26,9,26,137,91,86,5
26,9,26,163,50,0,50
26,11,26,17,233,279,-46
26,11,26,49,100,56,44
26,11,26,69,75,96,-21
26,11,26,99,39,25,14
26,11,26,111,0,54,-54
26,11,26,125,37,61,-24
26,11,26,129,125,89,36
26,11,26,145,87,99,-12
26,11,26,163,37,31,6
26,13,26,61,44,92,-48
26,13,26,103,42,82,-40
26,15,4,13,0,53,-53
26,15,17,31,0,23,-23
26,15,26,5,341,443,-102
26,15,26,25,379,380,-1
26,15,26,37,0,35,-35
26,15,26,45,229,233,-4
26,15,26,65,67,66,1
26,15,26,67,225,175,50
26,15,26,77,362,496,-134
26,15,26,81,927,749,178
26,15,26,117,28,0,28
26,15,26,139,113,87,26
26,15,26,159,38,0,38
26,15,26,163,0,32,-32
26,17,4,13,43,74,-31
26,17,6,73,0,23,-23
26,17,17,31,0,61,-61
26,17,26,11,279,233,46
26,17,26,45,28,30,-2
26,17,26,49,146,155,-9
26,17,26,51,98,111,-13
26,17,26,55,0,35,-35
26,17,26,57,0,35,-35
26,17,26,63,121,62,59
26,17,26,65,57,56,1
26,17,26,69,80,60,20
26,17,26,73,89,77,12
26,17,26,77,36,35,1
26,17,26,81,75,77,-2
26,17,26,99,61,51,10
26,17,26,107,0,25,-25
26,17,26,111,677,567,110
26,17,26,125,122,150,-28
26,17,26,129,66,49,17
26,17,26,139,24,0,24
26,17,26,143,41,0,41
26,17,26,145,1106,955,151
26,17,26,147,32,35,-3
26,17,26,151,39,0,39
26,17,26,157,295,167,128
26,17,26,161,36,42,-6
26,17,26,163,79,74,5
26,19,26,55,462,421,41
26,19,26,65,0,25,-25
26,19,26,81,39,23,16
26,19,26,89,60,80,-20
26,19,26,99,25,0,25
26,19,26,101,127,109,18
26,19,26,125,49,30,19
26,19,26,163,43,36,7
26,19,26,165,35,38,-3
26,21,4,13,47,112,-65
26,21,4,19,37,0,37
26,21,6,37,41,47,-6
26,21,6,65,0,32,-32
26,21,6,71,0,34,-34
26,21,6,73,51,47,4
26,21,12,95,47,46,1
26,21,13,121,27,28,-1
26,21,15,3,0,31,-31
26,21,17,31,401,287,114
26,21,17,43,57,44,13
26,21,17,97,42,22,20
26,21,17,197,44,0,44
26,21,18,3,0,35,-35
26,21,18,39,144,160,-16
26,21,18,89,43,0,43
26,21,18,91,235,219,16
26,21,18,97,96,130,-34
26,21,18,127,41,37,4
26,21,18,141,788,1172,-384
26,21,26,5,91,51,40
26,21,26,25,50,57,-7
26,21,26,27,688,683,5
26,21,26,45,23,0,23
26,21,26,49,42,0,42
26,21,26,65,81,71,10
26,21,26,73,66,0,66
26,21,26,75,36,0,36
26,21,26,77,315,426,-111
26,21,26,81,260,303,-43
26,21,26,99,55,20,35
26,21,26,121,44,0,44
26,21,26,125,168,80,88
26,21,26,139,123,100,23
26,21,26,149,66,46,20
26,21,26,159,689,683,6
26,21,26,161,65,40,25
26,21,26,163,93,79,14
26,21,27,53,0,30,-30
26,21,32,3,41,50,-9
26,21,37,183,0,27,-27
26,21,39,49,59,83,-24
26,21,47,65,0,32,-32
26,21,48,201,0,38,-38
26,21,48,439,0,41,-41
26,21,53,33,0,47,-47
26,21,55,79,0,35,-35
26,23,17,31,0,38,-38
26,23,18,3,36,50,-14
26,23,18,87,54,43,11
26,23,18,151,106,184,-78
26,23,26,25,491,564,-73
26,23,26,59,330,308,22
26,23,26,65,0,30,-30
26,23,26,75,46,42,4
26,23,26,77,48,114,-66
26,23,26,81,0,39,-39
26,23,26,149,298,334,-36
26,23,26,161,0,37,-37
26,23,26,163,87,105,-18
26,25,4,13,42,74,-32
26,25,6,37,0,26,-26
26,25,6,73,38,0,38
26,25,12,103,0,32,-32
26,25,17,31,63,131,-68
26,25,17,43,0,27,-27
26,25,18,3,46,42,4
26,25,18,97,0,41,-41
26,25,18,141,0,30,-30
26,25,26,5,66,77,-11
26,25,26,15,380,379,1
26,25,26,21,57,50,7
26,25,26,23,564,491,73
26,25,26,45,391,319,72
26,25,26,49,68,33,35
26,25,26,55,27,28,-1
26,25,26,59,102,88,14
26,25,26,65,119,187,-68
26,25,26,75,449,465,-16
26,25,26,77,978,1125,-147
26,25,26,81,132,159,-27
26,25,26,91,41,0,41
26,25,26,93,39,35,4
26,25,26,99,63,55,8
26,25,26,125,114,90,24
26,25,26,139,51,31,20
26,25,26,145,29,0,29
26,25,26,149,76,69,7
26,25,26,159,48,58,-10
26,25,26,161,55,104,-49
26,25,26,163,161,143,18
26,25,32,3,38,42,-4
26,25,39,49,0,36,-36
26,25,48,201,0,32,-32
26,27,17,31,75,32,43
26,27,18,39,781,671,110
26,27,18,141,673,420,253
26,27,26,21,683,688,-5
26,27,26,65,0,24,-24
26,27,26,77,116,146,-30
26,27,26,81,0,44,-44
26,27,26,149,326,311,15
26,27,26,159,245,328,-83
26,29,17,31,0,39,-39
26,29,26,9,151,165,-14
26,29,26,31,45,29,16
26,29,26,47,383,404,-21
26,29,26,49,28,0,28
26,29,26,55,62,107,-45
26,29,26,65,33,33,0
26,29,26,73,0,28,-28
26,29,26,79,28,0,28
26,29,26,81,77,62,15
26,29,26,125,68,42,26
26,29,26,137,61,63,-2
26,29,26,161,0,24,-24
26,29,26,163,58,38,20
26,31,26,7,0,27,-27
26,31,26,29,29,45,-16
26,31,26,33,32,49,-17
26,31,26,47,265,353,-88
26,31,26,49,70,27,43
26,31,26,55,0,38,-38
26,31,26,65,0,22,-22
26,31,26,81,35,52,-17
26,31,26,97,49,0,49
26,31,26,99,63,49,14
26,31,26,125,66,82,-16
26,31,26,137,63,68,-5
26,31,26,141,122,59,63
26,31,26,163,91,46,45
26,33,4,13,0,29,-29
26,33,26,31,49,32,17
26,33,26,47,55,36,19
26,33,26,49,62,35,27
26,33,26,55,0,30,-30
26,33,26,65,0,49,-49
26,33,26,77,0,26,-26
26,33,26,81,48,56,-8
26,33,26,95,0,33,-33
26,33,26,97,153,109,44
26,33,26,99,34,41,-7
26,33,26,103,28,53,-25
26,33,26,125,46,36,10
26,33,26,163,47,51,-4
26,35,26,37,37,0,37
26,35,26,45,25,25,0
26,35,26,49,93,73,20
26,35,26,51,121,96,25
26,35,26,57,39,41,-2
26,35,26,65,50,44,6
26,35,26,73,289,379,-90
26,35,26,75,0,49,-49
26,35,26,81,0,38,-38
26,35,26,93,44,0,44
26,35,26,99,94,44,50
26,35,26,107,0,34,-34
26,35,26,111,148,145,3
26,35,26,117,0,30,-30
26,35,26,125,82,76,6
26,35,26,133,63,48,15
26,35,26,143,34,51,-17
26,35,26,145,53,53,0
26,35,26,163,108,68,40
26,35,26,165,0,47,-47
26,37,4,13,0,71,-71
26,37,17,31,34,68,-34
26,37,26,15,35,0,35
26,37,26,35,0,37,-37
26,37,26,45,641,661,-20
26,37,26,49,77,53,24
26,37,26,55,0,35,-35
26,37,26,57,184,233,-49
26,37,26,65,2123,1879,244
26,37,26,67,205,218,-13
26,37,26,73,39,64,-25
26,37,26,75,53,40,13
26,37,26,77,56,53,3
26,37,26,81,159,159,0
26,37,26,93,59,46,13
26,37,26,99,39,45,-6
26,37,26,117,49,84,-35
26,37,26,125,81,123,-42
26,37,26,139,29,29,0
26,37,26,145,95,56,39
26,37,26,155,367,309,58
26,37,26,161,37,53,-16
26,37,26,163,63,64,-1
26,37,32,3,0,31,-31
26,39,26,49,41,0,41
26,39,26,65,0,31,-31
26,39,26,79,31,0,31
26,39,26,81,0,29,-29
26,39,26,99,55,0,55
26,39,26,125,74,26,48
26,39,26,135,0,37,-37
26,39,26,137,99,98,1
26,39,26,143,121,100,21
26,39,26,145,38,0,38
26,39,26,163,66,0,66
26,41,17,31,0,28,-28
26,41,26,3,31,29,2
26,41,26,43,34,77,-43
26,41,26,81,0,39,-39
26,41,26,103,132,170,-38
26,41,26,109,128,187,-59
26,41,26,153,54,42,12
26,41,26,163,35,0,35
26,41,55,9,54,69,-15
26,41,55,75,0,39,-39
26,41,55,79,0,40,-40
26,41,55,87,0,32,-32
26,41,55,139,0,30,-30
26,43,17,31,0,32,-32
26,43,26,41,77,34,43
26,43,26,61,0,29,-29
26,43,26,71,68,58,10
26,43,26,103,85,98,-13
26,43,26,109,63,68,-5
26,43,55,9,61,92,-31
26,43,55,37,123,84,39
26,43,55,75,115,134,-19
26,43,55,87,0,30,-30
26,45,4,13,27,85,-58
26,45,12,57,0,26,-26
26,45,12,71,0,53,-53
26,45,12,81,0,32,-32
26,45,12,95,0,30,-30
26,45,12,103,0,27,-27
26,45,17,31,34,65,-31
26,45,26,15,233,229,4
26,45,26,17,30,28,2
26,45,26,21,0,23,-23
26,45,26,25,319,391,-72
26,45,26,35,25,25,0
26,45,26,37,661,641,20
26,45,26,49,139,88,51
26,45,26,55,0,40,-40
26,45,26,57,31,34,-3
26,45,26,65,4272,3854,418
26,45,26,67,291,225,66
26,45,26,73,63,46,17
26,45,26,75,182,190,-8
26,45,26,77,121,107,14
26,45,26,81,213,250,-37
26,45,26,93,79,95,-16
26,45,26,99,65,49,16
26,45,26,107,32,0,32
26,45,26,117,32,49,-17
26,45,26,121,23,29,-6
26,45,26,125,129,152,-23
26,45,26,139,76,61,15
26,45,26,145,79,36,43
26,45,26,155,114,90,24
26,45,26,161,57,128,-71
26,45,26,163,157,123,34
26,45,32,3,0,103,-103
26,45,37,119,0,27,-27
26,45,48,201,0,38,-38
26,47,17,31,0,45,-45
26,47,26,9,40,42,-2
26,47,26,29,404,383,21
26,47,26,31,353,265,88
26,47,26,33,36,55,-19
26,47,26,49,31,0,31
26,47,26,55,67,80,-13
26,47,26,65,51,62,-11
26,47,26,73,36,0,36
26,47,26,81,77,94,-17
26,47,26,99,54,0,54
26,47,26,103,0,29,-29
26,47,26,125,108,98,10
26,47,26,137,57,44,13
26,47,26,145,38,0,38
26,47,26,161,25,22,3
26,47,26,163,91,27,64
26,49,1,89,0,34,-34
26,49,4,13,129,455,-326
26,49,4,15,0,48,-48
26,49,4,19,0,85,-85
26,49,4,21,0,78,-78
26,49,6,37,60,94,-34
26,49,6,59,0,45,-45
26,49,6,71,0,45,-45
26,49,6,73,85,101,-16
26,49,8,1,0,42,-42
26,49,8,41,0,52,-52
26,49,12,9,26,30,-4
26,49,12,11,0,74,-74
26,49,12,15,40,48,-8
26,49,12,21,0,57,-57
26,49,12,31,29,49,-20
26,49,12,53,0,34,-34
26,49,12,55,0,29,-29
26,49,12,57,28,84,-56
26,49,12,69,0,57,-57
26,49,12,71,45,108,-63
26,49,12,81,33,50,-17
26,49,12,83,0,39,-39
26,49,12,95,0,80,-80
26,49,12,99,26,75,-49
26,49,12,101,36,109,-73
26,49,12,103,61,110,-49
26,49,12,105,0,86,-86
26,49,12,115,45,84,-39
26,49,12,127,0,34,-34
26,49,13,67,0,61,-61
26,49,13,89,26,97,-71
26,49,13,121,33,81,-48
26,49,13,135,0,101,-101
26,49,13,151,0,34,-34
26,49,15,3,0,28,-28
26,49,17,31,77,273,-196
26,49,17,43,0,34,-34
26,49,17,97,0,34,-34
26,49,18,3,0,51,-51
26,49,18,57,0,42,-42
26,49,18,97,44,124,-80
26,49,21,111,29,51,-22
26,49,26,1,0,63,-63
26,49,26,5,0,50,-50
26,49,26,7,0,46,-46
26,49,26,9,28,0,28
26,49,26,11,56,100,-44
26,49,26,17,155,146,9
26,49,26,21,0,42,-42
26,49,26,25,33,68,-35
26,49,26,29,0,28,-28
26,49,26,31,27,70,-43
26,49,26,33,35,62,-27
26,49,26,35,73,93,-20
26,49,26,37,53,77,-24
26,49,26,39,0,41,-41
26,49,26,45,88,139,-51
26,49,26,47,0,31,-31
26,49,26,51,72,116,-44
26,49,26,55,68,116,-48
26,49,26,57,29,0,29
26,49,26,63,41,55,-14
26,49,26,65,290,395,-105
26,49,26,69,127,157,-30
26,49,26,73,89,88,1
26,49,26,75,41,63,-22
26,49,26,77,53,143,-90
26,49,26,79,0,35,-35
26,49,26,81,162,284,-122
26,49,26,87,1168,1137,31
26,49,26,91,26,35,-9
26,49,26,93,737,830,-93
26,49,26,99,478,461,17
26,49,26,101,30,25,5
26,49,26,107,31,36,-5
26,49,26,111,79,113,-34
26,49,26,113,0,32,-32
26,49,26,115,36,49,-13
26,49,26,119,0,28,-28
26,49,26,121,25,85,-60
26,49,26,125,2956,2633,323
26,49,26,129,57,130,-73
26,49,26,133,0,47,-47
26,49,26,135,0,27,-27
26,49,26,137,28,29,-1
26,49,26,139,25,147,-122
26,49,26,143,84,108,-24
26,49,26,145,861,938,-77
26,49,26,147,123,88,35
26,49,26,151,76,57,19
26,49,26,155,668,750,-82
26,49,26,157,424,475,-51
26,49,26,161,300,366,-66
26,49,26,163,687,773,-86
26,49,26,165,31,32,-1
26,49,27,53,0,30,-30
26,49,28,47,0,27,-27
26,49,29,189,0,38,-38
26,49,32,3,52,214,-162
26,49,36,29,0,44,-44
26,49,36,61,0,29,-29
26,49,37,21,0,26,-26
26,49,37,51,0,37,-37
26,49,37,67,0,30,-30
26,49,37,119,0,131,-131
26,49,37,183,0,70,-70
26,49,39,35,52,39,13
26,49,39,49,35,100,-65
26,49,39,95,45,59,-14
26,49,39,113,0,39,-39
26,49,40,109,0,32,-32
26,49,40,143,0,30,-30
26,49,41,51,0,25,-25
26,49,45,15,0,29,-29
26,49,45,19,0,32,-32
26,49,45,45,0,47,-47
26,49,47,37,43,119,-76
26,49,47,119,0,38,-38
26,49,47,149,0,53,-53
26,49,47,157,30,102,-72
26,49,47,165,0,43,-43
26,49,48,27,60,35,25
26,49,48,29,0,46,-46
26,49,48,85,0,68,-68
26,49,48,113,27,68,-41
26,49,48,141,0,34,-34
26,49,48,201,58,157,-99
26,49,48,439,0,91,-91
26,49,48,453,0,59,-59
26,49,48,491,0,38,-38
26,49,51,59,0,26,-26
26,49,51,153,0,40,-40
26,49,51,710,0,27,-27
26,49,51,810,31,33,-2
26,49,53,33,0,38,-38
26,49,53,61,0,28,-28
26,49,55,79,0,32,-32
26,49,56,5,0,66,-66
26,49,56,25,0,51,-51
26,51,26,17,111,98,13
26,51,26,35,96,121,-25
26,51,26,49,116,72,44
26,51,26,73,48,82,-34
26,51,26,81,0,27,-27
26,51,26,99,106,25,81
26,51,26,111,221,311,-90
26,51,26,125,112,91,21
26,51,26,129,34,79,-45
26,51,26,143,0,29,-29
26,51,26,145,78,63,15
26,51,26,163,147,48,99
26,53,17,97,24,0,24
26,53,26,103,25,0,25
26,53,26,131,67,26,41
26,53,27,53,0,26,-26
26,53,55,51,112,116,-4
26,53,55,125,34,0,34
26,55,4,13,43,46,-3
26,55,6,37,27,35,-8
26,55,6,73,32,27,5
26,55,12,11,0,32,-32
26,55,12,71,41,0,41
26,55,12,103,0,35,-35
26,55,17,31,47,133,-86
26,55,26,7,54,0,54
26,55,26,9,361,236,125
26,55,26,17,35,0,35
26,55,26,19,421,462,-41
26,55,26,25,28,27,1
26,55,26,29,107,62,45
26,55,26,31,38,0,38
26,55,26,33,30,0,30
26,55,26,37,35,0,35
26,55,26,45,40,0,40
26,55,26,47,80,67,13
26,55,26,49,116,68,48
26,55,26,61,24,0,24
26,55,26,65,142,97,45
26,55,26,73,63,45,18
26,55,26,75,26,0,26
26,55,26,77,72,81,-9
26,55,26,79,337,353,-16
26,55,26,81,229,289,-60
26,55,26,89,611,461,150
26,55,26,93,0,33,-33
26,55,26,99,99,64,35
26,55,26,101,138,63,75
26,55,26,103,42,32,10
26,55,26,105,39,0,39
26,55,26,107,42,26,16
26,55,26,111,54,31,23
26,55,26,113,40,39,1
26,55,26,121,63,35,28
26,55,26,125,191,155,36
26,55,26,133,30,42,-12
26,55,26,137,80,32,48
26,55,26,139,39,59,-20
26,55,26,143,47,0,47
26,55,26,145,78,53,25
26,55,26,147,30,0,30
26,55,26,161,86,59,27
26,55,26,163,154,85,69
26,55,26,165,359,353,6
26,55,32,3,0,48,-48
26,55,37,21,0,31,-31
26,55,53,33,25,32,-7
26,57,26,17,35,0,35
26,57,26,35,41,39,2
26,57,26,37,233,184,49
26,57,26,45,34,31,3
26,57,26,49,0,29,-29
26,57,26,65,119,157,-38
26,57,26,67,41,34,7
26,57,26,73,362,384,-22
26,57,26,81,57,94,-37
26,57,26,111,115,144,-29
26,57,26,117,258,263,-5
26,57,26,125,31,32,-1
26,57,26,139,0,26,-26
26,57,26,145,177,180,-3
26,57,26,155,47,55,-8
26,57,26,163,51,0,51
26,59,17,31,0,28,-28
26,59,18,151,51,57,-6
26,59,26,23,308,330,-22
26,59,26,25,88,102,-14
26,59,26,65,0,62,-62
26,59,26,75,446,447,-1
26,59,26,77,32,45,-13
26,59,26,81,0,36,-36
26,59,26,91,311,371,-60
26,59,26,115,55,41,14
26,59,26,125,29,67,-38
26,59,26,161,66,74,-8
26,59,26,163,153,98,55
26,59,39,51,36,28,8
26,59,39,95,31,44,-13
26,59,39,171,92,60,32
26,61,4,13,0,24,-24
26,61,26,13,92,44,48
26,61,26,43,29,0,29
26,61,26,55,0,24,-24
26,61,26,81,37,34,3
26,61,26,83,78,84,-6
26,61,26,93,25,26,-1
26,61,26,103,103,127,-24
26,61,26,125,37,51,-14
26,61,26,131,58,41,17
26,61,26,163,56,45,11
26,61,27,53,0,33,-33
26,61,55,9,35,34,1
26,63,26,17,62,121,-59
26,63,26,49,55,41,14
26,63,26,87,0,35,-35
26,63,26,99,114,114,0
26,63,26,125,141,106,35
26,63,26,145,45,105,-60
26,63,26,147,52,0,52
26,63,26,151,155,139,16
26,63,26,157,181,237,-56
26,63,26,163,56,54,2
26,65,4,13,125,294,-169
26,65,4,19,39,55,-16
26,65,4,25,0,24,-24
26,65,6,1,33,48,-15
26,65,6,13,0,31,-31
26,65,6,37,108,166,-58
26,65,6,59,0,48,-48
26,65,6,65,0,32,-32
26,65,6,67,0,28,-28
26,65,6,71,26,0,26
26,65,6,73,53,113,-60
26,65,6,75,0,49,-49
26,65,6,85,0,55,-55
26,65,8,5,0,27,-27
26,65,8,13,0,28,-28
26,65,8,31,0,44,-44
26,65,8,35,0,33,-33
26,65,8,41,0,46,-46
26,65,8,69,0,32,-32
26,65,9,3,0,33,-33
26,65,11,1,36,76,-40
26,65,12,11,36,52,-16
26,65,12,21,0,24,-24
26,65,12,31,0,35,-35
26,65,12,57,34,84,-50
26,65,12,71,48,61,-13
26,65,12,81,0,54,-54
26,65,12,86,28,73,-45
26,65,12,95,52,66,-14
26,65,12,103,0,90,-90
26,65,12,105,0,48,-48
26,65,12,115,0,60,-60
26,65,13,67,0,58,-58
26,65,13,89,0,37,-37
26,65,13,121,0,65,-65
26,65,13,135,0,37,-37
26,65,15,3,0,32,-32
26,65,17,19,28,0,28
26,65,17,31,227,541,-314
26,65,17,43,56,52,4
26,65,17,97,0,22,-22
26,65,17,197,0,37,-37
26,65,18,3,38,52,-14
26,65,18,57,0,52,-52
26,65,18,97,37,52,-15
26,65,18,141,44,49,-5
26,65,18,157,0,29,-29
26,65,21,67,0,37,-37
26,65,21,111,0,60,-60
26,65,22,71,0,23,-23
26,65,24,3,0,37,-37
26,65,24,5,0,37,-37
26,65,24,31,27,56,-29
26,65,25,17,44,43,1
26,65,25,25,23,0,23
26,65,26,5,63,37,26
26,65,26,7,27,0,27
26,65,26,15,66,67,-1
26,65,26,17,56,57,-1
26,65,26,19,25,0,25
26,65,26,21,71,81,-10
26,65,26,23,30,0,30
26,65,26,25,187,119,68
26,65,26,27,24,0,24
26,65,26,29,33,33,0
26,65,26,31,22,0,22
26,65,26,33,49,0,49
26,65,26,35,44,50,-6
26,65,26,37,1879,2123,-244
26,65,26,39,31,0,31
26,65,26,45,3854,4272,-418
26,65,26,47,62,51,11
26,65,26,49,395,290,105
26,65,26,55,97,142,-45
26,65,26,57,157,119,38
26,65,26,59,62,0,62
26,65,26,67,222,231,-9
26,65,26,73,214,115,99
26,65,26,75,732,663,69
26,65,26,77,245,323,-78
26,65,26,81,556,646,-90
26,65,26,87,40,0,40
26,65,26,89,26,0,26
26,65,26,91,90,68,22
26,65,26,93,568,633,-65
26,65,26,97,26,33,-7
26,65,26,99,249,210,39
26,65,26,103,52,38,14
26,65,26,105,30,0,30
26,65,26,107,62,60,2
26,65,26,111,86,83,3
26,65,26,115,42,41,1
26,65,26,117,82,44,38
26,65,26,121,91,81,10
26,65,26,125,703,952,-249
26,65,26,129,32,0,32
26,65,26,133,26,0,26
26,65,26,137,36,0,36
26,65,26,139,125,167,-42
26,65,26,143,32,42,-10
26,65,26,145,216,110,106
26,65,26,147,74,46,28
26,65,26,151,21,0,21
26,65,26,155,658,564,94
26,65,26,157,35,0,35
26,65,26,159,33,0,33
26,65,26,161,377,524,-147
26,65,26,163,653,621,32
26,65,26,165,32,33,-1
26,65,27,53,36,52,-16
26,65,27,123,29,0,29
26,65,29,189,32,36,-4
26,65,32,3,37,370,-333
26,65,34,23,0,31,-31
26,65,35,1,0,33,-33
26,65,36,29,0,33,-33
26,65,36,47,38,48,-10
26,65,36,55,0,28,-28
26,65,36,61,50,83,-33
26,65,37,63,0,33,-33
26,65,37,119,0,79,-79
26,65,37,183,29,73,-44
26,65,39,35,0,56,-56
26,65,39,49,36,94,-58
26,65,39,61,48,38,10
26,65,39,95,0,30,-30
26,65,39,113,0,38,-38
26,65,41,51,0,53,-53
26,65,41,67,0,30,-30
26,65,42,3,0,46,-46
26,65,42,101,22,44,-22
26,65,47,37,39,74,-35
26,65,47,93,0,43,-43
26,65,47,157,0,31,-31
26,65,48,29,43,57,-14
26,65,48,85,0,38,-38
26,65,48,113,0,56,-56
26,65,48,201,50,94,-44
26,65,48,215,0,57,-57
26,65,48,439,0,59,-59
26,65,48,453,23,52,-29
26,65,49,35,41,33,8
26,65,51,13,0,24,-24
26,65,51,59,51,61,-10
26,65,51,510,0,25,-25
26,65,51,810,0,37,-37
26,65,53,33,34,108,-74
26,65,53,53,0,37,-37
26,65,55,25,37,52,-15
26,65,55,79,0,53,-53
26,67,17,31,0,25,-25
26,67,26,5,35,33,2
26,67,26,15,175,225,-50
26,67,26,37,218,205,13
26,67,26,45,225,291,-66
26,67,26,57,34,41,-7
26,67,26,65,231,222,9
26,67,26,73,29,39,-10
26,67,26,75,31,0,31
26,67,26,77,28,60,-32
26,67,26,81,989,1079,-90
26,67,26,99,0,32,-32
26,67,26,107,26,45,-19
26,67,26,117,558,683,-125
26,67,26,121,0,47,-47
26,67,26,125,28,49,-21
26,67,26,139,86,70,16
26,67,26,155,26,33,-7
26,67,26,163,31,0,31
26,69,26,1,149,138,11
26,69,26,7,44,27,17
26,69,26,11,96,75,21
26,69,26,17,60,80,-20
26,69,26,49,157,127,30
26,69,26,81,27,0,27
26,69,26,87,28,0,28
26,69,26,99,105,61,44
26,69,26,125,110,76,34
26,69,26,129,131,92,39
26,69,26,145,68,79,-11
26,69,26,147,34,0,34
26,69,26,161,30,22,8
26,69,26,163,122,55,67
26,71,26,43,58,68,-10
26,71,26,103,0,57,-57
26,71,55,9,0,29,-29
26,71,55,37,0,32,-32
26,73,4,13,0,44,-44
26,73,6,73,0,28,-28
26,73,12,71,0,27,-27
26,73,17,31,0,72,-72
26,73,26,17,77,89,-12
26,73,26,21,0,66,-66
26,73,26,29,28,0,28
26,73,26,35,379,289,90
26,73,26,37,64,39,25
26,73,26,45,46,63,-17
26,73,26,47,0,36,-36
26,73,26,49,88,89,-1
26,73,26,51,82,48,34
26,73,26,55,45,63,-18
26,73,26,57,384,362,22
26,73,26,65,115,214,-99
26,73,26,67,39,29,10
26,73,26,75,32,36,-4
26,73,26,77,34,0,34
26,73,26,81,146,167,-21
26,73,26,87,28,0,28
26,73,26,93,22,33,-11
26,73,26,99,72,97,-25
26,73,26,103,29,0,29
26,73,26,107,213,200,13
26,73,26,111,307,333,-26
26,73,26,117,170,154,16
26,73,26,121,26,31,-5
26,73,26,125,112,179,-67
26,73,26,133,60,32,28
26,73,26,139,0,46,-46
26,73,26,143,24,0,24
26,73,26,145,108,82,26
26,73,26,147,29,23,6
26,73,26,155,41,35,6
26,73,26,157,37,22,15
26,73,26,161,42,63,-21
26,73,26,163,140,127,13
26,73,32,3,0,42,-42
26,75,4,13,45,121,-76
26,75,6,73,0,28,-28
26,75,12,11,0,39,-39
26,75,12,31,0,27,-27
26,75,12,57,33,23,10
26,75,12,71,26,47,-21
26,75,12,103,0,30,-30
26,75,12,105,0,42,-42
26,75,17,31,0,116,-116
26,75,18,3,0,31,-31
26,75,18,97,0,32,-32
26,75,26,21,0,36,-36
26,75,26,23,42,46,-4
26,75,26,25,465,449,16
26,75,26,35,49,0,49
26,75,26,37,40,53,-13
26,75,26,45,190,182,8
26,75,26,49,63,41,22
26,75,26,55,0,26,-26
26,75,26,59,447,446,1
26,75,26,65,663,732,-69
26,75,26,67,0,31,-31
26,75,26,73,36,32,4
26,75,26,77,107,183,-76
26,75,26,81,79,164,-85
26,75,26,91,505,449,56
26,75,26,93,137,124,13
26,75,26,99,54,74,-20
26,75,26,111,26,0,26
26,75,26,115,72,52,20
26,75,26,121,0,28,-28
26,75,26,125,176,196,-20
26,75,26,139,31,59,-28
26,75,26,143,0,31,-31
26,75,26,155,35,0,35
26,75,26,161,641,741,-100
26,75,26,163,540,370,170
26,75,32,3,0,55,-55
26,75,37,183,0,26,-26
26,75,39,49,0,45,-45
26,75,39,95,44,26,18
26,75,47,37,0,30,-30
26,75,47,93,0,28,-28
26,75,48,29,0,28,-28
26,75,48,201,0,43,-43
26,75,53,53,0,28,-28
26,77,4,13,58,245,-187
26,77,4,19,0,30,-30
26,77,6,1,0,30,-30
26,77,6,37,71,110,-39
26,77,6,59,32,47,-15
26,77,6,73,64,83,-19
26,77,6,75,0,23,-23
26,77,6,85,0,34,-34
26,77,8,5,0,36,-36
26,77,8,31,0,31,-31
26,77,9,11,0,109,-109
26,77,11,1,0,28,-28
26,77,12,11,0,31,-31
26,77,12,31,0,33,-33
26,77,12,57,0,44,-44
26,77,12,71,46,64,-18
26,77,12,73,20,0,20
26,77,12,86,0,21,-21
26,77,12,95,0,46,-46
26,77,12,99,0,40,-40
26,77,12,103,0,53,-53
26,77,12,105,31,0,31
26,77,12,115,0,39,-39
26,77,13,67,0,49,-49
26,77,13,89,0,26,-26
26,77,13,121,0,44,-44
26,77,13,135,0,35,-35
26,77,15,3,0,23,-23
26,77,17,31,287,522,-235
26,77,17,43,53,87,-34
26,77,17,89,0,36,-36
26,77,17,97,47,58,-11
26,77,17,197,58,41,17
26,77,18,3,33,50,-17
26,77,18,39,65,43,22
26,77,18,57,0,43,-43
26,77,18,89,35,0,35
26,77,18,97,49,118,-69
26,77,18,141,86,121,-35
26,77,21,67,0,22,-22
26,77,24,31,25,0,25
26,77,25,17,0,24,-24
26,77,26,5,1150,1021,129
26,77,26,15,496,362,134
26,77,26,17,35,36,-1
26,77,26,21,426,315,111
26,77,26,23,114,48,66
26,77,26,25,1125,978,147
26,77,26,27,146,116,30
26,77,26,33,26,0,26
26,77,26,37,53,56,-3
26,77,26,45,107,121,-14
26,77,26,49,143,53,90
26,77,26,55,81,72,9
26,77,26,59,45,32,13
26,77,26,65,323,245,78
26,77,26,67,60,28,32
26,77,26,73,0,34,-34
26,77,26,75,183,107,76
26,77,26,81,772,833,-61
26,77,26,89,24,0,24
26,77,26,91,38,35,3
26,77,26,93,107,60,47
26,77,26,99,201,146,55
26,77,26,101,0,34,-34
26,77,26,103,33,0,33
26,77,26,105,28,0,28
26,77,26,107,45,27,18
26,77,26,111,20,25,-5
26,77,26,115,0,36,-36
26,77,26,117,0,31,-31
26,77,26,121,139,108,31
26,77,26,123,38,0,38
26,77,26,125,490,389,101
26,77,26,139,246,280,-34
26,77,26,145,78,53,25
26,77,26,147,45,32,13
26,77,26,149,583,477,106
26,77,26,159,1855,1601,254
26,77,26,161,286,252,34
26,77,26,163,423,290,133
26,77,27,53,53,63,-10
26,77,29,95,20,0,20
26,77,29,189,27,0,27
26,77,31,55,0,46,-46
26,77,32,3,33,120,-87
26,77,34,17,0,22,-22
26,77,36,47,0,31,-31
26,77,36,61,0,30,-30
26,77,37,21,0,29,-29
26,77,37,63,0,20,-20
26,77,37,119,0,66,-66
26,77,37,183,0,59,-59
26,77,39,35,31,49,-18
26,77,39,49,34,80,-46
26,77,39,95,38,38,0
26,77,41,51,0,39,-39
26,77,42,3,41,35,6
26,77,42,101,0,34,-34
26,77,47,37,0,36,-36
26,77,47,157,0,43,-43
26,77,48,29,0,35,-35
26,77,48,85,0,28,-28
26,77,48,113,0,45,-45
26,77,48,201,0,100,-100
26,77,48,439,0,37,-37
26,77,48,453,0,46,-46
26,77,48,491,0,31,-31
26,77,49,35,0,24,-24
26,77,53,33,0,63,-63
26,77,53,61,0,25,-25
26,77,55,25,0,39,-39
26,77,55,79,0,49,-49
26,79,26,9,196,209,-13
26,79,26,29,0,28,-28
26,79,26,39,0,31,-31
26,79,26,49,35,0,35
26,79,26,55,353,337,16
26,79,26,81,39,33,6
26,79,26,99,31,0,31
26,79,26,125,39,25,14
26,79,26,137,0,29,-29
26,79,26,163,38,0,38
26,79,26,165,29,49,-20
26,81,1,89,0,47,-47
26,81,2,20,0,44,-44
26,81,4,13,200,520,-320
26,81,4,19,38,79,-41
26,81,4,21,0,39,-39
26,81,6,1,0,33,-33
26,81,6,13,0,39,-39
26,81,6,19,0,41,-41
26,81,6,29,39,0,39
26,81,6,37,141,209,-68
26,81,6,47,22,0,22
26,81,6,59,92,105,-13
26,81,6,65,28,77,-49
26,81,6,67,0,43,-43
26,81,6,71,46,34,12
26,81,6,73,115,139,-24
26,81,6,75,0,55,-55
26,81,6,85,31,50,-19
26,81,8,1,0,32,-32
26,81,8,5,26,39,-13
26,81,8,13,0,43,-43
26,81,8,31,29,93,-64
26,81,8,37,0,25,-25
26,81,8,41,52,58,-6
26,81,8,59,0,39,-39
26,81,8,69,0,27,-27
26,81,8,123,0,35,-35
26,81,11,1,0,51,-51
26,81,12,9,38,44,-6
26,81,12,11,64,81,-17
26,81,12,15,30,33,-3
26,81,12,21,55,45,10
26,81,12,31,38,79,-41
26,81,12,33,0,38,-38
26,81,12,55,0,30,-30
26,81,12,57,67,108,-41
26,81,12,69,0,44,-44
26,81,12,71,89,121,-32
26,81,12,81,0,97,-97
26,81,12,86,58,141,-83
26,81,12,87,0,32,-32
26,81,12,95,71,81,-10
26,81,12,97,36,36,0
26,81,12,99,49,61,-12
26,81,12,101,33,77,-44
26,81,12,103,62,67,-5
26,81,12,105,51,72,-21
26,81,12,111,0,33,-33
26,81,12,115,42,71,-29
26,81,12,117,0,29,-29
26,81,13,67,0,70,-70
26,81,13,89,0,49,-49
26,81,13,121,0,86,-86
26,81,13,135,51,103,-52
26,81,15,3,30,43,-13
26,81,15,9,0,28,-28
26,81,16,1,0,36,-36
26,81,17,31,508,884,-376
26,81,17,43,129,163,-34
26,81,17,89,83,34,49
26,81,17,97,41,55,-14
26,81,17,111,31,0,31
26,81,17,197,43,72,-29
26,81,17,201,0,33,-33
26,81,18,3,53,81,-28
26,81,18,39,50,49,1
26,81,18,57,47,87,-40
26,81,18,89,90,71,19
26,81,18,97,90,159,-69
26,81,18,141,74,72,2
26,81,20,91,0,49,-49
26,81,21,67,0,48,-48
26,81,21,111,0,64,-64
26,81,23,5,26,0,26
26,81,24,3,0,52,-52
26,81,24,5,0,22,-22
26,81,24,31,0,54,-54
26,81,24,510,0,24,-24
26,81,25,17,31,51,-20
26,81,25,25,0,27,-27
26,81,26,5,1354,1353,1
26,81,26,7,54,0,54
26,81,26,9,44,48,-4
26,81,26,15,749,927,-178
26,81,26,17,77,75,2
26,81,26,19,23,39,-16
26,81,26,21,303,260,43
26,81,26,23,39,0,39
26,81,26,25,159,132,27
26,81,26,27,44,0,44
26,81,26,29,62,77,-15
26,81,26,31,52,35,17
26,81,26,33,56,48,8
26,81,26,35,38,0,38
26,81,26,37,159,159,0
26,81,26,39,29,0,29
26,81,26,41,39,0,39
26,81,26,45,250,213,37
26,81,26,47,94,77,17
26,81,26,49,284,162,122
26,81,26,51,27,0,27
26,81,26,55,289,229,60
26,81,26,57,94,57,37
26,81,26,59,36,0,36
26,81,26,61,34,37,-3
26,81,26,65,646,556,90
26,81,26,67,1079,989,90
26,81,26,69,0,27,-27
26,81,26,73,167,146,21
26,81,26,75,164,79,85
26,81,26,77,833,772,61
26,81,26,79,33,39,-6
26,81,26,85,49,95,-46
26,81,26,87,33,0,33
26,81,26,89,63,63,0
26,81,26,91,95,23,72
26,81,26,93,147,118,29
26,81,26,97,37,29,8
26,81,26,99,305,200,105
26,81,26,101,76,93,-17
26,81,26,103,47,69,-22
26,81,26,105,140,122,18
26,81,26,107,368,371,-3
26,81,26,111,100,69,31
26,81,26,113,55,63,-8
26,81,26,115,40,0,40
26,81,26,117,1227,1448,-221
26,81,26,121,979,867,112
26,81,26,123,889,961,-72
26,81,26,125,662,624,38
26,81,26,127,84,136,-52
26,81,26,133,102,123,-21
26,81,26,137,77,40,37
26,81,26,139,4824,5654,-830
26,81,26,143,38,28,10
26,81,26,145,323,202,121
26,81,26,147,107,61,46
26,81,26,149,49,42,7
26,81,26,151,25,0,25
26,81,26,155,59,44,15
26,81,26,157,42,42,0
26,81,26,159,162,103,59
26,81,26,161,269,327,-58
26,81,26,163,626,494,132
26,81,26,165,107,92,15
26,81,27,53,42,108,-66
26,81,27,123,33,26,7
26,81,29,95,0,37,-37
26,81,29,189,43,58,-15
26,81,32,3,96,224,-128
26,81,32,31,0,28,-28
26,81,35,1,0,41,-41
26,81,36,5,63,58,5
26,81,36,29,36,0,36
26,81,36,47,30,57,-27
26,81,36,55,0,25,-25
26,81,36,61,52,109,-57
26,81,36,81,0,25,-25
26,81,36,103,36,0,36
26,81,37,51,0,35,-35
26,81,37,63,0,35,-35
26,81,37,67,0,32,-32
26,81,37,81,0,45,-45
26,81,37,119,40,134,-94
26,81,37,133,0,23,-23
26,81,37,183,0,111,-111
26,81,39,35,56,69,-13
26,81,39,49,40,160,-120
26,81,39,57,0,33,-33
26,81,39,61,55,41,14
26,81,39,95,79,51,28
26,81,39,113,39,41,-2
26,81,39,153,41,40,1
26,81,39,173,0,31,-31
26,81,40,143,0,30,-30
26,81,41,51,29,93,-64
26,81,41,67,0,48,-48
26,81,42,3,48,40,8
26,81,42,91,0,36,-36
26,81,42,101,0,51,-51
26,81,45,15,0,24,-24
26,81,45,19,0,38,-38
26,81,45,45,0,53,-53
26,81,45,83,0,39,-39
26,81,47,37,61,88,-27
26,81,47,65,0,33,-33
26,81,47,93,0,57,-57
26,81,47,157,36,59,-23
26,81,48,27,0,50,-50
26,81,48,29,0,96,-96
26,81,48,61,0,36,-36
26,81,48,85,0,39,-39
26,81,48,113,50,142,-92
26,81,48,121,36,50,-14
26,81,48,141,0,43,-43
26,81,48,201,36,157,-121
26,81,48,215,47,63,-16
26,81,48,339,0,35,-35
26,81,48,439,35,89,-54
26,81,48,453,0,99,-99
26,81,49,35,37,48,-11
26,81,51,13,0,35,-35
26,81,51,59,38,26,12
26,81,51,510,0,22,-22
26,81,51,810,31,39,-8
26,81,53,33,58,128,-70
26,81,53,53,0,38,-38
26,81,55,25,46,67,-21
26,81,55,79,40,97,-57
26,81,55,133,0,39,-39
26,83,26,61,84,78,6
26,85,26,81,95,49,46
26,85,26,101,59,53,6
26,85,26,105,47,63,-16
26,85,26,107,72,67,5
26,85,26,123,55,0,55
26,85,26,133,98,127,-29
26,85,26,139,50,31,19
26,85,26,163,56,0,56
26,85,26,165,37,51,-14
26,87,4,13,0,61,-61
26,87,12,71,0,50,-50
26,87,17,31,0,29,-29
26,87,26,49,1137,1168,-31
26,87,26,63,35,0,35
26,87,26,65,0,40,-40
26,87,26,69,0,28,-28
26,87,26,73,0,28,-28
26,87,26,81,0,33,-33
26,87,26,93,0,36,-36
26,87,26,99,772,601,171
26,87,26,125,920,953,-33
26,87,26,145,46,45,1
26,87,26,147,277,276,1
26,87,26,151,243,288,-45
26,87,26,157,228,347,-119
26,87,26,161,33,23,10
26,87,26,163,147,88,59
26,87,32,3,0,35,-35
26,89,17,31,0,34,-34
26,89,26,19,80,60,20
26,89,26,55,461,611,-150
26,89,26,65,0,26,-26
26,89,26,77,0,24,-24
26,89,26,81,63,63,0
26,89,26,99,40,0,40
26,89,26,125,75,39,36
26,89,26,161,0,31,-31
26,89,26,163,31,0,31
26,89,26,165,29,0,29
26,91,4,13,48,101,-53
26,91,12,71,0,45,-45
26,91,17,31,31,31,0
26,91,18,3,0,31,-31
26,91,26,25,0,41,-41
26,91,26,49,35,26,9
26,91,26,59,371,311,60
26,91,26,65,68,90,-22
26,91,26,75,449,505,-56
26,91,26,77,35,38,-3
26,91,26,81,23,95,-72
26,91,26,93,42,56,-14
26,91,26,99,52,50,2
26,91,26,115,347,367,-20
26,91,26,125,114,96,18
26,91,26,139,0,28,-28
26,91,26,145,26,0,26
26,91,26,161,614,611,3
26,91,26,163,355,319,36
26,91,32,3,0,56,-56
26,91,39,49,0,31,-31
26,91,39,51,106,164,-58
26,91,39,95,253,273,-20
26,91,39,173,39,54,-15
26,93,4,13,43,184,-141
26,93,6,37,31,46,-15
26,93,6,59,0,46,-46
26,93,6,73,0,30,-30
26,93,9,11,0,130,-130
26,93,12,57,26,54,-28
26,93,12,69,0,34,-34
26,93,12,71,0,83,-83
26,93,12,95,0,53,-53
26,93,12,99,0,23,-23
26,93,12,101,31,0,31
26,93,12,103,0,22,-22
26,93,12,105,0,28,-28
26,93,12,111,0,26,-26
26,93,12,115,0,37,-37
26,93,13,135,0,35,-35
26,93,17,31,48,156,-108
26,93,17,43,0,28,-28
26,93,18,97,0,39,-39
26,93,26,25,35,39,-4
26,93,26,35,0,44,-44
26,93,26,37,46,59,-13
26,93,26,45,95,79,16
26,93,26,49,830,737,93
26,93,26,55,33,0,33
26,93,26,61,26,25,1
26,93,26,65,633,568,65
26,93,26,73,33,22,11
26,93,26,75,124,137,-13
26,93,26,77,60,107,-47
26,93,26,81,118,147,-29
26,93,26,87,36,0,36
26,93,26,91,56,42,14
26,93,26,99,313,187,126
26,93,26,103,0,38,-38
26,93,26,115,73,79,-6
26,93,26,125,2458,1867,591
26,93,26,139,40,62,-22
26,93,26,143,24,28,-4
26,93,26,145,52,44,8
26,93,26,147,30,0,30
26,93,26,155,244,222,22
26,93,26,161,1188,1002,186
26,93,26,163,2017,1022,995
26,93,27,53,22,0,22
26,93,29,183,0,54,-54
26,93,29,189,0,50,-50
26,93,32,3,32,75,-43
26,93,36,61,0,27,-27
26,93,37,119,0,35,-35
26,93,39,35,0,37,-37
26,93,39,49,0,30,-30
26,93,39,95,30,0,30
26,93,45,45,0,28,-28
26,93,47,37,0,33,-33
26,93,48,113,0,23,-23
26,93,48,201,0,40,-40
26,93,48,453,0,35,-35
26,93,51,59,0,27,-27
26,93,53,33,0,39,-39
26,93,55,25,0,39,-39
26,95,26,33,33,0,33
26,95,26,97,45,0,45
26,95,26,103,0,59,-59
26,97,12,86,0,46,-46
26,97,24,33,0,52,-52
26,97,26,31,0,49,-49
26,97,26,33,109,153,-44
26,97,26,65,33,26,7
26,97,26,81,29,37,-8
26,97,26,95,0,45,-45
26,97,48,479,0,52,-52
26,99,1,73,0,47,-47
26,99,1,89,0,56,-56
26,99,1,97,0,24,-24
26,99,4,13,196,925,-729
26,99,4,15,58,28,30
26,99,4,19,32,146,-114
26,99,4,21,0,103,-103
26,99,6,1,0,51,-51
26,99,6,13,0,38,-38
26,99,6,37,97,274,-177
26,99,6,59,78,140,-62
26,99,6,65,0,118,-118
26,99,6,67,0,29,-29
26,99,6,71,40,40,0
26,99,6,73,134,295,-161
26,99,6,75,0,24,-24
26,99,6,85,0,56,-56
26,99,6,111,0,44,-44
26,99,8,5,0,27,-27
26,99,8,31,0,56,-56
26,99,8,35,0,27,-27
26,99,8,41,0,49,-49
26,99,9,3,0,34,-34
26,99,11,1,0,26,-26
26,99,12,9,31,74,-43
26,99,12,11,59,183,-124
26,99,12,15,0,46,-46
26,99,12,17,0,25,-25
26,99,12,19,0,55,-55
26,99,12,21,32,107,-75
26,99,12,31,43,106,-63
26,99,12,53,0,37,-37
26,99,12,57,59,147,-88
26,99,12,69,40,52,-12
26,99,12,71,100,269,-169
26,99,12,81,26,57,-31
26,99,12,83,31,43,-12
26,99,12,85,0,27,-27
26,99,12,86,40,91,-51
26,99,12,95,81,148,-67
26,99,12,97,0,35,-35
26,99,12,99,55,146,-91
26,99,12,101,48,101,-53
26,99,12,103,88,212,-124
26,99,12,105,0,101,-101
26,99,12,111,30,0,30
26,99,12,115,62,89,-27
26,99,12,117,35,51,-16
26,99,12,119,0,34,-34
26,99,12,127,0,40,-40
26,99,13,51,0,25,-25
26,99,13,67,33,104,-71
26,99,13,89,0,56,-56
26,99,13,97,0,31,-31
26,99,13,121,0,95,-95
26,99,13,135,38,71,-33
26,99,15,3,32,66,-34
26,99,17,31,196,605,-409
26,99,17,43,71,137,-66
26,99,17,143,0,30,-30
26,99,17,201,0,33,-33
26,99,18,3,30,55,-25
26,99,18,57,0,43,-43
26,99,18,89,0,63,-63
26,99,18,97,45,87,-42
26,99,18,141,0,33,-33
26,99,20,91,0,44,-44
26,99,20,173,0,32,-32
26,99,21,67,0,34,-34
26,99,21,111,0,41,-41
26,99,22,51,0,33,-33
26,99,24,5,0,32,-32
26,99,24,31,0,44,-44
26,99,25,17,0,49,-49
26,99,25,25,0,29,-29
26,99,26,1,0,41,-41
26,99,26,5,0,33,-33
26,99,26,7,32,41,-9
26,99,26,9,0,32,-32
26,99,26,11,25,39,-14
26,99,26,17,51,61,-10
26,99,26,19,0,25,-25
26,99,26,21,20,55,-35
26,99,26,25,55,63,-8
26,99,26,31,49,63,-14
26,99,26,33,41,34,7
26,99,26,35,44,94,-50
26,99,26,37,45,39,6
26,99,26,39,0,55,-55
26,99,26,45,49,65,-16
26,99,26,47,0,54,-54
26,99,26,49,461,478,-17
26,99,26,51,25,106,-81
26,99,26,55,64,99,-35
26,99,26,63,114,114,0
26,99,26,65,210,249,-39
26,99,26,67,32,0,32
26,99,26,69,61,105,-44
26,99,26,73,97,72,25
26,99,26,75,74,54,20
26,99,26,77,146,201,-55
26,99,26,79,0,31,-31
26,99,26,81,200,305,-105
26,99,26,87,601,772,-171
26,99,26,89,0,40,-40
26,99,26,91,50,52,-2
26,99,26,93,187,313,-126
26,99,26,103,29,32,-3
26,99,26,107,35,37,-2
26,99,26,111,40,56,-16
26,99,26,115,111,113,-2
26,99,26,119,0,52,-52
26,99,26,121,25,39,-14
26,99,26,125,11138,12559,-1421
26,99,26,129,31,59,-28
26,99,26,135,0,60,-60
26,99,26,137,52,69,-17
26,99,26,139,49,120,-71
26,99,26,141,23,48,-25
26,99,26,143,78,126,-48
26,99,26,145,166,127,39
26,99,26,147,2906,2714,192
26,99,26,151,238,237,1
26,99,26,155,53,0,53
26,99,26,157,80,101,-21
26,99,26,161,331,476,-145
26,99,26,163,17444,8250,9194
26,99,26,165,22,25,-3
26,99,27,53,0,73,-73
26,99,29,95,0,31,-31
26,99,29,189,0,89,-89
26,99,32,3,171,608,-437
26,99,34,17,0,24,-24
26,99,35,1,0,33,-33
26,99,36,5,38,0,38
26,99,36,29,31,30,1
26,99,36,45,0,31,-31
26,99,36,47,46,42,4
26,99,36,55,0,30,-30
26,99,36,61,45,74,-29
26,99,36,81,38,80,-42
26,99,37,21,0,31,-31
26,99,37,51,26,77,-51
26,99,37,81,0,26,-26
26,99,37,119,33,121,-88
26,99,37,133,63,70,-7
26,99,37,183,0,129,-129
26,99,39,17,0,64,-64
26,99,39,35,110,103,7
26,99,39,49,53,115,-62
26,99,39,61,0,40,-40
26,99,39,63,0,55,-55
26,99,39,93,33,30,3
26,99,39,95,77,110,-33
26,99,39,113,33,39,-6
26,99,39,153,0,57,-57
26,99,40,143,0,66,-66
26,99,41,51,0,22,-22
26,99,42,3,31,42,-11
26,99,42,101,33,29,4
26,99,45,13,0,31,-31
26,99,45,15,0,34,-34
26,99,45,19,26,0,26
26,99,45,45,0,73,-73
26,99,45,51,0,37,-37
26,99,45,79,0,33,-33
26,99,45,91,0,37,-37
26,99,47,37,0,100,-100
26,99,47,65,0,39,-39
26,99,47,93,0,49,-49
26,99,47,149,0,62,-62
26,99,47,155,0,31,-31
26,99,47,157,46,84,-38
26,99,47,187,0,66,-66
26,99,48,27,0,66,-66
26,99,48,29,0,95,-95
26,99,48,85,0,91,-91
26,99,48,113,30,124,-94
26,99,48,121,0,54,-54
26,99,48,141,0,44,-44
26,99,48,157,0,75,-75
26,99,48,201,70,175,-105
26,99,48,215,0,66,-66
26,99,48,245,0,40,-40
26,99,48,439,51,159,-108
26,99,48,453,0,49,-49
26,99,48,491,0,54,-54
26,99,51,13,0,40,-40
26,99,51,59,58,115,-57
26,99,51,107,0,32,-32
26,99,51,153,0,37,-37
26,99,51,810,40,50,-10
26,99,53,33,0,116,-116
26,99,53,53,0,51,-51
26,99,53,61,0,72,-72
26,99,55,25,25,23,2
26,99,55,79,0,66,-66
26,101,17,31,0,23,-23
26,101,26,19,109,127,-18
26,101,26,49,25,30,-5
26,101,26,55,63,138,-75
26,101,26,77,34,0,34
26,101,26,81,93,76,17
26,101,26,85,53,59,-6
26,101,26,105,118,146,-28
26,101,26,121,66,48,18
26,101,26,125,29,0,29
26,101,26,139,31,0,31
26,101,26,163,49,0,49
26,101,26,165,64,55,9
26,103,4,13,0,59,-59
26,103,4,19,0,23,-23
26,103,6,73,0,32,-32
26,103,17,31,27,65,-38
26,103,26,3,155,113,42
26,103,26,13,82,42,40
26,103,26,33,53,28,25
26,103,26,41,170,132,38
26,103,26,43,98,85,13
26,103,26,47,29,0,29
26,103,26,53,0,25,-25
26,103,26,55,32,42,-10
26,103,26,61,127,103,24
26,103,26,65,38,52,-14
26,103,26,71,57,0,57
26,103,26,73,0,29,-29
26,103,26,77,0,33,-33
26,103,26,81,69,47,22
26,103,26,93,38,0,38
26,103,26,95,59,0,59
26,103,26,99,32,29,3
26,103,26,109,60,30,30
26,103,26,125,68,70,-2
26,103,26,131,25,0,25
26,103,26,139,32,33,-1
26,103,26,153,43,0,43
26,103,26,161,44,37,7
26,103,26,163,69,39,30
26,103,27,53,0,65,-65
26,103,41,51,0,20,-20
26,103,53,33,0,26,-26
26,103,55,9,68,84,-16
26,103,55,25,0,42,-42
26,103,55,79,44,0,44
26,103,55,87,0,68,-68
26,103,55,139,0,29,-29
26,105,17,31,38,35,3
26,105,26,55,0,39,-39
26,105,26,65,0,30,-30
26,105,26,77,0,28,-28
26,105,26,81,122,140,-18
26,105,26,85,63,47,16
26,105,26,101,146,118,28
26,105,26,121,90,74,16
26,105,26,125,57,0,57
26,105,26,127,185,88,97
26,105,26,139,67,80,-13
26,105,26,163,31,0,31
26,105,26,165,27,0,27
26,107,17,31,0,31,-31
26,107,26,17,25,0,25
26,107,26,35,34,0,34
26,107,26,45,0,32,-32
26,107,26,49,36,31,5
26,107,26,55,26,42,-16
26,107,26,65,60,62,-2
26,107,26,67,45,26,19
26,107,26,73,200,213,-13
26,107,26,77,27,45,-18
26,107,26,81,371,368,3
26,107,26,85,67,72,-5
26,107,26,99,37,35,2
26,107,26,111,25,29,-4
26,107,26,117,228,227,1
26,107,26,121,35,58,-23
26,107,26,123,152,205,-53
26,107,26,125,102,69,33
26,107,26,133,329,292,37
26,107,26,139,85,59,26
26,107,26,145,29,0,29
26,107,26,161,20,31,-11
26,107,26,163,92,92,0
26,107,26,165,0,28,-28
26,109,26,41,187,128,59
26,109,26,43,68,63,5
26,109,26,103,30,60,-30
26,109,55,9,47,93,-46
26,109,55,75,453,393,60
26,109,55,79,32,0,32
26,109,55,83,0,30,-30
26,109,55,87,0,54,-54
26,111,4,13,0,56,-56
26,111,6,73,0,53,-53
26,111,17,31,53,73,-20
26,111,26,11,54,0,54
26,111,26,17,567,677,-110
26,111,26,35,145,148,-3
26,111,26,49,113,79,34
26,111,26,51,311,221,90
26,111,26,55,31,54,-23
26,111,26,57,144,115,29
26,111,26,65,83,86,-3
26,111,26,73,333,307,26
26,111,26,75,0,26,-26
26,111,26,77,25,20,5
26,111,26,81,69,100,-31
26,111,26,99,56,40,16
26,111,26,107,29,25,4
26,111,26,125,162,125,37
26,111,26,129,37,0,37
26,111,26,139,34,54,-20
26,111,26,143,40,37,3
26,111,26,145,614,543,71
26,111,26,157,40,28,12
26,111,26,161,79,40,39
26,111,26,163,131,68,63
26,111,39,89,0,26,-26
26,111,48,39,57,0,57
26,111,48,201,0,39,-39
26,113,26,49,32,0,32
26,113,26,55,39,40,-1
26,113,26,81,63,55,8
26,113,26,133,71,97,-26
26,113,26,143,81,48,33
26,113,26,163,52,0,52
26,113,26,165,288,363,-75
26,115,4,13,35,85,-50
26,115,6,37,0,26,-26
26,115,6,73,0,39,-39
26,115,12,71,0,65,-65
26,115,12,101,0,26,-26
26,115,17,31,0,61,-61
26,115,26,49,49,36,13
26,115,26,59,41,55,-14
26,115,26,65,41,42,-1
26,115,26,75,52,72,-20
26,115,26,77,36,0,36
26,115,26,81,0,40,-40
26,115,26,91,367,347,20
26,115,26,93,79,73,6
26,115,26,99,113,111,2
26,115,26,125,190,247,-57
26,115,26,145,26,0,26
26,115,26,147,46,0,46
26,115,26,161,519,571,-52
26,115,26,163,2559,2061,498
26,115,32,3,27,67,-40
26,115,37,119,0,43,-43
26,115,39,35,0,26,-26
26,115,39,49,33,46,-13
26,115,39,95,1855,1803,52
26,115,39,173,141,110,31
26,117,26,15,0,28,-28
26,117,26,35,30,0,30
26,117,26,37,84,49,35
26,117,26,45,49,32,17
26,117,26,57,263,258,5
26,117,26,65,44,82,-38
26,117,26,67,683,558,125
26,117,26,73,154,170,-16
26,117,26,77,31,0,31
26,117,26,81,1448,1227,221
26,117,26,107,227,228,-1
26,117,26,121,30,70,-40
26,117,26,123,211,168,43
26,117,26,125,47,29,18
26,117,26,139,94,96,-2
26,117,26,145,0,37,-37
26,117,26,161,27,0,27
26,117,26,163,50,0,50
26,119,26,7,50,72,-22
26,119,26,49,28,0,28
26,119,26,99,52,0,52
26,119,26,125,71,41,30
26,119,26,135,35,0,35
26,119,26,137,59,91,-32
26,119,26,163,54,30,24
26,121,4,13,36,102,-66
26,121,6,37,35,27,8
26,121,6,73,0,32,-32
26,121,12,71,0,26,-26
26,121,12,103,0,21,-21
26,121,12,105,0,23,-23
26,121,17,31,105,121,-16
26,121,18,141,0,29,-29
26,121,26,5,110,99,11
26,121,26,21,0,44,-44
26,121,26,45,29,23,6
26,121,26,49,85,25,60
26,121,26,55,35,63,-28
26,121,26,65,81,91,-10
26,121,26,67,47,0,47
26,121,26,73,31,26,5
26,121,26,75,28,0,28
26,121,26,77,108,139,-31
26,121,26,81,867,979,-112
26,121,26,99,39,25,14
26,121,26,101,48,66,-18
26,121,26,105,74,90,-16
26,121,26,107,58,35,23
26,121,26,117,70,30,40
26,121,26,123,536,429,107
26,121,26,125,95,98,-3
26,121,26,127,512,446,66
26,121,26,139,1855,1676,179
26,121,26,145,0,33,-33
26,121,26,161,79,35,44
26,121,26,163,83,88,-5
26,121,32,3,0,32,-32
26,121,39,49,0,35,-35
26,121,45,45,0,26,-26
26,121,48,215,0,35,-35
26,121,53,33,0,31,-31
26,121,55,79,0,37,-37
26,123,26,5,0,32,-32
26,123,26,77,0,38,-38
26,123,26,81,961,889,72
26,123,26,85,0,55,-55
26,123,26,107,205,152,53
26,123,26,117,168,211,-43
26,123,26,121,429,536,-107
26,123,26,127,181,171,10
26,123,26,133,0,43,-43
26,123,26,139,185,165,20
26,125,1,3,0,32,-32
26,125,1,73,0,71,-71
26,125,1,89,48,114,-66
26,125,1,97,0,48,-48
26,125,1,101,41,61,-20
26,125,2,20,0,44,-44
26,125,4,3,0,33,-33
26,125,4,5,0,23,-23
26,125,4,13,422,1583,-1161
26,125,4,15,0,47,-47
26,125,4,19,68,219,-151
26,125,4,21,0,133,-133
26,125,4,25,0,60,-60
26,125,4,27,0,25,-25
26,125,5,119,0,53,-53
26,125,6,1,94,202,-108
26,125,6,13,0,89,-89
26,125,6,17,0,36,-36
26,125,6,19,0,54,-54
26,125,6,37,409,811,-402
26,125,6,53,0,43,-43
26,125,6,59,222,405,-183
26,125,6,65,56,141,-85
26,125,6,67,60,103,-43
26,125,6,71,52,75,-23
26,125,6,73,278,499,-221
26,125,6,75,57,162,-105
26,125,6,81,34,75,-41
26,125,6,85,103,267,-164
26,125,6,111,37,90,-53
26,125,8,1,0,45,-45
26,125,8,5,62,62,0
26,125,8,13,41,62,-21
26,125,8,31,72,187,-115
26,125,8,35,35,110,-75
26,125,8,37,0,35,-35
26,125,8,41,50,129,-79
26,125,8,59,30,82,-52
26,125,8,69,0,38,-38
26,125,9,1,57,127,-70
26,125,9,3,61,117,-56
26,125,9,9,42,58,-16
26,125,9,11,0,68,-68
26,125,10,3,65,68,-3
26,125,11,1,49,170,-121
26,125,12,1,0,34,-34
26,125,12,5,0,50,-50
26,125,12,9,43,79,-36
26,125,12,11,159,376,-217
26,125,12,15,48,65,-17
26,125,12,17,0,46,-46
26,125,12,21,66,215,-149
26,125,12,31,68,199,-131
26,125,12,33,0,36,-36
26,125,12,35,0,39,-39
26,125,12,53,34,40,-6
26,125,12,57,120,230,-110
26,125,12,61,0,30,-30
26,125,12,69,30,86,-56
26,125,12,71,128,329,-201
26,125,12,73,0,47,-47
26,125,12,81,52,123,-71
26,125,12,83,32,76,-44
26,125,12,86,95,203,-108
26,125,12,87,0,32,-32
26,125,12,91,0,42,-42
26,125,12,95,133,252,-119
26,125,12,97,0,56,-56
26,125,12,99,163,365,-202
26,125,12,101,111,130,-19
26,125,12,103,152,260,-108
26,125,12,105,56,174,-118
26,125,12,109,27,72,-45
26,125,12,111,33,64,-31
26,125,12,115,90,185,-95
26,125,12,117,60,120,-60
26,125,12,119,0,64,-64
26,125,12,127,56,82,-26
26,125,13,51,37,39,-2
26,125,13,57,0,35,-35
26,125,13,63,0,42,-42
26,125,13,67,77,223,-146
26,125,13,89,52,199,-147
26,125,13,97,0,50,-50
26,125,13,117,0,48,-48
26,125,13,121,95,394,-299
26,125,13,135,83,187,-104
26,125,13,151,0,35,-35
26,125,13,245,0,31,-31
26,125,15,3,100,99,1
26,125,17,19,32,39,-7
26,125,17,31,939,2228,-1289
26,125,17,43,199,339,-140
26,125,17,89,69,89,-20
26,125,17,97,92,219,-127
26,125,17,111,0,66,-66
26,125,17,113,42,103,-61
26,125,17,143,61,40,21
26,125,17,197,125,136,-11
26,125,17,201,0,59,-59
26,125,18,3,96,88,8
26,125,18,5,39,40,-1
26,125,18,57,114,127,-13
26,125,18,81,0,32,-32
26,125,18,89,40,41,-1
26,125,18,97,116,229,-113
26,125,18,105,42,36,6
26,125,18,127,0,34,-34
26,125,18,141,33,104,-71
26,125,18,157,35,27,8
26,125,19,153,0,35,-35
26,125,19,163,0,60,-60
26,125,20,91,73,115,-42
26,125,20,173,0,49,-49
26,125,21,15,0,57,-57
26,125,21,67,38,101,-63
26,125,21,93,0,44,-44
26,125,21,111,49,117,-68
26,125,21,117,0,62,-62
26,125,22,17,0,37,-37
26,125,22,33,32,38,-6
26,125,22,51,0,28,-28
26,125,22,71,0,47,-47
26,125,22,103,0,26,-26
26,125,24,3,32,39,-7
26,125,24,5,78,86,-8
26,125,24,27,26,95,-69
26,125,24,31,77,200,-123
26,125,24,33,27,62,-35
26,125,24,510,0,94,-94
26,125,25,17,84,223,-139
26,125,25,21,54,75,-21
26,125,25,25,55,108,-53
26,125,25,27,33,42,-9
26,125,26,1,28,58,-30
26,125,26,5,85,83,2
26,125,26,7,67,72,-5
26,125,26,9,52,85,-33
26,125,26,11,61,37,24
26,125,26,17,150,122,28
26,125,26,19,30,49,-19
26,125,26,21,80,168,-88
26,125,26,25,90,114,-24
26,125,26,29,42,68,-26
26,125,26,31,82,66,16
26,125,26,33,36,46,-10
26,125,26,35,76,82,-6
26,125,26,37,123,81,42
26,125,26,39,26,74,-48
26,125,26,45,152,129,23
26,125,26,47,98,108,-10
26,125,26,49,2633,2956,-323
26,125,26,51,91,112,-21
26,125,26,55,155,191,-36
26,125,26,57,32,31,1
26,125,26,59,67,29,38
26,125,26,61,51,37,14
26,125,26,63,106,141,-35
26,125,26,65,952,703,249
26,125,26,67,49,28,21
26,125,26,69,76,110,-34
26,125,26,73,179,112,67
26,125,26,75,196,176,20
26,125,26,77,389,490,-101
26,125,26,79,25,39,-14
26,125,26,81,624,662,-38
26,125,26,87,953,920,33
26,125,26,89,39,75,-36
26,125,26,91,96,114,-18
26,125,26,93,1867,2458,-591
26,125,26,99,12559,11138,1421
26,125,26,101,0,29,-29
26,125,26,103,70,68,2
26,125,26,105,0,57,-57
26,125,26,107,69,102,-33
26,125,26,111,125,162,-37
26,125,26,115,247,190,57
26,125,26,117,29,47,-18
26,125,26,119,41,71,-30
26,125,26,121,98,95,3
26,125,26,127,25,0,25
26,125,26,129,71,57,14
26,125,26,133,0,35,-35
26,125,26,135,0,46,-46
26,125,26,137,73,73,0
26,125,26,139,167,190,-23
26,125,26,141,35,47,-12
26,125,26,143,87,155,-68
26,125,26,145,364,263,101
26,125,26,147,567,403,164
26,125,26,149,32,0,32
26,125,26,151,127,104,23
26,125,26,155,163,155,8
26,125,26,157,137,117,20
26,125,26,159,34,32,2
26,125,26,161,1879,2126,-247
26,125,26,163,27079,17275,9804
26,125,26,165,63,80,-17
26,125,27,37,29,44,-15
26,125,27,53,138,270,-132
26,125,27,123,46,53,-7
26,125,29,47,0,39,-39
26,125,29,95,47,83,-36
26,125,29,165,0,36,-36
26,125,29,183,32,51,-19
26,125,29,189,150,235,-85
26,125,29,510,0,36,-36
26,125,31,55,33,59,-26
26,125,32,3,206,822,-616
26,125,34,3,45,68,-23
26,125,34,5,0,57,-57
26,125,34,7,0,28,-28
26,125,34,13,0,32,-32
26,125,34,17,0,88,-88
26,125,34,23,74,110,-36
26,125,34,27,0,87,-87
26,125,34,35,0,24,-24
26,125,35,1,0,75,-75
26,125,35,43,0,37,-37
26,125,35,49,0,27,-27
26,125,36,1,0,52,-52
26,125,36,5,32,32,0
26,125,36,29,92,80,12
26,125,36,47,92,190,-98
26,125,36,55,90,79,11
26,125,36,59,40,38,2
26,125,36,61,178,498,-320
26,125,36,81,65,126,-61
26,125,36,103,33,31,2
26,125,36,119,42,58,-16
26,125,37,21,32,36,-4
26,125,37,25,0,32,-32
26,125,37,51,28,69,-41
26,125,37,63,0,69,-69
26,125,37,67,0,63,-63
26,125,37,81,46,76,-30
26,125,37,97,0,90,-90
26,125,37,119,125,412,-287
26,125,37,125,0,28,-28
26,125,37,129,0,47,-47
26,125,37,133,64,97,-33
26,125,37,135,0,46,-46
26,125,37,147,0,38,-38
26,125,37,183,74,367,-293
26,125,39,3,0,26,-26
26,125,39,17,23,97,-74
26,125,39,35,293,359,-66
26,125,39,41,34,78,-44
26,125,39,49,263,322,-59
26,125,39,57,32,0,32
26,125,39,61,121,155,-34
26,125,39,63,34,30,4
26,125,39,85,0,26,-26
26,125,39,93,0,60,-60
26,125,39,95,177,275,-98
26,125,39,103,32,27,5
26,125,39,113,115,121,-6
26,125,39,133,0,33,-33
26,125,39,151,0,35,-35
26,125,39,153,111,87,24
26,125,39,159,0,55,-55
26,125,39,165,0,92,-92
26,125,39,173,57,67,-10
26,125,40,109,0,47,-47
26,125,40,143,0,69,-69
26,125,41,51,48,107,-59
26,125,41,67,35,55,-20
26,125,42,3,142,172,-30
26,125,42,17,0,49,-49
26,125,42,29,0,65,-65
26,125,42,43,0,35,-35
26,125,42,45,0,21,-21
26,125,42,49,29,47,-18
26,125,42,91,64,89,-25
26,125,42,101,57,97,-40
26,125,44,7,0,41,-41
26,125,45,7,0,31,-31
26,125,45,13,0,94,-94
26,125,45,15,0,45,-45
26,125,45,19,37,90,-53
26,125,45,35,0,52,-52
26,125,45,45,63,199,-136
26,125,45,51,0,68,-68
26,125,45,63,0,38,-38
26,125,45,79,45,47,-2
26,125,45,83,0,42,-42
26,125,45,91,0,72,-72
26,125,47,37,77,235,-158
26,125,47,65,0,59,-59
26,125,47,93,37,115,-78
26,125,47,113,0,31,-31
26,125,47,119,33,27,6
26,125,47,125,0,73,-73
26,125,47,149,0,62,-62
26,125,47,157,102,139,-37
26,125,47,165,0,60,-60
26,125,47,187,0,73,-73
26,125,48,27,38,35,3
26,125,48,29,65,137,-72
26,125,48,39,0,32,-32
26,125,48,85,72,298,-226
26,125,48,113,109,328,-219
26,125,48,121,66,158,-92
26,125,48,141,66,59,7
26,125,48,157,0,98,-98
26,125,48,201,132,601,-469
26,125,48,215,39,52,-13
26,125,48,339,0,113,-113
26,125,48,439,110,359,-249
26,125,48,453,46,191,-145
26,125,48,491,0,89,-89
26,125,49,35,62,83,-21
26,125,51,3,0,49,-49
26,125,51,13,28,114,-86
26,125,51,41,0,54,-54
26,125,51,59,116,243,-127
26,125,51,87,0,66,-66
26,125,51,107,0,74,-74
26,125,51,153,37,52,-15
26,125,51,510,27,58,-31
26,125,51,550,52,0,52
26,125,51,710,44,31,13
26,125,51,810,82,56,26
26,125,53,11,0,53,-53
26,125,53,33,118,401,-283
26,125,53,53,48,56,-8
26,125,53,61,44,152,-108
26,125,55,9,33,0,33
26,125,55,25,85,139,-54
26,125,55,79,67,148,-81
26,125,55,117,0,45,-45
26,125,55,133,59,61,-2
26,127,26,81,136,84,52
26,127,26,105,88,185,-97
26,127,26,121,446,512,-66
26,127,26,123,171,181,-10
26,127,26,125,0,25,-25
26,127,26,139,97,81,16
26,127,48,215,43,72,-29
26,129,26,11,89,125,-36
26,129,26,17,49,66,-17
26,129,26,49,130,57,73
26,129,26,51,79,34,45
26,129,26,65,0,32,-32
26,129,26,69,92,131,-39
26,129,26,99,59,31,28
26,129,26,111,0,37,-37
26,129,26,125,57,71,-14
26,129,26,135,49,0,49
26,129,26,143,85,58,27
26,129,26,145,39,65,-26
26,129,26,157,37,0,37
26,129,26,163,106,35,71
26,131,26,53,26,67,-41
26,131,26,61,41,58,-17
26,131,26,103,0,25,-25
26,133,26,35,48,63,-15
26,133,26,49,47,0,47
26,133,26,55,42,30,12
26,133,26,65,0,26,-26
26,133,26,73,32,60,-28
26,133,26,81,123,102,21
26,133,26,85,127,98,29
26,133,26,107,292,329,-37
26,133,26,113,97,71,26
26,133,26,123,43,0,43
26,133,26,125,35,0,35
26,133,26,139,0,25,-25
26,133,26,163,51,0,51
26,133,26,165,254,298,-44
26,135,26,39,37,0,37
26,135,26,49,27,0,27
26,135,26,99,60,0,60
26,135,26,119,0,35,-35
26,135,26,125,46,0,46
26,135,26,129,0,49,-49
26,135,26,163,30,0,30
26,137,26,7,40,0,40
26,137,26,9,86,91,-5
26,137,26,29,63,61,2
26,137,26,31,68,63,5
26,137,26,39,98,99,-1
26,137,26,47,44,57,-13
26,137,26,49,29,28,1
26,137,26,55,32,80,-48
26,137,26,65,0,36,-36
26,137,26,79,29,0,29
26,137,26,81,40,77,-37
26,137,26,99,69,52,17
26,137,26,119,91,59,32
26,137,26,125,73,73,0
26,137,26,143,46,0,46
26,137,26,163,91,54,37
26,137,48,221,0,44,-44
26,139,4,13,62,143,-81
26,139,4,19,0,48,-48
26,139,6,37,66,58,8
26,139,6,59,28,45,-17
26,139,6,71,29,29,0
26,139,6,73,49,76,-27
26,139,6,77,0,59,-59
26,139,6,85,0,33,-33
26,139,8,41,29,54,-25
26,139,8,59,0,35,-35
26,139,12,11,26,31,-5
26,139,12,57,27,0,27
26,139,12,71,39,38,1
26,139,12,95,0,21,-21
26,139,12,99,0,30,-30
26,139,12,103,0,48,-48
26,139,12,115,0,50,-50
26,139,12,127,0,23,-23
26,139,15,3,32,34,-2
26,139,17,31,216,251,-35
26,139,17,43,62,53,9
26,139,18,3,28,0,28
26,139,18,97,23,32,-9
26,139,25,17,0,22,-22
26,139,26,5,1871,1924,-53
26,139,26,15,87,113,-26
26,139,26,17,0,24,-24
26,139,26,21,100,123,-23
26,139,26,25,31,51,-20
26,139,26,37,29,29,0
26,139,26,45,61,76,-15
26,139,26,49,147,25,122
26,139,26,55,59,39,20
26,139,26,57,26,0,26
26,139,26,65,167,125,42
26,139,26,67,70,86,-16
26,139,26,73,46,0,46
26,139,26,75,59,31,28
26,139,26,77,280,246,34
26,139,26,81,5654,4824,830
26,139,26,85,31,50,-19
26,139,26,91,28,0,28
26,139,26,93,62,40,22
26,139,26,99,120,49,71
26,139,26,101,0,31,-31
26,139,26,103,33,32,1
26,139,26,105,80,67,13
26,139,26,107,59,85,-26
26,139,26,111,54,34,20
26,139,26,117,96,94,2
26,139,26,121,1676,1855,-179
26,139,26,123,165,185,-20
26,139,26,125,190,167,23
26,139,26,127,81,97,-16
26,139,26,133,25,0,25
26,139,26,145,83,35,48
26,139,26,159,144,96,48
26,139,26,161,81,99,-18
26,139,26,163,186,124,62
26,139,26,165,30,36,-6
26,139,27,53,38,33,5
26,139,32,3,0,48,-48
26,139,36,55,0,40,-40
26,139,36,61,0,23,-23
26,139,37,119,0,43,-43
26,139,39,49,48,35,13
26,139,41,51,0,23,-23
26,139,47,149,0,35,-35
26,139,48,29,0,63,-63
26,139,48,113,37,0,37
26,139,48,201,0,66,-66
26,139,48,215,133,166,-33
26,139,48,439,0,39,-39
26,139,53,33,28,0,28
26,139,55,79,0,53,-53
26,141,26,7,119,135,-16
26,141,26,31,59,122,-63
26,141,26,99,48,23,25
26,141,26,125,47,35,12
26,143,12,71,0,31,-31
26,143,26,17,0,41,-41
26,143,26,35,51,34,17
26,143,26,39,100,121,-21
26,143,26,49,108,84,24
26,143,26,51,29,0,29
26,143,26,55,0,47,-47
26,143,26,65,42,32,10
26,143,26,73,0,24,-24
26,143,26,75,31,0,31
26,143,26,81,28,38,-10
26,143,26,93,28,24,4
26,143,26,99,126,78,48
26,143,26,111,37,40,-3
26,143,26,113,48,81,-33
26,143,26,125,155,87,68
26,143,26,129,58,85,-27
26,143,26,137,0,46,-46
26,143,26,145,59,45,14
26,143,26,147,31,0,31
26,143,26,155,41,0,41
26,143,26,163,170,87,83
26,143,26,165,31,0,31
26,145,4,13,55,112,-57
26,145,6,73,0,56,-56
26,145,8,41,0,37,-37
26,145,12,57,0,34,-34
26,145,12,71,32,32,0
26,145,12,95,0,39,-39
26,145,12,103,0,32,-32
26,145,13,67,0,31,-31
26,145,13,121,0,25,-25
26,145,17,31,41,86,-45
26,145,18,97,0,37,-37
26,145,26,1,23,0,23
26,145,26,11,99,87,12
26,145,26,17,955,1106,-151
26,145,26,25,0,29,-29
26,145,26,35,53,53,0
26,145,26,37,56,95,-39
26,145,26,39,0,38,-38
26,145,26,45,36,79,-43
26,145,26,47,0,38,-38
26,145,26,49,938,861,77
26,145,26,51,63,78,-15
26,145,26,55,53,78,-25
26,145,26,57,180,177,3
26,145,26,63,105,45,60
26,145,26,65,110,216,-106
26,145,26,69,79,68,11
26,145,26,73,82,108,-26
26,145,26,77,53,78,-25
26,145,26,81,202,323,-121
26,145,26,87,45,46,-1
26,145,26,91,0,26,-26
26,145,26,93,44,52,-8
26,145,26,99,127,166,-39
26,145,26,107,0,29,-29
26,145,26,111,543,614,-71
26,145,26,115,0,26,-26
26,145,26,117,37,0,37
26,145,26,121,33,0,33
26,145,26,125,263,364,-101
26,145,26,129,65,39,26
26,145,26,139,35,83,-48
26,145,26,143,45,59,-14
26,145,26,147,0,57,-57
26,145,26,151,43,26,17
26,145,26,155,249,259,-10
26,145,26,157,449,346,103
26,145,26,161,108,149,-41
26,145,26,163,188,245,-57
26,145,27,53,0,28,-28
26,145,32,3,0,88,-88
26,145,37,51,0,35,-35
26,145,37,119,0,46,-46
26,145,37,133,0,30,-30
26,145,39,35,0,30,-30
26,145,39,49,29,63,-34
26,145,39,95,43,0,43
26,145,47,37,0,36,-36
26,145,47,157,0,30,-30
26,145,48,27,0,32,-32
26,145,48,29,32,92,-60
26,145,48,201,0,46,-46
26,145,48,439,0,27,-27
26,145,48,453,0,39,-39
26,147,4,13,57,125,-68
26,147,4,21,0,61,-61
26,147,6,37,0,23,-23
26,147,6,73,0,42,-42
26,147,12,11,0,25,-25
26,147,12,15,0,32,-32
26,147,12,57,0,33,-33
26,147,12,69,0,35,-35
26,147,12,71,0,41,-41
26,147,12,95,0,20,-20
26,147,12,99,0,30,-30
26,147,12,101,0,50,-50
26,147,12,103,0,45,-45
26,147,12,105,0,36,-36
26,147,12,115,0,36,-36
26,147,17,31,1013,66,947
26,147,17,43,53,0,53
26,147,26,17,35,32,3
26,147,26,49,88,123,-35
26,147,26,55,0,30,-30
26,147,26,63,0,52,-52
26,147,26,65,46,74,-28
26,147,26,69,0,34,-34
26,147,26,73,23,29,-6
26,147,26,77,32,45,-13
26,147,26,81,61,107,-46
26,147,26,87,276,277,-1
26,147,26,93,0,30,-30
26,147,26,99,2714,2906,-192
26,147,26,115,0,46,-46
26,147,26,125,403,567,-164
26,147,26,143,0,31,-31
26,147,26,145,57,0,57
26,147,26,151,589,683,-94
26,147,26,161,60,81,-21
26,147,26,163,460,386,74
26,147,32,3,28,81,-53
26,147,37,119,0,45,-45
26,147,39,49,0,22,-22
26,147,48,439,0,31,-31
26,149,4,13,0,36,-36
26,149,17,31,58,48,10
26,149,18,39,273,312,-39
26,149,18,87,311,218,93
26,149,18,113,31,0,31
26,149,18,141,39,31,8
26,149,18,151,0,50,-50
26,149,26,5,0,51,-51
26,149,26,21,46,66,-20
26,149,26,23,334,298,36
26,149,26,25,69,76,-7
26,149,26,27,311,326,-15
26,149,26,77,477,583,-106
26,149,26,81,42,49,-7
26,149,26,125,0,32,-32
26,149,26,159,68,99,-31
26,149,26,163,41,39,2
26,151,4,13,0,35,-35
26,151,26,17,0,39,-39
26,151,26,49,57,76,-19
26,151,26,63,139,155,-16
26,151,26,65,0,21,-21
26,151,26,81,0,25,-25
26,151,26,87,288,243,45
26,151,26,99,237,238,-1
26,151,26,125,104,127,-23
26,151,26,145,26,43,-17
26,151,26,147,683,589,94
26,151,26,157,166,163,3
26,151,26,161,0,28,-28
26,151,26,163,84,87,-3
26,153,26,41,42,54,-12
26,153,26,103,0,43,-43
26,155,4,13,0,43,-43
26,155,17,31,0,25,-25
26,155,26,37,309,367,-58
26,155,26,45,90,114,-24
26,155,26,49,750,668,82
26,155,26,57,55,47,8
26,155,26,65,564,658,-94
26,155,26,67,33,26,7
26,155,26,73,35,41,-6
26,155,26,75,0,35,-35
26,155,26,81,44,59,-15
26,155,26,93,222,244,-22
26,155,26,99,0,53,-53
26,155,26,125,155,163,-8
26,155,26,143,0,41,-41
26,155,26,145,259,249,10
26,155,26,161,23,29,-6
26,155,26,163,62,61,1
26,155,32,3,0,45,-45
26,157,4,13,0,22,-22
26,157,26,17,167,295,-128
26,157,26,49,475,424,51
26,157,26,63,237,181,56
26,157,26,65,0,35,-35
26,157,26,73,22,37,-15
26,157,26,81,42,42,0
26,157,26,87,347,228,119
26,157,26,99,101,80,21
26,157,26,111,28,40,-12
26,157,26,125,117,137,-20
26,157,26,129,0,37,-37
26,157,26,145,346,449,-103
26,157,26,151,163,166,-3
26,157,26,161,0,25,-25
26,157,26,163,56,31,25
26,159,4,13,0,49,-49
26,159,12,57,0,26,-26
26,159,12,105,42,0,42
26,159,17,31,174,126,48
26,159,17,97,26,0,26
26,159,18,141,40,37,3
26,159,26,5,474,569,-95
26,159,26,15,0,38,-38
26,159,26,21,683,689,-6
26,159,26,25,58,48,10
26,159,26,27,328,245,83
26,159,26,65,0,33,-33
26,159,26,77,1601,1855,-254
26,159,26,81,103,162,-59
26,159,26,125,32,34,-2
26,159,26,139,96,144,-48
26,159,26,149,99,68,31
26,159,26,161,0,34,-34
26,159,26,163,35,28,7
26,159,32,3,0,26,-26
26,159,48,215,43,72,-29
26,161,2,20,0,28,-28
26,161,4,13,155,367,-212
26,161,4,19,40,103,-63
26,161,6,1,89,158,-69
26,161,6,13,29,67,-38
26,161,6,37,216,423,-207
26,161,6,59,92,142,-50
26,161,6,67,26,38,-12
26,161,6,71,0,39,-39
26,161,6,73,168,366,-198
26,161,6,75,115,198,-83
26,161,6,81,0,89,-89
26,161,6,85,95,334,-239
26,161,6,97,0,32,-32
26,161,8,5,0,55,-55
26,161,8,13,21,82,-61
26,161,8,31,35,86,-51
26,161,8,41,0,61,-61
26,161,8,69,31,0,31
26,161,9,1,32,68,-36
26,161,9,3,41,51,-10
26,161,9,7,0,96,-96
26,161,9,9,34,37,-3
26,161,9,11,0,895,-895
26,161,11,1,142,181,-39
26,161,12,1,23,0,23
26,161,12,9,0,28,-28
26,161,12,11,58,103,-45
26,161,12,15,0,28,-28
26,161,12,21,0,49,-49
26,161,12,31,0,31,-31
26,161,12,57,53,66,-13
26,161,12,71,47,95,-48
26,161,12,86,35,75,-40
26,161,12,95,32,78,-46
26,161,12,99,64,75,-11
26,161,12,101,0,32,-32
26,161,12,103,36,90,-54
26,161,12,105,0,41,-41
26,161,12,115,0,40,-40
26,161,12,117,0,30,-30
26,161,12,127,0,24,-24
26,161,13,67,23,67,-44
26,161,13,89,55,69,-14
26,161,13,121,44,151,-107
26,161,13,135,0,66,-66
26,161,15,3,23,48,-25
26,161,17,19,29,37,-8
26,161,17,31,572,1043,-471
26,161,17,43,48,181,-133
26,161,17,89,0,43,-43
26,161,17,97,64,134,-70
26,161,17,197,38,66,-28
26,161,18,3,51,0,51
26,161,18,5,0,23,-23
26,161,18,57,23,60,-37
26,161,18,89,0,37,-37
26,161,18,97,66,105,-39
26,161,18,105,43,43,0
26,161,18,141,0,36,-36
26,161,18,157,42,0,42
26,161,19,103,67,33,34
26,161,20,91,0,54,-54
26,161,21,111,43,49,-6
26,161,22,71,23,21,2
26,161,24,5,38,45,-7
26,161,24,31,71,160,-89
26,161,24,33,40,38,2
26,161,24,510,28,63,-35
26,161,25,9,0,34,-34
26,161,25,17,160,313,-153
26,161,25,21,41,97,-56
26,161,25,25,89,107,-18
26,161,25,27,28,0,28
26,161,26,5,50,35,15
26,161,26,7,36,0,36
26,161,26,17,42,36,6
26,161,26,21,40,65,-25
26,161,26,23,37,0,37
26,161,26,25,104,55,49
26,161,26,29,24,0,24
26,161,26,37,53,37,16
26,161,26,45,128,57,71
26,161,26,47,22,25,-3
26,161,26,49,366,300,66
26,161,26,55,59,86,-27
26,161,26,59,74,66,8
26,161,26,65,524,377,147
26,161,26,69,22,30,-8
26,161,26,73,63,42,21
26,161,26,75,741,641,100
26,161,26,77,252,286,-34
26,161,26,81,327,269,58
26,161,26,87,23,33,-10
26,161,26,89,31,0,31
26,161,26,91,611,614,-3
26,161,26,93,1002,1188,-186
26,161,26,99,476,331,145
26,161,26,103,37,44,-7
26,161,26,107,31,20,11
26,161,26,111,40,79,-39
26,161,26,115,571,519,52
26,161,26,117,0,27,-27
26,161,26,121,35,79,-44
26,161,26,125,2126,1879,247
26,161,26,139,99,81,18
26,161,26,145,149,108,41
26,161,26,147,81,60,21
26,161,26,151,28,0,28
26,161,26,155,29,23,6
26,161,26,157,25,0,25
26,161,26,159,34,0,34
26,161,26,163,6331,5515,816
26,161,27,37,0,38,-38
26,161,27,53,83,225,-142
26,161,27,123,41,26,15
26,161,29,183,0,76,-76
26,161,29,189,44,198,-154
26,161,29,510,0,44,-44
26,161,31,55,0,36,-36
26,161,31,109,43,0,43
26,161,32,3,81,158,-77
26,161,34,3,0,43,-43
26,161,34,17,28,93,-65
26,161,34,21,51,49,2
26,161,34,23,32,100,-68
26,161,34,27,0,46,-46
26,161,34,35,0,55,-55
26,161,35,1,45,28,17
26,161,36,5,0,30,-30
26,161,36,29,43,61,-18
26,161,36,47,99,164,-65
26,161,36,55,74,52,22
26,161,36,59,29,24,5
26,161,36,61,191,455,-264
26,161,36,67,40,27,13
26,161,36,81,56,91,-35
26,161,36,103,28,0,28
26,161,36,109,39,29,10
26,161,36,119,0,60,-60
26,161,37,21,0,27,-27
26,161,37,63,55,73,-18
26,161,37,119,47,135,-88
26,161,37,135,36,64,-28
26,161,37,183,39,109,-70
26,161,39,17,0,49,-49
26,161,39,35,163,166,-3
26,161,39,49,88,187,-99
26,161,39,61,63,117,-54
26,161,39,93,0,41,-41
26,161,39,95,213,230,-17
26,161,39,113,34,32,2
26,161,39,153,34,0,34
26,161,39,173,67,0,67
26,161,40,143,0,32,-32
26,161,41,51,42,79,-37
26,161,41,67,0,60,-60
26,161,42,3,99,100,-1
26,161,42,27,0,37,-37
26,161,42,29,0,48,-48
26,161,42,91,37,91,-54
26,161,42,101,71,107,-36
26,161,44,7,28,35,-7
26,161,44,9,0,36,-36
26,161,45,13,0,31,-31
26,161,45,19,0,40,-40
26,161,45,45,0,54,-54
26,161,47,37,27,71,-44
26,161,47,93,0,63,-63
26,161,47,149,0,30,-30
26,161,47,157,47,32,15
26,161,47,187,0,42,-42
26,161,48,29,33,56,-23
26,161,48,85,0,38,-38
26,161,48,113,61,132,-71
26,161,48,121,0,43,-43
26,161,48,201,85,157,-72
26,161,48,439,46,70,-24
26,161,48,453,42,155,-113
26,161,48,491,0,33,-33
26,161,49,35,95,39,56
26,161,49,49,54,0,54
26,161,51,13,51,76,-25
26,161,51,59,52,93,-41
26,161,51,510,23,45,-22
26,161,51,710,0,29,-29
26,161,51,810,50,0,50
26,161,53,11,0,29,-29
26,161,53,33,118,298,-180
26,161,53,53,0,35,-35
26,161,55,25,76,103,-27
26,161,55,79,34,53,-19
26,161,55,133,0,33,-33
26,163,1,73,66,156,-90
26,163,1,81,0,41,-41
26,163,1,89,46,152,-106
26,163,1,97,38,89,-51
26,163,1,101,82,152,-70
26,163,1,103,0,30,-30
26,163,1,125,28,64,-36
26,163,2,90,0,27,-27
26,163,4,3,29,43,-14
26,163,4,13,378,1775,-1397
26,163,4,15,0,43,-43
26,163,4,19,49,231,-182
26,163,4,21,27,149,-122
26,163,4,25,0,38,-38
26,163,4,27,0,24,-24
26,163,5,69,0,28,-28
26,163,5,119,0,65,-65
26,163,6,1,69,147,-78
26,163,6,13,35,63,-28
26,163,6,19,0,33,-33
26,163,6,29,0,47,-47
26,163,6,37,334,647,-313
26,163,6,59,127,235,-108
26,163,6,65,53,134,-81
26,163,6,67,0,74,-74
26,163,6,71,57,121,-64
26,163,6,73,219,363,-144
26,163,6,75,31,64,-33
26,163,6,77,0,66,-66
26,163,6,81,0,61,-61
26,163,6,85,56,120,-64
26,163,6,95,0,41,-41
26,163,6,111,0,40,-40
26,163,8,5,0,79,-79
26,163,8,13,0,27,-27
26,163,8,31,0,76,-76
26,163,8,35,55,64,-9
26,163,8,41,46,165,-119
26,163,8,59,0,55,-55
26,163,8,69,0,26,-26
26,163,9,1,36,57,-21
26,163,9,3,0,91,-91
26,163,9,7,0,41,-41
26,163,9,9,26,62,-36
26,163,9,11,0,158,-158
26,163,10,3,0,32,-32
26,163,11,1,77,104,-27
26,163,12,1,0,39,-39
26,163,12,5,0,28,-28
26,163,12,9,61,93,-32
26,163,12,11,165,325,-160
26,163,12,15,0,71,-71
26,163,12,17,37,49,-12
26,163,12,19,0,36,-36
26,163,12,21,50,138,-88
26,163,12,31,142,201,-59
26,163,12,33,33,51,-18
26,163,12,53,28,55,-27
26,163,12,57,103,277,-174
26,163,12,61,0,40,-40
26,163,12,69,27,101,-74
26,163,12,71,127,307,-180
26,163,12,73,37,70,-33
26,163,12,81,48,134,-86
26,163,12,83,38,78,-40
26,163,12,85,0,25,-25
26,163,12,86,103,200,-97
26,163,12,91,29,0,29
26,163,12,95,129,331,-202
26,163,12,97,27,87,-60
26,163,12,99,73,226,-153
26,163,12,101,92,186,-94
26,163,12,103,134,281,-147
26,163,12,105,60,142,-82
26,163,12,109,0,56,-56
26,163,12,111,27,83,-56
26,163,12,115,62,125,-63
26,163,12,117,34,99,-65
26,163,12,119,0,36,-36
26,163,12,127,47,85,-38
26,163,13,21,0,46,-46
26,163,13,51,0,93,-93
26,163,13,63,101,131,-30
26,163,13,67,128,435,-307
26,163,13,77,0,59,-59
26,163,13,89,119,392,-273
26,163,13,97,32,78,-46
26,163,13,117,0,36,-36
26,163,13,121,132,518,-386
26,163,13,135,70,358,-288
26,163,13,151,0,101,-101
26,163,13,179,35,0,35
26,163,13,215,0,66,-66
26,163,13,217,35,0,35
26,163,13,245,0,35,-35
26,163,13,247,0,66,-66
26,163,15,3,77,106,-29
26,163,16,1,0,37,-37
26,163,17,19,0,44,-44
26,163,17,31,632,1418,-786
26,163,17,43,110,466,-356
26,163,17,89,34,76,-42
26,163,17,97,87,127,-40
26,163,17,113,0,40,-40
26,163,17,143,0,100,-100
26,163,17,197,92,132,-40
26,163,17,201,63,85,-22
26,163,18,3,60,110,-50
26,163,18,5,0,29,-29
26,163,18,39,30,59,-29
26,163,18,57,44,139,-95
26,163,18,63,0,40,-40
26,163,18,81,0,30,-30
26,163,18,89,91,109,-18
26,163,18,91,0,47,-47
26,163,18,97,116,258,-142
26,163,18,127,0,35,-35
26,163,18,141,33,74,-41
26,163,18,157,34,36,-2
26,163,19,153,0,43,-43
26,163,19,163,0,65,-65
26,163,20,61,29,28,1
26,163,20,91,38,68,-30
26,163,20,173,0,87,-87
26,163,21,15,0,27,-27
26,163,21,67,34,124,-90
26,163,21,73,0,29,-29
26,163,21,93,0,42,-42
26,163,21,111,75,163,-88
26,163,22,17,0,44,-44
26,163,22,33,0,59,-59
26,163,22,51,0,67,-67
26,163,22,71,0,75,-75
26,163,22,115,24,0,24
26,163,24,3,0,78,-78
26,163,24,5,31,101,-70
26,163,24,27,0,41,-41
26,163,24,31,49,135,-86
26,163,24,33,79,116,-37
26,163,24,510,27,48,-21
26,163,25,13,0,37,-37
26,163,25,17,51,93,-42
26,163,25,25,40,98,-58
26,163,25,27,0,45,-45
26,163,26,1,39,50,-11
26,163,26,5,49,51,-2
26,163,26,7,50,70,-20
26,163,26,9,0,50,-50
26,163,26,11,31,37,-6
26,163,26,15,32,0,32
26,163,26,17,74,79,-5
26,163,26,19,36,43,-7
26,163,26,21,79,93,-14
26,163,26,23,105,87,18
26,163,26,25,143,161,-18
26,163,26,29,38,58,-20
26,163,26,31,46,91,-45
26,163,26,33,51,47,4
26,163,26,35,68,108,-40
26,163,26,37,64,63,1
26,163,26,39,0,66,-66
26,163,26,41,0,35,-35
26,163,26,45,123,157,-34
26,163,26,47,27,91,-64
26,163,26,49,773,687,86
26,163,26,51,48,147,-99
26,163,26,55,85,154,-69
26,163,26,57,0,51,-51
26,163,26,59,98,153,-55
26,163,26,61,45,56,-11
26,163,26,63,54,56,-2
26,163,26,65,621,653,-32
26,163,26,67,0,31,-31
26,163,26,69,55,122,-67
26,163,26,73,127,140,-13
26,163,26,75,370,540,-170
26,163,26,77,290,423,-133
26,163,26,79,0,38,-38
26,163,26,81,494,626,-132
26,163,26,85,0,56,-56
26,163,26,87,88,147,-59
26,163,26,89,0,31,-31
26,163,26,91,319,355,-36
26,163,26,93,1022,2017,-995
26,163,26,99,8250,17444,-9194
26,163,26,101,0,49,-49
26,163,26,103,39,69,-30
26,163,26,105,0,31,-31
26,163,26,107,92,92,0
26,163,26,111,68,131,-63
26,163,26,113,0,52,-52
26,163,26,115,2061,2559,-498
26,163,26,117,0,50,-50
26,163,26,119,30,54,-24
26,163,26,121,88,83,5
26,163,26,125,17275,27079,-9804
26,163,26,129,35,106,-71
26,163,26,133,0,51,-51
26,163,26,135,0,30,-30
26,163,26,137,54,91,-37
26,163,26,139,124,186,-62
26,163,26,143,87,170,-83
26,163,26,145,245,188,57
26,163,26,147,386,460,-74
26,163,26,149,39,41,-2
26,163,26,151,87,84,3
26,163,26,155,61,62,-1
26,163,26,157,31,56,-25
26,163,26,159,28,35,-7
26,163,26,161,5515,6331,-816
26,163,26,165,33,65,-32
26,163,27,37,55,46,9
26,163,27,53,87,234,-147
26,163,27,123,0,47,-47
26,163,28,33,0,50,-50
26,163,28,47,0,53,-53
26,163,28,49,0,41,-41
26,163,28,75,0,55,-55
26,163,29,19,0,25,-25
26,163,29,47,0,48,-48
26,163,29,95,46,81,-35
26,163,29,183,0,85,-85
26,163,29,189,84,207,-123
26,163,29,510,43,44,-1
26,163,31,55,0,48,-48
26,163,32,3,293,1166,-873
26,163,32,31,0,36,-36
26,163,34,3,39,60,-21
26,163,34,7,22,30,-8
26,163,34,13,30,48,-18
26,163,34,17,36,80,-44
26,163,34,21,0,30,-30
26,163,34,23,53,82,-29
26,163,34,27,34,41,-7
26,163,34,31,0,44,-44
26,163,35,1,61,81,-20
26,163,35,13,0,31,-31
26,163,36,1,0,43,-43
26,163,36,5,78,122,-44
26,163,36,29,104,110,-6
26,163,36,45,0,34,-34
26,163,36,47,133,210,-77
26,163,36,55,36,35,1
26,163,36,59,0,36,-36
26,163,36,61,90,262,-172
26,163,36,67,0,39,-39
26,163,36,81,108,208,-100
26,163,36,87,0,35,-35
26,163,36,103,0,36,-36
26,163,36,119,30,36,-6
26,163,37,21,0,34,-34
26,163,37,25,0,42,-42
26,163,37,49,0,50,-50
26,163,37,51,62,81,-19
26,163,37,63,27,71,-44
26,163,37,67,0,62,-62
26,163,37,71,0,45,-45
26,163,37,81,0,125,-125
26,163,37,97,0,41,-41
26,163,37,119,76,436,-360
26,163,37,133,76,114,-38
26,163,37,135,0,31,-31
26,163,37,183,80,288,-208
26,163,39,3,48,56,-8
26,163,39,17,55,93,-38
26,163,39,23,28,0,28
26,163,39,25,0,27,-27
26,163,39,35,288,344,-56
26,163,39,41,0,76,-76
26,163,39,43,0,30,-30
26,163,39,49,217,504,-287
26,163,39,57,29,39,-10
26,163,39,61,89,173,-84
26,163,39,63,43,133,-90
26,163,39,93,72,96,-24
26,163,39,95,520,506,14
26,163,39,99,32,0,32
26,163,39,103,0,51,-51
26,163,39,109,0,36,-36
26,163,39,113,90,122,-32
26,163,39,133,0,35,-35
26,163,39,139,30,0,30
26,163,39,151,37,53,-16
26,163,39,153,81,153,-72
26,163,39,165,36,55,-19
26,163,39,173,80,106,-26
26,163,40,109,32,73,-41
26,163,40,143,0,56,-56
26,163,41,5,0,38,-38
26,163,41,51,0,115,-115
26,163,41,67,0,54,-54
26,163,42,3,105,179,-74
26,163,42,17,0,45,-45
26,163,42,29,0,44,-44
26,163,42,49,31,70,-39
26,163,42,91,0,64,-64
26,163,42,101,45,104,-59
26,163,45,13,0,33,-33
26,163,45,15,0,46,-46
26,163,45,19,28,56,-28
26,163,45,35,0,36,-36
26,163,45,45,65,149,-84
26,163,45,51,0,54,-54
26,163,45,63,0,41,-41
26,163,45,79,32,92,-60
26,163,45,83,0,42,-42
26,163,45,91,0,44,-44
26,163,47,9,0,38,-38
26,163,47,11,0,40,-40
26,163,47,13,0,33,-33
26,163,47,35,0,37,-37
26,163,47,37,126,329,-203
26,163,47,65,0,86,-86
26,163,47,93,66,170,-104
26,163,47,105,0,29,-29
26,163,47,113,36,0,36
26,163,47,119,0,58,-58
26,163,47,125,54,68,-14
26,163,47,141,0,40,-40
26,163,47,149,43,139,-96
26,163,47,157,138,394,-256
26,163,47,165,0,74,-74
26,163,47,179,0,37,-37
26,163,47,187,38,103,-65
26,163,47,189,0,31,-31
26,163,48,27,58,123,-65
26,163,48,29,66,211,-145
26,163,48,39,0,81,-81
26,163,48,85,48,187,-139
26,163,48,113,107,372,-265
26,163,48,121,32,173,-141
26,163,48,141,43,88,-45
26,163,48,157,0,99,-99
26,163,48,201,172,669,-497
26,163,48,215,65,147,-82
26,163,48,339,0,81,-81
26,163,48,427,0,49,-49
26,163,48,439,61,412,-351
26,163,48,453,46,96,-50
26,163,48,479,33,75,-42
26,163,48,491,0,51,-51
26,163,49,35,41,76,-35
26,163,51,13,27,87,-60
26,163,51,41,0,38,-38
26,163,51,59,89,171,-82
26,163,51,87,24,61,-37
26,163,51,107,0,70,-70
26,163,51,153,0,78,-78
26,163,51,161,38,0,38
26,163,51,179,0,39,-39
26,163,51,510,0,64,-64
26,163,51,550,138,31,107
26,163,51,650,0,44,-44
26,163,51,700,0,50,-50
26,163,51,710,103,77,26
26,163,51,740,32,42,-10
26,163,51,760,0,49,-49
26,163,51,800,39,0,39
26,163,51,810,193,162,31
26,163,53,11,0,31,-31
26,163,53,33,68,255,-187
26,163,53,35,0,33,-33
26,163,53,53,60,125,-65
26,163,53,61,0,106,-106
26,163,53,63,0,34,-34
26,163,54,39,0,33,-33
26,163,55,25,59,64,-5
26,163,55,79,89,169,-80
26,163,55,101,75,32,43
26,163,55,133,0,54,-54
26,163,55,139,0,29,-29
26,163,56,25,0,27,-27
26,165,4,13,0,29,-29
26,165,26,19,38,35,3
26,165,26,35,47,0,47
26,165,26,49,32,31,1
26,165,26,55,353,359,-6
26,165,26,65,33,32,1
26,165,26,79,49,29,20
26,165,26,81,92,107,-15
26,165,26,85,51,37,14
26,165,26,89,0,29,-29
26,165,26,99,25,22,3
26,165,26,101,55,64,-9
26,165,26,105,0,27,-27
26,165,26,107,28,0,28
26,165,26,113,363,288,75
26,165,26,125,80,63,17
26,165,26,133,298,254,44
26,165,26,139,36,30,6
26,165,26,143,0,31,-31
26,165,26,163,65,33,32
27,1,27,3,93,68,25
27,1,27,35,116,168,-52
27,1,27,37,42,0,42
27,1,27,53,148,53,95
27,1,27,61,59,78,-19
27,1,27,95,38,39,-1
27,1,27,123,46,46,0
27,1,27,137,0,56,-56
27,1,27,141,35,0,35
27,3,4,13,139,253,-114
27,3,4,21,0,48,-48
27,3,6,19,33,0,33
27,3,6,37,65,71,-6
27,3,6,59,49,41,8
27,3,6,73,68,78,-10
27,3,6,85,0,38,-38
27,3,8,41,0,49,-49
27,3,12,11,0,31,-31
27,3,12,57,31,0,31
27,3,12,71,0,46,-46
27,3,12,95,31,0,31
27,3,12,103,0,25,-25
27,3,15,3,33,0,33
27,3,17,31,125,129,-4
27,3,17,43,27,41,-14
27,3,19,153,45,33,12
27,3,20,91,0,34,-34
27,3,27,1,68,93,-25
27,3,27,5,26,34,-8
27,3,27,7,36,54,-18
27,3,27,9,81,51,30
27,3,27,13,59,101,-42
27,3,27,17,37,0,37
27,3,27,19,78,111,-33
27,3,27,21,41,92,-51
27,3,27,25,430,535,-105
27,3,27,27,0,23,-23
27,3,27,35,110,148,-38
27,3,27,37,877,783,94
27,3,27,41,28,54,-26
27,3,27,49,0,34,-34
27,3,27,53,9320,7401,1919
27,3,27,57,28,60,-32
27,3,27,59,634,883,-249
27,3,27,61,52,82,-30
27,3,27,65,81,109,-28
27,3,27,67,33,28,5
27,3,27,85,37,40,-3
27,3,27,91,30,0,30
27,3,27,95,159,213,-54
27,3,27,97,37,47,-10
27,3,27,99,26,37,-11
27,3,27,103,28,29,-1
27,3,27,109,87,133,-46
27,3,27,111,28,100,-72
27,3,27,115,129,132,-3
27,3,27,121,0,34,-34
27,3,27,123,4688,4255,433
27,3,27,131,24,41,-17
27,3,27,137,204,262,-58
27,3,27,139,150,180,-30
27,3,27,141,905,1350,-445
27,3,27,145,208,191,17
27,3,27,153,0,33,-33
27,3,27,159,0,37,-37
27,3,27,163,875,1159,-284
27,3,27,169,38,28,10
27,3,27,171,463,644,-181
27,3,31,55,0,35,-35
27,3,32,3,57,58,-1
27,3,36,61,26,26,0
27,3,38,17,76,76,0
27,3,38,35,36,29,7
27,3,46,99,0,52,-52
27,3,47,37,0,27,-27
27,3,48,27,0,23,-23
27,3,48,85,0,32,-32
27,3,48,113,35,27,8
27,3,48,201,39,37,2
27,3,48,215,40,0,40
27,3,48,439,0,38,-38
27,3,51,59,0,31,-31
27,3,53,33,32,69,-37
27,3,55,5,27,0,27
27,3,55,25,29,78,-49
27,3,55,31,44,0,44
27,3,55,33,0,27,-27
27,3,55,35,30,37,-7
27,3,55,63,0,33,-33
27,3,55,79,55,49,6
27,3,55,93,32,38,-6
27,3,55,95,36,96,-60
27,3,55,109,107,174,-67
27,3,55,133,0,26,-26
27,5,4,13,25,25,0
27,5,27,3,34,26,8
27,5,27,7,28,28,0
27,5,27,27,189,225,-36
27,5,27,37,28,32,-4
27,5,27,53,61,114,-53
27,5,27,57,125,100,25
27,5,27,87,100,139,-39
27,5,27,111,259,229,30
27,5,27,137,0,35,-35
27,5,27,159,34,46,-12
27,5,38,17,188,292,-104
27,7,4,13,0,38,-38
27,7,27,3,54,36,18
27,7,27,5,28,28,0
27,7,27,21,163,146,17
27,7,27,27,32,39,-7
27,7,27,29,149,140,9
27,7,27,35,59,66,-7
27,7,27,37,28,52,-24
27,7,27,53,155,188,-33
27,7,27,57,227,234,-7
27,7,27,61,96,52,44
27,7,27,71,78,30,48
27,7,27,111,28,0,28
27,7,27,113,49,53,-4
27,7,27,119,52,50,2
27,7,27,123,79,84,-5
27,7,27,135,68,33,35
27,7,27,137,79,97,-18
27,7,27,145,36,47,-11
27,7,27,163,0,24,-24
27,7,38,17,56,106,-50
27,7,38,35,36,42,-6
27,9,27,3,51,81,-30
27,9,27,21,24,32,-8
27,9,27,35,39,77,-38
27,9,27,37,32,30,2
27,9,27,41,25,0,25
27,9,27,53,184,330,-146
27,9,27,65,26,0,26
27,9,27,67,39,23,16
27,9,27,93,51,37,14
27,9,27,95,126,81,45
27,9,27,97,220,218,2
27,9,27,109,0,24,-24
27,9,27,123,60,75,-15
27,9,27,137,39,56,-17
27,9,27,141,329,331,-2
27,9,27,145,2357,2230,127
27,9,27,153,35,31,4
27,9,27,171,118,142,-24
27,9,38,17,0,27,-27
27,11,46,51,0,41,-41
27,13,4,13,0,64,-64
27,13,6,73,0,22,-22
27,13,27,3,101,59,42
27,13,27,15,180,115,65
27,13,27,19,42,41,1
27,13,27,35,0,29,-29
27,13,27,37,163,232,-69
27,13,27,43,136,101,35
27,13,27,47,47,43,4
27,13,27,49,23,0,23
27,13,27,53,293,519,-226
27,13,27,79,208,255,-47
27,13,27,83,51,35,16
27,13,27,85,43,32,11
27,13,27,91,117,55,62
27,13,27,99,69,48,21
27,13,27,103,1301,1270,31
27,13,27,105,28,0,28
27,13,27,109,113,140,-27
27,13,27,117,26,0,26
27,13,27,123,108,172,-64
27,13,27,127,25,0,25
27,13,27,129,28,0,28
27,13,27,131,85,70,15
27,13,27,137,51,38,13
27,13,27,139,102,93,9
27,13,27,143,55,0,55
27,13,27,145,23,47,-24
27,13,27,147,48,47,1
27,13,27,161,225,191,34
27,13,27,163,55,62,-7
27,13,27,165,151,92,59
27,13,27,171,35,0,35
27,13,46,99,52,50,2
27,13,48,201,0,27,-27
27,13,53,33,0,25,-25
27,15,27,13,115,180,-65
27,15,27,37,0,53,-53
27,15,27,53,58,101,-43
27,15,27,83,0,28,-28
27,15,27,85,27,0,27
27,15,27,103,130,159,-29
27,15,27,123,26,46,-20
27,15,27,127,69,77,-8
27,15,27,129,33,0,33
27,15,27,143,34,29,5
27,15,27,145,0,30,-30
27,15,27,165,62,33,29
27,15,48,215,45,32,13
27,17,27,3,0,37,-37
27,17,27,35,0,34,-34
27,17,27,37,48,27,21
27,17,27,53,85,61,24
27,17,27,61,30,0,30
27,17,27,103,0,24,-24
27,17,27,115,119,88,31
27,17,27,123,52,72,-20
27,17,27,137,863,736,127
27,17,27,163,0,25,-25
27,17,55,31,99,82,17
27,19,4,13,69,107,-38
27,19,6,37,22,38,-16
27,19,6,59,34,0,34
27,19,16,1,257,0,257
27,19,17,31,40,57,-17
27,19,27,3,111,78,33
27,19,27,13,41,42,-1
27,19,27,35,0,38,-38
27,19,27,37,286,255,31
27,19,27,53,3220,2119,1101
27,19,27,67,22,0,22
27,19,27,79,37,49,-12
27,19,27,85,218,286,-68
27,19,27,103,31,0,31
27,19,27,109,30,50,-20
27,19,27,123,155,166,-11
27,19,27,129,34,0,34
27,19,27,131,24,27,-3
27,19,27,137,53,41,12
27,19,27,139,742,700,42
27,19,27,141,39,57,-18
27,19,27,143,79,134,-55
27,19,27,145,66,41,25
27,19,27,163,61,48,13
27,19,27,171,199,264,-65
27,21,27,3,92,41,51
27,21,27,7,146,163,-17
27,21,27,9,32,24,8
27,21,27,35,461,579,-118
27,21,27,37,56,28,28
27,21,27,53,228,116,112
27,21,27,57,97,142,-45
27,21,27,61,118,64,54
27,21,27,95,33,0,33
27,21,27,97,65,38,27
27,21,27,123,49,47,2
27,21,27,137,39,64,-25
27,21,27,141,43,0,43
27,21,27,145,32,36,-4
27,21,27,153,53,51,2
27,21,27,171,44,0,44
27,21,38,17,43,40,3
27,23,27,53,35,41,-6
27,23,27,67,86,103,-17
27,23,27,73,41,62,-21
27,23,27,83,37,41,-4
27,23,27,123,0,37,-37
27,23,27,129,42,0,42
27,23,27,145,0,26,-26
27,23,27,151,66,45,21
27,23,27,173,60,96,-36
27,25,4,13,0,34,-34
27,25,27,3,535,430,105
27,25,27,37,137,91,46
27,25,27,53,305,305,0
27,25,27,59,254,299,-45
27,25,27,61,0,26,-26
27,25,27,65,48,57,-9
27,25,27,95,0,36,-36
27,25,27,115,214,173,41
27,25,27,123,640,506,134
27,25,27,137,49,51,-2
27,25,27,139,0,36,-36
27,25,27,141,40,26,14
27,25,27,145,0,24,-24
27,25,27,163,703,609,94
27,25,55,13,0,42,-42
27,25,55,95,153,179,-26
27,25,55,109,29,58,-29
27,27,4,13,28,0,28
27,27,27,3,23,0,23
27,27,27,5,225,189,36
27,27,27,7,39,32,7
27,27,27,37,47,50,-3
27,27,27,41,64,46,18
27,27,27,53,149,245,-96
27,27,27,57,42,32,10
27,27,27,87,24,0,24
27,27,27,107,104,39,65
27,27,27,109,0,28,-28
27,27,27,111,225,146,79
27,27,27,113,40,0,40
27,27,27,119,93,47,46
27,27,27,123,63,67,-4
27,27,27,135,36,0,36
27,27,27,137,34,50,-16
27,27,27,145,51,45,6
27,27,27,167,92,29,63
27,27,38,15,44,32,12
27,27,38,17,2074,1781,293
27,27,38,35,48,62,-14
27,27,38,77,55,36,19
27,27,46,99,0,45,-45
27,29,27,7,140,149,-9
27,29,27,119,34,70,-36
27,31,27,53,60,44,16
27,31,27,137,27,58,-31
27,33,27,53,0,30,-30
27,33,27,63,47,49,-2
27,33,27,83,0,27,-27
27,33,27,105,31,35,-4
27,33,27,127,0,29,-29
27,33,27,165,47,0,47
27,33,46,99,0,33,-33
27,35,4,13,35,54,-19
27,35,27,1,168,116,52
27,35,27,3,148,110,38
27,35,27,7,66,59,7
27,35,27,9,77,39,38
27,35,27,13,29,0,29
27,35,27,17,34,0,34
27,35,27,19,38,0,38
27,35,27,21,579,461,118
27,35,27,37,156,84,72
27,35,27,53,447,345,102
27,35,27,57,0,42,-42
27,35,27,61,40,49,-9
27,35,27,67,0,32,-32
27,35,27,95,57,102,-45
27,35,27,97,221,174,47
27,35,27,109,27,36,-9
27,35,27,111,36,46,-10
27,35,27,123,143,142,1
27,35,27,137,128,178,-50
27,35,27,139,62,31,31
27,35,27,141,116,70,46
27,35,27,145,174,174,0
27,35,27,153,63,56,7
27,35,27,159,40,40,0
27,35,27,163,63,65,-2
27,35,27,171,60,42,18
27,35,38,17,33,33,0
27,37,2,20,0,34,-34
27,37,4,13,200,384,-184
27,37,4,19,29,62,-33
27,37,6,1,42,29,13
27,37,6,13,0,31,-31
27,37,6,37,185,160,25
27,37,6,59,25,48,-23
27,37,6,65,0,30,-30
27,37,6,67,44,0,44
27,37,6,73,103,125,-22
27,37,6,75,0,31,-31
27,37,6,85,44,49,-5
27,37,8,1,0,26,-26
27,37,8,5,29,49,-20
27,37,8,31,28,57,-29
27,37,8,35,0,52,-52
27,37,8,41,0,47,-47
27,37,8,59,31,0,31
27,37,8,69,0,31,-31
27,37,11,1,0,40,-40
27,37,12,11,0,42,-42
27,37,12,31,0,30,-30
27,37,12,57,70,60,10
27,37,12,71,50,75,-25
27,37,12,86,30,0,30
27,37,12,95,22,52,-30
27,37,12,99,29,25,4
27,37,12,103,0,51,-51
27,37,12,115,0,24,-24
27,37,13,67,27,0,27
27,37,13,121,39,27,12
27,37,15,3,36,0,36
27,37,16,1,58,0,58
27,37,17,31,220,311,-91
27,37,17,43,66,48,18
27,37,17,97,45,31,14
27,37,17,111,0,29,-29
27,37,17,113,28,0,28
27,37,17,197,0,48,-48
27,37,18,89,0,43,-43
27,37,18,97,0,36,-36
27,37,19,13,0,36,-36
27,37,19,33,0,28,-28
27,37,19,103,36,0,36
27,37,19,113,55,51,4
27,37,19,153,67,144,-77
27,37,19,169,38,20,18
27,37,20,91,33,59,-26
27,37,25,17,38,51,-13
27,37,26,125,44,29,15
27,37,26,161,38,0,38
27,37,26,163,46,55,-9
27,37,27,1,0,42,-42
27,37,27,3,783,877,-94
27,37,27,5,32,28,4
27,37,27,7,52,28,24
27,37,27,9,30,32,-2
27,37,27,13,232,163,69
27,37,27,15,53,0,53
27,37,27,17,27,48,-21
27,37,27,19,255,286,-31
27,37,27,21,28,56,-28
27,37,27,25,91,137,-46
27,37,27,27,50,47,3
27,37,27,35,84,156,-72
27,37,27,39,25,35,-10
27,37,27,41,0,71,-71
27,37,27,47,58,41,17
27,37,27,49,388,423,-35
27,37,27,53,8607,7572,1035
27,37,27,57,0,32,-32
27,37,27,59,69,52,17
27,37,27,61,45,64,-19
27,37,27,67,49,32,17
27,37,27,79,125,119,6
27,37,27,83,59,50,9
27,37,27,85,60,69,-9
27,37,27,91,32,27,5
27,37,27,93,30,0,30
27,37,27,95,0,28,-28
27,37,27,99,83,38,45
27,37,27,103,73,57,16
27,37,27,109,329,288,41
27,37,27,111,47,39,8
27,37,27,115,51,80,-29
27,37,27,119,24,0,24
27,37,27,123,5642,4628,1014
27,37,27,127,0,25,-25
27,37,27,131,547,705,-158
27,37,27,137,347,263,84
27,37,27,139,2106,2815,-709
27,37,27,141,135,158,-23
27,37,27,143,0,41,-41
27,37,27,145,202,158,44
27,37,27,147,148,116,32
27,37,27,157,45,41,4
27,37,27,161,58,38,20
27,37,27,163,2082,2139,-57
27,37,27,169,98,65,33
27,37,27,171,162,280,-118
27,37,29,95,31,0,31
27,37,29,189,0,38,-38
27,37,31,55,43,57,-14
27,37,31,109,29,34,-5
27,37,32,3,85,176,-91
27,37,35,1,0,26,-26
27,37,36,47,24,26,-2
27,37,36,61,0,54,-54
27,37,36,81,43,0,43
27,37,37,119,36,29,7
27,37,37,133,33,0,33
27,37,37,183,0,47,-47
27,37,38,15,38,31,7
27,37,38,17,151,106,45
27,37,38,35,89,53,36
27,37,39,35,45,0,45
27,37,39,49,54,49,5
27,37,40,109,32,31,1
27,37,41,51,0,28,-28
27,37,42,101,0,27,-27
27,37,46,99,80,69,11
27,37,47,37,0,38,-38
27,37,47,157,36,41,-5
27,37,48,29,86,44,42
27,37,48,85,33,43,-10
27,37,48,113,46,55,-9
27,37,48,121,0,46,-46
27,37,48,201,46,64,-18
27,37,48,439,0,86,-86
27,37,48,453,38,0,38
27,37,49,35,55,48,7
27,37,51,59,0,32,-32
27,37,51,810,27,31,-4
27,37,53,33,85,132,-47
27,37,53,53,0,38,-38
27,37,55,5,37,32,5
27,37,55,9,62,37,25
27,37,55,17,35,0,35
27,37,55,25,109,116,-7
27,37,55,31,46,0,46
27,37,55,33,44,48,-4
27,37,55,35,121,87,34
27,37,55,63,27,43,-16
27,37,55,73,36,44,-8
27,37,55,79,89,76,13
27,37,55,87,32,36,-4
27,37,55,93,182,290,-108
27,37,55,95,66,86,-20
27,37,55,109,223,334,-111
27,37,55,129,26,35,-9
27,37,55,133,69,24,45
27,39,27,37,35,25,10
27,39,27,45,29,0,29
27,39,27,47,30,0,30
27,39,27,49,55,56,-1
27,39,27,53,26,44,-18
27,39,27,99,86,96,-10
27,39,27,109,535,478,57
27,39,27,123,0,25,-25
27,39,27,131,0,39,-39
27,39,27,147,116,94,22
27,41,4,13,0,25,-25
27,41,27,3,54,28,26
27,41,27,9,0,25,-25
27,41,27,27,46,64,-18
27,41,27,37,71,0,71
27,41,27,51,100,114,-14
27,41,27,53,210,185,25
27,41,27,67,44,31,13
27,41,27,83,29,0,29
27,41,27,85,26,0,26
27,41,27,111,161,168,-7
27,41,27,121,209,153,56
27,41,27,123,44,79,-35
27,41,27,137,0,38,-38
27,41,27,141,28,0,28
27,41,27,145,171,157,14
27,41,27,149,35,0,35
27,41,27,153,107,79,28
27,41,27,163,0,29,-29
27,41,27,171,46,41,5
27,41,38,17,47,110,-63
27,41,38,35,0,30,-30
27,43,19,189,30,0,30
27,43,27,13,101,136,-35
27,43,27,47,51,106,-55
27,43,27,53,0,41,-41
27,43,27,91,116,88,28
27,43,27,103,30,49,-19
27,43,27,109,0,67,-67
27,45,19,89,39,50,-11
27,45,19,191,31,102,-71
27,45,27,39,0,29,-29
27,45,27,49,0,27,-27
27,45,27,53,51,36,15
27,45,27,55,61,75,-14
27,45,27,99,81,60,21
27,45,27,109,330,375,-45
27,45,27,157,58,0,58
27,45,27,169,113,177,-64
27,45,55,63,0,24,-24
27,47,19,189,44,70,-26
27,47,19,195,35,28,7
27,47,27,13,43,47,-4
27,47,27,37,41,58,-17
27,47,27,39,0,30,-30
27,47,27,43,106,51,55
27,47,27,53,59,99,-40
27,47,27,99,217,237,-20
27,47,27,103,0,24,-24
27,47,27,109,76,100,-24
27,47,27,123,0,55,-55
27,47,27,131,24,38,-14
27,47,27,147,111,104,7
27,47,27,161,36,65,-29
27,47,27,169,0,21,-21
27,49,4,13,0,40,-40
27,49,27,3,34,0,34
27,49,27,13,0,23,-23
27,49,27,37,423,388,35
27,49,27,39,56,55,1
27,49,27,45,27,0,27
27,49,27,53,200,227,-27
27,49,27,99,30,0,30
27,49,27,109,351,332,19
27,49,27,123,137,129,8
27,49,27,131,143,164,-21
27,49,27,137,0,40,-40
27,49,27,139,43,0,43
27,49,27,145,0,33,-33
27,49,27,147,0,34,-34
27,49,27,157,177,139,38
27,49,27,163,75,58,17
27,49,27,169,45,40,5
27,49,55,93,167,198,-31
27,49,55,109,0,39,-39
27,51,27,41,114,100,14
27,51,27,53,0,33,-33
27,51,27,111,0,79,-79
27,51,27,149,28,0,28
27,53,1,73,0,37,-37
27,53,2,20,71,50,21
27,53,4,5,24,0,24
27,53,4,13,799,1157,-358
27,53,4,19,105,177,-72
27,53,4,21,0,60,-60
27,53,4,25,0,35,-35
27,53,5,7,46,86,-40
27,53,5,119,35,50,-15
27,53,5,143,51,41,10
27,53,6,1,127,271,-144
27,53,6,13,83,85,-2
27,53,6,17,0,25,-25
27,53,6,19,100,55,45
27,53,6,29,0,30,-30
27,53,6,37,732,904,-172
27,53,6,41,31,39,-8
27,53,6,53,29,50,-21
27,53,6,59,287,317,-30
27,53,6,65,121,148,-27
27,53,6,67,98,124,-26
27,53,6,71,68,93,-25
27,53,6,73,418,563,-145
27,53,6,75,160,312,-152
27,53,6,77,34,47,-13
27,53,6,81,77,103,-26
27,53,6,83,53,38,15
27,53,6,85,155,287,-132
27,53,6,87,0,21,-21
27,53,6,97,0,50,-50
27,53,6,111,41,74,-33
27,53,8,1,56,72,-16
27,53,8,5,74,203,-129
27,53,8,13,84,131,-47
27,53,8,31,192,298,-106
27,53,8,35,81,103,-22
27,53,8,37,0,31,-31
27,53,8,41,105,131,-26
27,53,8,59,65,103,-38
27,53,8,69,59,72,-13
27,53,8,117,25,20,5
27,53,8,123,0,31,-31
27,53,9,1,102,127,-25
27,53,9,3,94,84,10
27,53,9,9,75,58,17
27,53,10,3,37,49,-12
27,53,11,1,186,219,-33
27,53,12,1,29,0,29
27,53,12,9,63,56,7
27,53,12,11,147,125,22
27,53,12,21,67,137,-70
27,53,12,31,66,114,-48
27,53,12,57,149,129,20
27,53,12,71,120,198,-78
27,53,12,73,23,0,23
27,53,12,81,0,54,-54
27,53,12,83,0,39,-39
27,53,12,86,107,152,-45
27,53,12,87,0,27,-27
27,53,12,95,169,127,42
27,53,12,99,104,97,7
27,53,12,103,95,132,-37
27,53,12,105,43,38,5
27,53,12,113,0,23,-23
27,53,12,115,34,50,-16
27,53,12,117,0,34,-34
27,53,12,127,40,39,1
27,53,13,67,119,127,-8
27,53,13,89,154,131,23
27,53,13,121,163,248,-85
27,53,13,135,118,109,9
27,53,15,1,0,33,-33
27,53,15,3,85,122,-37
27,53,15,9,0,28,-28
27,53,16,1,191,56,135
27,53,17,19,74,56,18
27,53,17,31,1740,1951,-211
27,53,17,37,25,0,25
27,53,17,43,263,258,5
27,53,17,77,27,0,27
27,53,17,89,119,76,43
27,53,17,97,183,106,77
27,53,17,111,43,50,-7
27,53,17,113,37,34,3
27,53,17,143,61,0,61
27,53,17,161,70,0,70
27,53,17,167,49,32,17
27,53,17,197,102,72,30
27,53,17,201,52,51,1
27,53,18,3,31,0,31
27,53,18,39,33,0,33
27,53,18,57,64,72,-8
27,53,18,89,121,87,34
27,53,18,97,161,118,43
27,53,18,105,76,0,76
27,53,18,141,34,52,-18
27,53,18,157,61,30,31
27,53,19,13,94,68,26
27,53,19,33,46,63,-17
27,53,19,49,71,26,45
27,53,19,61,37,0,37
27,53,19,103,176,120,56
27,53,19,113,126,92,34
27,53,19,153,300,250,50
27,53,19,163,76,333,-257
27,53,19,169,135,82,53
27,53,19,189,20,0,20
27,53,19,191,36,0,36
27,53,19,193,37,49,-12
27,53,20,45,51,53,-2
27,53,20,55,44,0,44
27,53,20,91,163,117,46
27,53,20,111,128,32,96
27,53,20,173,65,51,14
27,53,20,209,0,33,-33
27,53,21,67,56,0,56
27,53,21,111,64,88,-24
27,53,22,33,0,35,-35
27,53,22,71,28,41,-13
27,53,23,5,34,25,9
27,53,24,5,25,65,-40
27,53,24,27,0,36,-36
27,53,24,31,114,169,-55
27,53,24,33,52,48,4
27,53,24,510,54,65,-11
27,53,25,9,38,45,-7
27,53,25,17,219,346,-127
27,53,25,21,69,66,3
27,53,25,25,159,183,-24
27,53,25,27,57,45,12
27,53,26,21,30,0,30
27,53,26,49,30,0,30
27,53,26,53,26,0,26
27,53,26,61,33,0,33
27,53,26,65,52,36,16
27,53,26,77,63,53,10
27,53,26,81,108,42,66
27,53,26,93,0,22,-22
27,53,26,99,73,0,73
27,53,26,103,65,0,65
27,53,26,125,270,138,132
27,53,26,139,33,38,-5
27,53,26,145,28,0,28
27,53,26,161,225,83,142
27,53,26,163,234,87,147
27,53,27,1,53,148,-95
27,53,27,3,7401,9320,-1919
27,53,27,5,114,61,53
27,53,27,7,188,155,33
27,53,27,9,330,184,146
27,53,27,13,519,293,226
27,53,27,15,101,58,43
27,53,27,17,61,85,-24
27,53,27,19,2119,3220,-1101
27,53,27,21,116,228,-112
27,53,27,23,41,35,6
27,53,27,25,305,305,0
27,53,27,27,245,149,96
27,53,27,31,44,60,-16
27,53,27,33,30,0,30
27,53,27,35,345,447,-102
27,53,27,37,7572,8607,-1035
27,53,27,39,44,26,18
27,53,27,41,185,210,-25
27,53,27,43,41,0,41
27,53,27,45,36,51,-15
27,53,27,47,99,59,40
27,53,27,49,227,200,27
27,53,27,51,33,0,33
27,53,27,55,56,0,56
27,53,27,57,67,64,3
27,53,27,59,260,370,-110
27,53,27,61,150,170,-20
27,53,27,63,27,0,27
27,53,27,65,89,68,21
27,53,27,67,210,121,89
27,53,27,71,0,36,-36
27,53,27,73,29,0,29
27,53,27,75,32,42,-10
27,53,27,79,136,125,11
27,53,27,83,158,54,104
27,53,27,85,318,254,64
27,53,27,89,32,0,32
27,53,27,91,84,30,54
27,53,27,93,121,127,-6
27,53,27,95,151,203,-52
27,53,27,97,108,96,12
27,53,27,99,130,90,40
27,53,27,103,156,129,27
27,53,27,105,61,42,19
27,53,27,109,763,534,229
27,53,27,111,184,215,-31
27,53,27,113,48,0,48
27,53,27,115,114,127,-13
27,53,27,119,62,42,20
27,53,27,121,39,64,-25
27,53,27,123,12854,12813,41
27,53,27,127,40,0,40
27,53,27,129,79,41,38
27,53,27,131,423,375,48
27,53,27,135,38,32,6
27,53,27,137,1020,799,221
27,53,27,139,2202,3491,-1289
27,53,27,141,1180,1573,-393
27,53,27,143,63,60,3
27,53,27,145,1185,725,460
27,53,27,147,168,160,8
27,53,27,149,36,28,8
27,53,27,151,56,31,25
27,53,27,153,39,57,-18
27,53,27,157,60,37,23
27,53,27,159,39,24,15
27,53,27,161,78,45,33
27,53,27,163,1883,2038,-155
27,53,27,169,190,131,59
27,53,27,171,2204,3624,-1420
27,53,27,173,34,33,1
27,53,29,19,42,31,11
27,53,29,77,34,41,-7
27,53,29,95,127,164,-37
27,53,29,183,45,37,8
27,53,29,189,181,145,36
27,53,29,510,83,64,19
27,53,30,29,0,35,-35
27,53,30,31,26,71,-45
27,53,30,63,42,37,5
27,53,30,111,35,25,10
27,53,31,43,0,52,-52
27,53,31,47,54,31,23
27,53,31,55,264,206,58
27,53,31,79,25,75,-50
27,53,31,109,77,49,28
27,53,31,153,52,39,13
27,53,32,3,240,428,-188
27,53,32,31,35,39,-4
27,53,33,11,31,36,-5
27,53,34,3,72,46,26
27,53,34,5,27,0,27
27,53,34,7,24,22,2
27,53,34,13,45,49,-4
27,53,34,17,77,79,-2
27,53,34,21,58,44,14
27,53,34,23,83,153,-70
27,53,34,27,75,95,-20
27,53,34,35,32,45,-13
27,53,34,39,0,36,-36
27,53,35,1,66,74,-8
27,53,36,5,89,64,25
27,53,36,29,61,45,16
27,53,36,47,205,328,-123
27,53,36,55,69,44,25
27,53,36,59,24,43,-19
27,53,36,61,352,503,-151
27,53,36,67,32,26,6
27,53,36,71,37,0,37
27,53,36,81,102,155,-53
27,53,36,91,0,27,-27
27,53,36,103,46,38,8
27,53,36,109,42,24,18
27,53,36,119,63,59,4
27,53,37,21,0,24,-24
27,53,37,63,57,36,21
27,53,37,67,0,36,-36
27,53,37,81,43,54,-11
27,53,37,119,151,244,-93
27,53,37,135,0,37,-37
27,53,37,183,69,133,-64
27,53,38,15,130,129,1
27,53,38,17,512,348,164
27,53,38,35,225,137,88
27,53,38,59,22,24,-2
27,53,38,93,35,0,35
27,53,38,101,54,31,23
27,53,39,17,51,47,4
27,53,39,35,131,111,20
27,53,39,49,259,221,38
27,53,39,61,106,91,15
27,53,39,95,0,28,-28
27,53,39,113,57,26,31
27,53,39,153,43,0,43
27,53,40,109,32,47,-15
27,53,40,143,41,48,-7
27,53,41,5,30,33,-3
27,53,41,39,34,69,-35
27,53,41,51,146,259,-113
27,53,41,67,92,134,-42
27,53,42,3,144,99,45
27,53,42,17,61,45,16
27,53,42,29,37,39,-2
27,53,42,45,32,0,32
27,53,42,91,47,89,-42
27,53,42,101,134,127,7
27,53,44,7,46,47,-1
27,53,45,13,0,30,-30
27,53,45,19,26,0,26
27,53,45,45,40,45,-5
27,53,46,11,43,33,10
27,53,46,13,52,33,19
27,53,46,29,49,28,21
27,53,46,79,22,0,22
27,53,46,83,44,35,9
27,53,46,99,295,243,52
27,53,46,103,69,35,34
27,53,47,37,138,134,4
27,53,47,65,31,0,31
27,53,47,125,28,0,28
27,53,47,157,149,126,23
27,53,48,27,0,60,-60
27,53,48,29,94,170,-76
27,53,48,41,0,31,-31
27,53,48,85,91,127,-36
27,53,48,113,233,309,-76
27,53,48,121,54,86,-32
27,53,48,141,0,49,-49
27,53,48,157,30,43,-13
27,53,48,201,231,412,-181
27,53,48,215,0,39,-39
27,53,48,339,0,56,-56
27,53,48,439,144,254,-110
27,53,48,453,136,201,-65
27,53,48,491,60,79,-19
27,53,49,35,116,171,-55
27,53,49,49,72,37,35
27,53,50,7,27,26,1
27,53,51,3,28,43,-15
27,53,51,13,73,70,3
27,53,51,59,182,205,-23
27,53,51,87,38,53,-15
27,53,51,107,33,0,33
27,53,51,153,29,0,29
27,53,51,510,51,39,12
27,53,51,540,27,0,27
27,53,51,710,0,36,-36
27,53,51,810,62,40,22
27,53,53,11,0,28,-28
27,53,53,33,404,679,-275
27,53,53,53,48,90,-42
27,53,53,61,55,66,-11
27,53,53,63,34,37,-3
27,53,53,67,0,44,-44
27,53,53,73,0,33,-33
27,53,55,3,29,0,29
27,53,55,5,170,73,97
27,53,55,9,181,144,37
27,53,55,13,52,55,-3
27,53,55,15,23,0,23
27,53,55,17,91,65,26
27,53,55,19,24,0,24
27,53,55,25,726,481,245
27,53,55,27,37,0,37
27,53,55,31,139,49,90
27,53,55,33,123,83,40
27,53,55,35,319,113,206
27,53,55,39,47,0,47
27,53,55,55,27,0,27
27,53,55,59,50,39,11
27,53,55,63,271,125,146
27,53,55,71,35,0,35
27,53,55,73,147,85,62
27,53,55,75,25,0,25
27,53,55,79,553,429,124
27,53,55,81,29,0,29
27,53,55,85,26,0,26
27,53,55,87,141,100,41
27,53,55,89,55,34,21
27,53,55,93,109,171,-62
27,53,55,95,157,110,47
27,53,55,97,111,31,80
27,53,55,101,83,0,83
27,53,55,105,68,32,36
27,53,55,109,264,367,-103
27,53,55,111,31,0,31
27,53,55,113,36,45,-9
27,53,55,117,48,42,6
27,53,55,119,23,0,23
27,53,55,121,32,0,32
27,53,55,123,0,33,-33
27,53,55,127,35,0,35
27,53,55,129,23,31,-8
27,53,55,131,85,37,48
27,53,55,133,208,167,41
27,53,55,139,92,80,12
27,53,55,141,68,0,68
27,55,19,5,22,51,-29
27,55,27,45,75,61,14
27,55,27,53,0,56,-56
27,55,27,109,27,52,-25
27,55,27,169,111,122,-11
27,55,55,25,0,25,-25
27,55,55,63,312,414,-102
27,57,27,3,60,28,32
27,57,27,5,100,125,-25
27,57,27,7,234,227,7
27,57,27,21,142,97,45
27,57,27,27,32,42,-10
27,57,27,35,42,0,42
27,57,27,37,32,0,32
27,57,27,53,64,67,-3
27,57,27,111,0,28,-28
27,57,27,123,23,32,-9
27,57,27,145,45,0,45
27,57,27,159,54,72,-18
27,57,38,17,45,50,-5
27,59,27,3,883,634,249
27,59,27,25,299,254,45
27,59,27,37,52,69,-17
27,59,27,53,370,260,110
27,59,27,65,172,160,12
27,59,27,95,134,98,36
27,59,27,115,98,109,-11
27,59,27,123,163,214,-51
27,59,27,137,35,51,-16
27,59,27,141,173,146,27
27,59,27,145,0,23,-23
27,59,27,163,91,92,-1
27,59,27,171,41,77,-36
27,61,4,13,0,28,-28
27,61,27,1,78,59,19
27,61,27,3,82,52,30
27,61,27,7,52,96,-44
27,61,27,17,0,30,-30
27,61,27,21,64,118,-54
27,61,27,25,26,0,26
27,61,27,35,49,40,9
27,61,27,37,64,45,19
27,61,27,53,170,150,20
27,61,27,71,34,0,34
27,61,27,123,82,75,7
27,61,27,137,393,421,-28
27,61,27,139,33,0,33
27,61,27,141,36,0,36
27,61,27,145,44,40,4
27,61,38,17,26,22,4
27,63,19,59,49,54,-5
27,63,19,63,0,26,-26
27,63,27,33,49,47,2
27,63,27,53,0,27,-27
27,63,27,91,50,50,0
27,63,27,105,51,87,-36
27,63,46,99,0,21,-21
27,65,27,3,109,81,28
27,65,27,9,0,26,-26
27,65,27,25,57,48,9
27,65,27,53,68,89,-21
27,65,27,59,160,172,-12
27,65,27,95,70,87,-17
27,65,27,115,193,195,-2
27,65,27,123,97,87,10
27,65,27,141,35,43,-8
27,65,27,145,33,32,1
27,67,4,13,30,0,30
27,67,27,3,28,33,-5
27,67,27,9,23,39,-16
27,67,27,19,0,22,-22
27,67,27,23,103,86,17
27,67,27,35,32,0,32
27,67,27,37,32,49,-17
27,67,27,41,31,44,-13
27,67,27,53,121,210,-89
27,67,27,83,68,0,68
27,67,27,85,41,36,5
27,67,27,93,79,70,9
27,67,27,123,56,87,-31
27,67,27,127,33,41,-8
27,67,27,129,161,134,27
27,67,27,137,0,61,-61
27,67,27,141,0,27,-27
27,67,27,145,194,263,-69
27,67,27,149,0,26,-26
27,67,27,151,108,162,-54
27,67,27,171,0,44,-44
27,67,27,173,26,0,26
27,67,38,17,0,26,-26
27,67,48,215,0,65,-65
27,69,38,35,0,27,-27
27,71,27,7,30,78,-48
27,71,27,53,36,0,36
27,71,27,61,0,34,-34
27,71,27,137,55,110,-55
27,73,27,23,62,41,21
27,73,27,53,0,29,-29
27,73,27,173,0,34,-34
27,75,27,53,42,32,10
27,75,27,123,0,27,-27
27,75,27,137,246,325,-79
27,77,27,135,48,69,-21
27,79,27,13,255,208,47
27,79,27,19,49,37,12
27,79,27,37,119,125,-6
27,79,27,53,125,136,-11
27,79,27,103,204,256,-52
27,79,27,109,0,27,-27
27,79,27,123,35,40,-5
27,79,27,131,154,184,-30
27,79,27,139,299,210,89
27,79,27,143,54,102,-48
27,79,27,147,25,27,-2
27,79,27,161,68,74,-6
27,81,27,83,88,116,-28
27,81,27,117,45,47,-2
27,81,46,11,57,30,27
27,83,27,13,35,51,-16
27,83,27,15,28,0,28
27,83,27,23,41,37,4
27,83,27,33,27,0,27
27,83,27,37,50,59,-9
27,83,27,41,0,29,-29
27,83,27,53,54,158,-104
27,83,27,67,0,68,-68
27,83,27,81,116,88,28
27,83,27,85,22,0,22
27,83,27,101,43,57,-14
27,83,27,105,37,0,37
27,83,27,117,37,61,-24
27,83,27,123,0,65,-65
27,83,27,127,115,91,24
27,83,27,129,56,0,56
27,83,27,145,0,40,-40
27,83,27,173,132,96,36
27,83,46,11,0,32,-32
27,83,46,99,56,90,-34
27,85,27,3,40,37,3
27,85,27,13,32,43,-11
27,85,27,15,0,27,-27
27,85,27,19,286,218,68
27,85,27,37,69,60,9
27,85,27,41,0,26,-26
27,85,27,53,254,318,-64
27,85,27,67,36,41,-5
27,85,27,83,0,22,-22
27,85,27,93,224,215,9
27,85,27,123,46,68,-22
27,85,27,129,80,95,-15
27,85,27,137,0,43,-43
27,85,27,139,49,90,-41
27,85,27,141,0,38,-38
27,85,27,143,142,118,24
27,85,27,145,66,84,-18
27,85,27,171,208,230,-22
27,85,48,61,0,42,-42
27,87,27,5,139,100,39
27,87,27,27,0,24,-24
27,87,27,119,0,37,-37
27,87,38,17,0,30,-30
27,89,27,53,0,32,-32
27,89,27,113,147,89,58
27,89,27,119,54,64,-10
27,89,27,135,0,31,-31
27,89,38,17,0,50,-50
27,89,38,35,35,92,-57
27,91,19,63,29,38,-9
27,91,27,3,0,30,-30
27,91,27,13,55,117,-62
27,91,27,37,27,32,-5
27,91,27,43,88,116,-28
27,91,27,53,30,84,-54
27,91,27,63,50,50,0
27,91,27,103,0,59,-59
27,91,27,109,0,23,-23
27,91,27,123,0,30,-30
27,91,27,165,42,41,1
27,91,46,99,0,42,-42
27,93,27,9,37,51,-14
27,93,27,37,0,30,-30
27,93,27,53,127,121,6
27,93,27,67,70,79,-9
27,93,27,85,215,224,-9
27,93,27,123,31,20,11
27,93,27,137,35,0,35
27,93,27,145,190,230,-40
27,93,27,171,199,213,-14
27,95,27,1,39,38,1
27,95,27,3,213,159,54
27,95,27,9,81,126,-45
27,95,27,21,0,33,-33
27,95,27,25,36,0,36
27,95,27,35,102,57,45
27,95,27,37,28,0,28
27,95,27,53,203,151,52
27,95,27,59,98,134,-36
27,95,27,65,87,70,17
27,95,27,97,80,35,45
27,95,27,115,0,37,-37
27,95,27,123,61,58,3
27,95,27,141,325,307,18
27,95,27,145,69,132,-63
27,95,27,171,82,54,28
27,97,27,3,47,37,10
27,97,27,9,218,220,-2
27,97,27,21,38,65,-27
27,97,27,35,174,221,-47
27,97,27,53,96,108,-12
27,97,27,95,35,80,-45
27,97,27,123,40,29,11
27,97,27,137,50,46,4
27,97,27,141,46,62,-16
27,97,27,145,330,277,53
27,97,27,153,212,135,77
27,97,27,159,38,42,-4
27,97,27,171,38,26,12
27,97,38,17,0,26,-26
27,99,19,89,0,28,-28
27,99,19,131,0,47,-47
27,99,27,3,37,26,11
27,99,27,13,48,69,-21
27,99,27,37,38,83,-45
27,99,27,39,96,86,10
27,99,27,45,60,81,-21
27,99,27,47,237,217,20
27,99,27,49,0,30,-30
27,99,27,53,90,130,-40
27,99,27,109,324,388,-64
27,99,27,123,33,40,-7
27,99,27,131,32,29,3
27,99,27,137,0,33,-33
27,99,27,147,95,186,-91
27,99,27,157,0,30,-30
27,99,27,169,30,30,0
27,101,27,83,57,43,14
27,101,27,105,68,66,2
27,101,27,117,28,42,-14
27,101,46,99,0,39,-39
27,103,27,3,29,28,1
27,103,27,13,1270,1301,-31
27,103,27,15,159,130,29
27,103,27,17,24,0,24
27,103,27,19,0,31,-31
27,103,27,37,57,73,-16
27,103,27,43,49,30,19
27,103,27,47,24,0,24
27,103,27,53,129,156,-27
27,103,27,79,256,204,52
27,103,27,91,59,0,59
27,103,27,109,0,52,-52
27,103,27,123,34,53,-19
27,103,27,131,24,46,-22
27,103,27,137,0,29,-29
27,103,27,139,55,52,3
27,103,27,143,35,64,-29
27,103,27,147,0,27,-27
27,103,27,161,44,50,-6
27,103,27,163,0,31,-31
27,103,27,165,49,29,20
27,105,19,21,46,0,46
27,105,19,143,0,51,-51
27,105,27,13,0,28,-28
27,105,27,33,35,31,4
27,105,27,53,42,61,-19
27,105,27,63,87,51,36
27,105,27,83,0,37,-37
27,105,27,101,66,68,-2
27,105,27,117,0,35,-35
27,105,27,133,63,74,-11
27,105,46,99,194,176,18
27,107,27,27,39,104,-65
27,107,27,119,0,40,-40
27,107,38,17,91,131,-40
27,109,4,13,115,196,-81
27,109,4,19,28,29,-1
27,109,6,37,42,38,4
27,109,6,73,29,25,4
27,109,8,31,0,29,-29
27,109,8,41,0,28,-28
27,109,12,31,0,32,-32
27,109,17,31,118,112,6
27,109,17,43,24,0,24
27,109,19,89,36,0,36
27,109,19,103,59,44,15
27,109,19,113,30,0,30
27,109,19,153,41,43,-2
27,109,19,169,36,0,36
27,109,25,17,27,0,27
27,109,25,25,0,35,-35
27,109,27,3,133,87,46
27,109,27,9,24,0,24
27,109,27,13,140,113,27
27,109,27,19,50,30,20
27,109,27,27,28,0,28
27,109,27,35,36,27,9
27,109,27,37,288,329,-41
27,109,27,39,478,535,-57
27,109,27,43,67,0,67
27,109,27,45,375,330,45
27,109,27,47,100,76,24
27,109,27,49,332,351,-19
27,109,27,53,534,763,-229
27,109,27,55,52,27,25
27,109,27,79,27,0,27
27,109,27,91,23,0,23
27,109,27,99,388,324,64
27,109,27,103,52,0,52
27,109,27,111,28,0,28
27,109,27,123,235,286,-51
27,109,27,131,91,86,5
27,109,27,137,85,96,-11
27,109,27,139,49,53,-4
27,109,27,141,34,35,-1
27,109,27,145,93,53,40
27,109,27,147,133,107,26
27,109,27,157,380,373,7
27,109,27,161,42,0,42
27,109,27,163,113,105,8
27,109,27,169,447,270,177
27,109,27,171,39,33,6
27,109,31,55,31,41,-10
27,109,32,3,41,39,2
27,109,36,61,0,39,-39
27,109,37,183,0,58,-58
27,109,38,17,43,61,-18
27,109,38,35,37,36,1
27,109,39,61,0,37,-37
27,109,46,99,41,37,4
27,109,48,201,36,45,-9
27,109,48,453,0,32,-32
27,109,53,33,34,93,-59
27,109,53,53,0,25,-25
27,109,55,9,32,0,32
27,109,55,25,98,99,-1
27,109,55,35,71,49,22
27,109,55,63,149,104,45
27,109,55,79,43,61,-18
27,109,55,121,24,0,24
27,109,55,133,25,0,25
27,109,55,139,29,0,29
27,109,55,141,23,0,23
27,111,4,13,0,51,-51
27,111,27,3,100,28,72
27,111,27,5,229,259,-30
27,111,27,7,0,28,-28
27,111,27,27,146,225,-79
27,111,27,35,46,36,10
27,111,27,37,39,47,-8
27,111,27,41,168,161,7
27,111,27,51,79,0,79
27,111,27,53,215,184,31
27,111,27,57,28,0,28
27,111,27,109,0,28,-28
27,111,27,119,0,27,-27
27,111,27,123,65,64,1
27,111,27,137,37,50,-13
27,111,27,145,79,95,-16
27,111,27,153,87,71,16
27,111,27,159,150,104,46
27,111,27,167,71,63,8
27,111,27,171,44,52,-8
27,111,38,17,231,320,-89
27,111,38,35,28,0,28
27,111,38,77,43,0,43
27,111,53,33,0,25,-25
27,113,27,7,53,49,4
27,113,27,27,0,40,-40
27,113,27,53,0,48,-48
27,113,27,89,89,147,-58
27,113,27,119,72,75,-3
27,113,27,125,85,79,6
27,113,27,135,88,53,35
27,113,38,17,31,63,-32
27,113,38,35,37,94,-57
27,115,27,3,132,129,3
27,115,27,17,88,119,-31
27,115,27,25,173,214,-41
27,115,27,37,80,51,29
27,115,27,53,127,114,13
27,115,27,59,109,98,11
27,115,27,65,195,193,2
27,115,27,95,37,0,37
27,115,27,123,134,93,41
27,115,27,137,64,99,-35
27,115,27,145,0,36,-36
27,115,27,163,100,62,38
27,115,55,13,33,43,-10
27,115,55,95,0,33,-33
27,117,27,13,0,26,-26
27,117,27,81,47,45,2
27,117,27,83,61,37,24
27,117,27,101,42,28,14
27,117,27,105,35,0,35
27,117,27,133,39,0,39
27,117,46,11,0,28,-28
27,117,46,99,95,107,-12
27,119,27,7,50,52,-2
27,119,27,27,47,93,-46
27,119,27,29,70,34,36
27,119,27,37,0,24,-24
27,119,27,53,42,62,-20
27,119,27,87,37,0,37
27,119,27,89,64,54,10
27,119,27,107,40,0,40
27,119,27,111,27,0,27
27,119,27,113,75,72,3
27,119,27,123,0,21,-21
27,119,27,125,55,29,26
27,119,27,135,25,59,-34
27,119,27,137,27,23,4
27,119,27,145,0,24,-24
27,119,38,17,55,137,-82
27,119,38,35,558,563,-5
27,121,27,3,34,0,34
27,121,27,41,153,209,-56
27,121,27,53,64,39,25
27,121,27,123,0,32,-32
27,121,27,145,68,42,26
27,121,27,149,48,41,7
27,121,27,151,0,41,-41
27,123,2,20,47,60,-13
27,123,4,13,173,316,-143
27,123,4,19,55,60,-5
27,123,6,1,50,70,-20
27,123,6,13,0,55,-55
27,123,6,19,80,56,24
27,123,6,37,201,225,-24
27,123,6,59,41,77,-36
27,123,6,65,34,48,-14
27,123,6,67,53,61,-8
27,123,6,71,37,29,8
27,123,6,73,104,150,-46
27,123,6,75,47,75,-28
27,123,6,85,51,78,-27
27,123,6,111,0,30,-30
27,123,8,5,31,50,-19
27,123,8,13,0,32,-32
27,123,8,31,55,86,-31
27,123,8,41,56,27,29
27,123,8,59,0,34,-34
27,123,8,69,27,33,-6
27,123,9,1,0,35,-35
27,123,9,3,0,36,-36
27,123,9,9,0,28,-28
27,123,11,1,62,80,-18
27,123,12,9,0,28,-28
27,123,12,11,53,54,-1
27,123,12,21,0,38,-38
27,123,12,31,0,29,-29
27,123,12,57,39,60,-21
27,123,12,71,25,56,-31
27,123,12,86,0,30,-30
27,123,12,95,41,44,-3
27,123,12,99,30,26,4
27,123,12,103,30,50,-20
27,123,12,115,0,33,-33
27,123,12,127,0,31,-31
27,123,13,67,0,37,-37
27,123,13,89,59,79,-20
27,123,13,121,26,50,-24
27,123,13,135,34,41,-7
27,123,15,3,49,51,-2
27,123,17,19,30,0,30
27,123,17,31,524,651,-127
27,123,17,43,43,61,-18
27,123,17,89,28,48,-20
27,123,17,97,37,41,-4
27,123,17,197,25,0,25
27,123,17,201,28,0,28
27,123,18,89,52,36,16
27,123,18,97,44,44,0
27,123,19,49,0,34,-34
27,123,19,61,25,0,25
27,123,19,103,84,39,45
27,123,19,113,29,43,-14
27,123,19,153,114,103,11
27,123,19,163,0,65,-65
27,123,19,169,48,0,48
27,123,20,91,0,36,-36
27,123,21,111,24,41,-17
27,123,24,31,31,50,-19
27,123,25,17,36,80,-44
27,123,25,21,25,35,-10
27,123,25,25,36,38,-2
27,123,26,65,0,29,-29
27,123,26,81,26,33,-7
27,123,26,125,53,46,7
27,123,26,161,26,41,-15
27,123,26,163,47,0,47
27,123,27,1,46,46,0
27,123,27,3,4255,4688,-433
27,123,27,7,84,79,5
27,123,27,9,75,60,15
27,123,27,13,172,108,64
27,123,27,15,46,26,20
27,123,27,17,72,52,20
27,123,27,19,166,155,11
27,123,27,21,47,49,-2
27,123,27,23,37,0,37
27,123,27,25,506,640,-134
27,123,27,27,67,63,4
27,123,27,35,142,143,-1
27,123,27,37,4628,5642,-1014
27,123,27,39,25,0,25
27,123,27,41,79,44,35
27,123,27,47,55,0,55
27,123,27,49,129,137,-8
27,123,27,53,12813,12854,-41
27,123,27,57,32,23,9
27,123,27,59,214,163,51
27,123,27,61,75,82,-7
27,123,27,65,87,97,-10
27,123,27,67,87,56,31
27,123,27,75,27,0,27
27,123,27,79,40,35,5
27,123,27,83,65,0,65
27,123,27,85,68,46,22
27,123,27,91,30,0,30
27,123,27,93,20,31,-11
27,123,27,95,58,61,-3
27,123,27,97,29,40,-11
27,123,27,99,40,33,7
27,123,27,103,53,34,19
27,123,27,109,286,235,51
27,123,27,111,64,65,-1
27,123,27,115,93,134,-41
27,123,27,119,21,0,21
27,123,27,121,32,0,32
27,123,27,131,195,135,60
27,123,27,137,486,351,135
27,123,27,139,327,395,-68
27,123,27,141,244,253,-9
27,123,27,145,281,233,48
27,123,27,147,62,46,16
27,123,27,151,33,0,33
27,123,27,153,32,32,0
27,123,27,157,0,21,-21
27,123,27,159,25,0,25
27,123,27,161,30,0,30
27,123,27,163,5368,7509,-2141
27,123,27,169,95,29,66
27,123,27,171,238,315,-77
27,123,29,47,0,25,-25
27,123,29,95,50,27,23
27,123,29,189,40,41,-1
27,123,29,510,27,28,-1
27,123,31,55,68,111,-43
27,123,31,109,25,27,-2
27,123,32,3,94,188,-94
27,123,35,1,37,44,-7
27,123,36,47,48,78,-30
27,123,36,61,56,125,-69
27,123,36,81,32,33,-1
27,123,37,119,28,58,-30
27,123,37,183,0,58,-58
27,123,38,15,43,26,17
27,123,38,17,181,64,117
27,123,38,35,55,0,55
27,123,39,35,63,0,63
27,123,39,49,69,76,-7
27,123,39,61,30,0,30
27,123,40,109,27,0,27
27,123,40,143,0,69,-69
27,123,41,5,0,30,-30
27,123,41,51,42,61,-19
27,123,41,67,0,32,-32
27,123,42,3,57,33,24
27,123,42,101,0,47,-47
27,123,44,7,0,24,-24
27,123,46,5,0,81,-81
27,123,46,13,20,0,20
27,123,46,99,110,120,-10
27,123,46,103,21,0,21
27,123,47,37,56,29,27
27,123,47,157,63,47,16
27,123,48,29,37,59,-22
27,123,48,85,23,0,23
27,123,48,113,78,122,-44
27,123,48,201,62,117,-55
27,123,48,215,0,24,-24
27,123,48,439,40,84,-44
27,123,48,453,50,69,-19
27,123,48,491,0,24,-24
27,123,49,35,50,31,19
27,123,51,13,38,29,9
27,123,51,59,44,59,-15
27,123,51,510,26,39,-13
27,123,53,33,126,187,-61
27,123,53,53,0,38,-38
27,123,55,5,57,45,12
27,123,55,9,75,52,23
27,123,55,13,38,58,-20
27,123,55,17,29,53,-24
27,123,55,25,335,204,131
27,123,55,31,43,48,-5
27,123,55,33,71,72,-1
27,123,55,35,167,104,63
27,123,55,59,37,0,37
27,123,55,63,141,93,48
27,123,55,73,75,46,29
27,123,55,79,255,226,29
27,123,55,87,51,42,9
27,123,55,93,177,204,-27
27,123,55,95,120,190,-70
27,123,55,97,29,33,-4
27,123,55,101,35,0,35
27,123,55,109,487,586,-99
27,123,55,129,0,37,-37
27,123,55,133,76,39,37
27,123,55,139,68,27,41
27,123,55,141,29,0,29
27,125,27,113,79,85,-6
27,125,27,119,29,55,-26
27,125,38,35,0,27,-27
27,127,27,13,0,25,-25
27,127,27,15,77,69,8
27,127,27,33,29,0,29
27,127,27,37,25,0,25
27,127,27,53,0,40,-40
27,127,27,67,41,33,8
27,127,27,83,91,115,-24
27,127,27,129,106,76,30
27,127,27,145,0,30,-30
27,127,46,11,0,31,-31
27,129,27,13,0,28,-28
27,129,27,15,0,33,-33
27,129,27,19,0,34,-34
27,129,27,23,0,42,-42
27,129,27,53,41,79,-38
27,129,27,67,134,161,-27
27,129,27,83,0,56,-56
27,129,27,85,95,80,15
27,129,27,127,76,106,-30
27,129,27,143,36,41,-5
27,129,27,145,0,38,-38
27,129,27,173,39,30,9
27,129,48,215,0,61,-61
27,131,4,13,0,36,-36
27,131,6,37,35,0,35
27,131,17,31,0,34,-34
27,131,27,3,41,24,17
27,131,27,13,70,85,-15
27,131,27,19,27,24,3
27,131,27,37,705,547,158
27,131,27,39,39,0,39
27,131,27,47,38,24,14
27,131,27,49,164,143,21
27,131,27,53,375,423,-48
27,131,27,79,184,154,30
27,131,27,99,29,32,-3
27,131,27,103,46,24,22
27,131,27,109,86,91,-5
27,131,27,123,135,195,-60
27,131,27,137,34,26,8
27,131,27,139,272,157,115
27,131,27,147,317,305,12
27,131,27,161,74,68,6
27,131,27,163,57,57,0
27,131,55,25,0,29,-29
27,133,19,119,0,48,-48
27,133,27,105,74,63,11
27,133,27,117,0,39,-39
27,133,46,99,119,176,-57
27,135,27,7,33,68,-35
27,135,27,27,0,36,-36
27,135,27,53,32,38,-6
27,135,27,77,69,48,21
27,135,27,89,31,0,31
27,135,27,113,53,88,-35
27,135,27,119,59,25,34
27,135,27,137,0,29,-29
27,135,38,17,37,56,-19
27,135,38,35,27,41,-14
27,137,4,5,0,32,-32
27,137,4,13,48,117,-69
27,137,6,59,0,29,-29
27,137,6,73,0,56,-56
27,137,8,41,0,38,-38
27,137,17,31,149,41,108
27,137,27,1,56,0,56
27,137,27,3,262,204,58
27,137,27,5,35,0,35
27,137,27,7,97,79,18
27,137,27,9,56,39,17
27,137,27,13,38,51,-13
27,137,27,17,736,863,-127
27,137,27,19,41,53,-12
27,137,27,21,64,39,25
27,137,27,25,51,49,2
27,137,27,27,50,34,16
27,137,27,31,58,27,31
27,137,27,35,178,128,50
27,137,27,37,263,347,-84
27,137,27,41,38,0,38
27,137,27,49,40,0,40
27,137,27,53,799,1020,-221
27,137,27,59,51,35,16
27,137,27,61,421,393,28
27,137,27,67,61,0,61
27,137,27,71,110,55,55
27,137,27,75,325,246,79
27,137,27,85,43,0,43
27,137,27,93,0,35,-35
27,137,27,97,46,50,-4
27,137,27,99,33,0,33
27,137,27,103,29,0,29
27,137,27,109,96,85,11
27,137,27,111,50,37,13
27,137,27,115,99,64,35
27,137,27,119,23,27,-4
27,137,27,123,351,486,-135
27,137,27,131,26,34,-8
27,137,27,135,29,0,29
27,137,27,139,53,79,-26
27,137,27,141,130,82,48
27,137,27,145,164,124,40
27,137,27,147,29,23,6
27,137,27,163,153,174,-21
27,137,27,171,67,66,1
27,137,30,31,0,46,-46
27,137,32,3,27,46,-19
27,137,38,17,83,71,12
27,137,38,35,66,32,34
27,137,41,51,0,27,-27
27,137,53,33,27,54,-27
27,137,55,3,32,0,32
27,137,55,7,32,0,32
27,137,55,25,50,64,-14
27,137,55,31,727,831,-104
27,137,55,35,40,49,-9
27,137,55,63,0,29,-29
27,137,55,79,30,25,5
27,137,55,95,31,32,-1
27,137,55,109,52,24,28
27,137,55,129,28,0,28
27,139,4,13,71,96,-25
27,139,4,19,0,34,-34
27,139,6,37,33,56,-23
27,139,6,73,33,45,-12
27,139,12,71,0,35,-35
27,139,16,1,75,0,75
27,139,17,31,36,47,-11
27,139,19,153,23,46,-23
27,139,27,3,180,150,30
27,139,27,13,93,102,-9
27,139,27,19,700,742,-42
27,139,27,25,36,0,36
27,139,27,35,31,62,-31
27,139,27,37,2815,2106,709
27,139,27,49,0,43,-43
27,139,27,53,3491,2202,1289
27,139,27,61,0,33,-33
27,139,27,79,210,299,-89
27,139,27,85,90,49,41
27,139,27,103,52,55,-3
27,139,27,109,53,49,4
27,139,27,123,395,327,68
27,139,27,131,157,272,-115
27,139,27,137,79,53,26
27,139,27,141,50,79,-29
27,139,27,143,63,89,-26
27,139,27,145,71,39,32
27,139,27,163,132,143,-11
27,139,27,169,0,31,-31
27,139,27,171,69,99,-30
27,139,32,3,0,28,-28
27,139,36,61,0,23,-23
27,139,46,99,0,40,-40
27,139,53,33,0,42,-42
27,139,55,35,0,27,-27
27,139,55,109,40,47,-7
27,141,4,13,45,74,-29
27,141,6,37,0,28,-28
27,141,27,1,0,35,-35
27,141,27,3,1350,905,445
27,141,27,9,331,329,2
27,141,27,19,57,39,18
27,141,27,21,0,43,-43
27,141,27,25,26,40,-14
27,141,27,35,70,116,-46
27,141,27,37,158,135,23
27,141,27,41,0,28,-28
27,141,27,53,1573,1180,393
27,141,27,59,146,173,-27
27,141,27,61,0,36,-36
27,141,27,65,43,35,8
27,141,27,67,27,0,27
27,141,27,85,38,0,38
27,141,27,95,307,325,-18
27,141,27,97,62,46,16
27,141,27,109,35,34,1
27,141,27,123,253,244,9
27,141,27,137,82,130,-48
27,141,27,139,79,50,29
27,141,27,145,828,826,2
27,141,27,153,23,0,23
27,141,27,163,100,53,47
27,141,27,171,1079,886,193
27,141,38,17,0,24,-24
27,143,27,13,0,55,-55
27,143,27,15,29,34,-5
27,143,27,19,134,79,55
27,143,27,37,41,0,41
27,143,27,53,60,63,-3
27,143,27,79,102,54,48
27,143,27,85,118,142,-24
27,143,27,103,64,35,29
27,143,27,129,41,36,5
27,143,27,139,89,63,26
27,145,4,13,40,93,-53
27,145,6,37,0,67,-67
27,145,6,73,0,26,-26
27,145,17,31,0,59,-59
27,145,27,3,191,208,-17
27,145,27,7,47,36,11
27,145,27,9,2230,2357,-127
27,145,27,13,47,23,24
27,145,27,15,30,0,30
27,145,27,19,41,66,-25
27,145,27,21,36,32,4
27,145,27,23,26,0,26
27,145,27,25,24,0,24
27,145,27,27,45,51,-6
27,145,27,35,174,174,0
27,145,27,37,158,202,-44
27,145,27,41,157,171,-14
27,145,27,49,33,0,33
27,145,27,53,725,1185,-460
27,145,27,57,0,45,-45
27,145,27,59,23,0,23
27,145,27,61,40,44,-4
27,145,27,65,32,33,-1
27,145,27,67,263,194,69
27,145,27,83,40,0,40
27,145,27,85,84,66,18
27,145,27,93,230,190,40
27,145,27,95,132,69,63
27,145,27,97,277,330,-53
27,145,27,109,53,93,-40
27,145,27,111,95,79,16
27,145,27,115,36,0,36
27,145,27,119,24,0,24
27,145,27,121,42,68,-26
27,145,27,123,233,281,-48
27,145,27,127,30,0,30
27,145,27,129,38,0,38
27,145,27,137,124,164,-40
27,145,27,139,39,71,-32
27,145,27,141,826,828,-2
27,145,27,151,35,36,-1
27,145,27,153,187,166,21
27,145,27,159,39,31,8
27,145,27,163,68,116,-48
27,145,27,171,504,535,-31
27,145,32,3,0,32,-32
27,145,38,15,21,0,21
27,145,38,17,80,89,-9
27,145,38,35,30,29,1
27,145,46,99,35,39,-4
27,145,53,33,0,34,-34
27,145,55,25,0,64,-64
27,145,55,79,0,27,-27
27,147,27,13,47,48,-1
27,147,27,37,116,148,-32
27,147,27,39,94,116,-22
27,147,27,47,104,111,-7
27,147,27,49,34,0,34
27,147,27,53,160,168,-8
27,147,27,79,27,25,2
27,147,27,99,186,95,91
27,147,27,103,27,0,27
27,147,27,109,107,133,-26
27,147,27,123,46,62,-16
27,147,27,131,305,317,-12
27,147,27,137,23,29,-6
27,147,27,161,167,123,44
27,149,27,41,0,35,-35
27,149,27,51,0,28,-28
27,149,27,53,28,36,-8
27,149,27,67,26,0,26
27,149,27,121,41,48,-7
27,149,27,151,0,28,-28
27,151,27,23,45,66,-21
27,151,27,53,31,56,-25
27,151,27,67,162,108,54
27,151,27,121,41,0,41
27,151,27,123,0,33,-33
27,151,27,145,36,35,1
27,151,27,149,28,0,28
27,153,27,3,33,0,33
27,153,27,9,31,35,-4
27,153,27,21,51,53,-2
27,153,27,35,56,63,-7
27,153,27,41,79,107,-28
27,153,27,53,57,39,18
27,153,27,97,135,212,-77
27,153,27,111,71,87,-16
27,153,27,123,32,32,0
27,153,27,141,0,23,-23
27,153,27,145,166,187,-21
27,153,27,159,98,119,-21
27,153,27,171,0,38,-38
27,153,38,17,0,21,-21
27,155,46,109,26,43,-17
27,157,27,37,41,45,-4
27,157,27,45,0,58,-58
27,157,27,49,139,177,-38
27,157,27,53,37,60,-23
27,157,27,99,30,0,30
27,157,27,109,373,380,-7
27,157,27,123,21,0,21
27,157,27,169,96,106,-10
27,157,55,11,45,33,12
27,157,55,91,36,0,36
27,157,55,93,40,0,40
27,159,27,3,37,0,37
27,159,27,5,46,34,12
27,159,27,35,40,40,0
27,159,27,53,24,39,-15
27,159,27,57,72,54,18
27,159,27,97,42,38,4
27,159,27,111,104,150,-46
27,159,27,123,0,25,-25
27,159,27,145,31,39,-8
27,159,27,153,119,98,21
27,159,38,17,0,42,-42
27,161,27,13,191,225,-34
27,161,27,37,38,58,-20
27,161,27,47,65,36,29
27,161,27,53,45,78,-33
27,161,27,79,74,68,6
27,161,27,103,50,44,6
27,161,27,109,0,42,-42
27,161,27,123,0,30,-30
27,161,27,131,68,74,-6
27,161,27,147,123,167,-44
27,161,48,215,48,0,48
27,163,4,13,154,223,-69
27,163,4,19,48,40,8
27,163,6,37,73,68,5
27,163,6,59,38,43,-5
27,163,6,65,0,35,-35
27,163,6,73,86,48,38
27,163,6,85,40,35,5
27,163,8,5,0,21,-21
27,163,8,41,31,0,31
27,163,9,3,0,45,-45
27,163,12,21,0,34,-34
27,163,12,71,42,49,-7
27,163,12,103,24,0,24
27,163,17,31,125,107,18
27,163,17,43,0,32,-32
27,163,19,153,37,58,-21
27,163,19,169,51,0,51
27,163,27,3,1159,875,284
27,163,27,7,24,0,24
27,163,27,13,62,55,7
27,163,27,17,25,0,25
27,163,27,19,48,61,-13
27,163,27,25,609,703,-94
27,163,27,35,65,63,2
27,163,27,37,2139,2082,57
27,163,27,41,29,0,29
27,163,27,49,58,75,-17
27,163,27,53,2038,1883,155
27,163,27,59,92,91,1
27,163,27,103,31,0,31
27,163,27,109,105,113,-8
27,163,27,115,62,100,-38
27,163,27,123,7509,5368,2141
27,163,27,131,57,57,0
27,163,27,137,174,153,21
27,163,27,139,143,132,11
27,163,27,141,53,100,-47
27,163,27,145,116,68,48
27,163,27,169,52,0,52
27,163,27,171,59,111,-52
27,163,30,31,0,25,-25
27,163,31,55,52,35,17
27,163,32,3,50,49,1
27,163,36,61,0,43,-43
27,163,38,17,38,40,-2
27,163,38,35,26,33,-7
27,163,39,49,0,30,-30
27,163,46,99,0,32,-32
27,163,48,113,0,40,-40
27,163,48,201,37,36,1
27,163,48,439,37,0,37
27,163,48,453,33,41,-8
27,163,51,59,53,33,20
27,163,53,33,35,63,-28
27,163,55,5,26,0,26
27,163,55,9,0,29,-29
27,163,55,13,0,40,-40
27,163,55,25,99,38,61
27,163,55,33,40,43,-3
27,163,55,35,80,38,42
27,163,55,63,33,0,33
27,163,55,79,66,41,25
27,163,55,87,26,0,26
27,163,55,93,146,235,-89
27,163,55,95,141,190,-49
27,163,55,109,641,1011,-370
27,163,55,133,74,0,74
27,165,27,13,92,151,-59
27,165,27,15,33,62,-29
27,165,27,33,0,47,-47
27,165,27,91,41,42,-1
27,165,27,103,29,49,-20
27,167,27,27,29,92,-63
27,167,27,111,63,71,-8
27,167,38,17,62,63,-1
27,167,38,77,170,171,-1
27,169,4,13,0,33,-33
27,169,17,31,54,68,-14
27,169,27,3,28,38,-10
27,169,27,37,65,98,-33
27,169,27,45,177,113,64
27,169,27,47,21,0,21
27,169,27,49,40,45,-5
27,169,27,53,131,190,-59
27,169,27,55,122,111,11
27,169,27,99,30,30,0
27,169,27,109,270,447,-177
27,169,27,123,29,95,-66
27,169,27,139,31,0,31
27,169,27,157,106,96,10
27,169,27,163,0,52,-52
27,169,55,11,107,108,-1
27,169,55,25,28,39,-11
27,169,55,63,152,280,-128
27,169,55,121,95,115,-20
27,171,4,13,56,69,-13
27,171,6,73,0,36,-36
27,171,27,3,644,463,181
27,171,27,9,142,118,24
27,171,27,13,0,35,-35
27,171,27,19,264,199,65
27,171,27,21,0,44,-44
27,171,27,35,42,60,-18
27,171,27,37,280,162,118
27,171,27,41,41,46,-5
27,171,27,53,3624,2204,1420
27,171,27,59,77,41,36
27,171,27,67,44,0,44
27,171,27,85,230,208,22
27,171,27,93,213,199,14
27,171,27,95,54,82,-28
27,171,27,97,26,38,-12
27,171,27,109,33,39,-6
27,171,27,111,52,44,8
27,171,27,123,315,238,77
27,171,27,137,66,67,-1
27,171,27,139,99,69,30
27,171,27,141,886,1079,-193
27,171,27,145,535,504,31
27,171,27,153,38,0,38
27,171,27,163,111,59,52
27,171,38,17,42,56,-14
27,171,46,99,0,36,-36
27,173,27,23,96,60,36
27,173,27,53,33,34,-1
27,173,27,67,0,26,-26
27,173,27,73,34,0,34
27,173,27,83,96,132,-36
27,173,27,129,30,39,-9
28,1,22,29,285,302,-17
28,1,22,33,49,76,-27
28,1,22,71,0,63,-63
28,1,28,21,0,30,-30
28,1,28,35,25,44,-19
28,1,28,37,59,69,-10
28,1,28,47,0,35,-35
28,1,28,49,77,87,-10
28,1,28,63,92,64,28
28,1,28,73,31,27,4
28,1,28,89,31,58,-27
28,1,28,121,50,53,-3
28,1,28,149,42,27,15
28,1,28,157,33,0,33
28,1,48,113,0,41,-41
28,1,48,201,35,53,-18
28,3,28,33,30,31,-1
28,3,28,71,0,31,-31
28,3,28,81,61,109,-48
28,3,28,93,34,0,34
28,3,28,115,0,32,-32
28,3,28,117,216,295,-79
28,3,28,139,127,114,13
28,3,28,141,232,189,43
28,3,47,37,0,24,-24
28,3,47,71,61,0,61
28,3,47,109,174,136,38
28,3,47,157,69,58,11
28,5,22,33,45,59,-14
28,5,22,51,42,38,4
28,5,22,71,43,30,13
28,5,22,105,0,46,-46
28,5,28,37,0,31,-31
28,5,28,49,31,39,-8
28,5,28,85,78,92,-14
28,5,28,113,258,273,-15
28,5,28,157,78,78,0
28,7,28,19,43,32,11
28,7,28,49,49,51,-2
28,7,28,51,147,91,56
28,7,28,79,108,69,39
28,7,28,89,60,65,-5
28,7,28,99,0,38,-38
28,7,28,105,37,31,6
28,7,28,121,49,30,19
28,7,28,159,41,0,41
28,9,28,33,82,29,53
28,9,28,93,154,144,10
28,9,28,139,117,122,-5
28,9,28,145,85,77,8
28,9,47,69,40,51,-11
28,9,47,157,79,81,-2
28,11,17,31,37,32,5
28,11,28,27,132,103,29
28,11,28,33,69,182,-113
28,11,28,43,0,30,-30
28,11,28,49,46,49,-3
28,11,28,83,45,0,45
28,11,28,89,0,51,-51
28,11,28,133,216,224,-8
28,11,28,135,36,0,36
28,11,28,151,197,212,-15
28,11,47,157,156,283,-127
28,11,48,201,0,30,-30
28,11,48,439,0,37,-37
28,13,28,17,134,129,5
28,13,28,43,26,43,-17
28,13,28,71,56,75,-19
28,13,28,81,40,64,-24
28,13,28,115,96,78,18
28,13,28,155,0,46,-46
28,13,28,161,43,37,6
28,15,28,43,96,133,-37
28,15,28,49,0,32,-32
28,15,28,83,291,251,40
28,15,28,97,126,91,35
28,15,47,157,0,35,-35
28,17,28,13,129,134,-5
28,17,28,25,99,86,13
28,17,28,81,226,356,-130
28,17,28,95,106,156,-50
28,17,28,115,89,177,-88
28,17,28,145,32,0,32
28,19,28,7,32,43,-11
28,19,28,105,79,103,-24
28,19,28,155,44,79,-35
28,19,28,159,71,45,26
28,21,28,1,30,0,30
28,21,28,49,78,147,-69
28,21,28,63,75,52,23
28,21,28,149,199,239,-40
28,23,28,35,31,44,-13
28,23,28,49,0,34,-34
28,23,28,61,84,61,23
28,23,28,67,85,72,13
28,23,28,75,724,735,-11
28,23,28,101,0,41,-41
28,23,28,121,0,32,-32
28,23,28,153,92,97,-5
28,25,17,31,33,0,33
28,25,28,17,86,99,-13
28,25,28,49,0,33,-33
28,25,28,81,38,90,-52
28,25,28,87,151,167,-16
28,25,28,95,115,100,15
28,25,28,105,195,137,58
28,25,28,155,49,69,-20
28,27,5,107,0,62,-62
28,27,17,31,24,0,24
28,27,28,11,103,132,-29
28,27,28,33,77,143,-66
28,27,28,49,0,57,-57
28,27,28,71,0,45,-45
28,27,28,107,31,72,-41
28,27,28,119,83,72,11
28,27,28,135,122,64,58
28,27,28,143,143,202,-59
28,27,47,157,113,217,-104
28,29,28,35,31,0,31
28,29,28,49,546,520,26
28,29,28,77,55,52,3
28,29,28,85,219,269,-50
28,29,28,89,36,81,-45
28,29,28,121,115,179,-64
28,29,28,127,58,34,24
28,31,28,35,313,300,13
28,31,28,47,44,24,20
28,31,28,49,46,0,46
28,31,28,65,99,97,2
28,31,28,67,146,151,-5
28,31,28,73,230,220,10
28,31,28,91,33,38,-5
28,31,28,109,31,0,31
28,31,28,121,0,44,-44
28,31,28,127,117,111,6
28,31,28,129,53,51,2
28,33,1,73,34,25,9
28,33,1,89,49,0,49
28,33,1,117,34,0,34
28,33,4,13,48,62,-14
28,33,5,31,42,44,-2
28,33,5,35,152,110,42
28,33,5,93,34,0,34
28,33,5,107,53,0,53
28,33,5,119,67,76,-9
28,33,6,37,128,40,88
28,33,6,73,34,0,34
28,33,12,11,42,0,42
28,33,12,31,34,0,34
28,33,12,71,28,0,28
28,33,12,95,0,27,-27
28,33,13,67,52,0,52
28,33,17,31,72,33,39
28,33,22,71,0,31,-31
28,33,26,163,50,0,50
28,33,28,3,31,30,1
28,33,28,9,29,82,-53
28,33,28,11,182,69,113
28,33,28,27,143,77,66
28,33,28,35,0,34,-34
28,33,28,43,106,0,106
28,33,28,47,36,103,-67
28,33,28,49,132,36,96
28,33,28,59,0,77,-77
28,33,28,71,181,100,81
28,33,28,73,42,0,42
28,33,28,81,114,98,16
28,33,28,83,75,0,75
28,33,28,87,54,37,17
28,33,28,89,61,56,5
28,33,28,93,656,793,-137
28,33,28,105,55,39,16
28,33,28,107,299,228,71
28,33,28,115,37,0,37
28,33,28,117,0,36,-36
28,33,28,119,48,0,48
28,33,28,121,125,52,73
28,33,28,133,50,38,12
28,33,28,135,35,0,35
28,33,28,137,720,689,31
28,33,28,139,0,42,-42
28,33,28,143,490,211,279
28,33,28,149,32,0,32
28,33,28,151,135,37,98
28,33,28,161,61,49,12
28,33,29,189,47,0,47
28,33,32,3,47,58,-11
28,33,47,37,80,68,12
28,33,47,47,125,104,21
28,33,47,69,30,0,30
28,33,47,71,30,0,30
28,33,47,93,26,0,26
28,33,47,113,40,45,-5
28,33,47,149,48,29,19
28,33,47,157,7744,3990,3754
28,33,47,165,30,0,30
28,33,47,167,130,70,60
28,33,47,187,0,52,-52
28,33,48,29,0,42,-42
28,33,48,85,0,30,-30
28,33,48,113,48,33,15
28,33,48,201,36,62,-26
28,33,48,439,42,96,-54
28,33,55,79,37,0,37
28,35,1,3,28,0,28
28,35,1,73,30,0,30
28,35,1,97,75,75,0
28,35,12,33,40,39,1
28,35,12,99,31,0,31
28,35,13,89,37,0,37
28,35,22,33,45,60,-15
28,35,22,51,78,61,17
28,35,22,71,0,59,-59
28,35,22,103,44,45,-1
28,35,28,1,44,25,19
28,35,28,23,44,31,13
28,35,28,29,0,31,-31
28,35,28,31,300,313,-13
28,35,28,33,34,0,34
28,35,28,41,27,44,-17
28,35,28,45,48,54,-6
28,35,28,47,226,351,-125
28,35,28,49,185,163,22
28,35,28,59,120,132,-12
28,35,28,61,50,31,19
28,35,28,65,142,98,44
28,35,28,67,477,421,56
28,35,28,71,35,0,35
28,35,28,73,1726,1961,-235
28,35,28,75,66,80,-14
28,35,28,77,35,0,35
28,35,28,81,0,27,-27
28,35,28,85,44,37,7
28,35,28,87,0,32,-32
28,35,28,89,74,117,-43
28,35,28,91,174,143,31
28,35,28,101,33,0,33
28,35,28,105,58,28,30
28,35,28,109,98,126,-28
28,35,28,111,238,197,41
28,35,28,113,86,49,37
28,35,28,121,115,154,-39
28,35,28,127,48,32,16
28,35,28,129,34,0,34
28,35,28,131,62,62,0
28,35,28,147,43,34,9
28,35,28,149,54,0,54
28,35,28,151,43,36,7
28,35,28,153,92,45,47
28,35,47,37,0,27,-27
28,35,47,157,43,58,-15
28,35,48,29,0,40,-40
28,35,48,113,0,48,-48
28,35,48,201,52,62,-10
28,37,28,1,69,59,10
28,37,28,5,31,0,31
28,37,28,85,184,118,66
28,37,28,113,0,38,-38
28,39,1,97,183,202,-19
28,39,28,41,90,91,-1
28,39,28,47,80,31,49
28,39,28,59,507,285,222
28,41,1,97,74,61,13
28,41,1,129,36,0,36
28,41,28,35,44,27,17
28,41,28,39,91,90,1
28,41,28,59,35,39,-4
28,41,28,111,62,62,0
28,41,28,153,80,63,17
28,43,28,11,30,0,30
28,43,28,13,43,26,17
28,43,28,15,133,96,37
28,43,28,33,0,106,-106
28,43,28,49,0,39,-39
28,43,28,71,38,52,-14
28,43,28,83,79,61,18
28,43,28,89,0,25,-25
28,43,28,97,142,83,59
28,43,28,121,0,50,-50
28,43,28,135,93,62,31
28,43,28,155,32,38,-6
28,43,28,161,102,139,-37
28,43,47,157,45,68,-23
28,45,22,51,122,65,57
28,45,22,71,61,66,-5
28,45,22,87,0,45,-45
28,45,22,103,221,196,25
28,45,28,35,54,48,6
28,45,28,47,721,753,-32
28,45,28,59,76,65,11
28,45,28,73,48,56,-8
28,45,28,109,220,241,-21
28,45,28,121,33,0,33
28,45,28,131,0,58,-58
28,45,48,201,42,0,42
28,47,1,3,80,86,-6
28,47,1,45,34,0,34
28,47,1,73,66,64,2
28,47,1,89,0,47,-47
28,47,1,97,286,320,-34
28,47,1,101,71,63,8
28,47,1,117,0,39,-39
28,47,2,20,55,0,55
28,47,4,13,72,73,-1
28,47,4,19,27,67,-40
28,47,6,37,61,62,-1
28,47,6,53,39,0,39
28,47,6,59,41,0,41
28,47,6,65,31,0,31
28,47,6,67,38,0,38
28,47,6,71,27,28,-1
28,47,6,73,227,144,83
28,47,6,95,44,30,14
28,47,6,111,84,0,84
28,47,8,31,25,0,25
28,47,8,41,77,55,22
28,47,11,1,31,26,5
28,47,12,5,120,53,67
28,47,12,9,64,40,24
28,47,12,11,49,38,11
28,47,12,31,146,124,22
28,47,12,33,165,97,68
28,47,12,57,88,79,9
28,47,12,71,37,0,37
28,47,12,86,112,152,-40
28,47,12,87,37,0,37
28,47,12,91,106,67,39
28,47,12,95,75,42,33
28,47,12,103,51,0,51
28,47,12,105,0,25,-25
28,47,12,113,49,32,17
28,47,13,39,47,0,47
28,47,13,63,35,26,9
28,47,13,67,47,58,-11
28,47,13,89,42,0,42
28,47,13,121,45,58,-13
28,47,13,135,49,46,3
28,47,13,153,41,64,-23
28,47,13,215,30,0,30
28,47,15,3,166,78,88
28,47,17,31,74,39,35
28,47,17,97,32,0,32
28,47,17,163,53,93,-40
28,47,18,97,32,0,32
28,47,20,173,0,28,-28
28,47,22,15,27,46,-19
28,47,22,17,25,0,25
28,47,22,33,136,92,44
28,47,22,51,195,112,83
28,47,22,55,39,38,1
28,47,22,63,57,38,19
28,47,22,71,78,128,-50
28,47,22,73,0,33,-33
28,47,22,87,0,34,-34
28,47,22,103,154,194,-40
28,47,22,109,33,34,-1
28,47,24,3,0,33,-33
28,47,24,33,0,33,-33
28,47,26,49,27,0,27
28,47,26,163,53,0,53
28,47,28,1,35,0,35
28,47,28,31,24,44,-20
28,47,28,33,103,36,67
28,47,28,35,351,226,125
28,47,28,39,31,80,-49
28,47,28,45,753,721,32
28,47,28,49,165,130,35
28,47,28,59,2558,2557,1
28,47,28,65,36,0,36
28,47,28,67,101,59,42
28,47,28,71,28,40,-12
28,47,28,73,170,151,19
28,47,28,75,80,50,30
28,47,28,81,38,0,38
28,47,28,85,29,0,29
28,47,28,87,54,0,54
28,47,28,89,68,63,5
28,47,28,91,50,0,50
28,47,28,105,50,59,-9
28,47,28,109,175,180,-5
28,47,28,111,0,55,-55
28,47,28,113,40,40,0
28,47,28,121,154,144,10
28,47,28,127,43,34,9
28,47,28,131,309,632,-323
28,47,28,149,77,28,49
28,47,28,151,34,0,34
28,47,29,77,0,26,-26
28,47,31,153,29,31,-2
28,47,32,3,134,121,13
28,47,37,51,45,30,15
28,47,37,119,26,0,26
28,47,37,133,52,46,6
28,47,39,35,31,0,31
28,47,40,109,37,83,-46
28,47,45,13,48,0,48
28,47,45,19,39,25,14
28,47,45,85,0,31,-31
28,47,47,37,34,27,7
28,47,47,93,0,39,-39
28,47,47,125,42,0,42
28,47,47,141,0,101,-101
28,47,47,157,76,108,-32
28,47,48,27,44,47,-3
28,47,48,29,171,150,21
28,47,48,113,51,57,-6
28,47,48,201,167,165,2
28,47,48,215,42,0,42
28,47,48,339,0,26,-26
28,47,48,355,0,25,-25
28,47,48,439,88,82,6
28,47,48,441,0,27,-27
28,47,48,453,0,36,-36
28,47,48,485,84,0,84
28,47,51,59,54,0,54
28,47,51,153,32,0,32
28,47,51,550,31,0,31
28,47,51,650,38,0,38
28,47,51,700,40,0,40
28,47,51,710,80,64,16
28,47,51,810,97,122,-25
28,47,53,29,44,0,44
28,47,53,53,52,33,19
28,47,55,79,28,0,28
28,49,1,3,0,24,-24
28,49,1,73,81,107,-26
28,49,1,89,0,53,-53
28,49,1,97,51,60,-9
28,49,1,101,26,0,26
28,49,4,13,37,50,-13
28,49,5,119,39,47,-8
28,49,6,37,70,81,-11
28,49,6,73,0,36,-36
28,49,12,31,0,27,-27
28,49,12,33,0,27,-27
28,49,12,57,25,0,25
28,49,13,63,0,42,-42
28,49,13,67,54,75,-21
28,49,13,89,78,75,3
28,49,13,121,35,79,-44
28,49,13,135,28,65,-37
28,49,17,31,140,148,-8
28,49,17,197,34,0,34
28,49,18,97,0,38,-38
28,49,22,17,34,35,-1
28,49,22,33,99,123,-24
28,49,22,51,86,135,-49
28,49,22,71,52,196,-144
28,49,22,73,65,57,8
28,49,24,33,34,0,34
28,49,26,163,41,0,41
28,49,28,1,87,77,10
28,49,28,5,39,31,8
28,49,28,7,51,49,2
28,49,28,11,49,46,3
28,49,28,15,32,0,32
28,49,28,21,147,78,69
28,49,28,23,34,0,34
28,49,28,25,33,0,33
28,49,28,27,57,0,57
28,49,28,29,520,546,-26
28,49,28,31,0,46,-46
28,49,28,33,36,132,-96
28,49,28,35,163,185,-22
28,49,28,43,39,0,39
28,49,28,47,130,165,-35
28,49,28,51,196,151,45
28,49,28,53,56,56,0
28,49,28,59,102,79,23
28,49,28,63,31,34,-3
28,49,28,65,64,0,64
28,49,28,67,69,42,27
28,49,28,71,78,121,-43
28,49,28,73,72,104,-32
28,49,28,75,82,101,-19
28,49,28,77,69,64,5
28,49,28,79,106,78,28
28,49,28,81,47,78,-31
28,49,28,83,112,72,40
28,49,28,85,108,119,-11
28,49,28,87,60,47,13
28,49,28,89,2615,4095,-1480
28,49,28,99,44,0,44
28,49,28,101,40,52,-12
28,49,28,105,105,105,0
28,49,28,113,103,74,29
28,49,28,121,2617,4053,-1436
28,49,28,123,129,158,-29
28,49,28,127,160,256,-96
28,49,28,129,0,29,-29
28,49,28,133,52,51,1
28,49,28,149,563,386,177
28,49,28,151,139,101,38
28,49,28,163,302,190,112
28,49,29,189,0,38,-38
28,49,31,55,0,27,-27
28,49,32,3,40,34,6
28,49,37,119,0,37,-37
28,49,47,37,56,128,-72
28,49,47,157,239,320,-81
28,49,48,29,0,34,-34
28,49,48,85,0,51,-51
28,49,48,113,70,172,-102
28,49,48,121,0,43,-43
28,49,48,201,91,195,-104
28,49,48,439,40,123,-83
28,49,48,453,26,71,-45
28,49,55,79,47,0,47
28,51,17,31,39,43,-4
28,51,28,7,91,147,-56
28,51,28,49,151,196,-45
28,51,28,83,59,73,-14
28,51,28,89,61,145,-84
28,51,28,121,35,50,-15
28,51,28,163,91,53,38
28,51,47,157,29,63,-34
28,53,28,49,56,56,0
28,53,28,83,33,0,33
28,53,28,133,74,63,11
28,53,28,151,52,0,52
28,53,28,163,45,53,-8
28,57,1,59,69,96,-27
28,57,28,81,589,565,24
28,57,28,95,135,108,27
28,57,28,115,74,63,11
28,57,28,117,58,89,-31
28,57,28,141,113,94,19
28,57,28,145,45,0,45
28,59,1,3,65,94,-29
28,59,1,73,44,49,-5
28,59,1,97,703,983,-280
28,59,1,99,31,0,31
28,59,1,101,33,31,2
28,59,4,13,0,46,-46
28,59,6,37,34,0,34
28,59,6,73,143,226,-83
28,59,8,41,52,0,52
28,59,12,5,56,43,13
28,59,12,9,39,0,39
28,59,12,11,24,0,24
28,59,12,31,49,67,-18
28,59,12,33,111,78,33
28,59,12,57,64,88,-24
28,59,12,86,0,26,-26
28,59,12,91,81,60,21
28,59,12,95,54,31,23
28,59,12,113,37,30,7
28,59,13,67,0,32,-32
28,59,13,89,0,29,-29
28,59,13,135,43,45,-2
28,59,15,3,37,0,37
28,59,17,31,27,0,27
28,59,22,33,70,25,45
28,59,22,51,106,83,23
28,59,22,71,33,43,-10
28,59,22,103,62,53,9
28,59,22,109,45,0,45
28,59,28,33,77,0,77
28,59,28,35,132,120,12
28,59,28,39,285,507,-222
28,59,28,41,39,35,4
28,59,28,45,65,76,-11
28,59,28,47,2557,2558,-1
28,59,28,49,79,102,-23
28,59,28,67,69,36,33
28,59,28,71,0,41,-41
28,59,28,73,87,109,-22
28,59,28,75,31,38,-7
28,59,28,89,43,57,-14
28,59,28,105,70,46,24
28,59,28,109,34,70,-36
28,59,28,121,99,78,21
28,59,28,131,75,96,-21
28,59,32,3,75,47,28
28,59,47,37,30,0,30
28,59,47,157,72,38,34
28,59,48,29,95,37,58
28,59,48,201,99,176,-77
28,59,48,245,0,32,-32
28,59,51,650,0,27,-27
28,59,51,710,43,70,-27
28,59,51,810,90,69,21
28,61,28,23,61,84,-23
28,61,28,35,31,50,-19
28,61,28,67,575,567,8
28,61,28,75,40,29,11
28,61,28,101,49,0,49
28,61,28,129,99,69,30
28,61,28,153,33,45,-12
28,63,28,1,64,92,-28
28,63,28,21,52,75,-23
28,63,28,49,34,31,3
28,63,28,149,32,58,-26
28,65,28,31,97,99,-2
28,65,28,35,98,142,-44
28,65,28,47,0,36,-36
28,65,28,49,0,64,-64
28,65,28,73,62,106,-44
28,65,28,77,82,65,17
28,65,28,91,72,72,0
28,65,28,121,33,0,33
28,65,28,127,61,67,-6
28,67,1,97,27,0,27
28,67,12,95,29,0,29
28,67,28,23,72,85,-13
28,67,28,31,151,146,5
28,67,28,35,421,477,-56
28,67,28,47,59,101,-42
28,67,28,49,42,69,-27
28,67,28,59,36,69,-33
28,67,28,61,567,575,-8
28,67,28,73,178,287,-109
28,67,28,75,48,37,11
28,67,28,89,0,27,-27
28,67,28,91,0,38,-38
28,67,28,111,82,77,5
28,67,28,121,67,81,-14
28,67,28,127,37,27,10
28,67,28,129,139,103,36
28,67,28,153,208,116,92
28,67,48,201,0,44,-44
28,69,28,75,119,218,-99
28,69,28,99,57,50,7
28,71,1,73,0,41,-41
28,71,13,121,0,35,-35
28,71,22,71,0,26,-26
28,71,28,3,31,0,31
28,71,28,13,75,56,19
28,71,28,27,45,0,45
28,71,28,33,100,181,-81
28,71,28,35,0,35,-35
28,71,28,43,52,38,14
28,71,28,47,40,28,12
28,71,28,49,121,78,43
28,71,28,59,41,0,41
28,71,28,75,31,0,31
28,71,28,81,91,117,-26
28,71,28,83,24,0,24
28,71,28,89,80,62,18
28,71,28,93,94,100,-6
28,71,28,105,45,0,45
28,71,28,107,195,131,64
28,71,28,115,102,115,-13
28,71,28,121,55,106,-51
28,71,28,137,47,41,6
28,71,28,145,78,47,31
28,71,28,151,0,23,-23
28,71,28,161,187,156,31
28,71,47,37,0,60,-60
28,71,47,157,201,183,18
28,71,48,113,0,24,-24
28,71,48,201,0,26,-26
28,73,1,97,57,35,22
28,73,12,33,0,24,-24
28,73,22,33,0,33,-33
28,73,22,51,64,28,36
28,73,22,71,0,53,-53
28,73,22,103,32,73,-41
28,73,28,1,27,31,-4
28,73,28,31,220,230,-10
28,73,28,33,0,42,-42
28,73,28,35,1961,1726,235
28,73,28,45,56,48,8
28,73,28,47,151,170,-19
28,73,28,49,104,72,32
28,73,28,59,109,87,22
28,73,28,65,106,62,44
28,73,28,67,287,178,109
28,73,28,75,55,56,-1
28,73,28,77,37,0,37
28,73,28,85,29,0,29
28,73,28,89,46,65,-19
28,73,28,91,284,162,122
28,73,28,109,171,149,22
28,73,28,111,118,95,23
28,73,28,113,49,32,17
28,73,28,121,130,131,-1
28,73,28,127,39,0,39
28,73,28,129,23,0,23
28,73,28,131,67,44,23
28,73,28,153,30,0,30
28,73,47,157,27,26,1
28,73,48,201,30,36,-6
28,75,1,23,60,50,10
28,75,1,73,61,68,-7
28,75,1,89,0,32,-32
28,75,1,97,0,35,-35
28,75,1,119,74,65,9
28,75,1,125,0,38,-38
28,75,6,31,0,76,-76
28,75,6,73,70,78,-8
28,75,12,31,0,36,-36
28,75,12,33,153,0,153
28,75,12,113,84,0,84
28,75,26,163,55,0,55
28,75,28,23,735,724,11
28,75,28,35,80,66,14
28,75,28,47,50,80,-30
28,75,28,49,101,82,19
28,75,28,59,38,31,7
28,75,28,61,29,40,-11
28,75,28,67,37,48,-11
28,75,28,69,218,119,99
28,75,28,71,0,31,-31
28,75,28,73,56,55,1
28,75,28,81,0,31,-31
28,75,28,87,32,35,-3
28,75,28,89,60,58,2
28,75,28,99,129,135,-6
28,75,28,101,246,186,60
28,75,28,105,44,40,4
28,75,28,121,78,150,-72
28,75,28,123,35,43,-8
28,75,28,153,30,0,30
28,75,28,159,42,0,42
28,75,37,49,0,60,-60
28,75,47,37,0,36,-36
28,75,47,157,33,54,-21
28,75,48,201,0,33,-33
28,75,48,355,47,0,47
28,75,48,439,34,0,34
28,75,51,810,0,95,-95
28,77,28,29,52,55,-3
28,77,28,35,0,35,-35
28,77,28,49,64,69,-5
28,77,28,65,65,82,-17
28,77,28,73,0,37,-37
28,77,28,85,141,166,-25
28,77,28,113,46,49,-3
28,77,28,127,61,46,15
28,79,28,7,69,108,-39
28,79,28,49,78,106,-28
28,79,28,89,117,104,13
28,79,28,99,176,222,-46
28,79,28,101,49,62,-13
28,79,28,121,116,135,-19
28,79,28,123,173,152,21
28,79,28,159,0,38,-38
28,81,1,73,0,47,-47
28,81,1,93,34,36,-2
28,81,17,31,37,0,37
28,81,28,3,109,61,48
28,81,28,13,64,40,24
28,81,28,17,356,226,130
28,81,28,25,90,38,52
28,81,28,33,98,114,-16
28,81,28,35,27,0,27
28,81,28,47,0,38,-38
28,81,28,49,78,47,31
28,81,28,57,565,589,-24
28,81,28,71,117,91,26
28,81,28,75,31,0,31
28,81,28,87,114,76,38
28,81,28,89,43,32,11
28,81,28,95,484,425,59
28,81,28,105,119,72,47
28,81,28,115,526,576,-50
28,81,28,117,333,328,5
28,81,28,121,71,73,-2
28,81,28,139,82,43,39
28,81,28,141,52,41,11
28,81,28,145,292,307,-15
28,81,28,151,46,0,46
28,81,47,37,39,44,-5
28,81,47,157,122,150,-28
28,81,48,201,0,29,-29
28,83,13,59,38,0,38
28,83,17,31,39,0,39
28,83,28,11,0,45,-45
28,83,28,15,251,291,-40
28,83,28,33,0,75,-75
28,83,28,43,61,79,-18
28,83,28,49,72,112,-40
28,83,28,51,73,59,14
28,83,28,53,0,33,-33
28,83,28,71,0,24,-24
28,83,28,89,0,77,-77
28,83,28,97,0,45,-45
28,83,28,121,0,45,-45
28,83,28,133,135,125,10
28,83,28,135,34,0,34
28,83,28,151,66,35,31
28,83,47,157,133,171,-38
28,85,22,51,0,34,-34
28,85,22,71,0,40,-40
28,85,28,5,92,78,14
28,85,28,29,269,219,50
28,85,28,35,37,44,-7
28,85,28,37,118,184,-66
28,85,28,47,0,29,-29
28,85,28,49,119,108,11
28,85,28,73,0,29,-29
28,85,28,77,166,141,25
28,85,28,89,0,32,-32
28,85,28,113,334,290,44
28,85,28,121,70,63,7
28,85,28,147,65,42,23
28,85,28,157,0,39,-39
28,85,48,201,0,28,-28
28,87,1,3,0,30,-30
28,87,1,73,0,68,-68
28,87,1,75,108,135,-27
28,87,1,97,0,28,-28
28,87,1,107,66,125,-59
28,87,1,117,0,43,-43
28,87,1,125,89,99,-10
28,87,2,20,0,32,-32
28,87,4,13,29,82,-53
28,87,5,119,0,30,-30
28,87,6,37,0,29,-29
28,87,6,95,0,49,-49
28,87,8,41,97,0,97
28,87,10,1,0,34,-34
28,87,12,57,0,41,-41
28,87,12,91,39,0,39
28,87,13,121,0,32,-32
28,87,13,185,77,0,77
28,87,17,31,29,0,29
28,87,28,25,167,151,16
28,87,28,33,37,54,-17
28,87,28,35,32,0,32
28,87,28,47,0,54,-54
28,87,28,49,47,60,-13
28,87,28,75,35,32,3
28,87,28,81,76,114,-38
28,87,28,89,0,49,-49
28,87,28,95,144,246,-102
28,87,28,103,173,135,38
28,87,28,105,235,257,-22
28,87,28,121,34,103,-69
28,87,32,3,0,37,-37
28,87,40,65,0,27,-27
28,87,47,37,24,0,24
28,87,47,157,55,75,-20
28,87,48,29,85,28,57
28,87,53,53,0,27,-27
28,89,1,73,40,79,-39
28,89,1,89,0,44,-44
28,89,1,97,44,0,44
28,89,1,117,35,47,-12
28,89,6,37,50,0,50
28,89,13,67,35,0,35
28,89,13,89,0,25,-25
28,89,13,121,0,40,-40
28,89,17,31,66,48,18
28,89,22,33,52,60,-8
28,89,22,51,46,36,10
28,89,22,71,0,38,-38
28,89,22,73,63,0,63
28,89,28,1,58,31,27
28,89,28,7,65,60,5
28,89,28,11,51,0,51
28,89,28,29,81,36,45
28,89,28,33,56,61,-5
28,89,28,35,117,74,43
28,89,28,43,25,0,25
28,89,28,47,63,68,-5
28,89,28,49,4095,2615,1480
28,89,28,51,145,61,84
28,89,28,59,57,43,14
28,89,28,67,27,0,27
28,89,28,71,62,80,-18
28,89,28,73,65,46,19
28,89,28,75,58,60,-2
28,89,28,79,104,117,-13
28,89,28,81,32,43,-11
28,89,28,83,77,0,77
28,89,28,85,32,0,32
28,89,28,87,49,0,49
28,89,28,105,83,76,7
28,89,28,113,0,41,-41
28,89,28,121,1115,1350,-235
28,89,28,123,54,38,16
28,89,28,127,38,55,-17
28,89,28,133,41,0,41
28,89,28,149,104,42,62
28,89,28,151,79,0,79
28,89,28,163,211,100,111
28,89,47,37,35,38,-3
28,89,47,157,121,128,-7
28,89,48,113,46,36,10
28,89,48,201,58,114,-56
28,89,48,439,0,34,-34
28,91,22,117,39,33,6
28,91,28,31,38,33,5
28,91,28,35,143,174,-31
28,91,28,47,0,50,-50
28,91,28,65,72,72,0
28,91,28,67,38,0,38
28,91,28,73,162,284,-122
28,91,28,109,46,34,12
28,91,28,113,0,41,-41
28,91,28,121,34,39,-5
28,91,28,147,135,96,39
28,93,28,3,0,34,-34
28,93,28,9,144,154,-10
28,93,28,33,793,656,137
28,93,28,71,100,94,6
28,93,28,107,34,38,-4
28,93,28,137,79,106,-27
28,93,28,139,40,32,8
28,93,28,145,47,59,-12
28,93,47,47,53,56,-3
28,93,47,157,1045,835,210
28,95,1,75,84,63,21
28,95,28,17,156,106,50
28,95,28,25,100,115,-15
28,95,28,57,108,135,-27
28,95,28,81,425,484,-59
28,95,28,87,246,144,102
28,95,28,105,37,42,-5
28,95,28,115,61,33,28
28,95,28,145,43,0,43
28,95,47,157,35,0,35
28,97,28,15,91,126,-35
28,97,28,43,83,142,-59
28,97,28,83,45,0,45
28,97,28,121,0,30,-30
28,97,28,155,0,37,-37
28,99,28,7,38,0,38
28,99,28,49,0,44,-44
28,99,28,69,50,57,-7
28,99,28,75,135,129,6
28,99,28,79,222,176,46
28,99,28,101,172,200,-28
28,99,28,105,39,34,5
28,99,28,121,43,50,-7
28,99,28,123,56,42,14
28,99,28,159,155,127,28
28,101,28,23,41,0,41
28,101,28,35,0,33,-33
28,101,28,49,52,40,12
28,101,28,61,0,49,-49
28,101,28,75,186,246,-60
28,101,28,79,62,49,13
28,101,28,99,200,172,28
28,101,28,121,45,55,-10
28,101,28,123,168,143,25
28,103,28,87,135,173,-38
28,103,28,105,31,56,-25
28,103,28,159,0,42,-42
28,105,1,73,0,46,-46
28,105,1,89,0,52,-52
28,105,1,125,37,38,-1
28,105,13,89,0,35,-35
28,105,17,31,0,27,-27
28,105,22,33,0,22,-22
28,105,28,7,31,37,-6
28,105,28,19,103,79,24
28,105,28,25,137,195,-58
28,105,28,33,39,55,-16
28,105,28,35,28,58,-30
28,105,28,47,59,50,9
28,105,28,49,105,105,0
28,105,28,59,46,70,-24
28,105,28,71,0,45,-45
28,105,28,75,40,44,-4
28,105,28,81,72,119,-47
28,105,28,87,257,235,22
28,105,28,89,76,83,-7
28,105,28,95,42,37,5
28,105,28,99,34,39,-5
28,105,28,103,56,31,25
28,105,28,121,87,144,-57
28,105,28,149,50,0,50
28,105,28,151,44,24,20
28,105,28,155,137,213,-76
28,105,28,159,100,102,-2
28,105,47,37,0,30,-30
28,105,47,157,79,122,-43
28,105,48,113,0,23,-23
28,105,48,201,0,45,-45
28,105,48,453,0,28,-28
28,107,17,31,24,0,24
28,107,28,27,72,31,41
28,107,28,33,228,299,-71
28,107,28,71,131,195,-64
28,107,28,93,38,34,4
28,107,28,119,184,109,75
28,107,28,135,65,89,-24
28,107,28,137,350,307,43
28,107,28,143,77,64,13
28,107,28,161,116,74,42
28,107,47,157,211,237,-26
28,109,1,97,0,31,-31
28,109,22,33,34,0,34
28,109,22,51,389,122,267
28,109,22,63,34,0,34
28,109,22,71,88,81,7
28,109,22,75,22,0,22
28,109,22,87,102,247,-145
28,109,22,103,662,538,124
28,109,22,105,37,49,-12
28,109,22,117,75,68,7
28,109,28,31,0,31,-31
28,109,28,35,126,98,28
28,109,28,45,241,220,21
28,109,28,47,180,175,5
28,109,28,59,70,34,36
28,109,28,73,149,171,-22
28,109,28,91,34,46,-12
28,109,28,121,0,33,-33
28,109,28,131,36,57,-21
28,109,48,201,32,33,-1
28,111,28,35,197,238,-41
28,111,28,41,62,62,0
28,111,28,47,55,0,55
28,111,28,67,77,82,-5
28,111,28,73,95,118,-23
28,113,22,33,29,79,-50
28,113,22,51,96,68,28
28,113,22,63,28,32,-4
28,113,22,71,35,110,-75
28,113,22,105,113,150,-37
28,113,28,5,273,258,15
28,113,28,35,49,86,-37
28,113,28,37,38,0,38
28,113,28,47,40,40,0
28,113,28,49,74,103,-29
28,113,28,73,32,49,-17
28,113,28,77,49,46,3
28,113,28,85,290,334,-44
28,113,28,89,41,0,41
28,113,28,91,41,0,41
28,113,28,121,58,50,8
28,113,28,147,194,124,70
28,113,28,157,36,45,-9
28,113,48,201,0,35,-35
28,113,48,439,0,34,-34
28,115,28,3,32,0,32
28,115,28,13,78,96,-18
28,115,28,17,177,89,88
28,115,28,33,0,37,-37
28,115,28,57,63,74,-11
28,115,28,71,115,102,13
28,115,28,81,576,526,50
28,115,28,95,33,61,-28
28,115,28,117,37,0,37
28,115,28,139,47,42,5
28,115,28,145,285,347,-62
28,117,28,3,295,216,79
28,117,28,33,36,0,36
28,117,28,57,89,58,31
28,117,28,81,328,333,-5
28,117,28,115,0,37,-37
28,117,28,139,60,0,60
28,117,28,141,86,93,-7
28,117,28,145,61,57,4
28,117,47,157,0,37,-37
28,119,28,27,72,83,-11
28,119,28,33,0,48,-48
28,119,28,107,109,184,-75
28,119,28,143,68,86,-18
28,119,47,157,0,35,-35
28,121,1,3,0,38,-38
28,121,1,73,35,74,-39
28,121,1,97,36,49,-13
28,121,1,117,0,42,-42
28,121,4,13,0,33,-33
28,121,5,119,0,31,-31
28,121,6,37,39,0,39
28,121,6,73,38,0,38
28,121,12,33,29,0,29
28,121,12,91,31,0,31
28,121,13,121,0,23,-23
28,121,13,135,0,31,-31
28,121,17,31,69,37,32
28,121,22,33,35,58,-23
28,121,22,51,33,49,-16
28,121,22,71,29,67,-38
28,121,22,73,44,34,10
28,121,22,103,48,52,-4
28,121,28,1,53,50,3
28,121,28,7,30,49,-19
28,121,28,23,32,0,32
28,121,28,29,179,115,64
28,121,28,31,44,0,44
28,121,28,33,52,125,-73
28,121,28,35,154,115,39
28,121,28,43,50,0,50
28,121,28,45,0,33,-33
28,121,28,47,144,154,-10
28,121,28,49,4053,2617,1436
28,121,28,51,50,35,15
28,121,28,59,78,99,-21
28,121,28,65,0,33,-33
28,121,28,67,81,67,14
28,121,28,71,106,55,51
28,121,28,73,131,130,1
28,121,28,75,150,78,72
28,121,28,79,135,116,19
28,121,28,81,73,71,2
28,121,28,83,45,0,45
28,121,28,85,63,70,-7
28,121,28,87,103,34,69
28,121,28,89,1350,1115,235
28,121,28,91,39,34,5
28,121,28,97,30,0,30
28,121,28,99,50,43,7
28,121,28,101,55,45,10
28,121,28,105,144,87,57
28,121,28,109,33,0,33
28,121,28,113,50,58,-8
28,121,28,123,344,321,23
28,121,28,127,329,392,-63
28,121,28,129,113,79,34
28,121,28,149,165,80,85
28,121,28,151,82,0,82
28,121,28,159,53,0,53
28,121,28,163,110,86,24
28,121,32,3,45,0,45
28,121,47,37,22,52,-30
28,121,47,157,97,69,28
28,121,48,85,0,59,-59
28,121,48,113,32,47,-15
28,121,48,201,64,82,-18
28,121,48,439,28,60,-32
28,123,28,49,158,129,29
28,123,28,75,43,35,8
28,123,28,79,152,173,-21
28,123,28,89,38,54,-16
28,123,28,99,42,56,-14
28,123,28,101,143,168,-25
28,123,28,121,321,344,-23
28,123,28,129,55,54,1
28,127,28,29,34,58,-24
28,127,28,31,111,117,-6
28,127,28,35,32,48,-16
28,127,28,47,34,43,-9
28,127,28,49,256,160,96
28,127,28,65,67,61,6
28,127,28,67,27,37,-10
28,127,28,73,0,39,-39
28,127,28,77,46,61,-15
28,127,28,89,55,38,17
28,127,28,121,392,329,63
28,127,28,129,115,87,28
28,129,28,31,51,53,-2
28,129,28,35,0,34,-34
28,129,28,49,29,0,29
28,129,28,61,69,99,-30
28,129,28,67,103,139,-36
28,129,28,73,0,23,-23
28,129,28,121,79,113,-34
28,129,28,123,54,55,-1
28,129,28,127,87,115,-28
28,131,28,35,62,62,0
28,131,28,45,58,0,58
28,131,28,47,632,309,323
28,131,28,59,96,75,21
28,131,28,73,44,67,-23
28,131,28,109,57,36,21
28,133,17,31,29,0,29
28,133,28,11,224,216,8
28,133,28,33,38,50,-12
28,133,28,49,51,52,-1
28,133,28,53,63,74,-11
28,133,28,83,125,135,-10
28,133,28,89,0,41,-41
28,133,28,135,52,0,52
28,133,28,151,139,190,-51
28,133,47,157,66,212,-146
28,133,48,113,0,29,-29
28,135,28,11,0,36,-36
28,135,28,27,64,122,-58
28,135,28,33,0,35,-35
28,135,28,43,62,93,-31
28,135,28,83,0,34,-34
28,135,28,107,89,65,24
28,135,28,133,0,52,-52
28,135,28,161,51,78,-27
28,135,47,157,72,62,10
28,137,28,33,689,720,-31
28,137,28,71,41,47,-6
28,137,28,93,106,79,27
28,137,28,107,307,350,-43
28,137,28,143,100,64,36
28,137,47,157,360,202,158
28,139,28,3,114,127,-13
28,139,28,9,122,117,5
28,139,28,33,42,0,42
28,139,28,81,43,82,-39
28,139,28,93,32,40,-8
28,139,28,115,42,47,-5
28,139,28,117,0,60,-60
28,139,28,145,202,237,-35
28,139,47,69,36,28,8
28,139,47,157,88,37,51
28,141,1,33,51,64,-13
28,141,1,59,98,84,14
28,141,1,77,0,38,-38
28,141,28,3,189,232,-43
28,141,28,57,94,113,-19
28,141,28,81,41,52,-11
28,141,28,117,93,86,7
28,141,47,71,30,0,30
28,141,47,109,0,31,-31
28,141,47,157,46,0,46
28,143,5,107,62,34,28
28,143,28,27,202,143,59
28,143,28,33,211,490,-279
28,143,28,107,64,77,-13
28,143,28,119,86,68,18
28,143,28,137,64,100,-36
28,143,47,157,253,176,77
28,145,28,9,77,85,-8
28,145,28,17,0,32,-32
28,145,28,57,0,45,-45
28,145,28,71,47,78,-31
28,145,28,81,307,292,15
28,145,28,93,59,47,12
28,145,28,95,0,43,-43
28,145,28,115,347,285,62
28,145,28,117,57,61,-4
28,145,28,139,237,202,35
28,145,47,157,40,33,7
28,147,22,33,30,0,30
28,147,22,51,33,0,33
28,147,22,71,0,38,-38
28,147,22,117,61,43,18
28,147,28,35,34,43,-9
28,147,28,85,42,65,-23
28,147,28,91,96,135,-39
28,147,28,113,124,194,-70
28,149,17,31,39,0,39
28,149,22,33,0,36,-36
28,149,22,65,113,110,3
28,149,22,73,0,30,-30
28,149,28,1,27,42,-15
28,149,28,21,239,199,40
28,149,28,33,0,32,-32
28,149,28,35,0,54,-54
28,149,28,47,28,77,-49
28,149,28,49,386,563,-177
28,149,28,63,58,32,26
28,149,28,89,42,104,-62
28,149,28,105,0,50,-50
28,149,28,121,80,165,-85
28,149,28,125,51,52,-1
28,149,28,151,29,72,-43
28,149,47,157,0,88,-88
28,149,48,113,37,49,-12
28,149,48,201,40,55,-15
28,149,48,439,0,44,-44
28,151,5,17,81,64,17
28,151,5,119,0,28,-28
28,151,17,31,49,46,3
28,151,28,11,212,197,15
28,151,28,33,37,135,-98
28,151,28,35,36,43,-7
28,151,28,47,0,34,-34
28,151,28,49,101,139,-38
28,151,28,53,0,52,-52
28,151,28,55,0,32,-32
28,151,28,71,23,0,23
28,151,28,81,0,46,-46
28,151,28,83,35,66,-31
28,151,28,89,0,79,-79
28,151,28,105,24,44,-20
28,151,28,121,0,82,-82
28,151,28,125,73,54,19
28,151,28,133,190,139,51
28,151,28,149,72,29,43
28,151,47,37,0,39,-39
28,151,47,157,243,396,-153
28,151,48,113,0,79,-79
28,151,48,201,34,50,-16
28,151,48,439,0,63,-63
28,153,1,97,34,0,34
28,153,1,129,55,0,55
28,153,28,23,97,92,5
28,153,28,35,45,92,-47
28,153,28,41,63,80,-17
28,153,28,61,45,33,12
28,153,28,67,116,208,-92
28,153,28,73,0,30,-30
28,153,28,75,0,30,-30
28,155,28,13,46,0,46
28,155,28,19,79,44,35
28,155,28,25,69,49,20
28,155,28,43,38,32,6
28,155,28,97,37,0,37
28,155,28,105,213,137,76
28,157,22,33,87,135,-48
28,157,22,37,0,35,-35
28,157,22,71,0,32,-32
28,157,22,125,38,0,38
28,157,28,1,0,33,-33
28,157,28,5,78,78,0
28,157,28,85,39,0,39
28,157,28,113,45,36,9
28,159,28,7,0,41,-41
28,159,28,19,45,71,-26
28,159,28,75,0,42,-42
28,159,28,79,38,0,38
28,159,28,99,127,155,-28
28,159,28,103,42,0,42
28,159,28,105,102,100,2
28,159,28,121,0,53,-53
28,161,28,13,37,43,-6
28,161,28,33,49,61,-12
28,161,28,43,139,102,37
28,161,28,71,156,187,-31
28,161,28,107,74,116,-42
28,161,28,135,78,51,27
28,161,47,157,41,43,-2
28,163,28,49,190,302,-112
28,163,28,51,53,91,-38
28,163,28,53,53,45,8
28,163,28,89,100,211,-111
28,163,28,121,86,110,-24
28,163,47,157,46,36,10
29,1,4,13,0,42,-42
29,1,17,31,0,25,-25
29,1,29,19,79,174,-95
29,1,29,47,28,0,28
29,1,29,77,30,0,30
29,1,29,95,0,34,-34
29,1,29,103,71,53,18
29,1,29,111,32,0,32
29,1,29,121,161,90,71
29,1,29,127,0,31,-31
29,1,29,171,63,31,32
29,1,29,175,26,0,26
29,1,29,189,45,76,-31
29,1,29,197,86,103,-17
29,1,29,211,75,59,16
29,1,29,510,0,25,-25
29,1,49,49,53,0,53
29,3,20,43,45,57,-12
29,3,20,91,0,23,-23
29,3,29,21,1113,1115,-2
29,3,29,47,55,63,-8
29,3,29,63,56,35,21
29,3,29,87,48,0,48
29,3,29,95,25,30,-5
29,3,29,147,62,43,19
29,3,29,165,46,63,-17
29,5,19,145,28,0,28
29,5,29,147,39,50,-11
29,7,29,19,219,295,-76
29,7,29,27,192,192,0
29,7,29,51,40,33,7
29,7,29,127,34,34,0
29,7,29,137,77,50,27
29,7,29,139,113,51,62
29,7,29,163,81,44,37
29,7,29,173,46,31,15
29,7,29,175,46,52,-6
29,7,29,183,0,28,-28
29,7,29,189,64,44,20
29,9,5,7,224,261,-37
29,9,5,15,60,82,-22
29,9,5,143,59,42,17
29,9,20,173,33,0,33
29,9,29,43,53,99,-46
29,9,29,77,157,246,-89
29,9,29,95,35,0,35
29,9,29,97,138,104,34
29,9,29,109,490,432,58
29,9,29,119,57,83,-26
29,9,29,145,148,149,-1
29,9,29,209,81,111,-30
29,9,29,213,0,55,-55
29,11,20,37,85,104,-19
29,11,29,39,33,0,33
29,11,29,57,84,43,41
29,11,29,77,23,59,-36
29,11,29,97,132,254,-122
29,11,29,217,44,97,-53
29,13,20,91,32,60,-28
29,13,20,107,31,0,31
29,13,20,121,43,45,-2
29,13,29,37,279,263,16
29,13,29,47,24,0,24
29,13,29,77,0,21,-21
29,13,29,83,50,44,6
29,13,29,95,184,140,44
29,13,29,185,32,40,-8
29,13,29,217,78,112,-34
29,15,20,91,60,0,60
29,15,29,29,48,46,2
29,15,29,37,45,45,0
29,15,29,47,29,64,-35
29,15,29,77,28,47,-19
29,15,29,83,74,109,-35
29,15,29,95,221,107,114
29,15,29,101,54,42,12
29,15,29,107,35,0,35
29,15,29,141,36,0,36
29,15,29,159,210,279,-69
29,15,29,195,37,0,37
29,17,29,31,238,310,-72
29,17,29,123,58,50,8
29,17,29,157,35,56,-21
29,17,29,201,72,54,18
29,17,29,207,70,64,6
29,19,4,13,72,103,-31
29,19,4,19,45,34,11
29,19,5,119,27,0,27
29,19,5,143,24,28,-4
29,19,6,37,67,71,-4
29,19,6,59,35,27,8
29,19,6,73,53,67,-14
29,19,6,75,0,27,-27
29,19,6,85,0,32,-32
29,19,8,5,0,41,-41
29,19,8,31,0,28,-28
29,19,8,41,36,37,-1
29,19,11,1,0,29,-29
29,19,12,57,40,0,40
29,19,12,95,0,25,-25
29,19,12,103,0,25,-25
29,19,17,1,43,28,15
29,19,17,19,41,30,11
29,19,17,31,121,219,-98
29,19,17,43,31,0,31
29,19,17,97,31,0,31
29,19,17,113,59,45,14
29,19,17,119,52,53,-1
29,19,17,163,80,50,30
29,19,17,167,0,27,-27
29,19,17,197,40,0,40
29,19,18,97,0,22,-22
29,19,18,141,0,34,-34
29,19,19,153,25,55,-30
29,19,20,45,0,36,-36
29,19,20,91,164,218,-54
29,19,20,161,31,0,31
29,19,20,173,0,54,-54
29,19,20,209,0,28,-28
29,19,21,111,0,35,-35
29,19,22,33,28,0,28
29,19,24,31,31,36,-5
29,19,25,25,24,0,24
29,19,26,163,25,0,25
29,19,27,53,31,42,-11
29,19,29,1,174,79,95
29,19,29,7,295,219,76
29,19,29,21,40,37,3
29,19,29,23,27,0,27
29,19,29,27,635,614,21
29,19,29,29,123,61,62
29,19,29,31,103,69,34
29,19,29,37,51,48,3
29,19,29,41,54,32,22
29,19,29,43,28,42,-14
29,19,29,47,172,187,-15
29,19,29,51,588,539,49
29,19,29,53,268,239,29
29,19,29,65,37,0,37
29,19,29,71,101,67,34
29,19,29,73,25,0,25
29,19,29,77,223,184,39
29,19,29,83,0,22,-22
29,19,29,89,210,281,-71
29,19,29,91,24,0,24
29,19,29,95,361,520,-159
29,19,29,97,51,55,-4
29,19,29,99,69,68,1
29,19,29,101,71,59,12
29,19,29,103,25,0,25
29,19,29,107,34,36,-2
29,19,29,113,24,33,-9
29,19,29,115,40,0,40
29,19,29,121,108,70,38
29,19,29,127,104,56,48
29,19,29,131,62,31,31
29,19,29,135,53,35,18
29,19,29,137,113,76,37
29,19,29,139,74,0,74
29,19,29,141,39,0,39
29,19,29,147,45,0,45
29,19,29,151,30,42,-12
29,19,29,159,107,82,25
29,19,29,161,101,69,32
29,19,29,163,31,0,31
29,19,29,165,49,69,-20
29,19,29,169,62,0,62
29,19,29,173,25,23,2
29,19,29,175,368,319,49
29,19,29,183,342,294,48
29,19,29,187,34,0,34
29,19,29,189,641,753,-112
29,19,29,195,92,50,42
29,19,29,205,32,0,32
29,19,29,213,31,49,-18
29,19,29,219,35,32,3
29,19,29,510,162,248,-86
29,19,31,55,55,24,31
29,19,31,109,0,29,-29
29,19,32,3,38,44,-6
29,19,36,61,0,51,-51
29,19,37,119,0,25,-25
29,19,39,35,31,0,31
29,19,39,49,0,30,-30
29,19,40,109,32,36,-4
29,19,40,143,41,56,-15
29,19,41,51,0,45,-45
29,19,42,101,0,26,-26
29,19,45,79,0,28,-28
29,19,47,37,0,25,-25
29,19,47,157,72,55,17
29,19,48,29,34,60,-26
29,19,48,85,0,35,-35
29,19,48,113,37,67,-30
29,19,48,201,58,88,-30
29,19,48,439,42,60,-18
29,19,48,453,39,47,-8
29,19,53,33,33,59,-26
29,19,55,25,37,26,11
29,21,4,13,34,46,-12
29,21,6,37,27,0,27
29,21,19,153,28,28,0
29,21,19,179,0,32,-32
29,21,20,5,107,103,4
29,21,20,13,37,31,6
29,21,20,43,185,238,-53
29,21,20,91,104,181,-77
29,21,20,103,38,51,-13
29,21,20,173,58,26,32
29,21,20,209,71,43,28
29,21,29,3,1115,1113,2
29,21,29,19,37,40,-3
29,21,29,25,39,0,39
29,21,29,29,0,38,-38
29,21,29,37,27,42,-15
29,21,29,47,222,338,-116
29,21,29,49,158,167,-9
29,21,29,61,26,35,-9
29,21,29,63,186,209,-23
29,21,29,75,56,47,9
29,21,29,77,35,38,-3
29,21,29,81,0,32,-32
29,21,29,87,85,64,21
29,21,29,95,318,320,-2
29,21,29,115,31,0,31
29,21,29,117,39,48,-9
29,21,29,147,154,96,58
29,21,29,165,197,355,-158
29,21,29,177,22,0,22
29,21,29,189,51,56,-5
29,21,29,211,31,69,-38
29,21,31,55,43,31,12
29,21,31,79,0,36,-36
29,21,31,109,24,37,-13
29,21,31,153,33,0,33
29,21,48,201,0,37,-37
29,23,5,21,47,62,-15
29,23,5,31,24,50,-26
29,23,5,55,29,0,29
29,23,29,19,0,27,-27
29,23,29,31,73,108,-35
29,23,29,35,127,97,30
29,23,29,69,178,123,55
29,23,29,77,37,76,-39
29,23,29,99,52,54,-2
29,23,29,161,28,0,28
29,23,29,179,27,0,27
29,23,29,181,308,307,1
29,23,29,183,0,55,-55
29,23,29,187,47,0,47
29,23,29,189,67,78,-11
29,23,29,201,34,30,4
29,23,29,207,245,260,-15
29,23,29,223,204,187,17
29,23,29,510,35,0,35
29,25,29,21,0,39,-39
29,25,29,47,87,125,-38
29,25,29,49,80,113,-33
29,25,29,61,50,52,-2
29,25,29,63,0,57,-57
29,25,29,95,28,34,-6
29,25,29,117,89,54,35
29,25,29,177,56,50,6
29,27,29,7,192,192,0
29,27,29,19,614,635,-21
29,27,29,29,0,44,-44
29,27,29,51,875,999,-124
29,27,29,71,0,30,-30
29,27,29,77,52,56,-4
29,27,29,95,27,70,-43
29,27,29,99,31,0,31
29,27,29,131,67,47,20
29,27,29,135,52,52,0
29,27,29,139,36,43,-7
29,27,29,151,51,38,13
29,27,29,183,84,54,30
29,27,29,189,88,83,5
29,27,29,510,0,35,-35
29,29,4,13,39,38,1
29,29,6,73,31,0,31
29,29,17,31,24,0,24
29,29,17,119,33,0,33
29,29,17,167,0,21,-21
29,29,19,153,31,0,31
29,29,20,91,76,46,30
29,29,29,15,46,48,-2
29,29,29,19,61,123,-62
29,29,29,21,38,0,38
29,29,29,27,44,0,44
29,29,29,37,0,52,-52
29,29,29,47,55,40,15
29,29,29,51,83,131,-48
29,29,29,59,26,33,-7
29,29,29,71,0,27,-27
29,29,29,77,81,147,-66
29,29,29,95,163,110,53
29,29,29,97,56,53,3
29,29,29,99,30,34,-4
29,29,29,105,188,192,-4
29,29,29,131,470,433,37
29,29,29,141,173,217,-44
29,29,29,161,31,26,5
29,29,29,165,24,0,24
29,29,29,169,85,84,1
29,29,29,175,26,0,26
29,29,29,183,110,66,44
29,29,29,189,176,105,71
29,29,29,510,32,32,0
29,31,4,13,28,0,28
29,31,17,3,165,104,61
29,31,17,31,33,27,6
29,31,17,77,51,52,-1
29,31,17,119,0,28,-28
29,31,17,153,47,34,13
29,31,17,157,26,0,26
29,31,17,163,38,49,-11
29,31,17,181,72,47,25
29,31,17,199,0,43,-43
29,31,29,17,310,238,72
29,31,29,19,69,103,-34
29,31,29,23,108,73,35
29,31,29,51,0,42,-42
29,31,29,69,95,59,36
29,31,29,77,0,57,-57
29,31,29,95,0,49,-49
29,31,29,99,110,141,-31
29,31,29,123,25,0,25
29,31,29,133,101,36,65
29,31,29,143,112,65,47
29,31,29,155,36,39,-3
29,31,29,157,187,178,9
29,31,29,183,107,116,-9
29,31,29,186,38,35,3
29,31,29,187,69,104,-35
29,31,29,189,235,348,-113
29,31,29,201,927,810,117
29,31,29,207,218,148,70
29,31,29,223,0,31,-31
29,31,29,510,60,112,-52
29,31,47,37,0,30,-30
29,31,47,157,31,50,-19
29,31,48,201,0,25,-25
29,33,29,41,0,31,-31
29,33,29,47,44,53,-9
29,33,29,95,58,58,0
29,33,29,107,0,41,-41
29,33,29,117,68,58,10
29,33,29,177,25,46,-21
29,33,29,195,50,50,0
29,35,29,23,97,127,-30
29,35,29,179,33,0,33
29,35,29,181,0,38,-38
29,37,4,13,32,40,-8
29,37,6,37,0,26,-26
29,37,6,73,53,72,-19
29,37,20,91,936,733,203
29,37,20,103,0,47,-47
29,37,20,121,91,83,8
29,37,20,173,32,37,-5
29,37,20,209,107,72,35
29,37,29,13,263,279,-16
29,37,29,15,45,45,0
29,37,29,19,48,51,-3
29,37,29,21,42,27,15
29,37,29,29,52,0,52
29,37,29,47,265,244,21
29,37,29,77,84,95,-11
29,37,29,83,135,172,-37
29,37,29,85,0,32,-32
29,37,29,95,4194,2871,1323
29,37,29,97,38,0,38
29,37,29,99,29,0,29
29,37,29,101,210,245,-35
29,37,29,107,52,45,7
29,37,29,159,67,0,67
29,37,29,165,84,128,-44
29,37,29,167,33,47,-14
29,37,29,185,0,25,-25
29,37,29,189,29,33,-4
29,37,29,213,0,32,-32
29,37,29,217,44,33,11
29,37,37,133,53,0,53
29,37,48,113,24,0,24
29,39,29,11,0,33,-33
29,39,29,43,0,30,-30
29,39,29,77,65,115,-50
29,39,29,95,52,52,0
29,39,29,97,26,27,-1
29,39,29,167,93,80,13
29,39,29,185,36,0,36
29,39,29,217,155,184,-29
29,41,29,19,32,54,-22
29,41,29,33,31,0,31
29,41,29,89,0,33,-33
29,41,29,95,27,0,27
29,41,29,115,58,71,-13
29,41,29,121,0,29,-29
29,41,29,175,58,93,-35
29,43,4,13,60,30,30
29,43,5,5,42,0,42
29,43,5,7,35,36,-1
29,43,5,9,39,60,-21
29,43,5,143,0,35,-35
29,43,6,37,30,0,30
29,43,6,73,47,0,47
29,43,20,91,68,40,28
29,43,20,173,36,0,36
29,43,29,9,99,53,46
29,43,29,19,42,28,14
29,43,29,39,30,0,30
29,43,29,47,35,29,6
29,43,29,51,39,0,39
29,43,29,59,60,37,23
29,43,29,67,83,60,23
29,43,29,77,3765,3206,559
29,43,29,91,59,36,23
29,43,29,95,91,96,-5
29,43,29,97,84,82,2
29,43,29,99,33,0,33
29,43,29,105,60,51,9
29,43,29,109,199,163,36
29,43,29,145,43,0,43
29,43,29,161,0,36,-36
29,43,29,165,33,0,33
29,43,29,167,67,107,-40
29,43,29,183,0,37,-37
29,43,29,189,103,55,48
29,43,29,209,462,253,209
29,43,29,213,533,321,212
29,43,29,215,44,0,44
29,43,29,225,267,319,-52
29,43,29,229,64,48,16
29,43,32,3,65,29,36
29,43,40,109,0,31,-31
29,43,40,143,59,43,16
29,43,48,201,0,38,-38
29,45,19,111,105,95,10
29,45,29,199,38,0,38
29,47,4,13,94,172,-78
29,47,4,19,0,39,-39
29,47,5,7,0,26,-26
29,47,5,143,23,0,23
29,47,6,37,76,66,10
29,47,6,59,0,31,-31
29,47,6,65,44,0,44
29,47,6,67,26,0,26
29,47,6,71,52,0,52
29,47,6,73,48,79,-31
29,47,8,1,31,0,31
29,47,8,5,0,37,-37
29,47,8,41,0,43,-43
29,47,8,59,37,30,7
29,47,12,11,0,22,-22
29,47,12,57,0,54,-54
29,47,12,71,0,34,-34
29,47,15,3,37,41,-4
29,47,17,31,75,92,-17
29,47,17,43,0,27,-27
29,47,17,119,47,0,47
29,47,18,97,29,0,29
29,47,19,113,0,44,-44
29,47,19,153,62,97,-35
29,47,20,45,97,62,35
29,47,20,91,1164,1260,-96
29,47,20,103,135,94,41
29,47,20,121,25,0,25
29,47,20,161,54,39,15
29,47,20,173,128,73,55
29,47,20,177,65,70,-5
29,47,20,209,709,500,209
29,47,26,125,39,0,39
29,47,26,163,48,0,48
29,47,27,123,25,0,25
29,47,29,1,0,28,-28
29,47,29,3,63,55,8
29,47,29,13,0,24,-24
29,47,29,15,64,29,35
29,47,29,19,187,172,15
29,47,29,21,338,222,116
29,47,29,25,125,87,38
29,47,29,29,40,55,-15
29,47,29,33,53,44,9
29,47,29,37,244,265,-21
29,47,29,43,29,35,-6
29,47,29,49,499,501,-2
29,47,29,51,59,59,0
29,47,29,61,52,33,19
29,47,29,63,56,28,28
29,47,29,77,181,106,75
29,47,29,83,0,36,-36
29,47,29,95,5429,4536,893
29,47,29,97,65,37,28
29,47,29,101,101,97,4
29,47,29,107,111,105,6
29,47,29,115,29,0,29
29,47,29,117,72,37,35
29,47,29,141,34,0,34
29,47,29,145,30,43,-13
29,47,29,147,61,47,14
29,47,29,159,36,29,7
29,47,29,165,4546,3690,856
29,47,29,167,0,45,-45
29,47,29,177,781,662,119
29,47,29,183,113,96,17
29,47,29,189,174,142,32
29,47,29,195,37,0,37
29,47,29,213,0,29,-29
29,47,29,510,29,42,-13
29,47,31,55,112,55,57
29,47,31,109,48,47,1
29,47,31,153,39,34,5
29,47,32,3,60,81,-21
29,47,40,27,32,0,32
29,47,40,109,61,45,16
29,47,40,143,51,50,1
29,47,47,157,33,0,33
29,47,48,29,25,29,-4
29,47,48,85,0,33,-33
29,47,48,113,61,65,-4
29,47,48,121,0,63,-63
29,47,48,201,57,108,-51
29,47,48,439,77,101,-24
29,47,48,453,0,23,-23
29,47,49,35,38,0,38
29,47,51,59,31,0,31
29,47,51,810,35,0,35
29,47,53,33,48,0,48
29,47,53,53,0,28,-28
29,47,55,79,42,0,42
29,49,20,91,30,33,-3
29,49,29,21,167,158,9
29,49,29,25,113,80,33
29,49,29,47,501,499,2
29,49,29,61,107,69,38
29,49,29,63,119,120,-1
29,49,29,95,130,134,-4
29,49,29,117,37,0,37
29,49,29,165,145,95,50
29,49,29,177,0,56,-56
29,51,17,31,62,59,3
29,51,17,119,0,26,-26
29,51,20,91,32,61,-29
29,51,29,7,33,40,-7
29,51,29,19,539,588,-49
29,51,29,27,999,875,124
29,51,29,29,131,83,48
29,51,29,31,42,0,42
29,51,29,43,0,39,-39
29,51,29,47,59,59,0
29,51,29,71,27,31,-4
29,51,29,73,47,29,18
29,51,29,77,99,159,-60
29,51,29,95,121,149,-28
29,51,29,97,45,0,45
29,51,29,99,32,33,-1
29,51,29,101,58,0,58
29,51,29,125,87,57,30
29,51,29,131,239,221,18
29,51,29,135,306,230,76
29,51,29,141,90,79,11
29,51,29,151,254,263,-9
29,51,29,159,39,0,39
29,51,29,161,72,24,48
29,51,29,169,47,0,47
29,51,29,175,34,32,2
29,51,29,183,43,86,-43
29,51,29,189,204,239,-35
29,51,29,510,78,103,-25
29,53,29,19,239,268,-29
29,53,29,89,169,138,31
29,53,29,95,0,38,-38
29,53,29,135,62,68,-6
29,53,29,141,33,34,-1
29,53,29,159,83,111,-28
29,53,29,195,34,50,-16
29,55,29,65,33,56,-23
29,55,29,71,544,464,80
29,55,29,73,46,46,0
29,55,29,77,0,43,-43
29,55,29,93,38,40,-2
29,55,29,99,68,47,21
29,55,29,161,197,210,-13
29,55,29,183,39,63,-24
29,55,29,189,124,116,8
29,55,29,221,65,38,27
29,55,29,510,39,30,9
29,57,29,11,43,84,-41
29,57,29,77,224,181,43
29,57,29,97,30,52,-22
29,57,29,109,56,37,19
29,59,29,29,33,26,7
29,59,29,43,37,60,-23
29,59,29,77,345,446,-101
29,59,29,85,62,46,16
29,59,29,95,38,0,38
29,59,29,105,86,140,-54
29,59,29,167,103,144,-41
29,59,29,225,101,56,45
29,61,29,21,35,26,9
29,61,29,25,52,50,2
29,61,29,47,33,52,-19
29,61,29,49,69,107,-38
29,61,29,63,33,26,7
29,61,29,79,0,77,-77
29,61,29,81,52,39,13
29,61,29,95,0,47,-47
29,61,29,117,0,40,-40
29,63,29,3,35,56,-21
29,63,29,21,209,186,23
29,63,29,25,57,0,57
29,63,29,47,28,56,-28
29,63,29,49,120,119,1
29,63,29,61,26,33,-7
29,63,29,75,35,0,35
29,63,29,95,36,24,12
29,63,29,165,0,26,-26
29,65,29,19,0,37,-37
29,65,29,55,56,33,23
29,65,29,77,37,52,-15
29,65,29,93,37,0,37
29,65,29,99,24,0,24
29,65,29,161,276,225,51
29,65,29,169,43,0,43
29,65,29,183,34,0,34
29,65,29,189,70,42,28
29,65,29,215,61,50,11
29,67,29,43,60,83,-23
29,67,29,77,91,132,-41
29,67,29,91,0,34,-34
29,67,29,153,84,37,47
29,67,29,213,38,54,-16
29,67,29,215,47,0,47
29,67,29,225,61,51,10
29,67,29,229,100,127,-27
29,69,5,21,102,153,-51
29,69,5,31,48,109,-61
29,69,5,55,98,174,-76
29,69,5,93,129,84,45
29,69,29,23,123,178,-55
29,69,29,31,59,95,-36
29,69,29,77,0,23,-23
29,69,29,143,117,184,-67
29,69,29,155,253,186,67
29,69,29,189,32,0,32
29,69,29,201,39,74,-35
29,69,29,207,187,143,44
29,71,4,13,57,0,57
29,71,17,31,0,21,-21
29,71,17,119,53,41,12
29,71,17,163,36,47,-11
29,71,29,19,67,101,-34
29,71,29,27,30,0,30
29,71,29,29,27,0,27
29,71,29,51,31,27,4
29,71,29,55,464,544,-80
29,71,29,73,387,366,21
29,71,29,77,88,97,-9
29,71,29,95,55,49,6
29,71,29,99,787,558,229
29,71,29,113,39,34,5
29,71,29,125,40,0,40
29,71,29,151,43,0,43
29,71,29,161,114,108,6
29,71,29,169,36,0,36
29,71,29,183,360,274,86
29,71,29,187,80,36,44
29,71,29,189,1391,1011,380
29,71,29,213,0,32,-32
29,71,29,219,205,175,30
29,71,29,221,90,109,-19
29,71,29,510,252,241,11
29,73,29,19,0,25,-25
29,73,29,51,29,47,-18
29,73,29,55,46,46,0
29,73,29,71,366,387,-21
29,73,29,77,0,24,-24
29,73,29,99,0,26,-26
29,73,29,125,72,84,-12
29,73,29,139,47,43,4
29,73,29,151,45,59,-14
29,73,29,161,37,0,37
29,73,29,183,32,41,-9
29,73,29,189,65,36,29
29,73,29,219,0,28,-28
29,73,29,510,28,0,28
29,75,29,21,47,56,-9
29,75,29,63,0,35,-35
29,75,29,81,0,47,-47
29,75,29,95,0,22,-22
29,75,29,147,67,63,4
29,77,4,13,119,156,-37
29,77,4,19,35,49,-14
29,77,4,25,27,0,27
29,77,5,5,73,60,13
29,77,5,7,114,176,-62
29,77,5,9,61,57,4
29,77,5,15,35,52,-17
29,77,5,45,37,0,37
29,77,5,51,0,25,-25
29,77,5,115,0,28,-28
29,77,5,119,48,69,-21
29,77,5,125,29,0,29
29,77,5,131,40,40,0
29,77,5,143,104,93,11
29,77,6,37,94,113,-19
29,77,6,59,69,50,19
29,77,6,65,83,36,47
29,77,6,67,48,0,48
29,77,6,71,93,45,48
29,77,6,73,132,80,52
29,77,6,75,0,27,-27
29,77,6,85,39,0,39
29,77,8,1,0,40,-40
29,77,8,5,25,0,25
29,77,8,41,42,79,-37
29,77,8,59,0,36,-36
29,77,8,69,0,33,-33
29,77,12,11,36,23,13
29,77,12,57,28,39,-11
29,77,12,71,36,0,36
29,77,12,83,24,0,24
29,77,12,95,42,67,-25
29,77,12,103,31,41,-10
29,77,12,127,35,0,35
29,77,13,67,0,26,-26
29,77,15,3,43,54,-11
29,77,16,1,0,34,-34
29,77,17,31,79,149,-70
29,77,17,119,39,28,11
29,77,17,163,25,0,25
29,77,19,153,57,54,3
29,77,20,37,49,0,49
29,77,20,45,29,26,3
29,77,20,91,195,276,-81
29,77,20,161,0,38,-38
29,77,20,173,91,124,-33
29,77,20,177,31,40,-9
29,77,20,209,27,40,-13
29,77,27,53,41,34,7
29,77,28,47,26,0,26
29,77,29,1,0,30,-30
29,77,29,9,246,157,89
29,77,29,11,59,23,36
29,77,29,13,21,0,21
29,77,29,15,47,28,19
29,77,29,19,184,223,-39
29,77,29,21,38,35,3
29,77,29,23,76,37,39
29,77,29,27,56,52,4
29,77,29,29,147,81,66
29,77,29,31,57,0,57
29,77,29,37,95,84,11
29,77,29,39,115,65,50
29,77,29,43,3206,3765,-559
29,77,29,47,106,181,-75
29,77,29,51,159,99,60
29,77,29,55,43,0,43
29,77,29,57,181,224,-43
29,77,29,59,446,345,101
29,77,29,65,52,37,15
29,77,29,67,132,91,41
29,77,29,69,23,0,23
29,77,29,71,97,88,9
29,77,29,73,24,0,24
29,77,29,83,88,50,38
29,77,29,85,78,96,-18
29,77,29,91,283,145,138
29,77,29,95,476,483,-7
29,77,29,97,369,282,87
29,77,29,99,75,78,-3
29,77,29,101,55,52,3
29,77,29,105,244,223,21
29,77,29,109,672,613,59
29,77,29,131,54,43,11
29,77,29,141,37,0,37
29,77,29,145,138,101,37
29,77,29,149,41,0,41
29,77,29,153,61,46,15
29,77,29,159,81,35,46
29,77,29,161,130,74,56
29,77,29,165,43,82,-39
29,77,29,167,859,798,61
29,77,29,169,129,105,24
29,77,29,183,168,182,-14
29,77,29,185,75,22,53
29,77,29,187,66,0,66
29,77,29,189,341,387,-46
29,77,29,203,30,0,30
29,77,29,207,30,0,30
29,77,29,209,441,363,78
29,77,29,213,550,371,179
29,77,29,215,105,122,-17
29,77,29,217,65,33,32
29,77,29,225,1281,1340,-59
29,77,29,229,218,104,114
29,77,29,510,65,148,-83
29,77,31,55,46,46,0
29,77,31,109,29,0,29
29,77,32,3,133,90,43
29,77,36,61,27,0,27
29,77,37,51,0,38,-38
29,77,37,133,32,0,32
29,77,39,49,29,31,-2
29,77,40,27,0,37,-37
29,77,40,109,32,68,-36
29,77,40,143,110,232,-122
29,77,41,51,68,39,29
29,77,41,67,0,32,-32
29,77,47,37,0,30,-30
29,77,47,157,46,0,46
29,77,48,27,23,0,23
29,77,48,29,44,50,-6
29,77,48,85,0,74,-74
29,77,48,113,95,97,-2
29,77,48,121,0,41,-41
29,77,48,141,0,31,-31
29,77,48,201,64,77,-13
29,77,48,439,119,102,17
29,77,48,453,0,37,-37
29,77,48,491,0,30,-30
29,77,53,33,0,37,-37
29,77,53,53,26,0,26
29,77,55,79,27,0,27
29,79,29,61,77,0,77
29,79,29,95,0,24,-24
29,79,29,117,51,63,-12
29,79,29,129,35,45,-10
29,79,29,211,0,59,-59
29,81,29,21,32,0,32
29,81,29,61,39,52,-13
29,81,29,75,47,0,47
29,83,20,91,0,32,-32
29,83,29,13,44,50,-6
29,83,29,15,109,74,35
29,83,29,19,22,0,22
29,83,29,37,172,135,37
29,83,29,47,36,0,36
29,83,29,77,50,88,-38
29,83,29,95,150,204,-54
29,83,29,101,178,244,-66
29,83,29,107,33,36,-3
29,83,29,159,67,111,-44
29,83,29,185,92,112,-20
29,85,29,37,32,0,32
29,85,29,59,46,62,-16
29,85,29,77,96,78,18
29,85,29,95,78,43,35
29,85,29,167,89,83,6
29,85,29,185,0,48,-48
29,87,29,3,0,48,-48
29,87,29,21,64,85,-21
29,87,29,147,91,85,6
29,89,29,19,281,210,71
29,89,29,41,33,0,33
29,89,29,53,138,169,-31
29,89,29,175,61,30,31
29,89,29,195,33,40,-7
29,91,5,5,35,54,-19
29,91,5,49,48,42,6
29,91,29,19,0,24,-24
29,91,29,43,36,59,-23
29,91,29,67,34,0,34
29,91,29,77,145,283,-138
29,91,29,149,235,151,84
29,91,29,153,114,95,19
29,91,29,161,43,0,43
29,91,29,203,187,99,88
29,91,29,215,190,105,85
29,91,29,225,42,0,42
29,91,29,229,75,77,-2
29,93,29,55,40,38,2
29,93,29,65,0,37,-37
29,93,29,99,70,33,37
29,93,29,123,39,54,-15
29,93,29,179,46,0,46
29,93,29,187,196,322,-126
29,93,29,189,29,41,-12
29,93,29,221,72,45,27
29,93,29,223,48,0,48
29,95,2,20,29,0,29
29,95,4,13,315,460,-145
29,95,4,19,83,65,18
29,95,4,21,0,47,-47
29,95,5,7,45,99,-54
29,95,5,119,79,76,3
29,95,5,131,0,31,-31
29,95,5,143,63,37,26
29,95,6,1,56,51,5
29,95,6,13,28,35,-7
29,95,6,19,0,23,-23
29,95,6,37,383,290,93
29,95,6,53,0,28,-28
29,95,6,59,150,96,54
29,95,6,65,107,73,34
29,95,6,67,46,41,5
29,95,6,71,100,75,25
29,95,6,73,252,234,18
29,95,6,75,35,74,-39
29,95,6,81,27,0,27
29,95,6,85,63,70,-7
29,95,6,99,28,0,28
29,95,6,111,0,31,-31
29,95,8,1,30,37,-7
29,95,8,5,72,96,-24
29,95,8,13,0,41,-41
29,95,8,31,111,108,3
29,95,8,35,32,52,-20
29,95,8,41,109,119,-10
29,95,8,59,33,64,-31
29,95,8,69,32,37,-5
29,95,11,1,43,70,-27
29,95,12,1,23,0,23
29,95,12,9,0,27,-27
29,95,12,11,69,77,-8
29,95,12,21,45,0,45
29,95,12,31,73,75,-2
29,95,12,57,58,63,-5
29,95,12,71,66,31,35
29,95,12,86,55,66,-11
29,95,12,95,63,74,-11
29,95,12,99,30,47,-17
29,95,12,103,51,70,-19
29,95,12,105,37,33,4
29,95,12,115,37,29,8
29,95,12,117,0,30,-30
29,95,13,67,49,73,-24
29,95,13,89,44,72,-28
29,95,13,121,40,86,-46
29,95,13,135,0,39,-39
29,95,15,3,53,90,-37
29,95,16,1,24,0,24
29,95,17,31,366,450,-84
29,95,17,43,69,37,32
29,95,17,89,33,40,-7
29,95,17,97,40,24,16
29,95,17,119,39,41,-2
29,95,17,163,70,32,38
29,95,17,167,0,40,-40
29,95,17,197,0,50,-50
29,95,17,201,43,0,43
29,95,18,97,81,63,18
29,95,18,141,28,0,28
29,95,19,13,24,0,24
29,95,19,103,54,47,7
29,95,19,113,0,82,-82
29,95,19,153,132,107,25
29,95,19,163,39,47,-8
29,95,19,169,35,0,35
29,95,20,5,33,37,-4
29,95,20,15,27,0,27
29,95,20,37,71,42,29
29,95,20,45,501,280,221
29,95,20,51,23,0,23
29,95,20,59,56,74,-18
29,95,20,61,27,42,-15
29,95,20,79,27,0,27
29,95,20,91,6437,7470,-1033
29,95,20,103,167,235,-68
29,95,20,111,90,0,90
29,95,20,121,79,139,-60
29,95,20,125,38,0,38
29,95,20,155,38,43,-5
29,95,20,161,112,59,53
29,95,20,169,66,34,32
29,95,20,173,357,256,101
29,95,20,177,277,193,84
29,95,20,209,2479,2395,84
29,95,21,111,0,44,-44
29,95,22,51,29,38,-9
29,95,22,71,24,74,-50
29,95,24,31,0,40,-40
29,95,24,33,27,37,-10
29,95,25,17,36,64,-28
29,95,25,21,0,26,-26
29,95,25,25,0,31,-31
29,95,26,77,0,20,-20
29,95,26,81,37,0,37
29,95,26,99,31,0,31
29,95,26,125,83,47,36
29,95,26,163,81,46,35
29,95,27,37,0,31,-31
29,95,27,53,164,127,37
29,95,27,123,27,50,-23
29,95,29,1,34,0,34
29,95,29,3,30,25,5
29,95,29,9,0,35,-35
29,95,29,13,140,184,-44
29,95,29,15,107,221,-114
29,95,29,19,520,361,159
29,95,29,21,320,318,2
29,95,29,25,34,28,6
29,95,29,27,70,27,43
29,95,29,29,110,163,-53
29,95,29,31,49,0,49
29,95,29,33,58,58,0
29,95,29,37,2871,4194,-1323
29,95,29,39,52,52,0
29,95,29,41,0,27,-27
29,95,29,43,96,91,5
29,95,29,47,4536,5429,-893
29,95,29,49,134,130,4
29,95,29,51,149,121,28
29,95,29,53,38,0,38
29,95,29,59,0,38,-38
29,95,29,61,47,0,47
29,95,29,63,24,36,-12
29,95,29,71,49,55,-6
29,95,29,75,22,0,22
29,95,29,77,483,476,7
29,95,29,79,24,0,24
29,95,29,83,204,150,54
29,95,29,85,43,78,-35
29,95,29,97,128,147,-19
29,95,29,99,56,47,9
29,95,29,101,960,906,54
29,95,29,105,39,32,7
29,95,29,107,1032,1074,-42
29,95,29,109,30,40,-10
29,95,29,115,38,27,11
29,95,29,117,32,45,-13
29,95,29,119,0,28,-28
29,95,29,131,42,23,19
29,95,29,141,57,128,-71
29,95,29,145,37,47,-10
29,95,29,147,77,32,45
29,95,29,159,195,162,33
29,95,29,161,77,41,36
29,95,29,165,1490,1528,-38
29,95,29,167,59,67,-8
29,95,29,169,33,0,33
29,95,29,175,26,27,-1
29,95,29,177,231,286,-55
29,95,29,183,189,204,-15
29,95,29,185,58,87,-29
29,95,29,189,515,489,26
29,95,29,195,116,82,34
29,95,29,201,44,0,44
29,95,29,209,43,33,10
29,95,29,211,26,0,26
29,95,29,213,57,65,-8
29,95,29,217,78,49,29
29,95,29,225,29,34,-5
29,95,29,510,199,226,-27
29,95,31,55,262,217,45
29,95,31,109,118,87,31
29,95,31,153,38,68,-30
29,95,32,3,215,221,-6
29,95,32,31,0,38,-38
29,95,34,23,0,33,-33
29,95,35,1,64,64,0
29,95,35,13,28,0,28
29,95,36,45,0,42,-42
29,95,36,47,68,105,-37
29,95,36,55,25,0,25
29,95,36,61,66,96,-30
29,95,36,81,32,49,-17
29,95,36,103,0,25,-25
29,95,37,51,31,36,-5
29,95,37,63,30,0,30
29,95,37,119,51,43,8
29,95,37,133,78,0,78
29,95,37,183,0,55,-55
29,95,39,35,54,48,6
29,95,39,49,67,63,4
29,95,39,61,42,0,42
29,95,40,27,40,40,0
29,95,40,109,149,134,15
29,95,40,143,182,133,49
29,95,41,51,42,80,-38
29,95,41,67,0,32,-32
29,95,42,3,32,39,-7
29,95,42,101,37,37,0
29,95,44,7,0,24,-24
29,95,46,99,60,0,60
29,95,47,37,38,53,-15
29,95,47,157,64,56,8
29,95,48,27,0,79,-79
29,95,48,29,57,131,-74
29,95,48,85,71,118,-47
29,95,48,113,172,255,-83
29,95,48,121,62,91,-29
29,95,48,141,49,40,9
29,95,48,157,0,38,-38
29,95,48,201,198,261,-63
29,95,48,215,27,0,27
29,95,48,303,30,0,30
29,95,48,423,0,43,-43
29,95,48,439,141,243,-102
29,95,48,453,90,97,-7
29,95,48,491,32,56,-24
29,95,49,35,50,59,-9
29,95,49,49,34,40,-6
29,95,51,13,0,39,-39
29,95,51,59,65,58,7
29,95,51,107,0,32,-32
29,95,51,153,0,38,-38
29,95,51,510,0,24,-24
29,95,51,810,36,0,36
29,95,53,33,84,172,-88
29,95,53,53,31,53,-22
29,95,55,25,37,38,-1
29,95,55,79,79,88,-9
29,97,4,13,65,58,7
29,97,5,7,134,219,-85
29,97,5,131,0,36,-36
29,97,5,143,100,67,33
29,97,6,37,56,59,-3
29,97,6,65,46,0,46
29,97,6,71,33,0,33
29,97,6,73,40,0,40
29,97,8,41,23,0,23
29,97,17,31,0,28,-28
29,97,20,21,502,382,120
29,97,20,37,311,143,168
29,97,20,91,70,93,-23
29,97,20,99,87,46,41
29,97,20,125,35,36,-1
29,97,20,173,56,70,-14
29,97,20,177,0,37,-37
29,97,29,9,104,138,-34
29,97,29,11,254,132,122
29,97,29,19,55,51,4
29,97,29,29,53,56,-3
29,97,29,37,0,38,-38
29,97,29,39,27,26,1
29,97,29,43,82,84,-2
29,97,29,47,37,65,-28
29,97,29,51,0,45,-45
29,97,29,57,52,30,22
29,97,29,77,282,369,-87
29,97,29,95,147,128,19
29,97,29,109,258,231,27
29,97,29,119,105,79,26
29,97,29,145,1955,1573,382
29,97,29,167,36,0,36
29,97,29,183,0,40,-40
29,97,29,189,0,73,-73
29,97,29,213,40,81,-41
29,97,29,217,107,57,50
29,97,32,3,36,0,36
29,97,40,27,0,29,-29
29,97,40,41,63,81,-18
29,97,40,109,53,41,12
29,97,40,115,239,153,86
29,97,40,131,34,0,34
29,97,40,143,92,182,-90
29,97,48,113,0,61,-61
29,97,48,439,41,55,-14
29,99,4,13,38,54,-16
29,99,6,37,0,35,-35
29,99,6,73,47,45,2
29,99,8,41,26,0,26
29,99,17,31,26,39,-13
29,99,17,119,180,145,35
29,99,17,133,63,88,-25
29,99,17,163,257,170,87
29,99,20,91,0,27,-27
29,99,29,19,68,69,-1
29,99,29,23,54,52,2
29,99,29,27,0,31,-31
29,99,29,29,34,30,4
29,99,29,31,141,110,31
29,99,29,37,0,29,-29
29,99,29,43,0,33,-33
29,99,29,51,33,32,1
29,99,29,55,47,68,-21
29,99,29,65,0,24,-24
29,99,29,71,558,787,-229
29,99,29,73,26,0,26
29,99,29,77,78,75,3
29,99,29,93,33,70,-37
29,99,29,95,47,56,-9
29,99,29,113,76,89,-13
29,99,29,123,38,37,1
29,99,29,157,55,61,-6
29,99,29,161,26,51,-25
29,99,29,163,31,0,31
29,99,29,169,0,39,-39
29,99,29,183,536,640,-104
29,99,29,186,245,313,-68
29,99,29,187,610,663,-53
29,99,29,189,6502,5226,1276
29,99,29,201,0,34,-34
29,99,29,207,0,31,-31
29,99,29,219,52,58,-6
29,99,29,221,269,297,-28
29,99,29,223,33,55,-22
29,99,29,510,1651,1180,471
29,99,32,3,0,23,-23
29,99,47,125,36,0,36
29,99,47,157,25,0,25
29,99,48,113,29,0,29
29,99,48,201,0,31,-31
29,101,2,20,45,0,45
29,101,4,13,0,41,-41
29,101,12,57,0,38,-38
29,101,16,39,0,32,-32
29,101,20,91,68,117,-49
29,101,20,173,44,0,44
29,101,20,209,41,0,41
29,101,29,15,42,54,-12
29,101,29,19,59,71,-12
29,101,29,37,245,210,35
29,101,29,47,97,101,-4
29,101,29,51,0,58,-58
29,101,29,77,52,55,-3
29,101,29,83,244,178,66
29,101,29,95,906,960,-54
29,101,29,107,200,178,22
29,101,29,159,357,346,11
29,101,29,165,43,0,43
29,101,29,183,39,0,39
29,101,29,189,0,60,-60
29,101,29,195,0,56,-56
29,101,32,3,0,42,-42
29,101,40,109,0,33,-33
29,101,48,29,32,40,-8
29,101,48,439,0,34,-34
29,103,29,1,53,71,-18
29,103,29,19,0,25,-25
29,103,29,111,37,44,-7
29,103,29,205,0,27,-27
29,105,29,29,192,188,4
29,105,29,43,51,60,-9
29,105,29,59,140,86,54
29,105,29,77,223,244,-21
29,105,29,95,32,39,-7
29,105,29,109,0,32,-32
29,105,29,161,35,0,35
29,105,29,167,0,37,-37
29,105,29,169,181,177,4
29,105,29,213,0,34,-34
29,105,29,215,55,57,-2
29,105,29,225,108,135,-27
29,105,29,229,162,68,94
29,107,20,91,0,39,-39
29,107,29,15,0,35,-35
29,107,29,19,36,34,2
29,107,29,33,41,0,41
29,107,29,37,45,52,-7
29,107,29,47,105,111,-6
29,107,29,83,36,33,3
29,107,29,95,1074,1032,42
29,107,29,101,178,200,-22
29,107,29,141,40,0,40
29,107,29,159,54,28,26
29,107,29,165,0,25,-25
29,107,29,177,139,74,65
29,107,29,195,112,114,-2
29,109,5,7,38,30,8
29,109,29,9,432,490,-58
29,109,29,43,163,199,-36
29,109,29,57,37,56,-19
29,109,29,77,613,672,-59
29,109,29,95,40,30,10
29,109,29,97,231,258,-27
29,109,29,105,32,0,32
29,109,29,145,94,107,-13
29,109,29,209,132,99,33
29,109,29,213,0,44,-44
29,109,29,225,44,0,44
29,111,17,1,115,150,-35
29,111,29,1,0,32,-32
29,111,29,103,44,37,7
29,111,29,127,59,84,-25
29,113,29,19,33,24,9
29,113,29,71,34,39,-5
29,113,29,99,89,76,13
29,113,29,139,54,83,-29
29,113,29,163,200,207,-7
29,113,29,183,2276,1383,893
29,113,29,189,713,308,405
29,113,29,219,257,281,-24
29,113,29,510,72,69,3
29,115,29,19,0,40,-40
29,115,29,21,0,31,-31
29,115,29,41,71,58,13
29,115,29,47,0,29,-29
29,115,29,95,27,38,-11
29,115,29,117,92,137,-45
29,115,29,121,45,45,0
29,117,20,91,0,32,-32
29,117,29,21,48,39,9
29,117,29,25,54,89,-35
29,117,29,33,58,68,-10
29,117,29,47,37,72,-35
29,117,29,49,0,37,-37
29,117,29,61,40,0,40
29,117,29,79,63,51,12
29,117,29,95,45,32,13
29,117,29,115,137,92,45
29,119,5,7,368,478,-110
29,119,5,143,77,68,9
29,119,29,9,83,57,26
29,119,29,95,28,0,28
29,119,29,97,79,105,-26
29,119,29,145,448,475,-27
29,119,40,41,74,101,-27
29,119,40,115,65,46,19
29,119,48,215,0,44,-44
29,121,29,1,90,161,-71
29,121,29,19,70,108,-38
29,121,29,41,29,0,29
29,121,29,115,45,45,0
29,121,29,175,99,143,-44
29,121,29,205,72,31,41
29,123,29,17,50,58,-8
29,123,29,31,0,25,-25
29,123,29,93,54,39,15
29,123,29,99,37,38,-1
29,123,29,157,51,0,51
29,123,29,186,45,0,45
29,123,29,187,204,248,-44
29,123,29,189,0,30,-30
29,125,29,51,57,87,-30
29,125,29,71,0,40,-40
29,125,29,73,84,72,12
29,125,29,131,0,37,-37
29,125,29,151,63,54,9
29,125,29,161,133,120,13
29,125,29,169,0,34,-34
29,127,17,1,186,210,-24
29,127,17,149,41,42,-1
29,127,29,1,31,0,31
29,127,29,7,34,34,0
29,127,29,19,56,104,-48
29,127,29,111,84,59,25
29,127,29,137,75,80,-5
29,127,29,163,91,76,15
29,127,29,173,323,299,24
29,127,29,183,57,28,29
29,127,29,189,46,26,20
29,127,29,205,42,60,-18
29,129,29,79,45,35,10
29,131,29,19,31,62,-31
29,131,29,27,47,67,-20
29,131,29,29,433,470,-37
29,131,29,51,221,239,-18
29,131,29,77,43,54,-11
29,131,29,95,23,42,-19
29,131,29,125,37,0,37
29,131,29,135,43,57,-14
29,131,29,141,195,158,37
29,131,29,169,42,67,-25
29,131,29,189,23,31,-8
29,133,29,31,36,101,-65
29,133,29,143,0,60,-60
29,133,29,189,0,31,-31
29,133,29,201,248,245,3
29,135,29,19,35,53,-18
29,135,29,27,52,52,0
29,135,29,51,230,306,-76
29,135,29,53,68,62,6
29,135,29,131,57,43,14
29,135,29,141,95,120,-25
29,135,29,159,54,68,-14
29,137,29,7,50,77,-27
29,137,29,19,76,113,-37
29,137,29,127,80,75,5
29,137,29,173,33,0,33
29,137,29,175,74,108,-34
29,137,29,183,33,0,33
29,137,29,205,57,55,2
29,139,29,7,51,113,-62
29,139,29,19,0,74,-74
29,139,29,27,43,36,7
29,139,29,73,43,47,-4
29,139,29,113,83,54,29
29,139,29,183,122,60,62
29,139,29,189,0,66,-66
29,139,29,219,148,148,0
29,141,20,91,50,0,50
29,141,29,15,0,36,-36
29,141,29,19,0,39,-39
29,141,29,29,217,173,44
29,141,29,47,0,34,-34
29,141,29,51,79,90,-11
29,141,29,53,34,33,1
29,141,29,77,0,37,-37
29,141,29,95,128,57,71
29,141,29,107,0,40,-40
29,141,29,131,158,195,-37
29,141,29,135,120,95,25
29,141,29,159,131,130,1
29,141,29,195,26,0,26
29,143,29,31,65,112,-47
29,143,29,69,184,117,67
29,143,29,133,60,0,60
29,143,29,155,65,64,1
29,143,29,201,194,261,-67
29,143,29,207,69,96,-27
29,145,5,7,107,144,-37
29,145,5,143,46,51,-5
29,145,6,71,23,0,23
29,145,6,73,42,0,42
29,145,20,21,104,87,17
29,145,20,37,0,33,-33
29,145,29,9,149,148,1
29,145,29,43,0,43,-43
29,145,29,47,43,30,13
29,145,29,77,101,138,-37
29,145,29,95,47,37,10
29,145,29,97,1573,1955,-382
29,145,29,109,107,94,13
29,145,29,119,475,448,27
29,145,29,213,0,28,-28
29,145,40,41,56,33,23
29,145,40,115,164,156,8
29,145,40,143,44,95,-51
29,147,19,145,40,53,-13
29,147,19,153,0,22,-22
29,147,19,173,44,36,8
29,147,20,91,0,59,-59
29,147,29,3,43,62,-19
29,147,29,5,50,39,11
29,147,29,19,0,45,-45
29,147,29,21,96,154,-58
29,147,29,47,47,61,-14
29,147,29,75,63,67,-4
29,147,29,87,85,91,-6
29,147,29,95,32,77,-45
29,147,29,165,27,50,-23
29,147,29,227,59,34,25
29,147,31,55,0,29,-29
29,149,5,49,40,86,-46
29,149,29,77,0,41,-41
29,149,29,91,151,235,-84
29,151,29,19,42,30,12
29,151,29,27,38,51,-13
29,151,29,51,263,254,9
29,151,29,71,0,43,-43
29,151,29,73,59,45,14
29,151,29,125,54,63,-9
29,153,5,5,74,71,3
29,153,29,67,37,84,-47
29,153,29,77,46,61,-15
29,153,29,91,95,114,-19
29,153,29,213,0,50,-50
29,155,5,93,147,207,-60
29,155,29,31,39,36,3
29,155,29,69,186,253,-67
29,155,29,143,64,65,-1
29,155,29,189,0,27,-27
29,155,29,201,36,39,-3
29,155,47,45,65,71,-6
29,155,47,157,53,0,53
29,157,17,157,75,53,22
29,157,29,17,56,35,21
29,157,29,31,178,187,-9
29,157,29,99,61,55,6
29,157,29,123,0,51,-51
29,157,29,186,135,108,27
29,157,29,187,0,39,-39
29,157,29,189,51,69,-18
29,157,29,510,0,25,-25
29,159,20,91,42,37,5
29,159,29,15,279,210,69
29,159,29,19,82,107,-25
29,159,29,37,0,67,-67
29,159,29,47,29,36,-7
29,159,29,51,0,39,-39
29,159,29,53,111,83,28
29,159,29,77,35,81,-46
29,159,29,83,111,67,44
29,159,29,95,162,195,-33
29,159,29,101,346,357,-11
29,159,29,107,28,54,-26
29,159,29,135,68,54,14
29,159,29,141,130,131,-1
29,159,29,189,0,31,-31
29,159,29,195,165,146,19
29,161,6,73,0,28,-28
29,161,6,85,0,33,-33
29,161,20,91,0,78,-78
29,161,29,19,69,101,-32
29,161,29,23,0,28,-28
29,161,29,29,26,31,-5
29,161,29,43,36,0,36
29,161,29,51,24,72,-48
29,161,29,55,210,197,13
29,161,29,65,225,276,-51
29,161,29,71,108,114,-6
29,161,29,73,0,37,-37
29,161,29,77,74,130,-56
29,161,29,91,0,43,-43
29,161,29,95,41,77,-36
29,161,29,99,51,26,25
29,161,29,105,0,35,-35
29,161,29,125,120,133,-13
29,161,29,169,213,216,-3
29,161,29,183,46,94,-48
29,161,29,187,28,0,28
29,161,29,189,134,206,-72
29,161,29,215,94,71,23
29,161,29,510,49,66,-17
29,161,48,201,0,52,-52
29,163,17,149,45,23,22
29,163,29,7,44,81,-37
29,163,29,19,0,31,-31
29,163,29,99,0,31,-31
29,163,29,113,207,200,7
29,163,29,127,76,91,-15
29,163,29,173,61,43,18
29,163,29,183,101,115,-14
29,163,29,189,77,60,17
29,165,4,13,39,88,-49
29,165,6,73,29,46,-17
29,165,8,31,0,27,-27
29,165,8,41,0,22,-22
29,165,17,31,70,55,15
29,165,19,153,30,0,30
29,165,20,5,30,28,2
29,165,20,45,50,57,-7
29,165,20,91,715,690,25
29,165,20,103,239,206,33
29,165,20,173,49,31,18
29,165,20,177,63,42,21
29,165,20,209,383,289,94
29,165,26,125,36,0,36
29,165,29,3,63,46,17
29,165,29,19,69,49,20
29,165,29,21,355,197,158
29,165,29,29,0,24,-24
29,165,29,37,128,84,44
29,165,29,43,0,33,-33
29,165,29,47,3690,4546,-856
29,165,29,49,95,145,-50
29,165,29,63,26,0,26
29,165,29,77,82,43,39
29,165,29,95,1528,1490,38
29,165,29,101,0,43,-43
29,165,29,107,25,0,25
29,165,29,147,50,27,23
29,165,29,177,109,97,12
29,165,29,183,51,0,51
29,165,29,189,73,82,-9
29,165,31,55,42,61,-19
29,165,31,109,34,0,34
29,165,32,3,32,31,1
29,165,35,1,36,0,36
29,165,40,109,46,0,46
29,165,48,85,0,37,-37
29,165,48,113,45,0,45
29,165,48,121,0,30,-30
29,165,48,201,53,40,13
29,165,48,439,51,76,-25
29,165,53,33,0,40,-40
29,167,29,37,47,33,14
29,167,29,39,80,93,-13
29,167,29,43,107,67,40
29,167,29,47,45,0,45
29,167,29,59,144,103,41
29,167,29,77,798,859,-61
29,167,29,85,83,89,-6
29,167,29,95,67,59,8
29,167,29,97,0,36,-36
29,167,29,105,37,0,37
29,167,29,185,30,0,30
29,167,29,213,39,0,39
29,167,29,225,45,56,-11
29,169,2,20,40,51,-11
29,169,2,90,59,67,-8
29,169,4,3,39,0,39
29,169,4,13,0,31,-31
29,169,6,37,41,28,13
29,169,6,71,65,88,-23
29,169,6,73,79,90,-11
29,169,8,41,120,163,-43
29,169,12,57,0,50,-50
29,169,12,86,36,0,36
29,169,13,53,0,61,-61
29,169,13,179,67,61,6
29,169,13,215,50,41,9
29,169,13,245,43,0,43
29,169,15,3,163,209,-46
29,169,20,61,39,127,-88
29,169,20,103,55,77,-22
29,169,20,161,0,69,-69
29,169,21,47,79,67,12
29,169,21,93,63,54,9
29,169,22,115,133,95,38
29,169,24,25,0,62,-62
29,169,29,19,0,62,-62
29,169,29,29,84,85,-1
29,169,29,51,0,47,-47
29,169,29,65,0,43,-43
29,169,29,71,0,36,-36
29,169,29,77,105,129,-24
29,169,29,95,0,33,-33
29,169,29,99,39,0,39
29,169,29,105,177,181,-4
29,169,29,125,34,0,34
29,169,29,131,67,42,25
29,169,29,161,216,213,3
29,169,29,183,38,27,11
29,169,29,189,50,67,-17
29,169,29,215,133,151,-18
29,169,36,45,124,74,50
29,169,36,71,44,0,44
29,169,37,51,87,149,-62
29,169,37,133,132,94,38
29,169,40,31,81,46,35
29,169,45,79,43,52,-9
29,169,47,125,147,129,18
29,169,48,27,282,265,17
29,169,48,29,99,60,39
29,169,48,99,76,85,-9
29,169,48,141,106,87,19
29,169,48,201,0,49,-49
29,169,48,439,28,0,28
29,169,51,59,52,55,-3
29,169,51,700,36,0,36
29,169,53,53,187,103,84
29,169,53,67,43,58,-15
29,171,29,1,31,63,-32
29,171,29,211,37,0,37
29,173,29,7,31,46,-15
29,173,29,19,23,25,-2
29,173,29,127,299,323,-24
29,173,29,137,0,33,-33
29,173,29,163,43,61,-18
29,175,29,1,0,26,-26
29,175,29,7,52,46,6
29,175,29,19,319,368,-49
29,175,29,29,0,26,-26
29,175,29,41,93,58,35
29,175,29,51,32,34,-2
29,175,29,89,30,61,-31
29,175,29,95,27,26,1
29,175,29,121,143,99,44
29,175,29,137,108,74,34
29,175,29,189,0,24,-24
29,175,29,205,32,0,32
29,177,20,91,31,0,31
29,177,29,21,0,22,-22
29,177,29,25,50,56,-6
29,177,29,33,46,25,21
29,177,29,47,662,781,-119
29,177,29,49,56,0,56
29,177,29,95,286,231,55
29,177,29,107,74,139,-65
29,177,29,165,97,109,-12
29,179,29,23,0,27,-27
29,179,29,35,0,33,-33
29,179,29,93,0,46,-46
29,179,29,187,27,48,-21
29,181,29,23,307,308,-1
29,181,29,35,38,0,38
29,183,1,89,28,63,-35
29,183,4,13,190,216,-26
29,183,4,19,34,44,-10
29,183,5,7,41,40,1
29,183,5,119,0,37,-37
29,183,6,37,108,96,12
29,183,6,59,74,69,5
29,183,6,65,64,36,28
29,183,6,71,0,54,-54
29,183,6,73,87,92,-5
29,183,6,111,47,0,47
29,183,8,35,37,37,0
29,183,8,41,0,26,-26
29,183,8,69,0,33,-33
29,183,12,11,33,48,-15
29,183,12,31,37,26,11
29,183,12,57,48,58,-10
29,183,12,71,42,48,-6
29,183,12,86,46,23,23
29,183,12,95,36,52,-16
29,183,12,99,0,49,-49
29,183,12,103,62,60,2
29,183,12,105,0,34,-34
29,183,12,117,0,33,-33
29,183,13,67,0,49,-49
29,183,13,121,32,50,-18
29,183,15,3,41,42,-1
29,183,17,1,60,31,29
29,183,17,19,46,0,46
29,183,17,31,186,178,8
29,183,17,43,63,74,-11
29,183,17,83,39,0,39
29,183,17,97,63,0,63
29,183,17,113,0,49,-49
29,183,17,115,36,0,36
29,183,17,119,445,356,89
29,183,17,133,29,64,-35
29,183,17,143,38,0,38
29,183,17,163,290,201,89
29,183,17,167,74,33,41
29,183,17,197,55,0,55
29,183,17,201,48,0,48
29,183,18,57,0,30,-30
29,183,18,97,28,29,-1
29,183,18,163,31,0,31
29,183,19,113,53,0,53
29,183,19,153,42,24,18
29,183,19,163,0,37,-37
29,183,20,91,159,155,4
29,183,20,173,56,54,2
29,183,21,67,33,0,33
29,183,21,111,27,49,-22
29,183,24,3,36,0,36
29,183,26,93,54,0,54
29,183,26,125,51,32,19
29,183,26,161,76,0,76
29,183,26,163,85,0,85
29,183,27,53,37,45,-8
29,183,29,7,28,0,28
29,183,29,19,294,342,-48
29,183,29,23,55,0,55
29,183,29,27,54,84,-30
29,183,29,29,66,110,-44
29,183,29,31,116,107,9
29,183,29,43,37,0,37
29,183,29,47,96,113,-17
29,183,29,51,86,43,43
29,183,29,55,63,39,24
29,183,29,65,0,34,-34
29,183,29,71,274,360,-86
29,183,29,73,41,32,9
29,183,29,77,182,168,14
29,183,29,95,204,189,15
29,183,29,97,40,0,40
29,183,29,99,640,536,104
29,183,29,101,0,39,-39
29,183,29,113,1383,2276,-893
29,183,29,127,28,57,-29
29,183,29,137,0,33,-33
29,183,29,139,60,122,-62
29,183,29,161,94,46,48
29,183,29,163,115,101,14
29,183,29,165,0,51,-51
29,183,29,169,27,38,-11
29,183,29,186,30,28,2
29,183,29,187,89,103,-14
29,183,29,189,12051,6296,5755
29,183,29,201,28,0,28
29,183,29,207,0,26,-26
29,183,29,213,33,36,-3
29,183,29,215,30,0,30
29,183,29,219,865,1376,-511
29,183,29,223,0,36,-36
29,183,29,510,1121,1085,36
29,183,31,55,51,49,2
29,183,31,109,32,0,32
29,183,32,3,115,99,16
29,183,35,1,27,0,27
29,183,36,61,0,28,-28
29,183,37,133,0,40,-40
29,183,37,183,57,0,57
29,183,39,35,31,0,31
29,183,39,49,43,0,43
29,183,40,109,0,40,-40
29,183,40,143,63,74,-11
29,183,45,45,0,34,-34
29,183,47,37,32,37,-5
29,183,47,157,74,40,34
29,183,48,27,0,27,-27
29,183,48,29,47,69,-22
29,183,48,85,58,105,-47
29,183,48,113,62,75,-13
29,183,48,121,64,55,9
29,183,48,167,31,0,31
29,183,48,201,60,157,-97
29,183,48,439,89,111,-22
29,183,48,453,0,44,-44
29,183,48,491,0,40,-40
29,183,49,35,0,39,-39
29,183,49,49,0,34,-34
29,183,51,59,34,55,-21
29,183,53,33,41,65,-24
29,183,53,53,0,35,-35
29,183,55,79,35,0,35
29,185,29,13,40,32,8
29,185,29,37,25,0,25
29,185,29,39,0,36,-36
29,185,29,77,22,75,-53
29,185,29,83,112,92,20
29,185,29,85,48,0,48
29,185,29,95,87,58,29
29,185,29,167,0,30,-30
29,185,29,217,35,0,35
29,186,29,31,35,38,-3
29,186,29,99,313,245,68
29,186,29,123,0,45,-45
29,186,29,157,108,135,-27
29,186,29,183,28,30,-2
29,186,29,187,208,237,-29
29,186,29,189,95,138,-43
29,186,29,221,0,38,-38
29,186,29,510,65,34,31
29,187,4,13,37,0,37
29,187,17,119,0,32,-32
29,187,17,163,30,0,30
29,187,29,19,0,34,-34
29,187,29,23,0,47,-47
29,187,29,31,104,69,35
29,187,29,71,36,80,-44
29,187,29,77,0,66,-66
29,187,29,93,322,196,126
29,187,29,99,663,610,53
29,187,29,123,248,204,44
29,187,29,157,39,0,39
29,187,29,161,0,28,-28
29,187,29,179,48,27,21
29,187,29,183,103,89,14
29,187,29,186,237,208,29
29,187,29,189,348,306,42
29,187,29,221,444,407,37
29,187,29,223,42,38,4
29,187,29,510,112,79,33
29,189,1,73,71,89,-18
29,189,1,89,73,152,-79
29,189,2,90,0,25,-25
29,189,4,13,325,563,-238
29,189,4,19,76,129,-53
29,189,4,21,0,30,-30
29,189,5,7,66,89,-23
29,189,5,119,86,117,-31
29,189,5,143,0,38,-38
29,189,6,1,94,118,-24
29,189,6,13,51,90,-39
29,189,6,37,411,567,-156
29,189,6,53,0,39,-39
29,189,6,59,182,206,-24
29,189,6,65,95,90,5
29,189,6,67,48,77,-29
29,189,6,71,61,78,-17
29,189,6,73,296,361,-65
29,189,6,75,50,116,-66
29,189,6,81,30,83,-53
29,189,6,83,29,0,29
29,189,6,85,98,183,-85
29,189,6,95,42,0,42
29,189,6,111,123,58,65
29,189,8,1,0,28,-28
29,189,8,5,71,105,-34
29,189,8,13,36,91,-55
29,189,8,31,144,161,-17
29,189,8,35,41,57,-16
29,189,8,41,65,117,-52
29,189,8,59,34,73,-39
29,189,8,69,37,46,-9
29,189,8,123,0,34,-34
29,189,9,1,61,61,0
29,189,9,3,50,56,-6
29,189,9,9,60,51,9
29,189,9,11,33,0,33
29,189,10,3,28,35,-7
29,189,11,1,73,130,-57
29,189,12,1,43,34,9
29,189,12,5,0,29,-29
29,189,12,9,38,38,0
29,189,12,11,153,170,-17
29,189,12,21,29,105,-76
29,189,12,31,94,120,-26
29,189,12,33,24,23,1
29,189,12,57,145,151,-6
29,189,12,71,64,134,-70
29,189,12,73,25,0,25
29,189,12,81,0,53,-53
29,189,12,86,86,92,-6
29,189,12,91,28,0,28
29,189,12,95,100,171,-71
29,189,12,99,77,121,-44
29,189,12,101,0,58,-58
29,189,12,103,143,127,16
29,189,12,105,0,50,-50
29,189,12,109,0,50,-50
29,189,12,111,0,22,-22
29,189,12,113,0,38,-38
29,189,12,115,28,83,-55
29,189,12,117,65,71,-6
29,189,12,127,32,32,0
29,189,13,51,0,41,-41
29,189,13,57,0,35,-35
29,189,13,63,38,38,0
29,189,13,67,82,141,-59
29,189,13,89,84,134,-50
29,189,13,117,0,54,-54
29,189,13,121,115,241,-126
29,189,13,135,86,142,-56
29,189,15,3,66,69,-3
29,189,17,1,61,64,-3
29,189,17,19,133,78,55
29,189,17,21,25,0,25
29,189,17,27,59,0,59
29,189,17,31,954,1279,-325
29,189,17,43,265,249,16
29,189,17,49,25,0,25
29,189,17,51,21,0,21
29,189,17,77,121,84,37
29,189,17,81,43,39,4
29,189,17,83,81,93,-12
29,189,17,89,90,64,26
29,189,17,97,100,124,-24
29,189,17,111,26,28,-2
29,189,17,113,95,82,13
29,189,17,115,89,32,57
29,189,17,117,48,61,-13
29,189,17,119,1384,1418,-34
29,189,17,121,36,30,6
29,189,17,133,270,346,-76
29,189,17,135,0,32,-32
29,189,17,143,143,76,67
29,189,17,157,60,31,29
29,189,17,161,40,0,40
29,189,17,163,1488,1457,31
29,189,17,167,208,109,99
29,189,17,179,46,0,46
29,189,17,197,88,82,6
29,189,17,199,72,58,14
29,189,17,201,39,53,-14
29,189,18,3,48,39,9
29,189,18,57,78,89,-11
29,189,18,89,67,44,23
29,189,18,97,179,126,53
29,189,18,105,57,27,30
29,189,18,141,52,42,10
29,189,18,157,36,29,7
29,189,18,163,48,50,-2
29,189,18,167,25,0,25
29,189,19,103,44,50,-6
29,189,19,113,30,48,-18
29,189,19,153,78,58,20
29,189,19,163,49,88,-39
29,189,20,45,55,37,18
29,189,20,91,327,442,-115
29,189,20,161,0,30,-30
29,189,20,173,108,109,-1
29,189,20,177,30,32,-2
29,189,20,209,35,0,35
29,189,21,67,52,36,16
29,189,21,111,117,101,16
29,189,21,145,0,40,-40
29,189,22,33,57,59,-2
29,189,22,51,0,36,-36
29,189,22,71,0,129,-129
29,189,24,3,50,52,-2
29,189,24,5,47,71,-24
29,189,24,21,0,29,-29
29,189,24,27,50,34,16
29,189,24,31,45,92,-47
29,189,24,33,79,35,44
29,189,24,510,36,40,-4
29,189,25,9,0,29,-29
29,189,25,17,75,127,-52
29,189,25,21,38,39,-1
29,189,25,25,56,80,-24
29,189,26,49,38,0,38
29,189,26,65,36,32,4
29,189,26,77,0,27,-27
29,189,26,81,58,43,15
29,189,26,93,50,0,50
29,189,26,99,89,0,89
29,189,26,125,235,150,85
29,189,26,161,198,44,154
29,189,26,163,207,84,123
29,189,27,37,38,0,38
29,189,27,53,145,181,-36
29,189,27,123,41,40,1
29,189,28,33,0,47,-47
29,189,28,49,38,0,38
29,189,29,1,76,45,31
29,189,29,7,44,64,-20
29,189,29,19,753,641,112
29,189,29,21,56,51,5
29,189,29,23,78,67,11
29,189,29,27,83,88,-5
29,189,29,29,105,176,-71
29,189,29,31,348,235,113
29,189,29,37,33,29,4
29,189,29,43,55,103,-48
29,189,29,47,142,174,-32
29,189,29,51,239,204,35
29,189,29,55,116,124,-8
29,189,29,65,42,70,-28
29,189,29,69,0,32,-32
29,189,29,71,1011,1391,-380
29,189,29,73,36,65,-29
29,189,29,77,387,341,46
29,189,29,93,41,29,12
29,189,29,95,489,515,-26
29,189,29,97,73,0,73
29,189,29,99,5226,6502,-1276
29,189,29,101,60,0,60
29,189,29,113,308,713,-405
29,189,29,123,30,0,30
29,189,29,127,26,46,-20
29,189,29,131,31,23,8
29,189,29,133,31,0,31
29,189,29,139,66,0,66
29,189,29,155,27,0,27
29,189,29,157,69,51,18
29,189,29,159,31,0,31
29,189,29,161,206,134,72
29,189,29,163,60,77,-17
29,189,29,165,82,73,9
29,189,29,169,67,50,17
29,189,29,175,24,0,24
29,189,29,183,6296,12051,-5755
29,189,29,186,138,95,43
29,189,29,187,306,348,-42
29,189,29,195,30,0,30
29,189,29,201,86,60,26
29,189,29,207,56,27,29
29,189,29,209,0,42,-42
29,189,29,213,44,48,-4
29,189,29,215,31,0,31
29,189,29,219,212,428,-216
29,189,29,221,64,100,-36
29,189,29,223,36,36,0
29,189,29,510,22716,19149,3567
29,189,31,55,124,172,-48
29,189,31,109,48,42,6
29,189,31,153,0,45,-45
29,189,32,3,213,276,-63
29,189,34,5,0,26,-26
29,189,34,13,30,27,3
29,189,34,17,86,67,19
29,189,34,23,67,51,16
29,189,34,27,0,34,-34
29,189,35,1,50,54,-4
29,189,36,5,37,0,37
29,189,36,29,58,0,58
29,189,36,47,59,95,-36
29,189,36,55,33,47,-14
29,189,36,59,42,35,7
29,189,36,61,119,380,-261
29,189,36,81,73,74,-1
29,189,36,119,0,38,-38
29,189,37,51,36,42,-6
29,189,37,63,28,41,-13
29,189,37,71,0,41,-41
29,189,37,81,47,0,47
29,189,37,119,124,158,-34
29,189,37,129,0,25,-25
29,189,37,133,30,35,-5
29,189,37,135,0,42,-42
29,189,37,183,59,147,-88
29,189,39,17,36,39,-3
29,189,39,35,136,82,54
29,189,39,49,150,183,-33
29,189,39,61,79,72,7
29,189,39,113,44,40,4
29,189,39,165,0,52,-52
29,189,40,27,28,0,28
29,189,40,109,78,100,-22
29,189,40,143,112,149,-37
29,189,41,51,59,91,-32
29,189,41,67,37,55,-18
29,189,42,3,94,95,-1
29,189,42,29,0,32,-32
29,189,42,91,49,35,14
29,189,42,101,57,75,-18
29,189,45,13,35,0,35
29,189,45,19,49,54,-5
29,189,45,79,35,43,-8
29,189,46,99,0,40,-40
29,189,47,37,165,217,-52
29,189,47,93,59,27,32
29,189,47,125,43,58,-15
29,189,47,149,39,32,7
29,189,47,157,276,159,117
29,189,47,187,31,70,-39
29,189,48,27,45,66,-21
29,189,48,29,154,197,-43
29,189,48,85,115,223,-108
29,189,48,113,248,350,-102
29,189,48,121,99,125,-26
29,189,48,141,40,44,-4
29,189,48,157,0,111,-111
29,189,48,201,273,480,-207
29,189,48,339,50,76,-26
29,189,48,439,144,318,-174
29,189,48,453,111,170,-59
29,189,48,491,30,56,-26
29,189,49,35,60,117,-57
29,189,49,49,59,49,10
29,189,51,3,0,36,-36
29,189,51,13,30,73,-43
29,189,51,41,48,0,48
29,189,51,59,108,164,-56
29,189,51,87,64,29,35
29,189,51,107,27,62,-35
29,189,51,153,40,0,40
29,189,51,510,0,52,-52
29,189,51,710,51,0,51
29,189,51,810,53,49,4
29,189,53,33,195,339,-144
29,189,53,35,28,28,0
29,189,53,53,47,97,-50
29,189,53,61,31,82,-51
29,189,55,25,112,90,22
29,189,55,79,116,94,22
29,189,55,133,30,42,-12
29,195,20,91,0,25,-25
29,195,29,15,0,37,-37
29,195,29,19,50,92,-42
29,195,29,33,50,50,0
29,195,29,47,0,37,-37
29,195,29,53,50,34,16
29,195,29,89,40,33,7
29,195,29,95,82,116,-34
29,195,29,101,56,0,56
29,195,29,107,114,112,2
29,195,29,141,0,26,-26
29,195,29,159,146,165,-19
29,195,29,189,0,30,-30
29,197,29,1,103,86,17
29,199,29,45,0,38,-38
29,201,29,17,54,72,-18
29,201,29,23,30,34,-4
29,201,29,31,810,927,-117
29,201,29,69,74,39,35
29,201,29,95,0,44,-44
29,201,29,99,34,0,34
29,201,29,133,245,248,-3
29,201,29,143,261,194,67
29,201,29,155,39,36,3
29,201,29,183,0,28,-28
29,201,29,189,60,86,-26
29,201,29,207,209,206,3
29,201,29,510,0,26,-26
29,201,30,41,28,0,28
29,201,47,157,0,27,-27
29,203,29,77,0,30,-30
29,203,29,91,99,187,-88
29,203,29,215,37,64,-27
29,205,29,19,0,32,-32
29,205,29,103,27,0,27
29,205,29,121,31,72,-41
29,205,29,127,60,42,18
29,205,29,137,55,57,-2
29,205,29,175,0,32,-32
29,207,29,17,64,70,-6
29,207,29,23,260,245,15
29,207,29,31,148,218,-70
29,207,29,69,143,187,-44
29,207,29,77,0,30,-30
29,207,29,99,31,0,31
29,207,29,143,96,69,27
29,207,29,183,26,0,26
29,207,29,189,27,56,-29
29,207,29,201,206,209,-3
29,207,29,223,68,44,24
29,207,29,510,0,25,-25
29,209,4,13,29,0,29
29,209,5,9,38,0,38
29,209,5,15,81,66,15
29,209,5,143,37,0,37
29,209,20,91,33,30,3
29,209,20,173,33,0,33
29,209,29,9,111,81,30
29,209,29,43,253,462,-209
29,209,29,77,363,441,-78
29,209,29,95,33,43,-10
29,209,29,109,99,132,-33
29,209,29,189,42,0,42
29,209,29,213,582,706,-124
29,209,40,143,0,33,-33
29,211,29,1,59,75,-16
29,211,29,21,69,31,38
29,211,29,79,59,0,59
29,211,29,95,0,26,-26
29,211,29,171,0,37,-37
29,213,4,13,69,39,30
29,213,5,7,66,45,21
29,213,5,9,199,151,48
29,213,5,15,0,23,-23
29,213,5,119,29,0,29
29,213,5,143,32,27,5
29,213,6,71,27,0,27
29,213,12,95,31,0,31
29,213,20,91,38,0,38
29,213,29,9,55,0,55
29,213,29,19,49,31,18
29,213,29,37,32,0,32
29,213,29,43,321,533,-212
29,213,29,47,29,0,29
29,213,29,67,54,38,16
29,213,29,71,32,0,32
29,213,29,77,371,550,-179
29,213,29,95,65,57,8
29,213,29,97,81,40,41
29,213,29,105,34,0,34
29,213,29,109,44,0,44
29,213,29,145,28,0,28
29,213,29,153,50,0,50
29,213,29,167,0,39,-39
29,213,29,183,36,33,3
29,213,29,189,48,44,4
29,213,29,209,706,582,124
29,213,29,225,44,43,1
29,213,32,3,45,35,10
29,213,40,109,34,0,34
29,213,40,143,28,48,-20
29,213,42,71,32,0,32
29,213,47,37,0,30,-30
29,213,48,113,26,0,26
29,213,48,201,0,39,-39
29,215,29,43,0,44,-44
29,215,29,65,50,61,-11
29,215,29,67,0,47,-47
29,215,29,77,122,105,17
29,215,29,91,105,190,-85
29,215,29,105,57,55,2
29,215,29,161,71,94,-23
29,215,29,169,151,133,18
29,215,29,183,0,30,-30
29,215,29,189,0,31,-31
29,215,29,203,64,37,27
29,215,29,225,42,0,42
29,215,29,229,146,149,-3
29,217,20,11,52,52,0
29,217,20,37,0,33,-33
29,217,20,91,0,32,-32
29,217,20,173,0,30,-30
29,217,29,11,97,44,53
29,217,29,13,112,78,34
29,217,29,37,33,44,-11
29,217,29,39,184,155,29
29,217,29,77,33,65,-32
29,217,29,95,49,78,-29
29,217,29,97,57,107,-50
29,217,29,185,0,35,-35
29,219,17,119,0,22,-22
29,219,29,19,32,35,-3
29,219,29,71,175,205,-30
29,219,29,73,28,0,28
29,219,29,99,58,52,6
29,219,29,113,281,257,24
29,219,29,139,148,148,0
29,219,29,183,1376,865,511
29,219,29,189,428,212,216
29,219,29,510,49,45,4
29,221,29,55,38,65,-27
29,221,29,71,109,90,19
29,221,29,93,45,72,-27
29,221,29,99,297,269,28
29,221,29,186,38,0,38
29,221,29,187,407,444,-37
29,221,29,189,100,64,36
29,221,29,510,69,0,69
29,223,29,23,187,204,-17
29,223,29,31,31,0,31
29,223,29,93,0,48,-48
29,223,29,99,55,33,22
29,223,29,183,36,0,36
29,223,29,187,38,42,-4
29,223,29,189,36,36,0
29,223,29,207,44,68,-24
29,225,6,71,29,0,29
29,225,29,43,319,267,52
29,225,29,59,56,101,-45
29,225,29,67,51,61,-10
29,225,29,77,1340,1281,59
29,225,29,91,0,42,-42
29,225,29,95,34,29,5
29,225,29,105,135,108,27
29,225,29,109,0,44,-44
29,225,29,167,56,45,11
29,225,29,213,43,44,-1
29,225,29,215,0,42,-42
29,225,29,229,165,121,44
29,227,29,147,0,59,-59
29,229,29,43,48,64,-16
29,229,29,67,127,100,27
29,229,29,77,104,218,-114
29,229,29,91,77,75,2
29,229,29,105,68,162,-94
29,229,29,215,149,146,3
29,229,29,225,121,165,-44
29,510,1,73,0,31,-31
29,510,4,13,85,180,-95
29,510,4,19,32,0,32
29,510,5,119,22,51,-29
29,510,6,1,32,25,7
29,510,6,37,155,211,-56
29,510,6,59,35,54,-19
29,510,6,71,0,33,-33
29,510,6,73,74,70,4
29,510,6,75,41,74,-33
29,510,6,81,0,35,-35
29,510,6,85,0,41,-41
29,510,6,111,0,27,-27
29,510,8,5,32,0,32
29,510,8,13,0,23,-23
29,510,8,31,50,50,0
29,510,11,1,47,86,-39
29,510,12,11,40,0,40
29,510,12,31,26,61,-35
29,510,12,57,39,50,-11
29,510,12,86,39,51,-12
29,510,12,95,40,34,6
29,510,12,99,28,22,6
29,510,12,103,30,48,-18
29,510,13,67,28,37,-9
29,510,13,89,90,78,12
29,510,13,121,48,55,-7
29,510,13,135,0,51,-51
29,510,17,19,54,0,54
29,510,17,27,29,31,-2
29,510,17,31,465,592,-127
29,510,17,43,54,48,6
29,510,17,77,83,31,52
29,510,17,83,21,0,21
29,510,17,89,0,25,-25
29,510,17,97,42,30,12
29,510,17,113,24,33,-9
29,510,17,115,40,25,15
29,510,17,117,30,0,30
29,510,17,119,683,572,111
29,510,17,133,118,98,20
29,510,17,143,36,0,36
29,510,17,157,42,0,42
29,510,17,163,929,956,-27
29,510,17,167,149,71,78
29,510,17,197,23,0,23
29,510,17,199,40,25,15
29,510,18,97,69,88,-19
29,510,18,105,23,0,23
29,510,18,163,26,0,26
29,510,19,103,30,0,30
29,510,19,153,50,0,50
29,510,20,91,76,71,5
29,510,20,173,42,0,42
29,510,21,111,76,40,36
29,510,22,51,0,33,-33
29,510,22,71,0,29,-29
29,510,24,31,30,71,-41
29,510,24,510,34,0,34
29,510,25,17,47,52,-5
29,510,25,21,28,34,-6
29,510,25,25,31,53,-22
29,510,26,125,36,0,36
29,510,26,161,44,0,44
29,510,26,163,44,43,1
29,510,27,53,64,83,-19
29,510,27,123,28,27,1
29,510,29,1,25,0,25
29,510,29,19,248,162,86
29,510,29,23,0,35,-35
29,510,29,27,35,0,35
29,510,29,29,32,32,0
29,510,29,31,112,60,52
29,510,29,47,42,29,13
29,510,29,51,103,78,25
29,510,29,55,30,39,-9
29,510,29,71,241,252,-11
29,510,29,73,0,28,-28
29,510,29,77,148,65,83
29,510,29,95,226,199,27
29,510,29,99,1180,1651,-471
29,510,29,113,69,72,-3
29,510,29,157,25,0,25
29,510,29,161,66,49,17
29,510,29,183,1085,1121,-36
29,510,29,186,34,65,-31
29,510,29,187,79,112,-33
29,510,29,189,19149,22716,-3567
29,510,29,201,26,0,26
29,510,29,207,25,0,25
29,510,29,219,45,49,-4
29,510,29,221,0,69,-69
29,510,31,55,48,46,2
29,510,31,109,26,0,26
29,510,32,3,77,123,-46
29,510,34,17,0,22,-22
29,510,36,29,0,28,-28
29,510,36,47,37,54,-17
29,510,36,55,40,0,40
29,510,36,61,92,91,1
29,510,36,81,25,37,-12
29,510,37,63,0,30,-30
29,510,37,119,26,38,-12
29,510,39,35,60,32,28
29,510,39,49,61,77,-16
29,510,39,61,72,45,27
29,510,39,113,21,28,-7
29,510,39,153,23,0,23
29,510,40,109,0,28,-28
29,510,40,143,22,0,22
29,510,41,51,28,32,-4
29,510,42,3,30,48,-18
29,510,42,101,67,67,0
29,510,47,37,72,99,-27
29,510,47,157,122,109,13
29,510,48,29,0,44,-44
29,510,48,85,28,31,-3
29,510,48,113,91,138,-47
29,510,48,201,125,168,-43
29,510,48,439,46,64,-18
29,510,48,453,55,52,3
29,510,51,13,28,0,28
29,510,51,59,25,48,-23
29,510,53,33,91,148,-57
29,510,55,25,46,55,-9
29,510,55,79,44,50,-6
30,1,30,31,49,46,3
30,1,30,49,0,26,-26
30,1,30,57,63,47,16
30,1,30,63,58,52,6
30,1,30,93,51,28,23
30,1,30,111,23,43,-20
30,3,30,31,0,38,-38
30,3,30,87,48,58,-10
30,3,30,111,191,291,-100
30,3,56,33,49,37,12
30,5,30,41,94,96,-2
30,5,30,111,0,59,-59
30,7,30,31,71,39,32
30,7,30,49,123,131,-8
30,9,30,31,34,23,11
30,9,30,63,29,0,29
30,9,30,95,54,46,8
30,9,30,111,270,290,-20
30,9,56,29,0,32,-32
30,13,2,20,35,57,-22
30,13,2,90,66,34,32
30,13,4,13,57,103,-46
30,13,5,119,0,27,-27
30,13,6,37,68,0,68
30,13,6,71,36,0,36
30,13,6,73,44,44,0
30,13,6,83,124,112,12
30,13,8,5,0,39,-39
30,13,8,41,69,174,-105
30,13,8,69,0,26,-26
30,13,12,91,0,42,-42
30,13,16,1,48,68,-20
30,13,16,27,0,30,-30
30,13,30,15,94,77,17
30,13,30,27,71,56,15
30,13,30,29,113,166,-53
30,13,30,31,254,229,25
30,13,30,35,97,71,26
30,13,30,41,143,106,37
30,13,30,45,48,31,17
30,13,30,47,33,48,-15
30,13,30,49,270,341,-71
30,13,30,63,199,268,-69
30,13,30,73,81,73,8
30,13,30,77,26,0,26
30,13,30,81,0,38,-38
30,13,30,83,26,0,26
30,13,30,93,63,58,5
30,13,30,99,153,120,33
30,13,30,101,46,31,15
30,13,30,111,246,311,-65
30,13,32,3,84,73,11
30,13,41,67,0,27,-27
30,13,48,27,0,36,-36
30,13,48,29,34,57,-23
30,13,49,11,38,40,-2
30,13,49,35,63,33,30
30,13,49,53,39,0,39
30,13,53,11,38,0,38
30,13,53,33,76,64,12
30,13,53,53,36,48,-12
30,13,53,61,54,31,23
30,13,53,63,62,115,-53
30,13,53,73,42,0,42
30,13,56,21,0,42,-42
30,15,30,13,77,94,-17
30,15,30,41,0,24,-24
30,17,30,21,27,0,27
30,17,30,31,35,38,-3
30,17,30,63,0,24,-24
30,17,30,87,49,32,17
30,17,30,111,129,142,-13
30,19,30,111,0,28,-28
30,21,30,17,0,27,-27
30,21,30,111,39,74,-35
30,23,30,31,26,31,-5
30,23,30,49,29,33,-4
30,23,30,63,65,47,18
30,23,30,77,63,32,31
30,23,30,93,107,129,-22
30,25,30,111,0,28,-28
30,27,30,13,56,71,-15
30,27,30,31,89,76,13
30,27,30,45,0,45,-45
30,27,30,49,0,31,-31
30,27,30,63,31,0,31
30,27,30,111,83,105,-22
30,29,2,20,41,39,2
30,29,4,13,112,112,0
30,29,4,19,24,34,-10
30,29,6,37,70,41,29
30,29,6,59,75,63,12
30,29,6,65,76,0,76
30,29,6,71,44,30,14
30,29,6,73,149,59,90
30,29,6,85,27,0,27
30,29,6,97,29,0,29
30,29,8,13,0,38,-38
30,29,8,31,0,23,-23
30,29,8,41,0,28,-28
30,29,8,45,28,0,28
30,29,8,69,0,30,-30
30,29,16,1,61,47,14
30,29,16,55,75,55,20
30,29,17,31,31,0,31
30,29,27,53,35,0,35
30,29,30,13,166,113,53
30,29,30,31,197,207,-10
30,29,30,35,37,28,9
30,29,30,41,62,51,11
30,29,30,47,217,200,17
30,29,30,49,108,123,-15
30,29,30,53,281,208,73
30,29,30,63,459,402,57
30,29,30,73,37,33,4
30,29,30,81,79,29,50
30,29,30,89,107,59,48
30,29,30,93,40,44,-4
30,29,30,111,110,71,39
30,29,32,3,118,76,42
30,29,32,31,0,24,-24
30,29,35,1,40,0,40
30,29,41,5,0,36,-36
30,29,41,17,31,0,31
30,29,41,39,34,40,-6
30,29,41,51,60,57,3
30,29,41,67,0,21,-21
30,29,48,439,22,0,22
30,29,49,35,45,22,23
30,29,49,49,28,0,28
30,29,53,5,39,0,39
30,29,53,11,66,40,26
30,29,53,33,193,136,57
30,29,53,53,79,71,8
30,29,53,61,99,60,39
30,29,53,63,121,132,-11
30,29,53,73,0,25,-25
30,31,2,20,35,47,-12
30,31,4,5,39,0,39
30,31,4,13,97,114,-17
30,31,4,19,28,0,28
30,31,6,37,75,75,0
30,31,6,59,44,25,19
30,31,6,65,28,32,-4
30,31,6,67,0,22,-22
30,31,6,71,42,0,42
30,31,6,73,67,48,19
30,31,6,85,30,0,30
30,31,8,5,50,0,50
30,31,8,13,46,41,5
30,31,8,31,31,55,-24
30,31,8,41,28,46,-18
30,31,8,59,25,21,4
30,31,8,69,62,57,5
30,31,15,3,0,26,-26
30,31,16,1,72,87,-15
30,31,16,5,28,28,0
30,31,16,19,44,0,44
30,31,16,55,28,53,-25
30,31,17,31,38,27,11
30,31,23,5,21,0,21
30,31,25,17,32,0,32
30,31,27,53,71,26,45
30,31,27,137,46,0,46
30,31,27,163,25,0,25
30,31,30,1,46,49,-3
30,31,30,3,38,0,38
30,31,30,7,39,71,-32
30,31,30,9,23,34,-11
30,31,30,13,229,254,-25
30,31,30,17,38,35,3
30,31,30,23,31,26,5
30,31,30,27,76,89,-13
30,31,30,29,207,197,10
30,31,30,35,30,0,30
30,31,30,41,41,36,5
30,31,30,43,93,68,25
30,31,30,47,36,62,-26
30,31,30,49,261,300,-39
30,31,30,53,36,0,36
30,31,30,57,112,93,19
30,31,30,63,339,316,23
30,31,30,67,396,337,59
30,31,30,77,23,0,23
30,31,30,81,109,65,44
30,31,30,83,25,0,25
30,31,30,87,0,36,-36
30,31,30,93,132,132,0
30,31,30,95,27,44,-17
30,31,30,97,28,38,-10
30,31,30,99,0,28,-28
30,31,30,105,25,0,25
30,31,30,111,459,480,-21
30,31,32,3,83,64,19
30,31,32,31,34,0,34
30,31,38,15,20,0,20
30,31,38,17,26,0,26
30,31,41,5,0,41,-41
30,31,41,17,38,28,10
30,31,41,39,29,34,-5
30,31,41,51,52,125,-73
30,31,41,67,50,37,13
30,31,46,103,37,0,37
30,31,48,29,0,32,-32
30,31,49,35,99,86,13
30,31,53,11,60,26,34
30,31,53,33,144,183,-39
30,31,53,53,36,32,4
30,31,53,61,44,69,-25
30,31,53,63,93,55,38
30,31,53,73,26,52,-26
30,31,55,25,23,25,-2
30,31,56,5,33,0,33
30,31,56,25,24,0,24
30,31,56,29,28,30,-2
30,31,56,33,32,0,32
30,31,56,39,54,26,28
30,33,30,111,0,23,-23
30,35,30,13,71,97,-26
30,35,30,29,28,37,-9
30,35,30,31,0,30,-30
30,35,30,63,60,90,-30
30,35,30,73,34,39,-5
30,35,30,111,0,40,-40
30,37,30,111,0,48,-48
30,39,30,63,59,66,-7
30,41,29,201,0,28,-28
30,41,30,5,96,94,2
30,41,30,13,106,143,-37
30,41,30,15,24,0,24
30,41,30,29,51,62,-11
30,41,30,31,36,41,-5
30,41,30,49,34,46,-12
30,41,30,63,60,88,-28
30,41,30,111,43,97,-54
30,43,30,31,68,93,-25
30,43,30,49,379,322,57
30,43,30,63,41,51,-10
30,43,30,93,102,93,9
30,45,30,13,31,48,-17
30,45,30,27,45,0,45
30,47,4,13,0,22,-22
30,47,30,13,48,33,15
30,47,30,29,200,217,-17
30,47,30,31,62,36,26
30,47,30,63,265,320,-55
30,47,30,81,29,32,-3
30,47,30,89,59,44,15
30,47,30,111,30,38,-8
30,47,53,33,35,0,35
30,47,53,63,34,42,-8
30,49,4,13,50,33,17
30,49,4,19,0,23,-23
30,49,6,37,43,25,18
30,49,6,73,35,32,3
30,49,8,31,0,25,-25
30,49,11,1,0,22,-22
30,49,16,1,44,62,-18
30,49,16,55,36,0,36
30,49,30,1,26,0,26
30,49,30,7,131,123,8
30,49,30,13,341,270,71
30,49,30,23,33,29,4
30,49,30,27,31,0,31
30,49,30,29,123,108,15
30,49,30,31,300,261,39
30,49,30,41,46,34,12
30,49,30,43,322,379,-57
30,49,30,63,365,376,-11
30,49,30,67,33,35,-2
30,49,30,77,58,53,5
30,49,30,81,48,50,-2
30,49,30,93,152,118,34
30,49,30,111,169,196,-27
30,49,32,3,0,30,-30
30,49,41,51,30,34,-4
30,49,41,67,31,0,31
30,49,49,35,31,0,31
30,49,53,11,0,27,-27
30,49,53,33,91,87,4
30,49,53,53,59,30,29
30,49,53,61,43,0,43
30,49,53,63,62,38,24
30,53,4,13,31,0,31
30,53,16,55,45,36,9
30,53,30,29,208,281,-73
30,53,30,31,0,36,-36
30,53,30,63,80,54,26
30,53,53,33,27,0,27
30,53,53,63,34,27,7
30,57,30,1,47,63,-16
30,57,30,31,93,112,-19
30,57,30,63,0,22,-22
30,57,30,93,0,27,-27
30,61,30,63,104,120,-16
30,63,2,20,50,45,5
30,63,2,90,0,36,-36
30,63,4,13,163,81,82
30,63,4,19,35,24,11
30,63,4,25,0,27,-27
30,63,6,1,29,34,-5
30,63,6,37,67,72,-5
30,63,6,59,32,29,3
30,63,6,65,65,0,65
30,63,6,67,0,26,-26
30,63,6,71,43,0,43
30,63,6,73,95,51,44
30,63,6,75,21,39,-18
30,63,6,89,0,30,-30
30,63,8,5,35,46,-11
30,63,8,13,33,0,33
30,63,8,31,29,44,-15
30,63,8,35,37,27,10
30,63,8,41,49,0,49
30,63,8,69,31,0,31
30,63,8,77,0,27,-27
30,63,11,1,0,23,-23
30,63,16,1,74,137,-63
30,63,16,55,111,171,-60
30,63,17,31,32,21,11
30,63,23,5,0,23,-23
30,63,27,53,37,42,-5
30,63,30,1,52,58,-6
30,63,30,9,0,29,-29
30,63,30,13,268,199,69
30,63,30,17,24,0,24
30,63,30,23,47,65,-18
30,63,30,27,0,31,-31
30,63,30,29,402,459,-57
30,63,30,31,316,339,-23
30,63,30,35,90,60,30
30,63,30,39,66,59,7
30,63,30,41,88,60,28
30,63,30,43,51,41,10
30,63,30,47,320,265,55
30,63,30,49,376,365,11
30,63,30,53,54,80,-26
30,63,30,57,22,0,22
30,63,30,61,120,104,16
30,63,30,67,40,30,10
30,63,30,73,31,0,31
30,63,30,77,29,24,5
30,63,30,81,787,787,0
30,63,30,87,25,0,25
30,63,30,89,142,109,33
30,63,30,93,169,190,-21
30,63,30,111,288,364,-76
30,63,32,3,94,70,24
30,63,32,31,35,28,7
30,63,35,1,41,29,12
30,63,41,3,0,29,-29
30,63,41,5,29,30,-1
30,63,41,17,0,30,-30
30,63,41,39,35,58,-23
30,63,41,47,0,28,-28
30,63,41,51,85,146,-61
30,63,41,67,37,64,-27
30,63,48,113,32,0,32
30,63,48,201,33,0,33
30,63,49,5,0,32,-32
30,63,49,35,74,91,-17
30,63,53,11,54,26,28
30,63,53,33,219,256,-37
30,63,53,53,69,67,2
30,63,53,61,49,64,-15
30,63,53,63,191,211,-20
30,63,53,67,36,24,12
30,63,53,73,25,27,-2
30,63,56,5,0,31,-31
30,63,56,25,0,31,-31
30,65,30,111,108,136,-28
30,67,30,31,337,396,-59
30,67,30,49,35,33,2
30,67,30,63,30,40,-10
30,67,30,97,42,0,42
30,67,30,111,44,103,-59
30,67,56,29,37,0,37
30,71,30,111,0,26,-26
30,73,30,13,73,81,-8
30,73,30,29,33,37,-4
30,73,30,35,39,34,5
30,73,30,63,0,31,-31
30,73,30,99,30,0,30
30,73,30,101,33,23,10
30,77,30,13,0,26,-26
30,77,30,23,32,63,-31
30,77,30,31,0,23,-23
30,77,30,49,53,58,-5
30,77,30,63,24,29,-5
30,77,30,93,0,40,-40
30,81,4,13,53,29,24
30,81,6,37,42,0,42
30,81,6,73,34,29,5
30,81,16,1,28,24,4
30,81,16,55,0,34,-34
30,81,30,13,38,0,38
30,81,30,29,29,79,-50
30,81,30,31,65,109,-44
30,81,30,47,32,29,3
30,81,30,49,50,48,2
30,81,30,63,787,787,0
30,81,30,93,0,42,-42
30,81,30,111,37,50,-13
30,81,32,3,44,25,19
30,81,49,35,48,0,48
30,81,53,33,64,60,4
30,81,53,53,36,42,-6
30,81,53,63,42,58,-16
30,83,30,13,0,26,-26
30,83,30,31,0,25,-25
30,83,30,111,83,102,-19
30,83,38,105,35,25,10
30,85,30,105,0,43,-43
30,85,30,111,37,95,-58
30,85,38,105,43,0,43
30,87,30,3,58,48,10
30,87,30,17,32,49,-17
30,87,30,31,36,0,36
30,87,30,63,0,25,-25
30,87,30,111,125,214,-89
30,89,16,17,35,31,4
30,89,16,55,0,34,-34
30,89,30,29,59,107,-48
30,89,30,47,44,59,-15
30,89,30,63,109,142,-33
30,91,30,111,22,35,-13
30,93,30,1,28,51,-23
30,93,30,13,58,63,-5
30,93,30,23,129,107,22
30,93,30,29,44,40,4
30,93,30,31,132,132,0
30,93,30,43,93,102,-9
30,93,30,49,118,152,-34
30,93,30,57,27,0,27
30,93,30,63,190,169,21
30,93,30,77,40,0,40
30,93,30,81,42,0,42
30,93,30,111,109,80,29
30,93,32,3,31,34,-3
30,93,53,33,35,25,10
30,93,53,63,0,34,-34
30,95,30,9,46,54,-8
30,95,30,31,44,27,17
30,95,30,111,267,267,0
30,95,32,3,45,0,45
30,97,30,31,38,28,10
30,97,30,67,0,42,-42
30,97,30,111,34,39,-5
30,99,30,13,120,153,-33
30,99,30,31,28,0,28
30,99,30,73,0,30,-30
30,101,30,13,31,46,-15
30,101,30,73,23,33,-10
30,105,30,31,0,25,-25
30,105,30,85,43,0,43
30,105,30,111,36,40,-4
30,107,30,111,0,41,-41
30,111,2,20,52,42,10
30,111,4,13,196,129,67
30,111,4,19,33,0,33
30,111,4,25,34,0,34
30,111,6,37,58,36,22
30,111,6,59,30,0,30
30,111,6,67,0,34,-34
30,111,6,71,57,0,57
30,111,6,73,144,29,115
30,111,8,1,47,47,0
30,111,8,5,63,0,63
30,111,8,31,55,63,-8
30,111,8,35,37,31,6
30,111,8,41,60,41,19
30,111,8,59,43,29,14
30,111,8,69,44,33,11
30,111,16,1,47,72,-25
30,111,16,19,39,0,39
30,111,16,27,27,0,27
30,111,16,55,0,40,-40
30,111,27,53,25,35,-10
30,111,30,1,43,23,20
30,111,30,3,291,191,100
30,111,30,5,59,0,59
30,111,30,9,290,270,20
30,111,30,13,311,246,65
30,111,30,17,142,129,13
30,111,30,19,28,0,28
30,111,30,21,74,39,35
30,111,30,25,28,0,28
30,111,30,27,105,83,22
30,111,30,29,71,110,-39
30,111,30,31,480,459,21
30,111,30,33,23,0,23
30,111,30,35,40,0,40
30,111,30,37,48,0,48
30,111,30,41,97,43,54
30,111,30,47,38,30,8
30,111,30,49,196,169,27
30,111,30,63,364,288,76
30,111,30,65,136,108,28
30,111,30,67,103,44,59
30,111,30,71,26,0,26
30,111,30,81,50,37,13
30,111,30,83,102,83,19
30,111,30,85,95,37,58
30,111,30,87,214,125,89
30,111,30,91,35,22,13
30,111,30,93,80,109,-29
30,111,30,95,267,267,0
30,111,30,97,39,34,5
30,111,30,105,40,36,4
30,111,30,107,41,0,41
30,111,32,3,117,94,23
30,111,32,31,36,0,36
30,111,35,1,21,0,21
30,111,38,15,42,28,14
30,111,38,17,34,30,4
30,111,38,105,32,0,32
30,111,41,51,57,36,21
30,111,41,67,0,52,-52
30,111,46,99,0,30,-30
30,111,46,103,0,35,-35
30,111,48,201,44,56,-12
30,111,48,439,31,0,31
30,111,49,35,57,84,-27
30,111,53,11,28,0,28
30,111,53,33,145,128,17
30,111,53,53,71,51,20
30,111,53,61,36,44,-8
30,111,53,63,97,117,-20
30,111,53,67,0,24,-24
30,111,56,3,56,40,16
30,111,56,5,82,74,8
30,111,56,21,42,0,42
30,111,56,25,94,60,34
30,111,56,29,183,116,67
30,111,56,33,151,97,54
30,111,56,37,0,27,-27
30,111,56,43,39,0,39
31,1,4,13,0,37,-37
31,1,20,91,0,35,-35
31,1,31,19,102,107,-5
31,1,31,35,190,100,90
31,1,31,47,29,0,29
31,1,31,55,70,165,-95
31,1,31,65,31,0,31
31,1,31,79,235,235,0
31,1,31,99,27,0,27
31,1,31,109,121,234,-113
31,1,31,111,33,0,33
31,1,31,129,87,29,58
31,1,31,137,39,0,39
31,1,31,153,0,79,-79
31,1,31,181,92,45,47
31,1,31,185,28,0,28
31,3,31,55,0,27,-27
31,3,31,109,0,43,-43
31,3,31,119,51,86,-35
31,11,31,55,0,29,-29
31,11,31,109,26,32,-6
31,11,31,119,54,0,54
31,11,31,141,0,70,-70
31,13,31,45,57,52,5
31,13,31,109,42,87,-45
31,13,31,157,64,93,-29
31,13,31,161,38,0,38
31,13,46,103,0,48,-48
31,19,4,13,0,35,-35
31,19,8,5,0,25,-25
31,19,8,31,0,23,-23
31,19,8,69,0,42,-42
31,19,20,91,0,51,-51
31,19,31,1,107,102,5
31,19,31,33,0,25,-25
31,19,31,41,89,77,12
31,19,31,47,273,153,120
31,19,31,55,116,238,-122
31,19,31,61,55,0,55
31,19,31,63,32,0,32
31,19,31,65,28,0,28
31,19,31,79,266,267,-1
31,19,31,83,38,0,38
31,19,31,99,272,222,50
31,19,31,101,37,0,37
31,19,31,109,273,346,-73
31,19,31,111,75,110,-35
31,19,31,119,36,24,12
31,19,31,121,31,0,31
31,19,31,137,181,79,102
31,19,31,141,29,38,-9
31,19,31,145,40,33,7
31,19,31,153,36,76,-40
31,19,31,157,0,42,-42
31,19,31,163,72,45,27
31,19,46,103,0,30,-30
31,21,31,39,32,28,4
31,21,31,53,51,54,-3
31,21,31,55,64,61,3
31,21,31,177,75,66,9
31,23,31,37,49,47,2
31,23,31,55,41,49,-8
31,23,31,109,75,112,-37
31,23,31,141,100,102,-2
31,23,31,143,0,36,-36
31,23,31,155,32,29,3
31,23,31,159,0,41,-41
31,25,19,129,29,0,29
31,25,19,155,35,37,-2
31,25,31,55,525,411,114
31,25,31,109,314,368,-54
31,25,31,131,64,94,-30
31,25,31,153,490,540,-50
31,25,31,155,45,34,11
31,27,31,51,0,30,-30
31,27,31,55,0,50,-50
31,27,31,109,0,43,-43
31,27,31,119,37,60,-23
31,27,31,139,31,0,31
31,27,31,179,35,44,-9
31,27,46,135,37,80,-43
31,29,31,109,0,42,-42
31,31,46,121,64,0,64
31,33,31,19,25,0,25
31,33,31,45,45,0,45
31,33,31,55,36,0,36
31,33,31,105,41,0,41
31,33,31,109,32,40,-8
31,33,31,157,27,50,-23
31,35,31,1,100,190,-90
31,35,31,79,29,29,0
31,35,31,109,31,28,3
31,37,31,23,47,49,-2
31,37,31,53,45,52,-7
31,37,31,55,44,54,-10
31,37,31,109,31,73,-42
31,37,31,119,40,51,-11
31,37,31,141,153,182,-29
31,39,31,21,28,32,-4
31,39,31,53,72,74,-2
31,39,31,55,33,93,-60
31,39,31,109,40,71,-31
31,39,31,119,29,68,-39
31,39,31,167,32,0,32
31,41,31,19,77,89,-12
31,41,31,47,51,55,-4
31,41,31,55,0,21,-21
31,41,31,79,0,38,-38
31,41,31,109,57,59,-2
31,41,31,111,45,53,-8
31,43,6,25,47,0,47
31,43,19,149,0,40,-40
31,43,19,193,760,908,-148
31,43,20,111,29,0,29
31,43,27,53,52,0,52
31,43,31,51,66,65,1
31,43,31,55,35,94,-59
31,43,31,79,0,36,-36
31,43,31,109,30,32,-2
31,43,31,119,40,0,40
31,43,31,153,0,36,-36
31,43,31,173,101,69,32
31,43,46,99,0,35,-35
31,43,46,127,25,89,-64
31,45,31,13,52,57,-5
31,45,31,33,0,45,-45
31,45,31,55,0,22,-22
31,45,31,109,34,41,-7
31,45,31,157,52,47,5
31,45,31,161,61,63,-2
31,45,46,103,0,67,-67
31,47,27,53,31,54,-23
31,47,31,1,0,29,-29
31,47,31,19,153,273,-120
31,47,31,41,55,51,4
31,47,31,55,32,73,-41
31,47,31,63,46,31,15
31,47,31,73,95,47,48
31,47,31,79,39,143,-104
31,47,31,109,85,127,-42
31,47,31,111,151,137,14
31,47,31,137,35,59,-24
31,47,48,215,0,50,-50
31,49,31,101,29,0,29
31,51,19,193,58,59,-1
31,51,31,27,30,0,30
31,51,31,43,65,66,-1
31,51,31,109,0,38,-38
31,51,31,179,0,73,-73
31,53,4,13,30,25,5
31,53,19,155,35,27,8
31,53,20,91,0,24,-24
31,53,31,21,54,51,3
31,53,31,37,52,45,7
31,53,31,39,74,72,2
31,53,31,55,490,677,-187
31,53,31,109,163,195,-32
31,53,31,111,26,0,26
31,53,31,119,44,30,14
31,53,31,141,54,40,14
31,53,31,151,0,28,-28
31,53,31,153,75,103,-28
31,53,31,155,136,139,-3
31,53,31,177,147,126,21
31,55,2,20,23,48,-25
31,55,4,13,464,625,-161
31,55,4,19,82,108,-26
31,55,5,7,53,43,10
31,55,5,119,41,43,-2
31,55,6,1,60,54,6
31,55,6,13,56,29,27
31,55,6,37,379,230,149
31,55,6,53,37,0,37
31,55,6,59,100,93,7
31,55,6,65,81,75,6
31,55,6,67,40,63,-23
31,55,6,71,93,66,27
31,55,6,73,192,188,4
31,55,6,75,38,37,1
31,55,6,81,0,57,-57
31,55,6,85,37,50,-13
31,55,6,111,30,0,30
31,55,8,1,57,113,-56
31,55,8,5,107,160,-53
31,55,8,13,36,32,4
31,55,8,14,0,38,-38
31,55,8,31,128,198,-70
31,55,8,35,85,109,-24
31,55,8,37,0,25,-25
31,55,8,41,103,119,-16
31,55,8,59,64,81,-17
31,55,8,69,64,90,-26
31,55,8,77,23,0,23
31,55,8,123,0,45,-45
31,55,11,1,50,51,-1
31,55,12,9,0,38,-38
31,55,12,11,54,32,22
31,55,12,31,43,45,-2
31,55,12,33,29,0,29
31,55,12,57,57,83,-26
31,55,12,71,28,33,-5
31,55,12,86,52,37,15
31,55,12,95,34,72,-38
31,55,12,99,44,33,11
31,55,12,103,40,37,3
31,55,12,117,0,29,-29
31,55,12,127,0,30,-30
31,55,13,67,51,50,1
31,55,13,89,32,37,-5
31,55,13,121,57,76,-19
31,55,13,135,0,53,-53
31,55,15,3,63,40,23
31,55,17,19,38,0,38
31,55,17,31,354,409,-55
31,55,17,43,84,76,8
31,55,17,89,51,55,-4
31,55,17,97,0,36,-36
31,55,17,111,44,0,44
31,55,17,197,47,53,-6
31,55,18,57,47,50,-3
31,55,18,97,52,46,6
31,55,19,13,53,29,24
31,55,19,21,50,0,50
31,55,19,27,26,0,26
31,55,19,29,49,45,4
31,55,19,47,91,64,27
31,55,19,49,52,97,-45
31,55,19,71,42,25,17
31,55,19,85,211,157,54
31,55,19,103,88,71,17
31,55,19,113,73,92,-19
31,55,19,129,154,164,-10
31,55,19,133,0,32,-32
31,55,19,137,67,44,23
31,55,19,145,63,31,32
31,55,19,149,35,0,35
31,55,19,153,297,329,-32
31,55,19,155,1998,2007,-9
31,55,19,163,44,37,7
31,55,19,165,80,44,36
31,55,19,167,23,0,23
31,55,19,169,69,67,2
31,55,19,193,301,140,161
31,55,20,45,41,23,18
31,55,20,91,287,395,-108
31,55,20,161,48,28,20
31,55,20,173,117,115,2
31,55,20,177,70,71,-1
31,55,20,209,56,39,17
31,55,21,111,0,35,-35
31,55,22,71,0,37,-37
31,55,24,31,39,57,-18
31,55,24,33,0,36,-36
31,55,25,17,38,45,-7
31,55,25,25,0,37,-37
31,55,26,77,46,0,46
31,55,26,125,59,33,26
31,55,26,161,36,0,36
31,55,26,163,48,0,48
31,55,27,3,35,0,35
31,55,27,37,57,43,14
31,55,27,53,206,264,-58
31,55,27,109,41,31,10
31,55,27,123,111,68,43
31,55,27,163,35,52,-17
31,55,28,49,27,0,27
31,55,29,19,24,55,-31
31,55,29,21,31,43,-12
31,55,29,47,55,112,-57
31,55,29,77,46,46,0
31,55,29,95,217,262,-45
31,55,29,147,29,0,29
31,55,29,165,61,42,19
31,55,29,183,49,51,-2
31,55,29,189,172,124,48
31,55,29,510,46,48,-2
31,55,31,1,165,70,95
31,55,31,3,27,0,27
31,55,31,11,29,0,29
31,55,31,19,238,116,122
31,55,31,21,61,64,-3
31,55,31,23,49,41,8
31,55,31,25,411,525,-114
31,55,31,27,50,0,50
31,55,31,33,0,36,-36
31,55,31,37,54,44,10
31,55,31,39,93,33,60
31,55,31,41,21,0,21
31,55,31,43,94,35,59
31,55,31,45,22,0,22
31,55,31,47,73,32,41
31,55,31,53,677,490,187
31,55,31,67,71,0,71
31,55,31,79,302,204,98
31,55,31,81,48,0,48
31,55,31,89,52,0,52
31,55,31,93,23,0,23
31,55,31,107,25,0,25
31,55,31,109,1932,1228,704
31,55,31,111,168,107,61
31,55,31,119,251,130,121
31,55,31,121,36,0,36
31,55,31,127,39,0,39
31,55,31,131,152,67,85
31,55,31,139,36,0,36
31,55,31,141,217,111,106
31,55,31,145,0,26,-26
31,55,31,147,29,0,29
31,55,31,151,54,32,22
31,55,31,153,7968,9646,-1678
31,55,31,155,381,333,48
31,55,31,157,41,47,-6
31,55,31,159,46,0,46
31,55,31,167,41,0,41
31,55,31,169,28,0,28
31,55,31,173,31,0,31
31,55,31,177,628,585,43
31,55,31,179,61,0,61
31,55,31,185,53,0,53
31,55,32,3,202,242,-40
31,55,32,31,32,0,32
31,55,35,1,42,55,-13
31,55,36,47,0,58,-58
31,55,36,59,39,0,39
31,55,36,61,50,89,-39
31,55,36,81,34,39,-5
31,55,37,119,29,71,-42
31,55,37,133,45,0,45
31,55,37,183,0,48,-48
31,55,38,17,56,32,24
31,55,39,35,31,45,-14
31,55,39,49,68,67,1
31,55,39,61,0,32,-32
31,55,39,153,39,0,39
31,55,40,109,64,74,-10
31,55,40,143,87,91,-4
31,55,41,51,39,63,-24
31,55,41,67,0,50,-50
31,55,42,3,34,23,11
31,55,42,101,0,26,-26
31,55,45,19,33,0,33
31,55,46,27,37,0,37
31,55,46,83,41,34,7
31,55,46,99,225,146,79
31,55,46,103,53,58,-5
31,55,46,127,55,31,24
31,55,47,37,28,40,-12
31,55,47,157,74,81,-7
31,55,48,27,29,25,4
31,55,48,29,103,159,-56
31,55,48,61,0,36,-36
31,55,48,85,90,149,-59
31,55,48,113,120,212,-92
31,55,48,121,62,35,27
31,55,48,141,48,69,-21
31,55,48,201,153,231,-78
31,55,48,215,37,0,37
31,55,48,339,0,43,-43
31,55,48,439,128,123,5
31,55,48,453,49,117,-68
31,55,48,491,0,43,-43
31,55,49,35,103,133,-30
31,55,49,49,55,59,-4
31,55,51,3,0,33,-33
31,55,51,13,30,27,3
31,55,51,59,66,85,-19
31,55,51,153,0,39,-39
31,55,51,810,41,0,41
31,55,53,33,109,220,-111
31,55,53,35,29,0,29
31,55,53,53,40,45,-5
31,55,53,61,38,45,-7
31,55,53,63,0,66,-66
31,55,53,67,0,37,-37
31,55,55,25,63,46,17
31,55,55,79,62,55,7
31,55,56,21,23,35,-12
31,59,31,109,65,89,-24
31,59,31,185,63,59,4
31,61,31,19,0,55,-55
31,61,31,99,38,30,8
31,63,31,19,0,32,-32
31,63,31,47,31,46,-15
31,63,31,111,28,53,-25
31,65,31,1,0,31,-31
31,65,31,19,0,28,-28
31,65,31,79,0,28,-28
31,65,31,137,0,33,-33
31,65,31,145,30,30,0
31,67,20,117,47,0,47
31,67,31,55,0,71,-71
31,67,31,95,112,87,25
31,67,31,97,0,43,-43
31,67,31,109,361,529,-168
31,67,31,133,31,25,6
31,67,31,151,123,78,45
31,73,31,47,47,95,-48
31,77,31,93,0,43,-43
31,79,6,37,63,25,38
31,79,8,123,0,25,-25
31,79,20,111,56,0,56
31,79,27,53,75,25,50
31,79,29,21,36,0,36
31,79,31,1,235,235,0
31,79,31,19,267,266,1
31,79,31,35,29,29,0
31,79,31,41,38,0,38
31,79,31,43,36,0,36
31,79,31,47,143,39,104
31,79,31,55,204,302,-98
31,79,31,65,28,0,28
31,79,31,77,0,32,-32
31,79,31,81,177,185,-8
31,79,31,93,209,181,28
31,79,31,109,305,376,-71
31,79,31,111,74,44,30
31,79,31,119,44,31,13
31,79,31,121,158,156,2
31,79,31,141,58,0,58
31,79,31,151,0,51,-51
31,79,31,153,85,91,-6
31,79,31,163,62,0,62
31,79,31,185,48,34,14
31,79,39,49,29,0,29
31,81,31,55,0,48,-48
31,81,31,79,185,177,8
31,81,31,109,68,101,-33
31,81,31,121,50,46,4
31,81,31,185,48,46,2
31,83,31,19,0,38,-38
31,83,31,109,0,26,-26
31,83,31,137,48,71,-23
31,87,31,145,64,79,-15
31,89,31,55,0,52,-52
31,89,31,109,0,44,-44
31,89,31,119,40,60,-20
31,93,31,55,0,23,-23
31,93,31,77,43,0,43
31,93,31,79,181,209,-28
31,93,31,109,35,31,4
31,93,31,121,29,0,29
31,95,31,67,87,112,-25
31,95,31,109,0,89,-89
31,95,31,169,32,28,4
31,97,31,67,43,0,43
31,97,31,109,74,141,-67
31,97,31,131,40,55,-15
31,99,31,1,0,27,-27
31,99,31,19,222,272,-50
31,99,31,61,30,38,-8
31,99,31,109,24,47,-23
31,99,31,137,0,35,-35
31,101,31,19,0,37,-37
31,101,31,49,0,29,-29
31,101,31,109,24,36,-12
31,101,31,111,78,138,-60
31,101,31,135,42,0,42
31,105,31,33,0,41,-41
31,105,31,157,28,34,-6
31,105,56,21,24,43,-19
31,107,31,55,0,25,-25
31,107,31,109,26,38,-12
31,107,31,119,47,34,13
31,107,31,139,0,33,-33
31,107,46,135,35,85,-50
31,109,4,13,239,332,-93
31,109,4,19,40,67,-27
31,109,6,1,0,37,-37
31,109,6,37,72,132,-60
31,109,6,59,31,83,-52
31,109,6,65,33,45,-12
31,109,6,67,30,0,30
31,109,6,71,42,0,42
31,109,6,73,105,108,-3
31,109,6,85,26,43,-17
31,109,8,1,34,75,-41
31,109,8,5,42,110,-68
31,109,8,13,35,0,35
31,109,8,31,47,121,-74
31,109,8,35,38,59,-21
31,109,8,41,63,90,-27
31,109,8,59,26,68,-42
31,109,8,69,71,106,-35
31,109,8,123,32,0,32
31,109,11,1,0,28,-28
31,109,12,31,29,37,-8
31,109,12,95,24,39,-15
31,109,13,121,0,22,-22
31,109,17,31,125,215,-90
31,109,17,43,0,31,-31
31,109,17,197,0,41,-41
31,109,19,49,0,41,-41
31,109,19,71,25,0,25
31,109,19,103,33,28,5
31,109,19,153,108,163,-55
31,109,19,155,83,61,22
31,109,19,169,41,25,16
31,109,19,193,61,61,0
31,109,20,45,26,31,-5
31,109,20,91,124,229,-105
31,109,20,117,0,25,-25
31,109,20,161,48,41,7
31,109,20,173,73,93,-20
31,109,20,177,49,49,0
31,109,26,161,0,43,-43
31,109,27,37,34,29,5
31,109,27,53,49,77,-28
31,109,27,123,27,25,2
31,109,29,19,29,0,29
31,109,29,21,37,24,13
31,109,29,47,47,48,-1
31,109,29,77,0,29,-29
31,109,29,95,87,118,-31
31,109,29,165,0,34,-34
31,109,29,183,0,32,-32
31,109,29,189,42,48,-6
31,109,29,510,0,26,-26
31,109,31,1,234,121,113
31,109,31,3,43,0,43
31,109,31,11,32,26,6
31,109,31,13,87,42,45
31,109,31,19,346,273,73
31,109,31,23,112,75,37
31,109,31,25,368,314,54
31,109,31,27,43,0,43
31,109,31,29,42,0,42
31,109,31,33,40,32,8
31,109,31,35,28,31,-3
31,109,31,37,73,31,42
31,109,31,39,71,40,31
31,109,31,41,59,57,2
31,109,31,43,32,30,2
31,109,31,45,41,34,7
31,109,31,47,127,85,42
31,109,31,51,38,0,38
31,109,31,53,195,163,32
31,109,31,55,1228,1932,-704
31,109,31,59,89,65,24
31,109,31,67,529,361,168
31,109,31,79,376,305,71
31,109,31,81,101,68,33
31,109,31,83,26,0,26
31,109,31,89,44,0,44
31,109,31,93,31,35,-4
31,109,31,95,89,0,89
31,109,31,97,141,74,67
31,109,31,99,47,24,23
31,109,31,101,36,24,12
31,109,31,107,38,26,12
31,109,31,111,252,162,90
31,109,31,119,256,180,76
31,109,31,121,62,28,34
31,109,31,127,108,31,77
31,109,31,129,29,0,29
31,109,31,131,360,327,33
31,109,31,133,29,0,29
31,109,31,137,55,28,27
31,109,31,139,25,36,-11
31,109,31,141,263,109,154
31,109,31,143,59,27,32
31,109,31,145,68,49,19
31,109,31,147,100,62,38
31,109,31,151,441,298,143
31,109,31,153,390,662,-272
31,109,31,155,406,431,-25
31,109,31,157,129,80,49
31,109,31,159,528,517,11
31,109,31,167,40,0,40
31,109,31,169,87,40,47
31,109,31,173,27,0,27
31,109,31,175,42,0,42
31,109,31,177,66,32,34
31,109,31,179,79,25,54
31,109,31,185,255,158,97
31,109,32,3,84,106,-22
31,109,36,61,0,21,-21
31,109,37,183,0,28,-28
31,109,39,49,28,43,-15
31,109,39,153,0,29,-29
31,109,40,109,0,34,-34
31,109,40,143,42,52,-10
31,109,41,51,29,54,-25
31,109,46,11,0,28,-28
31,109,46,99,79,111,-32
31,109,46,103,41,0,41
31,109,47,37,34,34,0
31,109,47,157,39,28,11
31,109,48,27,0,38,-38
31,109,48,29,0,61,-61
31,109,48,85,0,38,-38
31,109,48,113,50,64,-14
31,109,48,121,33,29,4
31,109,48,201,28,103,-75
31,109,48,439,36,94,-58
31,109,48,453,36,62,-26
31,109,49,35,0,41,-41
31,109,51,59,0,39,-39
31,109,53,33,47,53,-6
31,109,53,53,0,47,-47
31,109,53,61,0,35,-35
31,109,55,25,0,42,-42
31,109,55,79,0,37,-37
31,111,8,1,39,0,39
31,111,8,69,0,34,-34
31,111,8,123,31,34,-3
31,111,31,1,0,33,-33
31,111,31,19,110,75,35
31,111,31,41,53,45,8
31,111,31,47,137,151,-14
31,111,31,53,0,26,-26
31,111,31,55,107,168,-61
31,111,31,63,53,28,25
31,111,31,79,44,74,-30
31,111,31,101,138,78,60
31,111,31,109,162,252,-90
31,111,31,113,41,34,7
31,111,31,135,49,0,49
31,111,31,145,65,29,36
31,111,31,153,30,54,-24
31,111,31,157,40,39,1
31,111,56,21,0,30,-30
31,119,19,193,34,0,34
31,119,31,3,86,51,35
31,119,31,11,0,54,-54
31,119,31,19,24,36,-12
31,119,31,27,60,37,23
31,119,31,37,51,40,11
31,119,31,39,68,29,39
31,119,31,43,0,40,-40
31,119,31,53,30,44,-14
31,119,31,55,130,251,-121
31,119,31,79,31,44,-13
31,119,31,89,60,40,20
31,119,31,107,34,47,-13
31,119,31,109,180,256,-76
31,119,31,139,150,137,13
31,119,31,141,94,155,-61
31,119,31,153,0,62,-62
31,119,31,167,171,95,76
31,119,31,179,113,100,13
31,119,46,99,0,28,-28
31,121,31,19,0,31,-31
31,121,31,55,0,36,-36
31,121,31,79,156,158,-2
31,121,31,81,46,50,-4
31,121,31,93,0,29,-29
31,121,31,109,28,62,-34
31,123,31,157,119,174,-55
31,125,31,141,65,58,7
31,127,31,55,0,39,-39
31,127,31,109,31,108,-77
31,127,31,131,111,62,49
31,127,31,147,45,37,8
31,127,31,153,0,24,-24
31,129,31,1,29,87,-58
31,129,31,109,0,29,-29
31,129,31,181,0,33,-33
31,131,19,71,47,45,2
31,131,31,25,94,64,30
31,131,31,55,67,152,-85
31,131,31,97,55,40,15
31,131,31,109,327,360,-33
31,131,31,127,62,111,-49
31,131,31,153,28,75,-47
31,133,31,67,25,31,-6
31,133,31,109,0,29,-29
31,133,31,147,0,26,-26
31,135,31,101,0,42,-42
31,135,31,111,0,49,-49
31,137,31,1,0,39,-39
31,137,31,19,79,181,-102
31,137,31,47,59,35,24
31,137,31,65,33,0,33
31,137,31,83,71,48,23
31,137,31,99,35,0,35
31,137,31,109,28,55,-27
31,139,31,27,0,31,-31
31,139,31,55,0,36,-36
31,139,31,107,33,0,33
31,139,31,109,36,25,11
31,139,31,119,137,150,-13
31,139,31,179,0,23,-23
31,141,31,11,70,0,70
31,141,31,19,38,29,9
31,141,31,23,102,100,2
31,141,31,37,182,153,29
31,141,31,53,40,54,-14
31,141,31,55,111,217,-106
31,141,31,79,0,58,-58
31,141,31,109,109,263,-154
31,141,31,119,155,94,61
31,141,31,125,58,65,-7
31,141,31,143,77,106,-29
31,141,31,153,0,61,-61
31,143,31,23,36,0,36
31,143,31,109,27,59,-32
31,143,31,141,106,77,29
31,143,31,185,47,65,-18
31,145,20,39,0,33,-33
31,145,31,19,33,40,-7
31,145,31,55,26,0,26
31,145,31,65,30,30,0
31,145,31,87,79,64,15
31,145,31,109,49,68,-19
31,145,31,111,29,65,-36
31,147,20,13,38,55,-17
31,147,31,55,0,29,-29
31,147,31,109,62,100,-38
31,147,31,127,37,45,-8
31,147,31,133,26,0,26
31,151,6,37,42,0,42
31,151,31,53,28,0,28
31,151,31,55,32,54,-22
31,151,31,67,78,123,-45
31,151,31,79,51,0,51
31,151,31,109,298,441,-143
31,151,31,159,39,72,-33
31,153,2,20,75,0,75
31,153,2,90,48,0,48
31,153,4,13,133,163,-30
31,153,4,19,65,55,10
31,153,6,37,81,63,18
31,153,6,53,370,52,318
31,153,6,73,92,73,19
31,153,6,83,0,31,-31
31,153,8,1,31,30,1
31,153,8,5,42,70,-28
31,153,8,31,0,41,-41
31,153,8,41,100,186,-86
31,153,8,69,0,35,-35
31,153,12,9,39,0,39
31,153,12,31,0,41,-41
31,153,12,57,0,72,-72
31,153,12,91,36,55,-19
31,153,13,153,0,37,-37
31,153,15,3,94,114,-20
31,153,17,31,62,37,25
31,153,17,43,33,0,33
31,153,17,163,41,83,-42
31,153,19,29,32,0,32
31,153,19,85,31,0,31
31,153,19,113,41,0,41
31,153,19,129,89,109,-20
31,153,19,153,72,115,-43
31,153,19,155,556,415,141
31,153,19,163,34,0,34
31,153,19,169,55,0,55
31,153,19,193,85,32,53
31,153,20,91,93,115,-22
31,153,20,173,0,70,-70
31,153,24,3,0,48,-48
31,153,27,53,39,52,-13
31,153,28,47,31,29,2
31,153,29,21,0,33,-33
31,153,29,47,34,39,-5
31,153,29,95,68,38,30
31,153,29,189,45,0,45
31,153,31,1,79,0,79
31,153,31,19,76,36,40
31,153,31,25,540,490,50
31,153,31,43,36,0,36
31,153,31,53,103,75,28
31,153,31,55,9646,7968,1678
31,153,31,79,91,85,6
31,153,31,109,662,390,272
31,153,31,111,54,30,24
31,153,31,119,62,0,62
31,153,31,127,24,0,24
31,153,31,131,75,28,47
31,153,31,141,61,0,61
31,153,31,155,140,90,50
31,153,31,177,77,65,12
31,153,32,3,94,112,-18
31,153,38,101,44,0,44
31,153,39,49,0,58,-58
31,153,40,109,49,0,49
31,153,44,5,54,0,54
31,153,46,99,59,61,-2
31,153,46,103,38,0,38
31,153,47,157,32,0,32
31,153,48,27,0,39,-39
31,153,48,29,258,172,86
31,153,48,85,0,54,-54
31,153,48,113,0,55,-55
31,153,48,141,43,0,43
31,153,48,201,20,87,-67
31,153,48,397,0,43,-43
31,153,48,439,36,84,-48
31,153,48,451,69,48,21
31,153,48,453,0,29,-29
31,153,48,485,35,0,35
31,153,48,491,0,30,-30
31,153,51,59,82,88,-6
31,153,51,153,0,36,-36
31,153,51,810,53,0,53
31,153,53,33,32,50,-18
31,153,53,53,36,0,36
31,153,53,63,0,45,-45
31,153,56,21,43,0,43
31,155,31,23,29,32,-3
31,155,31,25,34,45,-11
31,155,31,53,139,136,3
31,155,31,55,333,381,-48
31,155,31,109,431,406,25
31,155,31,153,90,140,-50
31,157,4,13,48,42,6
31,157,8,5,0,40,-40
31,157,8,31,0,36,-36
31,157,8,41,0,38,-38
31,157,8,59,37,29,8
31,157,8,69,55,51,4
31,157,8,123,36,0,36
31,157,31,7,26,0,26
31,157,31,13,93,64,29
31,157,31,19,42,0,42
31,157,31,33,50,27,23
31,157,31,45,47,52,-5
31,157,31,55,47,41,6
31,157,31,105,34,28,6
31,157,31,109,80,129,-49
31,157,31,111,39,40,-1
31,157,31,123,174,119,55
31,157,31,165,46,0,46
31,157,32,3,0,28,-28
31,157,46,103,28,41,-13
31,157,56,1,29,0,29
31,157,56,5,0,27,-27
31,157,56,15,77,107,-30
31,157,56,21,27,84,-57
31,157,56,25,38,0,38
31,157,56,31,30,0,30
31,159,31,23,41,0,41
31,159,31,55,0,46,-46
31,159,31,109,517,528,-11
31,159,31,151,72,39,33
31,159,31,185,108,74,34
31,161,31,13,0,38,-38
31,161,31,45,63,61,2
31,161,46,103,26,0,26
31,161,46,113,47,0,47
31,163,31,19,45,72,-27
31,163,31,79,0,62,-62
31,167,31,39,0,32,-32
31,167,31,55,0,41,-41
31,167,31,109,0,40,-40
31,167,31,119,95,171,-76
31,167,31,179,44,0,44
31,169,31,55,0,28,-28
31,169,31,95,28,32,-4
31,169,31,109,40,87,-47
31,173,19,193,60,157,-97
31,173,31,43,69,101,-32
31,173,31,55,0,31,-31
31,173,31,109,0,27,-27
31,175,31,109,0,42,-42
31,177,19,85,49,0,49
31,177,19,155,44,60,-16
31,177,31,21,66,75,-9
31,177,31,53,126,147,-21
31,177,31,55,585,628,-43
31,177,31,109,32,66,-34
31,177,31,153,65,77,-12
31,179,31,27,44,35,9
31,179,31,51,73,0,73
31,179,31,55,0,61,-61
31,179,31,109,25,79,-54
31,179,31,119,100,113,-13
31,179,31,139,23,0,23
31,179,31,167,0,44,-44
31,181,31,1,45,92,-47
31,181,31,129,33,0,33
31,185,31,1,0,28,-28
31,185,31,55,0,53,-53
31,185,31,59,59,63,-4
31,185,31,79,34,48,-14
31,185,31,81,46,48,-2
31,185,31,109,158,255,-97
31,185,31,143,65,47,18
31,185,31,159,74,108,-34
32,1,6,31,75,70,5
32,1,6,37,33,0,33
32,1,6,73,142,135,7
32,1,6,111,38,0,38
32,1,32,3,59,50,9
32,1,32,7,40,44,-4
32,1,32,19,281,220,61
32,1,32,21,0,32,-32
32,1,32,23,30,0,30
32,1,32,27,0,31,-31
32,1,32,31,280,393,-113
32,1,32,510,46,56,-10
32,1,51,810,57,51,6
32,1,53,29,62,64,-2
32,1,53,35,0,42,-42
32,3,1,3,0,48,-48
32,3,1,73,67,68,-1
32,3,1,81,42,0,42
32,3,1,89,47,53,-6
32,3,1,97,51,38,13
32,3,1,101,100,93,7
32,3,2,20,493,308,185
32,3,2,90,186,99,87
32,3,2,110,0,43,-43
32,3,2,122,27,0,27
32,3,2,170,32,53,-21
32,3,4,1,60,70,-10
32,3,4,3,103,102,1
32,3,4,5,307,294,13
32,3,4,7,0,30,-30
32,3,4,9,0,27,-27
32,3,4,12,48,41,7
32,3,4,13,4031,3983,48
32,3,4,15,1909,1998,-89
32,3,4,17,81,94,-13
32,3,4,19,1006,916,90
32,3,4,21,184,384,-200
32,3,4,23,35,0,35
32,3,4,25,215,355,-140
32,3,4,27,192,261,-69
32,3,5,7,58,104,-46
32,3,5,45,0,29,-29
32,3,5,51,0,41,-41
32,3,5,119,133,108,25
32,3,5,131,28,0,28
32,3,5,143,33,74,-41
32,3,6,1,1057,822,235
32,3,6,7,88,92,-4
32,3,6,13,598,531,67
32,3,6,17,154,101,53
32,3,6,19,512,461,51
32,3,6,23,0,73,-73
32,3,6,25,183,256,-73
32,3,6,27,44,0,44
32,3,6,29,926,760,166
32,3,6,31,96,67,29
32,3,6,33,43,42,1
32,3,6,37,15651,8128,7523
32,3,6,39,70,84,-14
32,3,6,41,94,82,12
32,3,6,45,44,44,0
32,3,6,47,195,113,82
32,3,6,53,423,353,70
32,3,6,55,65,36,29
32,3,6,57,43,46,-3
32,3,6,59,3352,2544,808
32,3,6,61,166,207,-41
32,3,6,65,2925,2212,713
32,3,6,67,802,822,-20
32,3,6,69,0,41,-41
32,3,6,71,3807,2452,1355
32,3,6,73,3986,3284,702
32,3,6,75,478,355,123
32,3,6,77,351,400,-49
32,3,6,79,169,239,-70
32,3,6,81,525,343,182
32,3,6,83,430,342,88
32,3,6,85,1213,835,378
32,3,6,87,128,94,34
32,3,6,89,60,121,-61
32,3,6,93,29,29,0
32,3,6,95,455,326,129
32,3,6,97,177,192,-15
32,3,6,99,350,212,138
32,3,6,101,60,45,15
32,3,6,103,28,42,-14
32,3,6,107,304,295,9
32,3,6,109,33,0,33
32,3,6,111,1043,779,264
32,3,6,113,111,70,41
32,3,6,115,93,55,38
32,3,8,1,360,313,47
32,3,8,5,501,559,-58
32,3,8,13,113,100,13
32,3,8,14,35,73,-38
32,3,8,29,0,56,-56
32,3,8,31,524,434,90
32,3,8,35,218,305,-87
32,3,8,37,41,60,-19
32,3,8,41,698,666,32
32,3,8,43,0,42,-42
32,3,8,45,71,40,31
32,3,8,59,350,281,69
32,3,8,67,39,33,6
32,3,8,69,172,199,-27
32,3,8,77,150,232,-82
32,3,8,85,0,69,-69
32,3,8,101,101,113,-12
32,3,8,117,28,0,28
32,3,8,123,123,145,-22
32,3,9,1,145,55,90
32,3,9,3,151,85,66
32,3,9,5,35,0,35
32,3,9,9,134,59,75
32,3,9,11,185,56,129
32,3,9,15,38,0,38
32,3,10,1,76,0,76
32,3,10,3,124,82,42
32,3,10,5,27,29,-2
32,3,11,1,129,103,26
32,3,12,1,46,35,11
32,3,12,5,137,87,50
32,3,12,9,157,176,-19
32,3,12,11,508,436,72
32,3,12,15,38,36,2
32,3,12,17,0,35,-35
32,3,12,19,52,29,23
32,3,12,21,111,67,44
32,3,12,31,266,183,83
32,3,12,33,118,47,71
32,3,12,35,33,43,-10
32,3,12,53,59,26,33
32,3,12,57,400,317,83
32,3,12,61,48,0,48
32,3,12,69,64,44,20
32,3,12,71,207,128,79
32,3,12,73,45,35,10
32,3,12,81,108,72,36
32,3,12,83,87,84,3
32,3,12,85,30,36,-6
32,3,12,86,733,602,131
32,3,12,87,33,27,6
32,3,12,91,232,157,75
32,3,12,95,678,414,264
32,3,12,97,109,113,-4
32,3,12,99,377,243,134
32,3,12,101,125,137,-12
32,3,12,103,280,190,90
32,3,12,105,92,74,18
32,3,12,109,56,57,-1
32,3,12,111,76,49,27
32,3,12,113,83,66,17
32,3,12,115,133,132,1
32,3,12,117,172,58,114
32,3,12,127,160,115,45
32,3,13,21,36,0,36
32,3,13,51,78,51,27
32,3,13,57,0,73,-73
32,3,13,59,30,0,30
32,3,13,63,73,59,14
32,3,13,67,215,191,24
32,3,13,89,212,175,37
32,3,13,97,0,43,-43
32,3,13,121,260,201,59
32,3,13,135,182,212,-30
32,3,13,151,51,0,51
32,3,13,153,147,55,92
32,3,13,179,35,21,14
32,3,13,185,38,54,-16
32,3,13,215,47,0,47
32,3,13,223,0,31,-31
32,3,13,245,61,29,32
32,3,15,1,286,218,68
32,3,15,3,2625,1344,1281
32,3,15,7,109,83,26
32,3,15,9,447,259,188
32,3,16,1,329,549,-220
32,3,16,5,101,101,0
32,3,16,11,32,62,-30
32,3,16,13,27,0,27
32,3,16,19,89,185,-96
32,3,16,27,159,168,-9
32,3,16,39,81,37,44
32,3,16,53,0,64,-64
32,3,16,55,74,189,-115
32,3,16,57,28,0,28
32,3,16,65,72,72,0
32,3,16,83,75,132,-57
32,3,17,19,61,0,61
32,3,17,31,2041,1280,761
32,3,17,37,42,29,13
32,3,17,43,398,195,203
32,3,17,77,25,0,25
32,3,17,89,150,151,-1
32,3,17,91,0,30,-30
32,3,17,97,258,169,89
32,3,17,99,37,0,37
32,3,17,111,99,57,42
32,3,17,113,52,0,52
32,3,17,119,84,65,19
32,3,17,143,67,49,18
32,3,17,161,47,25,22
32,3,17,163,185,81,104
32,3,17,167,47,29,18
32,3,17,179,21,0,21
32,3,17,197,241,181,60
32,3,17,201,129,64,65
32,3,18,3,98,60,38
32,3,18,19,0,25,-25
32,3,18,39,44,0,44
32,3,18,57,80,83,-3
32,3,18,63,0,43,-43
32,3,18,89,273,145,128
32,3,18,91,31,0,31
32,3,18,97,202,209,-7
32,3,18,105,0,35,-35
32,3,18,127,69,58,11
32,3,18,141,107,49,58
32,3,18,157,38,34,4
32,3,18,163,44,0,44
32,3,19,13,25,24,1
32,3,19,103,26,0,26
32,3,19,113,55,32,23
32,3,19,153,137,112,25
32,3,19,155,36,0,36
32,3,19,163,61,59,2
32,3,19,169,37,0,37
32,3,20,45,49,0,49
32,3,20,61,0,33,-33
32,3,20,91,203,159,44
32,3,20,103,34,47,-13
32,3,20,161,58,0,58
32,3,20,173,144,145,-1
32,3,20,177,41,71,-30
32,3,20,209,26,43,-17
32,3,21,15,0,46,-46
32,3,21,47,42,0,42
32,3,21,67,55,44,11
32,3,21,93,0,42,-42
32,3,21,111,138,175,-37
32,3,21,117,38,28,10
32,3,22,15,71,64,7
32,3,22,17,57,52,5
32,3,22,19,42,39,3
32,3,22,33,108,51,57
32,3,22,51,87,122,-35
32,3,22,55,40,45,-5
32,3,22,71,62,97,-35
32,3,22,73,0,47,-47
32,3,22,103,54,38,16
32,3,22,115,33,0,33
32,3,23,5,57,53,4
32,3,23,19,29,0,29
32,3,23,31,42,0,42
32,3,24,3,162,103,59
32,3,24,5,140,60,80
32,3,24,17,45,0,45
32,3,24,21,46,44,2
32,3,24,25,53,33,20
32,3,24,27,89,40,49
32,3,24,31,281,114,167
32,3,24,33,163,89,74
32,3,24,510,64,41,23
32,3,25,1,38,0,38
32,3,25,3,31,0,31
32,3,25,5,78,28,50
32,3,25,9,143,73,70
32,3,25,13,35,24,11
32,3,25,17,236,182,54
32,3,25,21,100,77,23
32,3,25,23,78,79,-1
32,3,25,25,137,84,53
32,3,25,27,117,91,26
32,3,26,21,50,41,9
32,3,26,25,42,38,4
32,3,26,37,31,0,31
32,3,26,45,103,0,103
32,3,26,49,214,52,162
32,3,26,55,48,0,48
32,3,26,65,370,37,333
32,3,26,73,42,0,42
32,3,26,75,55,0,55
32,3,26,77,120,33,87
32,3,26,81,224,96,128
32,3,26,87,35,0,35
32,3,26,91,56,0,56
32,3,26,93,75,32,43
32,3,26,99,608,171,437
32,3,26,115,67,27,40
32,3,26,121,32,0,32
32,3,26,125,822,206,616
32,3,26,139,48,0,48
32,3,26,145,88,0,88
32,3,26,147,81,28,53
32,3,26,155,45,0,45
32,3,26,159,26,0,26
32,3,26,161,158,81,77
32,3,26,163,1166,293,873
32,3,27,3,58,57,1
32,3,27,37,176,85,91
32,3,27,53,428,240,188
32,3,27,109,39,41,-2
32,3,27,123,188,94,94
32,3,27,137,46,27,19
32,3,27,139,28,0,28
32,3,27,145,32,0,32
32,3,27,163,49,50,-1
32,3,28,33,58,47,11
32,3,28,47,121,134,-13
32,3,28,49,34,40,-6
32,3,28,59,47,75,-28
32,3,28,87,37,0,37
32,3,28,121,0,45,-45
32,3,29,19,44,38,6
32,3,29,43,29,65,-36
32,3,29,47,81,60,21
32,3,29,77,90,133,-43
32,3,29,95,221,215,6
32,3,29,97,0,36,-36
32,3,29,99,23,0,23
32,3,29,101,42,0,42
32,3,29,165,31,32,-1
32,3,29,183,99,115,-16
32,3,29,189,276,213,63
32,3,29,213,35,45,-10
32,3,29,510,123,77,46
32,3,30,13,73,84,-11
32,3,30,29,76,118,-42
32,3,30,31,64,83,-19
32,3,30,49,30,0,30
32,3,30,63,70,94,-24
32,3,30,81,25,44,-19
32,3,30,93,34,31,3
32,3,30,95,0,45,-45
32,3,30,111,94,117,-23
32,3,31,55,242,202,40
32,3,31,109,106,84,22
32,3,31,153,112,94,18
32,3,31,157,28,0,28
32,3,32,1,50,59,-9
32,3,32,5,192,169,23
32,3,32,7,245,314,-69
32,3,32,9,0,48,-48
32,3,32,13,52,33,19
32,3,32,15,0,34,-34
32,3,32,17,93,193,-100
32,3,32,19,184,222,-38
32,3,32,21,0,30,-30
32,3,32,23,1462,2178,-716
32,3,32,29,0,30,-30
32,3,32,31,1981,1911,70
32,3,32,33,115,180,-65
32,3,32,510,196,249,-53
32,3,33,9,28,0,28
32,3,33,11,90,79,11
32,3,33,15,26,44,-18
32,3,33,17,36,0,36
32,3,34,1,266,123,143
32,3,34,3,231,85,146
32,3,34,5,91,36,55
32,3,34,7,97,55,42
32,3,34,13,144,33,111
32,3,34,15,56,25,31
32,3,34,17,182,45,137
32,3,34,19,25,0,25
32,3,34,21,44,40,4
32,3,34,23,186,79,107
32,3,34,25,101,86,15
32,3,34,27,85,46,39
32,3,34,29,115,61,54
32,3,34,31,56,54,2
32,3,34,35,42,0,42
32,3,34,37,57,0,57
32,3,34,39,112,0,112
32,3,35,1,564,638,-74
32,3,35,5,0,44,-44
32,3,35,9,157,39,118
32,3,35,13,146,123,23
32,3,35,15,0,32,-32
32,3,35,17,0,64,-64
32,3,35,25,37,40,-3
32,3,35,27,0,24,-24
32,3,35,28,37,33,4
32,3,35,29,0,44,-44
32,3,35,31,58,43,15
32,3,35,35,100,50,50
32,3,35,39,29,0,29
32,3,35,43,131,145,-14
32,3,35,45,126,165,-39
32,3,35,47,30,36,-6
32,3,35,49,99,113,-14
32,3,35,51,0,41,-41
32,3,35,61,56,100,-44
32,3,36,1,69,52,17
32,3,36,5,265,107,158
32,3,36,7,28,0,28
32,3,36,13,40,24,16
32,3,36,27,50,48,2
32,3,36,29,281,191,90
32,3,36,45,62,45,17
32,3,36,47,304,161,143
32,3,36,55,240,94,146
32,3,36,59,330,133,197
32,3,36,61,421,287,134
32,3,36,63,70,84,-14
32,3,36,65,50,40,10
32,3,36,67,131,49,82
32,3,36,71,112,55,57
32,3,36,81,583,274,309
32,3,36,83,33,0,33
32,3,36,85,85,47,38
32,3,36,87,90,38,52
32,3,36,91,46,0,46
32,3,36,103,360,174,186
32,3,36,105,33,0,33
32,3,36,109,24,29,-5
32,3,36,111,37,0,37
32,3,36,119,114,82,32
32,3,37,21,35,0,35
32,3,37,25,0,31,-31
32,3,37,49,43,0,43
32,3,37,51,142,92,50
32,3,37,63,33,37,-4
32,3,37,67,51,43,8
32,3,37,81,64,80,-16
32,3,37,85,40,37,3
32,3,37,97,0,63,-63
32,3,37,101,0,40,-40
32,3,37,119,228,226,2
32,3,37,129,26,35,-9
32,3,37,133,74,60,14
32,3,37,179,34,58,-24
32,3,37,183,137,262,-125
32,3,37,191,80,38,42
32,3,38,15,29,0,29
32,3,38,17,65,43,22
32,3,38,35,44,34,10
32,3,38,101,62,52,10
32,3,39,7,25,0,25
32,3,39,17,78,37,41
32,3,39,25,43,35,8
32,3,39,35,558,231,327
32,3,39,41,53,26,27
32,3,39,43,26,0,26
32,3,39,45,0,32,-32
32,3,39,49,268,247,21
32,3,39,55,32,0,32
32,3,39,57,57,74,-17
32,3,39,61,189,83,106
32,3,39,85,113,74,39
32,3,39,93,79,52,27
32,3,39,95,193,74,119
32,3,39,99,99,62,37
32,3,39,103,71,26,45
32,3,39,113,226,96,130
32,3,39,133,39,21,18
32,3,39,151,103,69,34
32,3,39,153,200,94,106
32,3,39,155,79,31,48
32,3,39,165,30,33,-3
32,3,39,173,50,0,50
32,3,40,27,68,65,3
32,3,40,31,63,81,-18
32,3,40,47,0,30,-30
32,3,40,109,282,241,41
32,3,40,143,167,232,-65
32,3,41,3,40,25,15
32,3,41,5,172,237,-65
32,3,41,7,39,26,13
32,3,41,11,29,86,-57
32,3,41,15,0,28,-28
32,3,41,17,77,126,-49
32,3,41,19,58,58,0
32,3,41,29,134,150,-16
32,3,41,33,58,85,-27
32,3,41,35,36,55,-19
32,3,41,39,229,244,-15
32,3,41,41,52,48,4
32,3,41,43,49,79,-30
32,3,41,47,136,190,-54
32,3,41,51,376,367,9
32,3,41,53,39,73,-34
32,3,41,59,0,32,-32
32,3,41,67,328,427,-99
32,3,41,71,40,58,-18
32,3,42,3,358,226,132
32,3,42,7,37,0,37
32,3,42,11,50,46,4
32,3,42,17,88,66,22
32,3,42,19,41,28,13
32,3,42,27,37,0,37
32,3,42,29,56,66,-10
32,3,42,41,31,42,-11
32,3,42,43,39,44,-5
32,3,42,45,67,39,28
32,3,42,49,69,33,36
32,3,42,69,30,26,4
32,3,42,71,59,53,6
32,3,42,77,52,26,26
32,3,42,79,67,51,16
32,3,42,89,38,0,38
32,3,42,91,139,85,54
32,3,42,95,40,22,18
32,3,42,101,190,143,47
32,3,42,125,33,30,3
32,3,42,129,59,47,12
32,3,42,133,44,46,-2
32,3,44,3,46,0,46
32,3,44,5,21,0,21
32,3,44,7,128,84,44
32,3,45,3,44,31,13
32,3,45,13,35,36,-1
32,3,45,15,28,33,-5
32,3,45,19,52,47,5
32,3,45,35,0,40,-40
32,3,45,45,38,82,-44
32,3,45,51,75,107,-32
32,3,45,63,30,0,30
32,3,45,79,74,47,27
32,3,45,83,0,42,-42
32,3,45,85,45,36,9
32,3,45,91,0,37,-37
32,3,46,83,0,31,-31
32,3,46,93,44,0,44
32,3,46,99,102,70,32
32,3,46,103,47,107,-60
32,3,47,37,151,224,-73
32,3,47,65,30,46,-16
32,3,47,93,87,111,-24
32,3,47,119,0,33,-33
32,3,47,125,66,30,36
32,3,47,149,48,84,-36
32,3,47,157,249,170,79
32,3,47,163,0,28,-28
32,3,47,179,0,33,-33
32,3,47,187,38,80,-42
32,3,47,189,0,40,-40
32,3,48,27,142,177,-35
32,3,48,29,644,739,-95
32,3,48,39,49,85,-36
32,3,48,41,38,44,-6
32,3,48,61,82,59,23
32,3,48,85,269,381,-112
32,3,48,91,36,78,-42
32,3,48,99,0,49,-49
32,3,48,113,673,667,6
32,3,48,121,169,329,-160
32,3,48,135,49,0,49
32,3,48,139,0,45,-45
32,3,48,141,614,622,-8
32,3,48,157,91,173,-82
32,3,48,167,53,74,-21
32,3,48,181,34,38,-4
32,3,48,187,30,83,-53
32,3,48,201,972,974,-2
32,3,48,209,0,82,-82
32,3,48,215,70,83,-13
32,3,48,245,44,31,13
32,3,48,257,32,43,-11
32,3,48,303,86,63,23
32,3,48,309,41,44,-3
32,3,48,329,0,58,-58
32,3,48,339,89,200,-111
32,3,48,355,79,99,-20
32,3,48,361,0,31,-31
32,3,48,375,62,60,2
32,3,48,381,75,55,20
32,3,48,423,53,37,16
32,3,48,439,466,775,-309
32,3,48,441,70,47,23
32,3,48,451,130,50,80
32,3,48,453,234,387,-153
32,3,48,465,0,39,-39
32,3,48,485,127,54,73
32,3,48,491,123,347,-224
32,3,49,1,0,47,-47
32,3,49,3,32,75,-43
32,3,49,5,133,217,-84
32,3,49,7,0,58,-58
32,3,49,11,332,415,-83
32,3,49,13,0,41,-41
32,3,49,17,0,46,-46
32,3,49,21,312,550,-238
32,3,49,25,33,66,-33
32,3,49,35,1324,1769,-445
32,3,49,39,0,74,-74
32,3,49,41,30,109,-79
32,3,49,43,48,108,-60
32,3,49,45,88,55,33
32,3,49,47,43,64,-21
32,3,49,49,758,984,-226
32,3,49,51,0,36,-36
32,3,49,53,977,1129,-152
32,3,49,57,160,332,-172
32,3,50,7,42,0,42
32,3,51,3,0,34,-34
32,3,51,13,101,89,12
32,3,51,41,60,0,60
32,3,51,59,395,307,88
32,3,51,87,44,37,7
32,3,51,107,101,106,-5
32,3,51,153,135,71,64
32,3,51,179,54,0,54
32,3,51,199,71,0,71
32,3,51,510,50,59,-9
32,3,51,550,41,37,4
32,3,51,650,61,61,0
32,3,51,700,58,74,-16
32,3,51,710,75,32,43
32,3,51,810,173,93,80
32,3,53,5,110,224,-114
32,3,53,9,28,43,-15
32,3,53,11,223,325,-102
32,3,53,15,37,43,-6
32,3,53,17,0,49,-49
32,3,53,21,38,110,-72
32,3,53,25,31,59,-28
32,3,53,27,0,35,-35
32,3,53,29,75,50,25
32,3,53,33,1059,1327,-268
32,3,53,35,159,169,-10
32,3,53,37,36,0,36
32,3,53,41,0,48,-48
32,3,53,53,528,549,-21
32,3,53,57,40,58,-18
32,3,53,61,438,427,11
32,3,53,63,298,362,-64
32,3,53,65,0,29,-29
32,3,53,67,151,167,-16
32,3,53,73,91,118,-27
32,3,53,77,92,111,-19
32,3,54,39,28,0,28
32,3,54,61,0,32,-32
32,3,55,9,61,57,4
32,3,55,25,135,101,34
32,3,55,27,24,0,24
32,3,55,35,39,0,39
32,3,55,59,64,44,20
32,3,55,63,0,35,-35
32,3,55,73,33,30,3
32,3,55,79,377,246,131
32,3,55,87,36,39,-3
32,3,55,97,35,0,35
32,3,55,101,44,62,-18
32,3,55,105,41,57,-16
32,3,55,109,30,0,30
32,3,55,133,81,88,-7
32,3,55,139,24,32,-8
32,3,56,1,26,29,-3
32,3,56,5,36,0,36
32,3,56,21,104,80,24
32,3,56,25,47,76,-29
32,3,56,29,0,28,-28
32,3,56,37,0,88,-88
32,3,56,41,0,61,-61
32,5,4,13,36,108,-72
32,5,6,1,68,36,32
32,5,6,3,72,0,72
32,5,6,13,70,25,45
32,5,6,17,600,308,292
32,5,6,19,64,0,64
32,5,6,37,245,73,172
32,5,6,51,87,0,87
32,5,6,59,52,34,18
32,5,6,61,46,52,-6
32,5,6,65,71,67,4
32,5,6,67,88,65,23
32,5,6,71,59,45,14
32,5,6,73,88,89,-1
32,5,6,75,30,29,1
32,5,6,85,160,43,117
32,5,6,97,44,24,20
32,5,6,111,0,26,-26
32,5,16,1,0,30,-30
32,5,32,3,169,192,-23
32,5,32,19,231,286,-55
32,5,32,31,462,590,-128
32,5,32,510,739,935,-196
32,5,53,33,0,24,-24
32,7,4,13,47,77,-30
32,7,4,15,34,0,34
32,7,4,19,26,54,-28
32,7,4,21,0,54,-54
32,7,6,67,44,0,44
32,7,6,71,53,0,53
32,7,6,73,0,31,-31
32,7,16,1,96,128,-32
32,7,16,5,0,27,-27
32,7,16,27,48,43,5
32,7,16,55,0,27,-27
32,7,16,83,99,169,-70
32,7,32,1,44,40,4
32,7,32,3,314,245,69
32,7,32,11,0,43,-43
32,7,32,13,91,134,-43
32,7,32,15,74,60,14
32,7,32,19,73,39,34
32,7,32,23,80,46,34
32,7,32,31,288,298,-10
32,7,32,33,50,47,3
32,7,32,510,35,46,-11
32,7,49,11,46,40,6
32,7,49,35,151,205,-54
32,7,49,45,186,172,14
32,7,49,49,54,63,-9
32,7,53,63,39,0,39
32,11,32,7,43,0,43
32,13,4,13,32,0,32
32,13,32,3,33,52,-19
32,13,32,7,134,91,43
32,13,32,15,47,60,-13
32,13,32,19,49,0,49
32,13,32,27,91,40,51
32,13,32,31,220,166,54
32,13,49,35,0,58,-58
32,15,32,3,34,0,34
32,15,32,7,60,74,-14
32,15,32,13,60,47,13
32,15,32,31,47,62,-15
32,17,32,3,193,93,100
32,17,49,53,39,0,39
32,19,4,13,79,66,13
32,19,6,1,72,0,72
32,19,6,13,77,0,77
32,19,6,17,56,60,-4
32,19,6,29,44,0,44
32,19,6,37,137,0,137
32,19,6,59,71,28,43
32,19,6,61,46,37,9
32,19,6,65,0,30,-30
32,19,6,67,121,62,59
32,19,6,71,75,63,12
32,19,6,73,121,60,61
32,19,6,77,52,27,25
32,19,6,85,60,39,21
32,19,6,97,31,31,0
32,19,6,99,49,0,49
32,19,32,1,220,281,-61
32,19,32,3,222,184,38
32,19,32,5,286,231,55
32,19,32,7,39,73,-34
32,19,32,13,0,49,-49
32,19,32,21,36,39,-3
32,19,32,23,0,57,-57
32,19,32,27,42,0,42
32,19,32,29,45,55,-10
32,19,32,31,1637,1616,21
32,19,32,510,1198,896,302
32,21,32,1,32,0,32
32,21,32,19,39,36,3
32,21,32,31,42,85,-43
32,23,4,13,70,84,-14
32,23,4,15,0,51,-51
32,23,6,27,26,35,-9
32,23,6,29,35,0,35
32,23,6,37,164,97,67
32,23,6,59,74,31,43
32,23,6,65,93,59,34
32,23,6,71,110,83,27
32,23,6,73,60,39,21
32,23,6,111,36,0,36
32,23,15,3,39,0,39
32,23,32,1,0,30,-30
32,23,32,3,2178,1462,716
32,23,32,7,46,80,-34
32,23,32,19,57,0,57
32,23,32,31,84,102,-18
32,23,32,33,0,30,-30
32,23,32,510,24,0,24
32,27,32,1,31,0,31
32,27,32,13,40,91,-51
32,27,32,19,0,42,-42
32,27,32,31,71,57,14
32,29,32,19,55,45,10
32,29,32,31,460,366,94
32,29,32,510,73,39,34
32,31,2,20,91,68,23
32,31,2,90,53,23,30
32,31,4,5,35,0,35
32,31,4,13,468,623,-155
32,31,4,15,75,45,30
32,31,4,19,137,184,-47
32,31,4,21,28,77,-49
32,31,4,25,38,35,3
32,31,4,27,27,44,-17
32,31,5,7,0,33,-33
32,31,6,1,527,398,129
32,31,6,7,139,165,-26
32,31,6,9,30,25,5
32,31,6,13,448,262,186
32,31,6,17,305,174,131
32,31,6,19,185,137,48
32,31,6,23,70,32,38
32,31,6,27,56,46,10
32,31,6,29,179,142,37
32,31,6,33,30,29,1
32,31,6,35,195,160,35
32,31,6,37,1022,678,344
32,31,6,39,0,34,-34
32,31,6,41,90,55,35
32,31,6,45,41,0,41
32,31,6,47,52,60,-8
32,31,6,51,52,27,25
32,31,6,53,156,107,49
32,31,6,55,49,0,49
32,31,6,57,561,338,223
32,31,6,59,396,307,89
32,31,6,61,608,458,150
32,31,6,63,198,149,49
32,31,6,65,360,225,135
32,31,6,67,745,754,-9
32,31,6,71,281,191,90
32,31,6,73,467,596,-129
32,31,6,75,149,171,-22
32,31,6,77,228,162,66
32,31,6,79,63,100,-37
32,31,6,81,207,145,62
32,31,6,83,68,53,15
32,31,6,85,521,348,173
32,31,6,87,78,58,20
32,31,6,89,147,115,32
32,31,6,91,77,31,46
32,31,6,93,49,25,24
32,31,6,95,178,113,65
32,31,6,97,164,151,13
32,31,6,99,181,164,17
32,31,6,101,67,0,67
32,31,6,103,27,40,-13
32,31,6,107,49,83,-34
32,31,6,111,161,92,69
32,31,6,113,103,112,-9
32,31,6,115,0,28,-28
32,31,8,1,35,39,-4
32,31,8,5,44,90,-46
32,31,8,13,35,36,-1
32,31,8,31,61,79,-18
32,31,8,35,34,48,-14
32,31,8,41,67,120,-53
32,31,8,59,44,67,-23
32,31,8,69,35,35,0
32,31,8,77,0,33,-33
32,31,9,1,28,0,28
32,31,11,1,0,26,-26
32,31,12,9,0,29,-29
32,31,12,11,51,0,51
32,31,12,31,35,28,7
32,31,12,57,44,0,44
32,31,12,86,29,30,-1
32,31,12,95,34,46,-12
32,31,12,99,36,31,5
32,31,12,103,30,27,3
32,31,12,127,0,22,-22
32,31,13,67,33,0,33
32,31,13,121,40,0,40
32,31,13,135,0,30,-30
32,31,15,1,65,61,4
32,31,15,3,188,156,32
32,31,15,9,70,50,20
32,31,16,1,158,204,-46
32,31,16,5,24,30,-6
32,31,16,19,0,43,-43
32,31,16,27,47,105,-58
32,31,16,55,0,46,-46
32,31,16,83,0,42,-42
32,31,17,31,116,91,25
32,31,17,43,29,35,-6
32,31,17,97,31,0,31
32,31,18,97,0,43,-43
32,31,24,31,0,45,-45
32,31,25,17,0,42,-42
32,31,25,25,0,25,-25
32,31,26,81,28,0,28
32,31,26,163,36,0,36
32,31,27,53,39,35,4
32,31,29,95,38,0,38
32,31,30,29,24,0,24
32,31,30,31,0,34,-34
32,31,30,63,28,35,-7
32,31,30,111,0,36,-36
32,31,31,55,0,32,-32
32,31,32,1,393,280,113
32,31,32,3,1911,1981,-70
32,31,32,5,590,462,128
32,31,32,7,298,288,10
32,31,32,13,166,220,-54
32,31,32,15,62,47,15
32,31,32,19,1616,1637,-21
32,31,32,21,85,42,43
32,31,32,23,102,84,18
32,31,32,27,57,71,-14
32,31,32,29,366,460,-94
32,31,32,510,1201,988,213
32,31,35,1,53,88,-35
32,31,36,47,0,28,-28
32,31,36,61,22,57,-35
32,31,36,81,38,0,38
32,31,37,51,29,0,29
32,31,37,119,0,28,-28
32,31,37,183,0,32,-32
32,31,39,35,37,0,37
32,31,39,49,24,45,-21
32,31,39,61,32,0,32
32,31,40,109,47,41,6
32,31,41,3,29,0,29
32,31,41,5,73,81,-8
32,31,41,11,0,44,-44
32,31,41,17,56,96,-40
32,31,41,19,36,71,-35
32,31,41,29,66,60,6
32,31,41,33,33,59,-26
32,31,41,35,81,78,3
32,31,41,39,102,125,-23
32,31,41,41,28,52,-24
32,31,41,43,24,0,24
32,31,41,47,59,61,-2
32,31,41,51,99,144,-45
32,31,41,53,0,32,-32
32,31,41,67,107,166,-59
32,31,42,3,0,42,-42
32,31,42,91,23,0,23
32,31,47,37,0,26,-26
32,31,47,157,35,42,-7
32,31,48,27,0,31,-31
32,31,48,29,62,105,-43
32,31,48,85,55,49,6
32,31,48,113,42,80,-38
32,31,48,121,49,50,-1
32,31,48,141,49,60,-11
32,31,48,157,0,35,-35
32,31,48,201,99,175,-76
32,31,48,339,0,34,-34
32,31,48,439,98,100,-2
32,31,48,453,56,92,-36
32,31,48,491,30,72,-42
32,31,49,11,0,48,-48
32,31,49,35,161,307,-146
32,31,49,49,42,140,-98
32,31,49,53,36,0,36
32,31,49,57,0,67,-67
32,31,51,13,25,0,25
32,31,51,59,35,0,35
32,31,53,9,0,25,-25
32,31,53,11,76,118,-42
32,31,53,15,27,0,27
32,31,53,33,259,361,-102
32,31,53,35,52,47,5
32,31,53,53,107,144,-37
32,31,53,57,0,31,-31
32,31,53,61,91,99,-8
32,31,53,63,60,140,-80
32,31,53,67,0,55,-55
32,31,53,73,26,0,26
32,31,53,77,31,43,-12
32,31,55,79,31,38,-7
32,33,32,3,180,115,65
32,33,32,7,47,50,-3
32,33,32,23,30,0,30
32,33,32,31,36,39,-3
32,510,4,13,72,69,3
32,510,6,1,39,43,-4
32,510,6,13,33,26,7
32,510,6,17,148,49,99
32,510,6,19,38,0,38
32,510,6,37,140,90,50
32,510,6,59,37,30,7
32,510,6,61,37,32,5
32,510,6,65,44,53,-9
32,510,6,67,48,60,-12
32,510,6,71,36,0,36
32,510,6,73,72,0,72
32,510,6,77,0,24,-24
32,510,6,85,62,32,30
32,510,6,97,31,0,31
32,510,32,1,56,46,10
32,510,32,3,249,196,53
32,510,32,5,935,739,196
32,510,32,7,46,35,11
32,510,32,19,896,1198,-302
32,510,32,23,0,24,-24
32,510,32,29,39,73,-34
32,510,32,31,988,1201,-213
32,510,41,39,0,26,-26
32,510,53,33,0,60,-60
33,1,4,13,0,33,-33
33,1,6,37,0,24,-24
33,1,9,1,27,0,27
33,1,12,71,0,41,-41
33,1,12,115,0,30,-30
33,1,23,5,22,47,-25
33,1,23,31,35,49,-14
33,1,25,9,131,77,54
33,1,25,17,198,137,61
33,1,25,21,42,47,-5
33,1,25,23,35,33,2
33,1,25,25,42,44,-2
33,1,25,27,73,31,42
33,1,33,3,236,243,-7
33,1,33,7,46,55,-9
33,1,33,9,409,438,-29
33,1,33,11,413,333,80
33,1,33,13,1507,1181,326
33,1,33,15,309,236,73
33,1,33,17,278,286,-8
33,1,33,19,31,28,3
33,1,36,61,0,25,-25
33,1,44,7,29,0,29
33,3,4,13,0,37,-37
33,3,9,3,26,0,26
33,3,23,5,83,98,-15
33,3,23,17,172,136,36
33,3,23,31,97,137,-40
33,3,25,1,29,0,29
33,3,25,5,29,25,4
33,3,25,9,178,82,96
33,3,25,17,246,105,141
33,3,25,21,68,44,24
33,3,25,23,54,22,32
33,3,25,25,43,84,-41
33,3,25,27,53,23,30
33,3,33,1,243,236,7
33,3,33,7,66,0,66
33,3,33,9,123,86,37
33,3,33,11,173,103,70
33,3,33,13,157,91,66
33,3,33,15,223,184,39
33,3,33,17,480,414,66
33,3,44,7,0,33,-33
33,3,50,7,0,28,-28
33,5,4,13,27,0,27
33,5,6,37,0,20,-20
33,5,9,1,35,0,35
33,5,9,3,63,38,25
33,5,9,5,26,0,26
33,5,9,9,72,38,34
33,5,12,101,0,27,-27
33,5,23,5,42,47,-5
33,5,23,31,41,41,0
33,5,25,5,24,0,24
33,5,25,9,37,85,-48
33,5,25,11,136,118,18
33,5,25,13,40,28,12
33,5,25,15,28,51,-23
33,5,25,17,171,162,9
33,5,25,21,40,33,7
33,5,25,23,31,0,31
33,5,25,25,32,85,-53
33,5,25,27,338,223,115
33,5,33,3,0,45,-45
33,5,33,9,69,90,-21
33,5,33,11,747,785,-38
33,5,33,13,133,131,2
33,5,33,15,122,156,-34
33,5,33,17,37,52,-15
33,5,33,19,194,229,-35
33,5,36,103,27,0,27
33,5,44,7,0,30,-30
33,5,45,51,0,31,-31
33,5,50,7,46,33,13
33,5,50,25,449,382,67
33,5,50,27,91,75,16
33,5,53,33,0,21,-21
33,7,23,5,28,47,-19
33,7,23,17,29,37,-8
33,7,25,17,0,42,-42
33,7,25,25,0,30,-30
33,7,33,1,55,0,55
33,7,33,3,83,66,17
33,7,33,9,230,342,-112
33,7,33,11,142,176,-34
33,7,33,13,73,95,-22
33,7,33,15,78,96,-18
33,7,33,17,0,66,-66
33,7,50,7,0,26,-26
33,7,50,9,88,124,-36
33,9,4,13,23,36,-13
33,9,6,37,37,44,-7
33,9,6,73,33,27,6
33,9,6,75,26,33,-7
33,9,6,85,0,32,-32
33,9,9,1,26,35,-9
33,9,9,3,46,38,8
33,9,9,9,61,0,61
33,9,11,1,0,36,-36
33,9,12,99,0,27,-27
33,9,12,115,23,30,-7
33,9,12,127,0,36,-36
33,9,17,31,34,40,-6
33,9,23,5,54,89,-35
33,9,23,11,24,0,24
33,9,23,31,28,30,-2
33,9,24,31,0,23,-23
33,9,25,1,36,54,-18
33,9,25,5,61,56,5
33,9,25,9,92,58,34
33,9,25,13,31,0,31
33,9,25,15,30,27,3
33,9,25,17,241,248,-7
33,9,25,21,92,80,12
33,9,25,23,47,30,17
33,9,25,25,103,143,-40
33,9,25,27,64,61,3
33,9,32,3,0,28,-28
33,9,33,1,438,409,29
33,9,33,3,86,123,-37
33,9,33,5,90,0,90
33,9,33,7,342,230,112
33,9,33,11,309,249,60
33,9,33,13,483,475,8
33,9,33,15,169,171,-2
33,9,33,17,0,88,-88
33,9,33,19,501,490,11
33,9,36,47,33,21,12
33,9,36,61,75,143,-68
33,9,42,101,26,0,26
33,9,44,7,58,35,23
33,9,50,5,176,118,58
33,9,50,7,100,75,25
33,9,50,9,50,0,50
33,9,50,17,282,295,-13
33,9,50,21,27,0,27
33,9,50,23,33,57,-24
33,9,50,25,37,26,11
33,9,50,27,590,530,60
33,9,53,33,36,41,-5
33,11,2,20,0,35,-35
33,11,4,13,129,264,-135
33,11,4,19,37,44,-7
33,11,6,1,0,65,-65
33,11,6,37,158,137,21
33,11,6,59,54,64,-10
33,11,6,65,0,38,-38
33,11,6,73,139,132,7
33,11,6,75,21,35,-14
33,11,6,85,38,101,-63
33,11,6,111,0,25,-25
33,11,8,13,25,26,-1
33,11,8,31,0,24,-24
33,11,8,41,39,53,-14
33,11,8,69,0,47,-47
33,11,9,1,105,86,19
33,11,9,3,118,113,5
33,11,9,5,32,0,32
33,11,9,7,42,0,42
33,11,9,9,99,80,19
33,11,9,11,39,39,0
33,11,9,13,0,37,-37
33,11,9,15,41,0,41
33,11,10,3,0,43,-43
33,11,11,1,30,56,-26
33,11,12,9,66,79,-13
33,11,12,11,90,87,3
33,11,12,15,0,37,-37
33,11,12,17,0,48,-48
33,11,12,21,0,54,-54
33,11,12,31,62,62,0
33,11,12,53,0,44,-44
33,11,12,57,80,155,-75
33,11,12,69,35,45,-10
33,11,12,71,44,99,-55
33,11,12,81,59,34,25
33,11,12,83,30,50,-20
33,11,12,86,51,62,-11
33,11,12,95,70,137,-67
33,11,12,97,0,44,-44
33,11,12,99,94,78,16
33,11,12,101,52,68,-16
33,11,12,103,81,118,-37
33,11,12,105,39,73,-34
33,11,12,109,0,38,-38
33,11,12,111,0,56,-56
33,11,12,115,32,75,-43
33,11,12,117,50,49,1
33,11,12,119,0,46,-46
33,11,12,127,59,25,34
33,11,13,67,0,40,-40
33,11,13,121,0,35,-35
33,11,13,135,0,25,-25
33,11,15,3,28,50,-22
33,11,17,31,60,78,-18
33,11,19,163,0,32,-32
33,11,21,111,30,49,-19
33,11,23,1,45,56,-11
33,11,23,3,0,25,-25
33,11,23,5,151,182,-31
33,11,23,11,45,41,4
33,11,23,17,36,26,10
33,11,23,19,87,95,-8
33,11,23,31,126,233,-107
33,11,24,3,53,0,53
33,11,24,5,0,29,-29
33,11,24,31,52,58,-6
33,11,25,1,93,89,4
33,11,25,3,32,0,32
33,11,25,5,161,103,58
33,11,25,9,1041,890,151
33,11,25,11,23,0,23
33,11,25,13,123,94,29
33,11,25,15,43,39,4
33,11,25,17,3640,2803,837
33,11,25,21,296,302,-6
33,11,25,23,140,159,-19
33,11,25,25,436,615,-179
33,11,25,27,637,365,272
33,11,27,53,36,31,5
33,11,32,3,79,90,-11
33,11,33,1,333,413,-80
33,11,33,3,0,173,-173
33,11,33,5,785,747,38
33,11,33,7,176,0,176
33,11,33,9,249,309,-60
33,11,33,13,2837,3290,-453
33,11,33,15,3826,3994,-168
33,11,33,17,516,459,57
33,11,33,19,133,194,-61
33,11,34,3,27,28,-1
33,11,34,17,26,30,-4
33,11,34,23,40,69,-29
33,11,36,1,24,28,-4
33,11,36,5,41,50,-9
33,11,36,27,32,0,32
33,11,36,29,40,53,-13
33,11,36,45,0,35,-35
33,11,36,47,68,73,-5
33,11,36,55,31,40,-9
33,11,36,59,53,23,30
33,11,36,61,68,125,-57
33,11,36,65,36,0,36
33,11,36,67,48,0,48
33,11,36,81,70,71,-1
33,11,36,103,47,44,3
33,11,36,119,31,34,-3
33,11,37,51,41,0,41
33,11,37,63,0,76,-76
33,11,37,81,0,33,-33
33,11,37,101,0,32,-32
33,11,37,119,27,60,-33
33,11,37,133,33,38,-5
33,11,37,183,63,409,-346
33,11,39,49,44,79,-35
33,11,42,3,27,38,-11
33,11,42,29,36,25,11
33,11,42,101,36,51,-15
33,11,44,3,52,27,25
33,11,44,5,0,31,-31
33,11,44,7,149,115,34
33,11,44,9,38,0,38
33,11,45,13,0,24,-24
33,11,45,19,0,46,-46
33,11,45,45,45,56,-11
33,11,45,51,0,64,-64
33,11,47,37,0,40,-40
33,11,47,93,0,38,-38
33,11,48,29,0,45,-45
33,11,48,85,52,44,8
33,11,48,113,31,67,-36
33,11,48,121,0,57,-57
33,11,48,201,47,93,-46
33,11,48,439,48,81,-33
33,11,48,453,30,46,-16
33,11,49,35,52,35,17
33,11,50,7,73,100,-27
33,11,50,21,38,35,3
33,11,50,25,47,38,9
33,11,50,27,52,30,22
33,11,51,13,41,41,0
33,11,51,59,82,80,2
33,11,51,107,0,29,-29
33,11,51,153,0,37,-37
33,11,51,510,0,26,-26
33,11,51,810,21,43,-22
33,11,53,33,46,63,-17
33,11,55,25,27,0,27
33,13,4,13,64,76,-12
33,13,4,19,0,35,-35
33,13,6,37,26,57,-31
33,13,6,73,0,37,-37
33,13,9,1,0,22,-22
33,13,9,3,27,54,-27
33,13,9,9,31,46,-15
33,13,11,1,0,37,-37
33,13,12,9,39,0,39
33,13,12,11,0,20,-20
33,13,12,71,0,48,-48
33,13,12,83,0,33,-33
33,13,12,95,0,30,-30
33,13,12,99,0,33,-33
33,13,12,103,43,39,4
33,13,12,115,0,30,-30
33,13,17,31,0,37,-37
33,13,23,5,73,48,25
33,13,23,11,0,42,-42
33,13,23,19,0,50,-50
33,13,23,31,64,86,-22
33,13,25,1,36,23,13
33,13,25,5,41,36,5
33,13,25,9,184,131,53
33,13,25,13,32,0,32
33,13,25,17,213,244,-31
33,13,25,21,76,89,-13
33,13,25,23,61,33,28
33,13,25,25,79,136,-57
33,13,25,27,66,63,3
33,13,33,1,1181,1507,-326
33,13,33,3,0,157,-157
33,13,33,5,131,133,-2
33,13,33,7,95,0,95
33,13,33,9,475,483,-8
33,13,33,11,3290,2837,453
33,13,33,15,1071,933,138
33,13,33,17,246,283,-37
33,13,33,19,331,315,16
33,13,36,47,0,25,-25
33,13,36,61,29,0,29
33,13,36,81,0,22,-22
33,13,37,183,0,42,-42
33,13,42,101,0,32,-32
33,13,44,7,36,51,-15
33,13,45,45,0,36,-36
33,13,48,201,0,28,-28
33,13,50,7,55,74,-19
33,13,50,25,30,0,30
33,13,50,27,55,29,26
33,13,53,33,0,26,-26
33,15,4,13,84,153,-69
33,15,4,19,30,37,-7
33,15,6,1,0,27,-27
33,15,6,37,80,95,-15
33,15,6,59,36,26,10
33,15,6,73,97,92,5
33,15,6,75,0,33,-33
33,15,6,85,0,34,-34
33,15,8,31,0,33,-33
33,15,9,1,87,32,55
33,15,9,3,91,90,1
33,15,9,9,65,69,-4
33,15,9,11,118,98,20
33,15,9,13,33,0,33
33,15,11,1,28,26,2
33,15,12,9,54,71,-17
33,15,12,11,75,73,2
33,15,12,15,36,42,-6
33,15,12,17,0,35,-35
33,15,12,21,27,52,-25
33,15,12,31,0,28,-28
33,15,12,57,67,51,16
33,15,12,69,0,26,-26
33,15,12,71,39,120,-81
33,15,12,81,30,37,-7
33,15,12,83,0,58,-58
33,15,12,85,0,27,-27
33,15,12,86,0,44,-44
33,15,12,95,47,49,-2
33,15,12,97,0,37,-37
33,15,12,99,57,97,-40
33,15,12,101,59,56,3
33,15,12,103,55,120,-65
33,15,12,105,0,26,-26
33,15,12,111,26,33,-7
33,15,12,115,47,65,-18
33,15,12,119,0,30,-30
33,15,12,127,45,61,-16
33,15,13,121,0,36,-36
33,15,15,3,45,44,1
33,15,17,31,51,73,-22
33,15,23,1,30,47,-17
33,15,23,3,25,0,25
33,15,23,5,242,192,50
33,15,23,11,31,51,-20
33,15,23,13,37,0,37
33,15,23,17,21,39,-18
33,15,23,19,82,77,5
33,15,23,25,29,35,-6
33,15,23,31,669,919,-250
33,15,24,3,0,25,-25
33,15,24,31,33,44,-11
33,15,25,1,84,39,45
33,15,25,3,27,0,27
33,15,25,5,93,98,-5
33,15,25,9,4127,2692,1435
33,15,25,13,51,47,4
33,15,25,15,40,32,8
33,15,25,17,1905,1435,470
33,15,25,21,216,185,31
33,15,25,23,159,108,51
33,15,25,25,422,527,-105
33,15,25,27,235,162,73
33,15,32,3,44,26,18
33,15,33,1,236,309,-73
33,15,33,3,184,223,-39
33,15,33,5,156,122,34
33,15,33,7,96,78,18
33,15,33,9,171,169,2
33,15,33,11,3994,3826,168
33,15,33,13,933,1071,-138
33,15,33,17,2328,2625,-297
33,15,34,23,0,35,-35
33,15,36,27,25,0,25
33,15,36,47,31,55,-24
33,15,36,55,38,0,38
33,15,36,61,79,90,-11
33,15,36,81,28,48,-20
33,15,36,91,35,0,35
33,15,36,103,46,33,13
33,15,36,119,37,26,11
33,15,37,119,0,49,-49
33,15,37,129,0,30,-30
33,15,37,133,24,0,24
33,15,37,183,0,109,-109
33,15,39,49,0,29,-29
33,15,41,51,22,0,22
33,15,42,101,0,30,-30
33,15,44,3,26,0,26
33,15,44,7,106,94,12
33,15,45,51,0,31,-31
33,15,48,113,0,33,-33
33,15,48,201,0,34,-34
33,15,48,453,0,30,-30
33,15,49,35,0,21,-21
33,15,50,5,0,27,-27
33,15,50,7,64,71,-7
33,15,50,23,24,0,24
33,15,50,27,37,0,37
33,15,51,13,0,32,-32
33,15,51,59,48,67,-19
33,15,51,810,0,31,-31
33,15,53,33,53,48,5
33,15,53,53,0,31,-31
33,17,4,13,42,38,4
33,17,6,37,32,27,5
33,17,6,73,32,43,-11
33,17,9,1,36,0,36
33,17,9,3,38,29,9
33,17,9,11,42,36,6
33,17,12,9,0,24,-24
33,17,12,71,0,29,-29
33,17,12,95,25,0,25
33,17,12,103,34,32,2
33,17,17,31,0,31,-31
33,17,23,1,0,26,-26
33,17,23,3,0,35,-35
33,17,23,5,116,123,-7
33,17,23,11,35,0,35
33,17,23,17,27,0,27
33,17,23,19,48,46,2
33,17,23,31,1097,1237,-140
33,17,25,1,31,29,2
33,17,25,5,38,0,38
33,17,25,9,321,283,38
33,17,25,13,24,0,24
33,17,25,17,234,218,16
33,17,25,21,84,53,31
33,17,25,23,0,32,-32
33,17,25,25,81,137,-56
33,17,25,27,69,74,-5
33,17,32,3,0,36,-36
33,17,33,1,286,278,8
33,17,33,3,414,480,-66
33,17,33,5,52,0,52
33,17,33,7,66,52,14
33,17,33,9,88,73,15
33,17,33,11,459,516,-57
33,17,33,13,283,246,37
33,17,33,15,2625,2328,297
33,17,36,47,0,29,-29
33,17,44,7,0,21,-21
33,17,50,7,24,34,-10
33,17,51,59,0,25,-25
33,19,9,3,26,0,26
33,19,9,9,37,0,37
33,19,23,5,0,27,-27
33,19,25,9,22,43,-21
33,19,25,17,59,44,15
33,19,25,25,0,22,-22
33,19,25,27,39,0,39
33,19,33,1,28,0,28
33,19,33,5,229,194,35
33,19,33,9,490,501,-11
33,19,33,11,194,133,61
33,19,33,13,315,331,-16
33,19,33,15,38,66,-28
33,19,33,17,0,40,-40
33,19,50,7,0,31,-31
33,19,50,17,33,29,4
33,19,50,21,25,0,25
33,19,50,25,56,57,-1
33,19,50,27,329,339,-10
34,1,4,13,37,77,-40
34,1,6,37,37,86,-49
34,1,6,59,0,58,-58
34,1,6,73,37,64,-27
34,1,9,1,0,22,-22
34,1,9,9,24,0,24
34,1,10,1,0,56,-56
34,1,10,3,61,97,-36
34,1,10,5,0,44,-44
34,1,11,1,0,26,-26
34,1,12,9,31,37,-6
34,1,12,11,87,162,-75
34,1,12,31,0,27,-27
34,1,12,57,43,65,-22
34,1,12,71,56,74,-18
34,1,12,85,0,27,-27
34,1,12,86,60,103,-43
34,1,12,87,0,33,-33
34,1,12,95,67,114,-47
34,1,12,97,33,33,0
34,1,12,99,86,228,-142
34,1,12,101,0,56,-56
34,1,12,103,0,52,-52
34,1,12,105,29,49,-20
34,1,12,111,0,40,-40
34,1,12,115,0,33,-33
34,1,12,127,0,54,-54
34,1,13,67,0,38,-38
34,1,13,121,37,0,37
34,1,13,135,0,41,-41
34,1,17,31,43,56,-13
34,1,17,43,26,0,26
34,1,24,3,21,0,21
34,1,24,5,53,38,15
34,1,24,31,0,46,-46
34,1,24,33,0,29,-29
34,1,24,510,31,34,-3
34,1,25,17,0,44,-44
34,1,25,25,0,37,-37
34,1,32,3,123,266,-143
34,1,34,3,109,84,25
34,1,34,5,523,330,193
34,1,34,7,1161,1078,83
34,1,34,9,1250,986,264
34,1,34,11,1029,1398,-369
34,1,34,13,131,112,19
34,1,34,15,609,668,-59
34,1,34,17,136,96,40
34,1,34,21,97,86,11
34,1,34,23,204,187,17
34,1,34,25,157,158,-1
34,1,34,27,58,43,15
34,1,34,29,737,500,237
34,1,34,31,63,59,4
34,1,34,33,94,93,1
34,1,34,35,55,31,24
34,1,34,39,79,65,14
34,1,36,5,155,89,66
34,1,36,47,192,157,35
34,1,36,59,0,33,-33
34,1,36,61,87,142,-55
34,1,36,71,27,0,27
34,1,36,81,173,189,-16
34,1,36,103,0,32,-32
34,1,36,119,35,0,35
34,1,37,81,0,45,-45
34,1,37,183,0,30,-30
34,1,42,3,22,26,-4
34,1,42,11,0,32,-32
34,1,42,17,157,114,43
34,1,42,29,63,83,-20
34,1,42,45,131,130,1
34,1,42,71,36,45,-9
34,1,42,79,0,42,-42
34,1,42,91,179,151,28
34,1,42,101,534,522,12
34,1,44,7,23,0,23
34,1,45,51,25,76,-51
34,1,48,113,0,49,-49
34,1,48,201,0,68,-68
34,1,51,59,43,34,9
34,1,53,33,0,26,-26
34,3,4,13,129,321,-192
34,3,4,19,0,49,-49
34,3,6,1,79,73,6
34,3,6,13,48,72,-24
34,3,6,37,430,584,-154
34,3,6,59,151,241,-90
34,3,6,65,0,73,-73
34,3,6,67,0,36,-36
34,3,6,71,30,34,-4
34,3,6,73,222,248,-26
34,3,6,75,74,83,-9
34,3,6,81,0,79,-79
34,3,6,85,134,157,-23
34,3,8,5,0,33,-33
34,3,8,13,0,42,-42
34,3,8,31,28,25,3
34,3,8,41,0,32,-32
34,3,9,1,261,409,-148
34,3,9,3,124,124,0
34,3,9,5,0,27,-27
34,3,9,9,176,102,74
34,3,9,11,0,40,-40
34,3,10,3,56,90,-34
34,3,10,5,0,66,-66
34,3,11,1,83,110,-27
34,3,12,1,0,35,-35
34,3,12,9,41,87,-46
34,3,12,11,278,432,-154
34,3,12,15,0,30,-30
34,3,12,21,42,128,-86
34,3,12,31,45,49,-4
34,3,12,35,0,42,-42
34,3,12,53,0,29,-29
34,3,12,57,159,194,-35
34,3,12,61,0,37,-37
34,3,12,69,0,49,-49
34,3,12,71,67,134,-67
34,3,12,81,34,93,-59
34,3,12,83,0,46,-46
34,3,12,85,0,39,-39
34,3,12,86,306,380,-74
34,3,12,95,166,238,-72
34,3,12,97,68,72,-4
34,3,12,99,271,550,-279
34,3,12,101,55,92,-37
34,3,12,103,66,119,-53
34,3,12,105,0,67,-67
34,3,12,109,0,68,-68
34,3,12,111,36,114,-78
34,3,12,115,41,103,-62
34,3,12,117,36,104,-68
34,3,12,127,43,79,-36
34,3,13,67,0,74,-74
34,3,13,89,55,110,-55
34,3,13,97,0,39,-39
34,3,13,121,105,162,-57
34,3,13,135,72,221,-149
34,3,15,3,48,57,-9
34,3,17,31,267,243,24
34,3,17,43,65,60,5
34,3,17,97,40,0,40
34,3,20,91,0,33,-33
34,3,24,3,0,46,-46
34,3,24,5,81,63,18
34,3,24,27,64,48,16
34,3,24,31,103,194,-91
34,3,24,33,36,58,-22
34,3,24,510,49,43,6
34,3,25,5,0,34,-34
34,3,25,9,36,74,-38
34,3,25,13,0,41,-41
34,3,25,17,189,306,-117
34,3,25,21,119,104,15
34,3,25,25,124,139,-15
34,3,25,27,105,46,59
34,3,26,125,68,45,23
34,3,26,161,43,0,43
34,3,26,163,60,39,21
34,3,27,53,46,72,-26
34,3,32,3,85,231,-146
34,3,33,11,28,27,1
34,3,34,1,84,109,-25
34,3,34,5,123,203,-80
34,3,34,7,123,151,-28
34,3,34,9,32,45,-13
34,3,34,13,2690,2515,175
34,3,34,15,0,63,-63
34,3,34,17,8317,5513,2804
34,3,34,19,85,126,-41
34,3,34,21,177,277,-100
34,3,34,23,1413,1653,-240
34,3,34,25,514,986,-472
34,3,34,27,1279,2227,-948
34,3,34,29,439,1361,-922
34,3,34,31,6827,7153,-326
34,3,34,35,368,544,-176
34,3,34,37,466,833,-367
34,3,34,39,876,807,69
34,3,34,41,106,228,-122
34,3,36,1,56,53,3
34,3,36,5,2211,790,1421
34,3,36,7,28,0,28
34,3,36,25,0,32,-32
34,3,36,27,79,82,-3
34,3,36,29,58,37,21
34,3,36,47,1698,924,774
34,3,36,55,72,59,13
34,3,36,59,443,298,145
34,3,36,61,4231,3032,1199
34,3,36,67,51,26,25
34,3,36,71,490,685,-195
34,3,36,79,0,32,-32
34,3,36,81,2640,1262,1378
34,3,36,83,32,0,32
34,3,36,85,302,155,147
34,3,36,87,1142,979,163
34,3,36,91,0,29,-29
34,3,36,103,264,294,-30
34,3,36,105,32,42,-10
34,3,36,109,42,0,42
34,3,36,111,48,86,-38
34,3,36,113,0,35,-35
34,3,36,119,693,520,173
34,3,37,25,0,40,-40
34,3,37,51,0,31,-31
34,3,37,71,0,39,-39
34,3,37,81,0,80,-80
34,3,37,119,101,288,-187
34,3,37,129,0,23,-23
34,3,37,133,66,31,35
34,3,37,179,0,86,-86
34,3,37,183,60,299,-239
34,3,39,35,47,38,9
34,3,39,49,61,75,-14
34,3,39,61,36,33,3
34,3,39,85,0,44,-44
34,3,41,67,0,38,-38
34,3,42,3,83,57,26
34,3,42,11,40,45,-5
34,3,42,17,112,132,-20
34,3,42,27,0,25,-25
34,3,42,29,38,111,-73
34,3,42,45,84,55,29
34,3,42,69,0,30,-30
34,3,42,71,0,53,-53
34,3,42,77,68,141,-73
34,3,42,79,43,91,-48
34,3,42,89,186,358,-172
34,3,42,91,126,164,-38
34,3,42,95,92,146,-54
34,3,42,101,173,199,-26
34,3,42,103,70,130,-60
34,3,42,127,0,71,-71
34,3,44,7,78,72,6
34,3,45,13,0,63,-63
34,3,45,19,0,32,-32
34,3,45,45,0,55,-55
34,3,45,51,22,94,-72
34,3,45,79,0,26,-26
34,3,45,91,0,65,-65
34,3,47,37,34,37,-3
34,3,48,29,0,45,-45
34,3,48,85,37,103,-66
34,3,48,113,99,139,-40
34,3,48,121,0,45,-45
34,3,48,157,0,81,-81
34,3,48,201,86,193,-107
34,3,48,439,28,85,-57
34,3,48,453,58,69,-11
34,3,49,35,30,24,6
34,3,50,7,0,32,-32
34,3,51,13,47,99,-52
34,3,51,41,0,64,-64
34,3,51,59,186,174,12
34,3,51,87,28,48,-20
34,3,51,95,0,32,-32
34,3,51,107,44,60,-16
34,3,51,153,0,50,-50
34,3,51,510,30,37,-7
34,3,51,710,32,0,32
34,3,51,760,0,31,-31
34,3,51,810,38,47,-9
34,3,53,33,63,130,-67
34,3,55,79,0,29,-29
34,5,2,20,64,60,4
34,5,4,13,81,165,-84
34,5,4,19,0,40,-40
34,5,6,1,0,32,-32
34,5,6,37,119,154,-35
34,5,6,59,0,51,-51
34,5,6,65,36,28,8
34,5,6,73,73,114,-41
34,5,6,75,0,24,-24
34,5,6,85,0,36,-36
34,5,6,95,36,0,36
34,5,8,5,0,32,-32
34,5,8,41,74,84,-10
34,5,9,1,51,38,13
34,5,9,3,24,50,-26
34,5,9,9,31,35,-4
34,5,10,1,43,139,-96
34,5,10,3,169,294,-125
34,5,10,5,0,92,-92
34,5,11,1,34,52,-18
34,5,12,9,32,55,-23
34,5,12,11,77,104,-27
34,5,12,15,0,25,-25
34,5,12,21,0,40,-40
34,5,12,31,39,59,-20
34,5,12,57,64,148,-84
34,5,12,61,0,37,-37
34,5,12,71,30,95,-65
34,5,12,81,0,32,-32
34,5,12,83,0,56,-56
34,5,12,86,31,57,-26
34,5,12,91,33,48,-15
34,5,12,95,47,88,-41
34,5,12,99,110,120,-10
34,5,12,101,33,43,-10
34,5,12,103,43,94,-51
34,5,12,105,29,53,-24
34,5,12,109,0,35,-35
34,5,12,113,0,46,-46
34,5,12,115,53,76,-23
34,5,12,117,22,37,-15
34,5,12,119,0,27,-27
34,5,12,127,0,56,-56
34,5,13,67,0,43,-43
34,5,13,89,29,32,-3
34,5,13,121,34,73,-39
34,5,13,135,0,89,-89
34,5,13,151,0,33,-33
34,5,13,153,0,36,-36
34,5,15,3,67,68,-1
34,5,17,31,40,82,-42
34,5,17,163,0,66,-66
34,5,18,97,0,48,-48
34,5,22,15,0,37,-37
34,5,24,3,78,125,-47
34,5,24,5,74,80,-6
34,5,24,25,0,26,-26
34,5,24,27,28,35,-7
34,5,24,31,62,96,-34
34,5,24,33,49,85,-36
34,5,24,510,46,46,0
34,5,25,17,65,66,-1
34,5,25,25,0,35,-35
34,5,25,27,0,35,-35
34,5,26,125,57,0,57
34,5,27,53,0,27,-27
34,5,29,189,26,0,26
34,5,32,3,36,91,-55
34,5,34,1,330,523,-193
34,5,34,3,203,123,80
34,5,34,7,5231,5800,-569
34,5,34,9,173,228,-55
34,5,34,11,147,167,-20
34,5,34,13,501,254,247
34,5,34,15,928,1322,-394
34,5,34,17,256,196,60
34,5,34,19,50,73,-23
34,5,34,21,3000,1858,1142
34,5,34,23,1151,573,578
34,5,34,25,567,385,182
34,5,34,27,156,90,66
34,5,34,29,1004,1037,-33
34,5,34,31,131,42,89
34,5,34,33,86,101,-15
34,5,34,35,332,206,126
34,5,34,39,379,191,188
34,5,36,5,122,92,30
34,5,36,29,34,43,-9
34,5,36,45,0,48,-48
34,5,36,47,351,223,128
34,5,36,55,0,34,-34
34,5,36,59,61,0,61
34,5,36,61,176,238,-62
34,5,36,71,0,51,-51
34,5,36,81,208,136,72
34,5,36,85,74,45,29
34,5,36,103,87,44,43
34,5,36,119,48,42,6
34,5,37,19,0,56,-56
34,5,37,51,79,62,17
34,5,37,63,0,31,-31
34,5,37,67,0,53,-53
34,5,37,81,0,55,-55
34,5,37,119,41,142,-101
34,5,37,129,0,26,-26
34,5,37,133,27,59,-32
34,5,37,183,37,122,-85
34,5,39,35,34,27,7
34,5,39,49,44,40,4
34,5,42,3,54,65,-11
34,5,42,11,29,58,-29
34,5,42,17,866,820,46
34,5,42,29,133,227,-94
34,5,42,41,0,51,-51
34,5,42,43,31,30,1
34,5,42,45,195,232,-37
34,5,42,49,0,22,-22
34,5,42,69,40,0,40
34,5,42,71,34,78,-44
34,5,42,75,0,34,-34
34,5,42,77,38,73,-35
34,5,42,79,0,43,-43
34,5,42,89,61,34,27
34,5,42,91,312,425,-113
34,5,42,95,56,31,25
34,5,42,101,1619,1570,49
34,5,42,133,31,33,-2
34,5,44,7,35,31,4
34,5,45,13,0,34,-34
34,5,45,15,0,47,-47
34,5,45,19,0,37,-37
34,5,45,51,0,98,-98
34,5,45,79,0,32,-32
34,5,48,27,33,56,-23
34,5,48,29,55,145,-90
34,5,48,85,0,43,-43
34,5,48,113,42,0,42
34,5,48,201,72,97,-25
34,5,48,439,35,87,-52
34,5,51,13,0,42,-42
34,5,51,41,0,51,-51
34,5,51,59,92,144,-52
34,5,51,107,0,59,-59
34,5,51,153,47,48,-1
34,5,51,179,0,49,-49
34,5,51,650,27,28,-1
34,5,51,710,33,0,33
34,5,51,810,50,80,-30
34,5,53,53,66,0,66
34,7,4,13,53,119,-66
34,7,6,1,0,45,-45
34,7,6,37,101,154,-53
34,7,6,59,32,65,-33
34,7,6,71,0,30,-30
34,7,6,73,62,69,-7
34,7,6,75,0,37,-37
34,7,6,85,0,43,-43
34,7,8,41,0,37,-37
34,7,9,1,43,62,-19
34,7,9,3,47,48,-1
34,7,9,9,45,0,45
34,7,10,1,33,130,-97
34,7,10,3,239,378,-139
34,7,10,5,26,100,-74
34,7,11,1,45,71,-26
34,7,12,9,57,71,-14
34,7,12,11,113,156,-43
34,7,12,15,0,35,-35
34,7,12,31,32,59,-27
34,7,12,57,52,145,-93
34,7,12,69,0,40,-40
34,7,12,71,39,73,-34
34,7,12,81,0,39,-39
34,7,12,83,0,69,-69
34,7,12,86,35,77,-42
34,7,12,95,121,157,-36
34,7,12,97,0,67,-67
34,7,12,99,82,178,-96
34,7,12,101,49,57,-8
34,7,12,103,52,78,-26
34,7,12,105,48,66,-18
34,7,12,111,28,30,-2
34,7,12,115,0,71,-71
34,7,12,117,32,70,-38
34,7,12,127,29,67,-38
34,7,13,67,39,49,-10
34,7,13,89,32,34,-2
34,7,13,121,0,78,-78
34,7,13,135,0,42,-42
34,7,15,3,40,0,40
34,7,17,31,74,91,-17
34,7,17,43,30,0,30
34,7,22,51,0,29,-29
34,7,24,3,0,36,-36
34,7,24,5,80,75,5
34,7,24,25,0,31,-31
34,7,24,27,0,36,-36
34,7,24,31,40,117,-77
34,7,24,33,58,42,16
34,7,24,510,31,78,-47
34,7,25,9,48,30,18
34,7,25,17,47,46,1
34,7,25,21,38,30,8
34,7,25,25,25,45,-20
34,7,25,27,31,0,31
34,7,26,125,28,0,28
34,7,26,163,30,22,8
34,7,27,53,22,24,-2
34,7,32,3,55,97,-42
34,7,34,1,1078,1161,-83
34,7,34,3,151,123,28
34,7,34,5,5800,5231,569
34,7,34,9,303,375,-72
34,7,34,11,467,474,-7
34,7,34,13,293,152,141
34,7,34,15,4791,6693,-1902
34,7,34,17,191,145,46
34,7,34,19,40,29,11
34,7,34,21,352,305,47
34,7,34,23,427,389,38
34,7,34,25,192,176,16
34,7,34,27,90,77,13
34,7,34,29,234,297,-63
34,7,34,31,107,81,26
34,7,34,33,220,323,-103
34,7,34,35,115,96,19
34,7,34,39,141,81,60
34,7,36,5,169,104,65
34,7,36,29,41,0,41
34,7,36,47,215,167,48
34,7,36,55,26,24,2
34,7,36,59,96,50,46
34,7,36,61,160,299,-139
34,7,36,81,158,185,-27
34,7,36,85,58,0,58
34,7,36,103,69,46,23
34,7,36,119,41,48,-7
34,7,37,19,0,42,-42
34,7,37,51,0,34,-34
34,7,37,63,0,27,-27
34,7,37,81,24,50,-26
34,7,37,119,60,118,-58
34,7,37,133,27,0,27
34,7,37,183,48,103,-55
34,7,39,49,29,45,-16
34,7,42,3,84,82,2
34,7,42,11,42,78,-36
34,7,42,17,435,395,40
34,7,42,29,117,194,-77
34,7,42,43,44,49,-5
34,7,42,45,412,431,-19
34,7,42,49,0,35,-35
34,7,42,71,45,106,-61
34,7,42,77,41,74,-33
34,7,42,79,27,40,-13
34,7,42,89,31,0,31
34,7,42,91,498,515,-17
34,7,42,95,45,49,-4
34,7,42,101,3328,2539,789
34,7,42,133,37,0,37
34,7,45,45,0,31,-31
34,7,45,51,0,95,-95
34,7,45,91,0,44,-44
34,7,48,29,0,34,-34
34,7,48,85,0,47,-47
34,7,48,113,0,51,-51
34,7,48,201,0,119,-119
34,7,48,439,0,59,-59
34,7,48,453,0,45,-45
34,7,51,13,0,41,-41
34,7,51,41,0,33,-33
34,7,51,59,55,79,-24
34,7,51,153,0,37,-37
34,7,51,550,0,29,-29
34,7,51,710,34,32,2
34,7,51,810,70,33,37
34,7,53,33,42,53,-11
34,7,53,53,0,43,-43
34,9,4,13,0,33,-33
34,9,6,73,33,40,-7
34,9,10,3,58,28,30
34,9,10,5,0,33,-33
34,9,12,9,0,41,-41
34,9,12,11,51,52,-1
34,9,12,21,0,69,-69
34,9,12,57,0,50,-50
34,9,12,71,0,63,-63
34,9,12,86,36,0,36
34,9,12,95,0,23,-23
34,9,12,99,29,53,-24
34,9,12,103,33,54,-21
34,9,12,111,0,25,-25
34,9,12,115,0,44,-44
34,9,13,57,30,0,30
34,9,17,31,24,0,24
34,9,24,3,0,34,-34
34,9,34,1,986,1250,-264
34,9,34,3,45,32,13
34,9,34,5,228,173,55
34,9,34,7,375,303,72
34,9,34,11,302,423,-121
34,9,34,13,40,26,14
34,9,34,15,327,226,101
34,9,34,17,27,22,5
34,9,34,21,88,34,54
34,9,34,23,48,31,17
34,9,34,25,65,45,20
34,9,34,27,40,0,40
34,9,34,29,56,59,-3
34,9,34,31,0,25,-25
34,9,34,33,37,29,8
34,9,34,39,26,0,26
34,9,36,47,38,29,9
34,9,36,61,27,35,-8
34,9,42,17,164,84,80
34,9,42,29,87,79,8
34,9,42,45,235,114,121
34,9,42,71,0,27,-27
34,9,42,77,0,22,-22
34,9,42,91,206,153,53
34,9,42,101,503,268,235
34,9,45,51,0,41,-41
34,9,51,59,25,0,25
34,11,4,13,0,22,-22
34,11,10,3,53,139,-86
34,11,12,57,32,49,-17
34,11,12,71,0,29,-29
34,11,12,95,36,31,5
34,11,12,99,31,39,-8
34,11,34,1,1398,1029,369
34,11,34,5,167,147,20
34,11,34,7,474,467,7
34,11,34,9,423,302,121
34,11,34,13,62,49,13
34,11,34,15,822,836,-14
34,11,34,17,48,28,20
34,11,34,21,48,57,-9
34,11,34,23,76,71,5
34,11,34,25,36,23,13
34,11,34,29,88,62,26
34,11,34,31,51,0,51
34,11,34,33,601,603,-2
34,11,34,39,30,0,30
34,11,36,5,49,31,18
34,11,36,47,45,0,45
34,11,36,61,0,37,-37
34,11,36,81,0,44,-44
34,11,42,11,0,33,-33
34,11,42,17,32,32,0
34,11,42,29,0,41,-41
34,11,42,45,44,67,-23
34,11,42,71,0,37,-37
34,11,42,91,0,45,-45
34,11,42,101,194,167,27
34,13,4,13,122,201,-79
34,13,6,1,39,65,-26
34,13,6,37,207,287,-80
34,13,6,59,28,104,-76
34,13,6,65,0,54,-54
34,13,6,71,0,33,-33
34,13,6,73,85,122,-37
34,13,6,75,33,69,-36
34,13,6,81,0,40,-40
34,13,6,85,40,71,-31
34,13,8,13,0,33,-33
34,13,9,1,139,108,31
34,13,9,3,78,90,-12
34,13,9,9,67,91,-24
34,13,9,11,0,46,-46
34,13,10,1,0,81,-81
34,13,10,3,107,182,-75
34,13,10,5,0,41,-41
34,13,11,1,89,140,-51
34,13,12,9,0,102,-102
34,13,12,11,217,396,-179
34,13,12,21,0,50,-50
34,13,12,31,52,130,-78
34,13,12,35,0,38,-38
34,13,12,57,93,222,-129
34,13,12,61,0,44,-44
34,13,12,69,0,31,-31
34,13,12,71,70,96,-26
34,13,12,73,39,0,39
34,13,12,83,0,24,-24
34,13,12,86,234,305,-71
34,13,12,95,207,323,-116
34,13,12,97,41,115,-74
34,13,12,99,207,415,-208
34,13,12,101,0,75,-75
34,13,12,103,54,99,-45
34,13,12,105,29,88,-59
34,13,12,111,33,84,-51
34,13,12,115,0,65,-65
34,13,12,117,47,83,-36
34,13,12,127,27,83,-56
34,13,13,63,47,121,-74
34,13,13,67,71,172,-101
34,13,13,89,105,168,-63
34,13,13,97,0,66,-66
34,13,13,121,136,215,-79
34,13,13,135,74,348,-274
34,13,13,151,0,111,-111
34,13,13,215,0,38,-38
34,13,13,217,0,32,-32
34,13,13,223,0,44,-44
34,13,15,3,30,36,-6
34,13,17,31,164,185,-21
34,13,17,43,34,0,34
34,13,17,97,29,37,-8
34,13,24,3,43,59,-16
34,13,24,5,77,103,-26
34,13,24,27,0,55,-55
34,13,24,31,122,161,-39
34,13,24,33,85,138,-53
34,13,24,510,79,64,15
34,13,25,1,0,40,-40
34,13,25,9,31,40,-9
34,13,25,13,33,0,33
34,13,25,17,160,144,16
34,13,25,21,38,64,-26
34,13,25,25,115,105,10
34,13,25,27,43,58,-15
34,13,26,125,32,0,32
34,13,26,163,48,30,18
34,13,27,53,49,45,4
34,13,29,189,27,30,-3
34,13,32,3,33,144,-111
34,13,34,1,112,131,-19
34,13,34,3,2515,2690,-175
34,13,34,5,254,501,-247
34,13,34,7,152,293,-141
34,13,34,11,49,62,-13
34,13,34,15,46,135,-89
34,13,34,17,5081,4064,1017
34,13,34,19,128,176,-48
34,13,34,21,294,454,-160
34,13,34,23,1898,3017,-1119
34,13,34,25,526,833,-307
34,13,34,27,2219,3530,-1311
34,13,34,29,476,936,-460
34,13,34,31,3254,2959,295
34,13,34,35,688,1285,-597
34,13,34,37,263,516,-253
34,13,34,39,6033,8882,-2849
34,13,34,41,149,365,-216
34,13,36,1,41,0,41
34,13,36,5,1467,819,648
34,13,36,7,31,0,31
34,13,36,27,63,46,17
34,13,36,29,43,0,43
34,13,36,45,0,29,-29
34,13,36,47,2003,1194,809
34,13,36,55,51,59,-8
34,13,36,59,184,177,7
34,13,36,61,2061,1585,476
34,13,36,67,37,52,-15
34,13,36,71,87,93,-6
34,13,36,81,1312,710,602
34,13,36,85,161,176,-15
34,13,36,87,140,118,22
34,13,36,103,132,193,-61
34,13,36,111,0,30,-30
34,13,36,119,279,252,27
34,13,37,25,0,31,-31
34,13,37,51,53,56,-3
34,13,37,63,67,112,-45
34,13,37,67,0,28,-28
34,13,37,81,44,127,-83
34,13,37,101,0,54,-54
34,13,37,119,121,306,-185
34,13,37,127,0,34,-34
34,13,37,133,26,54,-28
34,13,37,147,0,38,-38
34,13,37,179,0,40,-40
34,13,37,181,0,29,-29
34,13,37,183,86,322,-236
34,13,39,35,51,56,-5
34,13,39,49,82,80,2
34,13,39,61,44,37,7
34,13,42,3,48,49,-1
34,13,42,11,40,121,-81
34,13,42,13,0,53,-53
34,13,42,17,64,172,-108
34,13,42,25,0,39,-39
34,13,42,29,42,51,-9
34,13,42,43,0,61,-61
34,13,42,45,71,67,4
34,13,42,69,46,127,-81
34,13,42,71,0,51,-51
34,13,42,77,89,440,-351
34,13,42,79,68,151,-83
34,13,42,89,133,480,-347
34,13,42,91,81,102,-21
34,13,42,95,101,469,-368
34,13,42,101,251,414,-163
34,13,42,103,39,118,-79
34,13,42,133,0,30,-30
34,13,44,7,87,39,48
34,13,45,15,0,30,-30
34,13,45,19,0,45,-45
34,13,45,45,0,45,-45
34,13,45,51,0,53,-53
34,13,45,79,44,43,1
34,13,45,91,0,53,-53
34,13,48,27,0,27,-27
34,13,48,29,0,48,-48
34,13,48,85,0,48,-48
34,13,48,113,68,96,-28
34,13,48,157,0,62,-62
34,13,48,201,70,251,-181
34,13,48,439,0,76,-76
34,13,48,453,33,75,-42
34,13,51,13,27,47,-20
34,13,51,41,0,66,-66
34,13,51,59,73,98,-25
34,13,51,87,37,54,-17
34,13,51,107,0,35,-35
34,13,51,153,37,39,-2
34,13,51,510,34,0,34
34,13,51,550,28,0,28
34,13,51,650,43,44,-1
34,13,51,710,52,58,-6
34,13,51,760,45,121,-76
34,13,51,810,39,95,-56
34,13,53,33,35,60,-25
34,13,53,53,27,0,27
34,15,4,13,39,58,-19
34,15,6,37,24,49,-25
34,15,6,59,0,37,-37
34,15,6,65,0,31,-31
34,15,6,73,32,36,-4
34,15,10,1,46,83,-37
34,15,10,3,228,381,-153
34,15,10,5,0,67,-67
34,15,12,9,0,26,-26
34,15,12,11,29,63,-34
34,15,12,15,0,32,-32
34,15,12,31,0,27,-27
34,15,12,57,31,57,-26
34,15,12,71,0,65,-65
34,15,12,95,0,51,-51
34,15,12,97,0,29,-29
34,15,12,99,33,61,-28
34,15,12,103,52,37,15
34,15,12,105,0,38,-38
34,15,12,127,0,39,-39
34,15,24,3,0,25,-25
34,15,24,5,0,33,-33
34,15,24,15,0,24,-24
34,15,24,31,39,36,3
34,15,24,510,0,24,-24
34,15,25,17,0,27,-27
34,15,32,3,25,56,-31
34,15,34,1,668,609,59
34,15,34,3,63,0,63
34,15,34,5,1322,928,394
34,15,34,7,6693,4791,1902
34,15,34,9,226,327,-101
34,15,34,11,836,822,14
34,15,34,13,135,46,89
34,15,34,17,51,61,-10
34,15,34,21,143,103,40
34,15,34,23,197,137,60
34,15,34,25,97,85,12
34,15,34,27,67,22,45
34,15,34,29,135,99,36
34,15,34,31,38,0,38
34,15,34,33,769,1045,-276
34,15,34,35,48,38,10
34,15,34,39,94,30,64
34,15,36,47,61,56,5
34,15,36,61,33,44,-11
34,15,36,71,36,0,36
34,15,36,81,61,48,13
34,15,36,103,32,0,32
34,15,37,81,0,34,-34
34,15,37,119,0,47,-47
34,15,37,183,0,53,-53
34,15,42,3,25,30,-5
34,15,42,11,47,58,-11
34,15,42,17,205,246,-41
34,15,42,29,120,195,-75
34,15,42,45,502,264,238
34,15,42,71,31,57,-26
34,15,42,91,192,239,-47
34,15,42,101,1471,995,476
34,15,45,51,0,29,-29
34,15,48,201,0,39,-39
34,15,51,13,0,27,-27
34,15,51,59,0,39,-39
34,15,51,810,44,0,44
34,15,53,33,0,34,-34
34,17,4,13,126,200,-74
34,17,4,19,0,52,-52
34,17,6,1,127,115,12
34,17,6,13,35,0,35
34,17,6,37,507,600,-93
34,17,6,59,169,139,30
34,17,6,65,0,40,-40
34,17,6,67,27,31,-4
34,17,6,71,38,38,0
34,17,6,73,167,212,-45
34,17,6,75,82,161,-79
34,17,6,81,40,76,-36
34,17,6,85,161,194,-33
34,17,6,111,0,29,-29
34,17,8,5,26,24,2
34,17,8,31,37,53,-16
34,17,8,59,0,32,-32
34,17,9,1,336,359,-23
34,17,9,3,183,181,2
34,17,9,5,21,0,21
34,17,9,7,32,0,32
34,17,9,9,147,115,32
34,17,9,11,27,54,-27
34,17,10,1,0,32,-32
34,17,10,3,136,120,16
34,17,10,5,0,32,-32
34,17,11,1,153,103,50
34,17,12,1,21,0,21
34,17,12,9,40,60,-20
34,17,12,11,324,397,-73
34,17,12,21,36,54,-18
34,17,12,31,69,97,-28
34,17,12,35,0,43,-43
34,17,12,57,164,267,-103
34,17,12,69,0,74,-74
34,17,12,71,101,173,-72
34,17,12,73,22,0,22
34,17,12,81,0,40,-40
34,17,12,83,0,29,-29
34,17,12,86,451,768,-317
34,17,12,95,235,310,-75
34,17,12,97,100,142,-42
34,17,12,99,132,220,-88
34,17,12,101,31,67,-36
34,17,12,103,66,121,-55
34,17,12,105,0,134,-134
34,17,12,111,34,55,-21
34,17,12,115,29,41,-12
34,17,12,117,61,105,-44
34,17,12,127,39,64,-25
34,17,13,51,25,0,25
34,17,13,67,60,75,-15
34,17,13,89,84,78,6
34,17,13,121,154,163,-9
34,17,13,135,69,132,-63
34,17,15,3,39,54,-15
34,17,17,19,35,0,35
34,17,17,31,558,439,119
34,17,17,43,31,61,-30
34,17,17,97,33,28,5
34,17,18,97,43,28,15
34,17,18,105,37,0,37
34,17,19,163,0,146,-146
34,17,20,91,26,0,26
34,17,21,111,22,0,22
34,17,22,51,0,41,-41
34,17,23,5,0,32,-32
34,17,24,3,45,33,12
34,17,24,5,68,60,8
34,17,24,21,0,29,-29
34,17,24,27,56,33,23
34,17,24,31,224,152,72
34,17,24,33,63,85,-22
34,17,24,510,75,58,17
34,17,25,5,0,41,-41
34,17,25,9,67,78,-11
34,17,25,13,50,50,0
34,17,25,17,313,279,34
34,17,25,21,146,89,57
34,17,25,23,36,0,36
34,17,25,25,279,216,63
34,17,25,27,69,76,-7
34,17,26,77,22,0,22
34,17,26,99,24,0,24
34,17,26,125,88,0,88
34,17,26,161,93,28,65
34,17,26,163,80,36,44
34,17,27,53,79,77,2
34,17,29,189,67,86,-19
34,17,29,510,22,0,22
34,17,32,3,45,182,-137
34,17,33,11,30,26,4
34,17,34,1,96,136,-40
34,17,34,3,5513,8317,-2804
34,17,34,5,196,256,-60
34,17,34,7,145,191,-46
34,17,34,11,28,48,-20
34,17,34,13,4064,5081,-1017
34,17,34,15,61,51,10
34,17,34,19,153,113,40
34,17,34,21,447,602,-155
34,17,34,23,2570,4293,-1723
34,17,34,25,1109,1527,-418
34,17,34,27,1333,1558,-225
34,17,34,29,487,853,-366
34,17,34,31,1297,1886,-589
34,17,34,35,671,763,-92
34,17,34,37,230,254,-24
34,17,34,39,1902,3385,-1483
34,17,34,41,92,240,-148
34,17,35,1,0,27,-27
34,17,36,1,85,27,58
34,17,36,5,1312,945,367
34,17,36,7,55,0,55
34,17,36,27,88,71,17
34,17,36,29,97,72,25
34,17,36,47,2401,1649,752
34,17,36,55,95,59,36
34,17,36,59,555,453,102
34,17,36,61,6188,4143,2045
34,17,36,67,141,40,101
34,17,36,71,159,204,-45
34,17,36,79,29,0,29
34,17,36,81,2850,1766,1084
34,17,36,83,31,0,31
34,17,36,85,394,291,103
34,17,36,87,268,220,48
34,17,36,91,33,26,7
34,17,36,93,26,0,26
34,17,36,103,445,310,135
34,17,36,105,27,30,-3
34,17,36,109,109,0,109
34,17,36,111,39,0,39
34,17,36,119,482,501,-19
34,17,37,51,39,41,-2
34,17,37,63,53,75,-22
34,17,37,67,20,36,-16
34,17,37,81,0,75,-75
34,17,37,119,138,363,-225
34,17,37,129,33,0,33
34,17,37,133,32,47,-15
34,17,37,179,0,78,-78
34,17,37,183,78,229,-151
34,17,39,35,86,63,23
34,17,39,49,129,135,-6
34,17,39,61,51,62,-11
34,17,41,51,0,46,-46
34,17,41,67,0,34,-34
34,17,42,3,129,113,16
34,17,42,11,64,104,-40
34,17,42,17,144,117,27
34,17,42,25,0,38,-38
34,17,42,27,28,0,28
34,17,42,29,81,61,20
34,17,42,43,37,48,-11
34,17,42,45,106,51,55
34,17,42,69,38,68,-30
34,17,42,71,43,58,-15
34,17,42,77,147,320,-173
34,17,42,79,57,129,-72
34,17,42,89,113,322,-209
34,17,42,91,209,148,61
34,17,42,95,111,237,-126
34,17,42,101,414,374,40
34,17,42,103,48,96,-48
34,17,42,133,0,79,-79
34,17,44,3,29,0,29
34,17,44,7,115,86,29
34,17,45,15,0,28,-28
34,17,45,19,30,44,-14
34,17,45,45,0,36,-36
34,17,45,79,27,0,27
34,17,47,37,34,85,-51
34,17,47,157,37,45,-8
34,17,48,29,54,59,-5
34,17,48,85,67,76,-9
34,17,48,113,117,164,-47
34,17,48,121,0,32,-32
34,17,48,157,0,87,-87
34,17,48,201,133,309,-176
34,17,48,439,56,73,-17
34,17,48,453,64,79,-15
34,17,51,13,116,94,22
34,17,51,41,0,29,-29
34,17,51,59,200,172,28
34,17,51,87,32,36,-4
34,17,51,107,39,44,-5
34,17,51,153,33,29,4
34,17,51,510,42,52,-10
34,17,51,710,37,0,37
34,17,51,760,0,23,-23
34,17,51,810,41,62,-21
34,17,53,33,139,128,11
34,17,53,61,0,32,-32
34,17,55,25,35,0,35
34,17,55,79,31,0,31
34,19,6,37,42,48,-6
34,19,6,73,0,39,-39
34,19,10,5,0,29,-29
34,19,12,11,44,0,44
34,19,12,71,0,25,-25
34,19,12,99,0,35,-35
34,19,17,31,31,29,2
34,19,24,31,0,38,-38
34,19,25,17,0,50,-50
34,19,25,25,0,28,-28
34,19,32,3,0,25,-25
34,19,34,3,126,85,41
34,19,34,5,73,50,23
34,19,34,7,29,40,-11
34,19,34,13,176,128,48
34,19,34,17,113,153,-40
34,19,34,21,260,309,-49
34,19,34,23,725,319,406
34,19,34,25,116,109,7
34,19,34,27,382,221,161
34,19,34,29,99,148,-49
34,19,34,31,73,39,34
34,19,34,35,1575,834,741
34,19,34,37,49,24,25
34,19,34,39,417,176,241
34,19,34,41,552,691,-139
34,19,36,5,31,0,31
34,19,36,47,74,77,-3
34,19,36,59,39,0,39
34,19,36,61,105,137,-32
34,19,36,81,35,34,1
34,19,36,85,34,0,34
34,19,36,103,49,0,49
34,19,37,119,0,45,-45
34,19,37,183,0,95,-95
34,19,42,3,0,25,-25
34,19,42,17,279,423,-144
34,19,42,29,46,62,-16
34,19,42,77,40,60,-20
34,19,42,89,0,45,-45
34,19,42,91,38,61,-23
34,19,42,95,161,378,-217
34,19,42,101,76,78,-2
34,19,45,51,0,37,-37
34,19,53,33,0,40,-40
34,21,4,13,57,93,-36
34,21,6,1,55,68,-13
34,21,6,37,219,219,0
34,21,6,59,35,76,-41
34,21,6,67,0,25,-25
34,21,6,73,85,104,-19
34,21,6,75,36,50,-14
34,21,6,81,0,56,-56
34,21,6,85,49,87,-38
34,21,9,1,97,112,-15
34,21,9,3,39,55,-16
34,21,9,9,66,71,-5
34,21,10,1,0,52,-52
34,21,10,3,88,125,-37
34,21,11,1,75,139,-64
34,21,12,9,0,31,-31
34,21,12,11,98,103,-5
34,21,12,31,38,73,-35
34,21,12,35,0,28,-28
34,21,12,57,38,69,-31
34,21,12,71,23,34,-11
34,21,12,81,0,32,-32
34,21,12,86,56,90,-34
34,21,12,95,32,59,-27
34,21,12,97,0,45,-45
34,21,12,99,93,136,-43
34,21,12,101,0,31,-31
34,21,12,103,31,52,-21
34,21,12,105,0,37,-37
34,21,12,115,0,52,-52
34,21,13,67,41,49,-8
34,21,13,89,47,45,2
34,21,13,121,40,65,-25
34,21,13,135,34,57,-23
34,21,15,3,23,28,-5
34,21,17,31,142,154,-12
34,21,23,5,0,26,-26
34,21,24,3,0,21,-21
34,21,24,5,32,47,-15
34,21,24,27,0,50,-50
34,21,24,31,102,89,13
34,21,24,33,49,39,10
34,21,24,510,32,41,-9
34,21,25,9,0,24,-24
34,21,25,17,152,193,-41
34,21,25,21,54,52,2
34,21,25,25,94,77,17
34,21,25,27,35,30,5
34,21,26,161,49,51,-2
34,21,26,163,30,0,30
34,21,27,53,44,58,-14
34,21,32,3,40,44,-4
34,21,34,1,86,97,-11
34,21,34,3,277,177,100
34,21,34,5,1858,3000,-1142
34,21,34,7,305,352,-47
34,21,34,9,34,88,-54
34,21,34,11,57,48,9
34,21,34,13,454,294,160
34,21,34,15,103,143,-40
34,21,34,17,602,447,155
34,21,34,19,309,260,49
34,21,34,23,3731,2213,1518
34,21,34,25,743,681,62
34,21,34,27,218,196,22
34,21,34,29,487,707,-220
34,21,34,31,135,40,95
34,21,34,33,30,0,30
34,21,34,35,910,809,101
34,21,34,39,381,239,142
34,21,34,41,45,51,-6
34,21,36,5,156,72,84
34,21,36,47,443,310,133
34,21,36,55,52,0,52
34,21,36,59,130,57,73
34,21,36,61,529,808,-279
34,21,36,67,25,0,25
34,21,36,71,0,22,-22
34,21,36,81,336,174,162
34,21,36,85,55,43,12
34,21,36,87,39,0,39
34,21,36,103,90,91,-1
34,21,36,109,29,0,29
34,21,36,119,153,65,88
34,21,37,19,0,25,-25
34,21,37,25,0,42,-42
34,21,37,63,22,50,-28
34,21,37,81,0,36,-36
34,21,37,119,0,87,-87
34,21,37,179,0,44,-44
34,21,37,183,0,143,-143
34,21,39,35,30,22,8
34,21,39,49,59,34,25
34,21,39,61,33,0,33
34,21,41,51,0,26,-26
34,21,42,3,64,54,10
34,21,42,11,0,46,-46
34,21,42,17,1307,2229,-922
34,21,42,29,64,118,-54
34,21,42,45,90,56,34
34,21,42,71,31,67,-36
34,21,42,77,35,57,-22
34,21,42,89,0,50,-50
34,21,42,91,186,216,-30
34,21,42,95,49,65,-16
34,21,42,101,515,574,-59
34,21,44,7,49,50,-1
34,21,45,45,0,43,-43
34,21,45,51,0,72,-72
34,21,48,29,0,22,-22
34,21,48,85,0,40,-40
34,21,48,113,44,51,-7
34,21,48,201,62,102,-40
34,21,48,439,0,45,-45
34,21,48,453,49,48,1
34,21,51,13,33,70,-37
34,21,51,59,78,77,1
34,21,51,107,0,35,-35
34,21,51,510,32,33,-1
34,21,51,810,0,32,-32
34,21,53,33,78,101,-23
34,23,1,73,28,0,28
34,23,4,13,192,346,-154
34,23,4,19,0,57,-57
34,23,4,21,0,29,-29
34,23,5,7,0,41,-41
34,23,6,1,119,181,-62
34,23,6,13,60,61,-1
34,23,6,37,326,588,-262
34,23,6,59,122,244,-122
34,23,6,65,0,67,-67
34,23,6,67,39,39,0
34,23,6,71,43,116,-73
34,23,6,73,160,233,-73
34,23,6,75,49,48,1
34,23,6,81,43,92,-49
34,23,6,85,167,372,-205
34,23,6,111,0,38,-38
34,23,8,13,0,39,-39
34,23,8,31,32,34,-2
34,23,8,41,0,41,-41
34,23,9,1,280,206,74
34,23,9,3,179,148,31
34,23,9,9,149,109,40
34,23,9,11,52,50,2
34,23,10,1,0,102,-102
34,23,10,3,214,207,7
34,23,10,5,0,95,-95
34,23,11,1,41,115,-74
34,23,12,9,37,89,-52
34,23,12,11,170,324,-154
34,23,12,21,0,69,-69
34,23,12,31,59,130,-71
34,23,12,35,36,62,-26
34,23,12,53,0,53,-53
34,23,12,57,161,215,-54
34,23,12,69,27,65,-38
34,23,12,71,32,164,-132
34,23,12,81,33,43,-10
34,23,12,83,39,68,-29
34,23,12,86,159,233,-74
34,23,12,95,179,263,-84
34,23,12,97,72,159,-87
34,23,12,99,197,393,-196
34,23,12,101,40,106,-66
34,23,12,103,69,102,-33
34,23,12,105,48,90,-42
34,23,12,109,0,64,-64
34,23,12,111,34,58,-24
34,23,12,115,52,69,-17
34,23,12,117,35,90,-55
34,23,12,127,48,67,-19
34,23,13,63,0,33,-33
34,23,13,67,105,103,2
34,23,13,89,58,141,-83
34,23,13,117,0,61,-61
34,23,13,121,124,192,-68
34,23,13,135,59,296,-237
34,23,13,151,0,50,-50
34,23,13,217,0,35,-35
34,23,15,3,39,47,-8
34,23,17,19,39,0,39
34,23,17,31,380,316,64
34,23,17,43,148,108,40
34,23,17,77,60,0,60
34,23,17,97,75,73,2
34,23,17,113,40,0,40
34,23,17,161,53,0,53
34,23,17,197,0,31,-31
34,23,18,57,0,34,-34
34,23,18,97,53,55,-2
34,23,19,153,38,0,38
34,23,19,163,0,105,-105
34,23,20,91,80,0,80
34,23,21,67,25,0,25
34,23,21,111,0,49,-49
34,23,21,227,38,0,38
34,23,22,51,0,29,-29
34,23,23,5,42,0,42
34,23,24,3,49,51,-2
34,23,24,5,93,104,-11
34,23,24,27,89,102,-13
34,23,24,31,183,244,-61
34,23,24,33,84,109,-25
34,23,24,39,24,0,24
34,23,24,510,58,73,-15
34,23,25,9,68,58,10
34,23,25,13,42,40,2
34,23,25,17,248,250,-2
34,23,25,21,112,122,-10
34,23,25,25,90,152,-62
34,23,25,27,63,82,-19
34,23,26,65,31,0,31
34,23,26,125,110,74,36
34,23,26,161,100,32,68
34,23,26,163,82,53,29
34,23,27,53,153,83,70
34,23,29,95,33,0,33
34,23,29,189,51,67,-16
34,23,32,3,79,186,-107
34,23,33,11,69,40,29
34,23,33,15,35,0,35
34,23,34,1,187,204,-17
34,23,34,3,1653,1413,240
34,23,34,5,573,1151,-578
34,23,34,7,389,427,-38
34,23,34,9,0,48,-48
34,23,34,11,71,76,-5
34,23,34,13,3017,1898,1119
34,23,34,15,137,197,-60
34,23,34,17,4293,2570,1723
34,23,34,19,319,725,-406
34,23,34,21,2213,3731,-1518
34,23,34,25,3668,4891,-1223
34,23,34,27,1018,1038,-20
34,23,34,29,1397,2425,-1028
34,23,34,31,659,532,127
34,23,34,35,5309,6771,-1462
34,23,34,37,126,137,-11
34,23,34,39,6086,4402,1684
34,23,34,41,214,366,-152
34,23,35,1,26,40,-14
34,23,36,1,60,72,-12
34,23,36,5,792,459,333
34,23,36,7,28,31,-3
34,23,36,27,55,40,15
34,23,36,29,58,59,-1
34,23,36,47,1936,973,963
34,23,36,55,93,60,33
34,23,36,59,374,253,121
34,23,36,61,1196,1232,-36
34,23,36,67,57,30,27
34,23,36,71,81,89,-8
34,23,36,81,1826,885,941
34,23,36,85,1128,510,618
34,23,36,87,111,61,50
34,23,36,103,272,196,76
34,23,36,109,49,0,49
34,23,36,111,26,0,26
34,23,36,119,329,271,58
34,23,37,19,0,57,-57
34,23,37,25,0,60,-60
34,23,37,35,0,106,-106
34,23,37,51,0,56,-56
34,23,37,63,50,73,-23
34,23,37,67,0,48,-48
34,23,37,81,34,114,-80
34,23,37,85,0,33,-33
34,23,37,97,0,44,-44
34,23,37,101,0,42,-42
34,23,37,119,169,357,-188
34,23,37,129,0,25,-25
34,23,37,133,27,45,-18
34,23,37,135,0,38,-38
34,23,37,147,0,44,-44
34,23,37,179,0,88,-88
34,23,37,183,106,402,-296
34,23,39,17,0,36,-36
34,23,39,35,108,92,16
34,23,39,49,138,174,-36
34,23,39,61,42,40,2
34,23,39,113,27,0,27
34,23,41,67,0,39,-39
34,23,42,3,185,159,26
34,23,42,11,48,114,-66
34,23,42,17,315,549,-234
34,23,42,25,0,49,-49
34,23,42,27,0,33,-33
34,23,42,29,102,217,-115
34,23,42,41,0,53,-53
34,23,42,43,46,71,-25
34,23,42,45,103,59,44
34,23,42,49,30,0,30
34,23,42,69,55,79,-24
34,23,42,71,27,114,-87
34,23,42,75,0,33,-33
34,23,42,77,137,309,-172
34,23,42,79,39,104,-65
34,23,42,89,107,232,-125
34,23,42,91,282,339,-57
34,23,42,95,136,532,-396
34,23,42,101,354,401,-47
34,23,42,103,0,58,-58
34,23,42,107,0,32,-32
34,23,42,127,0,45,-45
34,23,42,133,33,32,1
34,23,44,7,62,41,21
34,23,45,13,0,38,-38
34,23,45,19,0,27,-27
34,23,45,45,29,80,-51
34,23,45,51,0,138,-138
34,23,45,63,0,35,-35
34,23,45,79,0,33,-33
34,23,45,83,0,65,-65
34,23,45,91,0,51,-51
34,23,47,157,44,42,2
34,23,48,29,46,65,-19
34,23,48,85,91,111,-20
34,23,48,113,162,234,-72
34,23,48,121,39,54,-15
34,23,48,157,0,93,-93
34,23,48,201,214,362,-148
34,23,48,439,69,107,-38
34,23,48,453,71,107,-36
34,23,48,491,0,31,-31
34,23,51,13,38,78,-40
34,23,51,41,0,42,-42
34,23,51,59,304,268,36
34,23,51,87,98,99,-1
34,23,51,107,61,59,2
34,23,51,153,47,60,-13
34,23,51,510,0,51,-51
34,23,51,710,39,33,6
34,23,51,760,0,26,-26
34,23,51,810,32,56,-24
34,23,53,33,104,189,-85
34,23,53,61,0,36,-36
34,23,55,25,55,46,9
34,23,55,79,34,0,34
34,23,55,133,37,0,37
34,25,1,89,0,42,-42
34,25,4,13,65,187,-122
34,25,4,19,0,47,-47
34,25,6,1,0,36,-36
34,25,6,13,0,43,-43
34,25,6,37,180,217,-37
34,25,6,59,26,106,-80
34,25,6,65,0,35,-35
34,25,6,71,0,25,-25
34,25,6,73,93,181,-88
34,25,6,75,37,31,6
34,25,6,85,35,91,-56
34,25,8,31,0,28,-28
34,25,8,41,31,28,3
34,25,9,1,127,114,13
34,25,9,3,66,47,19
34,25,9,9,47,54,-7
34,25,9,11,0,25,-25
34,25,10,1,0,56,-56
34,25,10,3,35,106,-71
34,25,10,5,0,69,-69
34,25,11,1,51,78,-27
34,25,12,9,46,79,-33
34,25,12,11,235,228,7
34,25,12,21,35,75,-40
34,25,12,31,0,101,-101
34,25,12,35,0,35,-35
34,25,12,53,0,53,-53
34,25,12,57,82,143,-61
34,25,12,61,0,54,-54
34,25,12,71,72,158,-86
34,25,12,81,0,44,-44
34,25,12,83,0,36,-36
34,25,12,85,0,60,-60
34,25,12,86,108,92,16
34,25,12,95,80,157,-77
34,25,12,97,0,58,-58
34,25,12,99,240,430,-190
34,25,12,101,0,93,-93
34,25,12,103,41,95,-54
34,25,12,105,29,69,-40
34,25,12,109,0,70,-70
34,25,12,111,38,79,-41
34,25,12,115,36,75,-39
34,25,12,117,0,82,-82
34,25,12,119,0,29,-29
34,25,12,127,0,93,-93
34,25,13,67,0,46,-46
34,25,13,89,0,47,-47
34,25,13,117,0,47,-47
34,25,13,121,46,102,-56
34,25,13,135,37,64,-27
34,25,15,3,51,47,4
34,25,17,31,77,80,-3
34,25,21,111,0,24,-24
34,25,24,3,52,75,-23
34,25,24,5,41,63,-22
34,25,24,25,0,62,-62
34,25,24,27,0,52,-52
34,25,24,31,61,99,-38
34,25,24,33,32,47,-15
34,25,24,510,43,64,-21
34,25,25,9,34,38,-4
34,25,25,17,71,114,-43
34,25,25,21,0,45,-45
34,25,25,25,52,88,-36
34,25,25,27,37,29,8
34,25,32,3,86,101,-15
34,25,34,1,158,157,1
34,25,34,3,986,514,472
34,25,34,5,385,567,-182
34,25,34,7,176,192,-16
34,25,34,9,45,65,-20
34,25,34,13,833,526,307
34,25,34,15,85,97,-12
34,25,34,17,1527,1109,418
34,25,34,19,109,116,-7
34,25,34,21,681,743,-62
34,25,34,23,4891,3668,1223
34,25,34,27,575,383,192
34,25,34,29,4556,6631,-2075
34,25,34,31,344,153,191
34,25,34,35,624,442,182
34,25,34,37,84,54,30
34,25,34,39,1053,721,332
34,25,34,41,78,93,-15
34,25,35,1,0,25,-25
34,25,36,5,233,93,140
34,25,36,27,34,0,34
34,25,36,47,1310,628,682
34,25,36,59,241,94,147
34,25,36,61,835,1057,-222
34,25,36,67,0,33,-33
34,25,36,71,97,155,-58
34,25,36,81,512,321,191
34,25,36,85,1381,388,993
34,25,36,87,81,38,43
34,25,36,103,171,117,54
34,25,36,119,149,114,35
34,25,37,19,0,51,-51
34,25,37,21,0,33,-33
34,25,37,25,0,68,-68
34,25,37,51,0,63,-63
34,25,37,63,0,47,-47
34,25,37,67,0,33,-33
34,25,37,81,0,63,-63
34,25,37,97,0,46,-46
34,25,37,119,77,181,-104
34,25,37,129,0,41,-41
34,25,37,133,62,43,19
34,25,37,179,0,62,-62
34,25,37,183,39,213,-174
34,25,39,35,28,0,28
34,25,39,49,0,37,-37
34,25,42,3,29,58,-29
34,25,42,11,0,47,-47
34,25,42,17,149,178,-29
34,25,42,25,0,31,-31
34,25,42,29,46,80,-34
34,25,42,41,29,25,4
34,25,42,43,0,29,-29
34,25,42,45,65,46,19
34,25,42,71,0,51,-51
34,25,42,77,49,42,7
34,25,42,79,37,66,-29
34,25,42,89,63,63,0
34,25,42,91,99,143,-44
34,25,42,95,58,116,-58
34,25,42,101,160,282,-122
34,25,42,103,0,45,-45
34,25,42,133,32,0,32
34,25,44,7,37,0,37
34,25,45,13,0,64,-64
34,25,45,15,0,35,-35
34,25,45,19,0,80,-80
34,25,45,35,0,55,-55
34,25,45,43,0,33,-33
34,25,45,51,0,141,-141
34,25,45,79,0,42,-42
34,25,45,91,0,54,-54
34,25,47,37,0,26,-26
34,25,48,27,0,34,-34
34,25,48,29,0,37,-37
34,25,48,85,0,61,-61
34,25,48,113,67,55,12
34,25,48,201,38,93,-55
34,25,48,439,0,38,-38
34,25,48,453,0,47,-47
34,25,51,3,0,28,-28
34,25,51,13,35,58,-23
34,25,51,59,46,138,-92
34,25,51,107,0,30,-30
34,25,51,153,37,70,-33
34,25,51,510,34,31,3
34,25,51,710,33,23,10
34,25,51,810,48,46,2
34,25,53,33,0,29,-29
34,27,4,13,153,241,-88
34,27,4,19,0,52,-52
34,27,5,7,0,41,-41
34,27,6,1,0,87,-87
34,27,6,13,53,30,23
34,27,6,37,212,252,-40
34,27,6,59,99,146,-47
34,27,6,65,0,42,-42
34,27,6,73,101,165,-64
34,27,6,75,45,46,-1
34,27,6,81,0,49,-49
34,27,6,85,61,126,-65
34,27,8,13,0,49,-49
34,27,8,31,0,39,-39
34,27,9,1,158,133,25
34,27,9,3,130,117,13
34,27,9,9,136,87,49
34,27,10,3,68,93,-25
34,27,10,5,0,53,-53
34,27,11,1,57,117,-60
34,27,12,9,0,50,-50
34,27,12,11,136,175,-39
34,27,12,15,0,28,-28
34,27,12,21,0,85,-85
34,27,12,31,33,76,-43
34,27,12,35,0,31,-31
34,27,12,53,0,31,-31
34,27,12,57,87,127,-40
34,27,12,71,43,95,-52
34,27,12,81,0,51,-51
34,27,12,85,0,29,-29
34,27,12,86,91,125,-34
34,27,12,95,57,128,-71
34,27,12,97,25,47,-22
34,27,12,99,127,209,-82
34,27,12,101,29,66,-37
34,27,12,103,28,80,-52
34,27,12,105,0,41,-41
34,27,12,109,0,37,-37
34,27,12,111,0,40,-40
34,27,12,115,37,77,-40
34,27,12,117,0,53,-53
34,27,12,119,0,41,-41
34,27,12,127,0,58,-58
34,27,13,67,0,32,-32
34,27,13,89,32,0,32
34,27,13,121,73,69,4
34,27,13,135,36,95,-59
34,27,15,3,0,29,-29
34,27,17,31,141,168,-27
34,27,17,43,44,0,44
34,27,17,97,0,65,-65
34,27,19,163,0,46,-46
34,27,20,91,45,0,45
34,27,24,3,35,50,-15
34,27,24,5,38,66,-28
34,27,24,31,76,95,-19
34,27,24,33,0,28,-28
34,27,24,510,42,45,-3
34,27,25,9,0,27,-27
34,27,25,13,0,35,-35
34,27,25,17,149,201,-52
34,27,25,21,49,78,-29
34,27,25,23,0,38,-38
34,27,25,25,69,140,-71
34,27,25,27,0,46,-46
34,27,26,125,87,0,87
34,27,26,161,46,0,46
34,27,26,163,41,34,7
34,27,27,53,95,75,20
34,27,29,189,34,0,34
34,27,32,3,46,85,-39
34,27,34,1,43,58,-15
34,27,34,3,2227,1279,948
34,27,34,5,90,156,-66
34,27,34,7,77,90,-13
34,27,34,13,3530,2219,1311
34,27,34,15,22,67,-45
34,27,34,17,1558,1333,225
34,27,34,19,221,382,-161
34,27,34,21,196,218,-22
34,27,34,23,1038,1018,20
34,27,34,25,383,575,-192
34,27,34,29,327,601,-274
34,27,34,31,3171,1993,1178
34,27,34,35,1329,1559,-230
34,27,34,37,1954,2372,-418
34,27,34,39,1546,1139,407
34,27,34,41,762,1313,-551
34,27,36,1,30,38,-8
34,27,36,5,113,119,-6
34,27,36,29,54,37,17
34,27,36,47,322,268,54
34,27,36,55,45,40,5
34,27,36,59,111,116,-5
34,27,36,61,774,1001,-227
34,27,36,67,28,32,-4
34,27,36,71,91,92,-1
34,27,36,81,288,310,-22
34,27,36,85,122,60,62
34,27,36,87,151,99,52
34,27,36,91,0,35,-35
34,27,36,103,177,123,54
34,27,36,109,24,24,0
34,27,36,111,33,0,33
34,27,36,119,225,123,102
34,27,37,19,0,44,-44
34,27,37,21,0,25,-25
34,27,37,49,0,32,-32
34,27,37,63,0,54,-54
34,27,37,81,0,82,-82
34,27,37,97,0,42,-42
34,27,37,119,76,196,-120
34,27,37,133,29,0,29
34,27,37,179,0,100,-100
34,27,37,183,51,237,-186
34,27,39,35,57,40,17
34,27,39,49,31,74,-43
34,27,41,51,0,32,-32
34,27,42,3,89,82,7
34,27,42,11,0,46,-46
34,27,42,17,78,195,-117
34,27,42,25,0,28,-28
34,27,42,27,23,27,-4
34,27,42,29,52,134,-82
34,27,42,41,37,0,37
34,27,42,45,51,45,6
34,27,42,69,50,59,-9
34,27,42,71,0,38,-38
34,27,42,77,67,132,-65
34,27,42,79,35,38,-3
34,27,42,89,217,288,-71
34,27,42,91,126,134,-8
34,27,42,95,133,250,-117
34,27,42,101,95,152,-57
34,27,42,103,110,112,-2
34,27,42,127,0,38,-38
34,27,42,133,25,0,25
34,27,44,7,50,28,22
34,27,45,13,0,50,-50
34,27,45,19,0,75,-75
34,27,45,45,0,102,-102
34,27,45,51,0,66,-66
34,27,45,91,0,36,-36
34,27,47,37,0,45,-45
34,27,48,29,28,32,-4
34,27,48,85,59,72,-13
34,27,48,113,58,42,16
34,27,48,121,0,36,-36
34,27,48,157,0,44,-44
34,27,48,201,92,121,-29
34,27,48,439,54,55,-1
34,27,48,453,37,91,-54
34,27,48,491,0,34,-34
34,27,51,13,58,81,-23
34,27,51,59,82,127,-45
34,27,51,95,0,39,-39
34,27,51,107,52,49,3
34,27,51,153,0,42,-42
34,27,51,510,0,33,-33
34,27,51,810,37,0,37
34,27,53,33,49,94,-45
34,29,4,13,60,180,-120
34,29,6,37,108,145,-37
34,29,6,59,31,58,-27
34,29,6,65,0,30,-30
34,29,6,71,0,29,-29
34,29,6,73,122,112,10
34,29,6,111,0,36,-36
34,29,8,41,0,42,-42
34,29,9,1,59,34,25
34,29,9,3,43,43,0
34,29,9,9,56,34,22
34,29,10,1,0,43,-43
34,29,10,3,39,65,-26
34,29,10,5,0,58,-58
34,29,11,1,24,47,-23
34,29,12,9,57,109,-52
34,29,12,11,138,190,-52
34,29,12,15,43,98,-55
34,29,12,17,0,35,-35
34,29,12,21,39,102,-63
34,29,12,31,39,67,-28
34,29,12,35,29,78,-49
34,29,12,53,30,60,-30
34,29,12,57,60,145,-85
34,29,12,61,31,68,-37
34,29,12,69,0,83,-83
34,29,12,71,97,193,-96
34,29,12,81,26,70,-44
34,29,12,83,38,70,-32
34,29,12,85,47,65,-18
34,29,12,86,34,102,-68
34,29,12,87,0,47,-47
34,29,12,95,57,123,-66
34,29,12,97,0,36,-36
34,29,12,99,165,293,-128
34,29,12,101,47,109,-62
34,29,12,103,82,117,-35
34,29,12,105,38,72,-34
34,29,12,109,0,46,-46
34,29,12,111,72,124,-52
34,29,12,115,40,115,-75
34,29,12,117,41,60,-19
34,29,12,119,0,41,-41
34,29,12,127,51,130,-79
34,29,13,135,0,47,-47
34,29,15,3,32,36,-4
34,29,17,31,51,39,12
34,29,24,3,34,0,34
34,29,24,5,0,25,-25
34,29,24,25,0,28,-28
34,29,24,31,46,50,-4
34,29,24,510,48,38,10
34,29,25,17,30,49,-19
34,29,25,21,0,35,-35
34,29,25,25,0,44,-44
34,29,32,3,61,115,-54
34,29,34,1,500,737,-237
34,29,34,3,1361,439,922
34,29,34,5,1037,1004,33
34,29,34,7,297,234,63
34,29,34,9,59,56,3
34,29,34,11,0,88,-88
34,29,34,13,936,476,460
34,29,34,15,99,135,-36
34,29,34,17,853,487,366
34,29,34,19,148,99,49
34,29,34,21,707,487,220
34,29,34,23,2425,1397,1028
34,29,34,25,6631,4556,2075
34,29,34,27,601,327,274
34,29,34,31,621,255,366
34,29,34,35,521,240,281
34,29,34,37,163,76,87
34,29,34,39,1175,411,764
34,29,34,41,82,88,-6
34,29,36,5,117,80,37
34,29,36,47,817,275,542
34,29,36,55,0,31,-31
34,29,36,59,119,74,45
34,29,36,61,216,274,-58
34,29,36,71,54,63,-9
34,29,36,81,267,239,28
34,29,36,85,750,248,502
34,29,36,87,181,97,84
34,29,36,103,87,79,8
34,29,36,119,114,80,34
34,29,37,19,0,35,-35
34,29,37,21,0,42,-42
34,29,37,35,0,29,-29
34,29,37,49,0,23,-23
34,29,37,51,0,32,-32
34,29,37,57,0,41,-41
34,29,37,67,0,39,-39
34,29,37,97,0,53,-53
34,29,37,101,0,61,-61
34,29,37,119,32,137,-105
34,29,37,127,0,31,-31
34,29,37,133,42,31,11
34,29,37,179,0,76,-76
34,29,37,183,0,154,-154
34,29,39,35,37,0,37
34,29,42,3,0,32,-32
34,29,42,11,35,65,-30
34,29,42,17,185,258,-73
34,29,42,29,67,106,-39
34,29,42,45,55,65,-10
34,29,42,69,0,35,-35
34,29,42,71,33,76,-43
34,29,42,77,69,49,20
34,29,42,79,30,61,-31
34,29,42,81,0,26,-26
34,29,42,89,116,107,9
34,29,42,91,136,152,-16
34,29,42,95,66,91,-25
34,29,42,101,199,289,-90
34,29,42,103,53,48,5
34,29,42,127,27,48,-21
34,29,42,133,0,42,-42
34,29,44,7,31,0,31
34,29,45,13,0,102,-102
34,29,45,15,0,35,-35
34,29,45,19,0,38,-38
34,29,45,43,0,39,-39
34,29,45,45,0,44,-44
34,29,45,51,40,193,-153
34,29,45,83,0,28,-28
34,29,45,91,0,57,-57
34,29,48,27,0,37,-37
34,29,48,85,0,47,-47
34,29,48,113,0,40,-40
34,29,48,201,30,87,-57
34,29,48,439,0,46,-46
34,29,48,453,0,29,-29
34,29,49,35,0,31,-31
34,29,51,13,0,32,-32
34,29,51,41,0,46,-46
34,29,51,59,28,58,-30
34,29,51,710,31,0,31
34,29,51,810,47,51,-4
34,31,4,13,49,144,-95
34,31,4,19,0,40,-40
34,31,6,1,0,25,-25
34,31,6,37,95,109,-14
34,31,6,59,33,91,-58
34,31,6,65,0,42,-42
34,31,6,73,55,50,5
34,31,6,85,0,41,-41
34,31,9,1,65,72,-7
34,31,9,3,63,49,14
34,31,9,9,76,89,-13
34,31,10,3,0,34,-34
34,31,10,5,0,38,-38
34,31,11,1,0,27,-27
34,31,12,9,27,67,-40
34,31,12,11,116,251,-135
34,31,12,21,0,46,-46
34,31,12,31,0,49,-49
34,31,12,57,194,208,-14
34,31,12,69,0,49,-49
34,31,12,71,98,124,-26
34,31,12,81,0,44,-44
34,31,12,83,0,41,-41
34,31,12,86,159,237,-78
34,31,12,95,163,233,-70
34,31,12,97,85,126,-41
34,31,12,99,92,259,-167
34,31,12,101,0,80,-80
34,31,12,103,0,63,-63
34,31,12,105,42,83,-41
34,31,12,111,0,61,-61
34,31,12,115,40,49,-9
34,31,12,117,33,61,-28
34,31,12,127,35,66,-31
34,31,13,63,0,73,-73
34,31,13,67,0,61,-61
34,31,13,89,30,55,-25
34,31,13,121,0,82,-82
34,31,13,135,0,182,-182
34,31,17,31,86,56,30
34,31,17,43,0,35,-35
34,31,24,3,0,27,-27
34,31,24,5,46,32,14
34,31,24,31,39,47,-8
34,31,24,33,0,50,-50
34,31,25,9,47,54,-7
34,31,25,13,0,44,-44
34,31,25,17,36,54,-18
34,31,25,21,0,30,-30
34,31,25,25,64,60,4
34,31,25,27,0,43,-43
34,31,26,163,44,0,44
34,31,32,3,54,56,-2
34,31,34,1,59,63,-4
34,31,34,3,7153,6827,326
34,31,34,5,42,131,-89
34,31,34,7,81,107,-26
34,31,34,9,25,0,25
34,31,34,11,0,51,-51
34,31,34,13,2959,3254,-295
34,31,34,15,0,38,-38
34,31,34,17,1886,1297,589
34,31,34,19,39,73,-34
34,31,34,21,40,135,-95
34,31,34,23,532,659,-127
34,31,34,25,153,344,-191
34,31,34,27,1993,3171,-1178
34,31,34,29,255,621,-366
34,31,34,35,176,274,-98
34,31,34,37,495,983,-488
34,31,34,39,438,557,-119
34,31,34,41,101,160,-59
34,31,36,1,0,27,-27
34,31,36,5,761,604,157
34,31,36,27,26,33,-7
34,31,36,47,512,366,146
34,31,36,55,28,33,-5
34,31,36,59,89,98,-9
34,31,36,61,852,768,84
34,31,36,67,33,0,33
34,31,36,71,169,263,-94
34,31,36,81,560,328,232
34,31,36,85,70,59,11
34,31,36,87,257,161,96
34,31,36,91,0,25,-25
34,31,36,103,101,106,-5
34,31,36,111,36,35,1
34,31,36,119,158,152,6
34,31,37,25,0,79,-79
34,31,37,63,0,38,-38
34,31,37,71,0,46,-46
34,31,37,81,32,52,-20
34,31,37,101,0,50,-50
34,31,37,119,45,212,-167
34,31,37,129,0,29,-29
34,31,37,133,47,42,5
34,31,37,147,0,37,-37
34,31,37,179,0,61,-61
34,31,37,183,0,178,-178
34,31,39,35,0,37,-37
34,31,42,3,0,29,-29
34,31,42,11,42,79,-37
34,31,42,17,40,56,-16
34,31,42,69,0,42,-42
34,31,42,71,0,74,-74
34,31,42,75,0,27,-27
34,31,42,77,96,239,-143
34,31,42,79,80,413,-333
34,31,42,89,106,352,-246
34,31,42,91,46,56,-10
34,31,42,95,56,141,-85
34,31,42,101,111,172,-61
34,31,42,103,43,117,-74
34,31,42,127,0,31,-31
34,31,42,133,0,32,-32
34,31,44,7,73,59,14
34,31,45,45,0,76,-76
34,31,45,51,0,57,-57
34,31,45,79,0,37,-37
34,31,45,83,0,39,-39
34,31,47,37,0,42,-42
34,31,48,113,0,35,-35
34,31,48,201,57,80,-23
34,31,48,439,0,67,-67
34,31,48,453,0,31,-31
34,31,49,49,0,40,-40
34,31,51,59,26,38,-12
34,31,51,153,0,35,-35
34,31,51,710,32,0,32
34,31,51,810,38,0,38
34,31,53,33,0,28,-28
34,33,10,1,0,28,-28
34,33,10,3,317,443,-126
34,33,10,5,0,38,-38
34,33,12,95,0,28,-28
34,33,34,1,93,94,-1
34,33,34,5,101,86,15
34,33,34,7,323,220,103
34,33,34,9,29,37,-8
34,33,34,11,603,601,2
34,33,34,15,1045,769,276
34,33,34,21,0,30,-30
34,33,34,23,29,0,29
34,33,34,29,28,0,28
34,33,42,29,30,47,-17
34,33,42,45,83,62,21
34,33,42,101,133,87,46
34,35,4,13,73,116,-43
34,35,6,1,49,44,5
34,35,6,37,95,166,-71
34,35,6,59,41,77,-36
34,35,6,65,0,30,-30
34,35,6,73,60,88,-28
34,35,6,75,26,43,-17
34,35,6,85,63,73,-10
34,35,9,1,101,84,17
34,35,9,3,34,64,-30
34,35,9,9,83,45,38
34,35,10,1,0,31,-31
34,35,10,3,32,83,-51
34,35,10,5,0,44,-44
34,35,11,1,27,40,-13
34,35,12,11,83,105,-22
34,35,12,21,0,45,-45
34,35,12,31,35,48,-13
34,35,12,57,57,116,-59
34,35,12,71,0,71,-71
34,35,12,86,68,70,-2
34,35,12,95,35,55,-20
34,35,12,99,53,132,-79
34,35,12,103,0,62,-62
34,35,12,105,0,27,-27
34,35,12,111,0,26,-26
34,35,12,115,0,37,-37
34,35,12,127,0,31,-31
34,35,13,67,0,39,-39
34,35,13,89,0,30,-30
34,35,13,121,71,54,17
34,35,13,135,0,50,-50
34,35,17,31,75,101,-26
34,35,17,43,43,0,43
34,35,24,3,26,32,-6
34,35,24,5,46,41,5
34,35,24,31,73,116,-43
34,35,24,33,24,27,-3
34,35,24,510,0,27,-27
34,35,25,17,94,114,-20
34,35,25,21,40,42,-2
34,35,25,25,39,60,-21
34,35,25,27,33,0,33
34,35,26,125,24,0,24
34,35,26,161,55,0,55
34,35,27,53,45,32,13
34,35,32,3,0,42,-42
34,35,34,1,31,55,-24
34,35,34,3,544,368,176
34,35,34,5,206,332,-126
34,35,34,7,96,115,-19
34,35,34,13,1285,688,597
34,35,34,15,38,0,38
34,35,34,17,763,671,92
34,35,34,19,834,1575,-741
34,35,34,21,809,910,-101
34,35,34,23,6771,5309,1462
34,35,34,25,442,624,-182
34,35,34,27,1559,1329,230
34,35,34,29,240,521,-281
34,35,34,31,274,176,98
34,35,34,37,87,102,-15
34,35,34,39,3242,2091,1151
34,35,34,41,252,462,-210
34,35,36,1,26,0,26
34,35,36,5,122,59,63
34,35,36,29,23,0,23
34,35,36,47,331,185,146
34,35,36,55,40,0,40
34,35,36,59,128,57,71
34,35,36,61,322,503,-181
34,35,36,67,29,0,29
34,35,36,71,44,28,16
34,35,36,81,251,222,29
34,35,36,85,188,55,133
34,35,36,87,47,51,-4
34,35,36,103,97,76,21
34,35,36,119,102,67,35
34,35,37,19,0,34,-34
34,35,37,25,0,33,-33
34,35,37,51,0,31,-31
34,35,37,81,0,75,-75
34,35,37,119,41,146,-105
34,35,37,179,0,40,-40
34,35,37,183,0,161,-161
34,35,39,35,29,0,29
34,35,39,49,36,51,-15
34,35,39,61,26,0,26
34,35,42,3,36,47,-11
34,35,42,17,141,332,-191
34,35,42,29,50,81,-31
34,35,42,45,70,39,31
34,35,42,71,0,46,-46
34,35,42,77,57,174,-117
34,35,42,79,31,41,-10
34,35,42,89,54,121,-67
34,35,42,91,140,174,-34
34,35,42,95,150,470,-320
34,35,42,101,130,160,-30
34,35,42,103,0,40,-40
34,35,44,7,38,0,38
34,35,45,13,0,35,-35
34,35,45,19,0,27,-27
34,35,45,45,0,39,-39
34,35,45,51,0,34,-34
34,35,45,91,0,47,-47
34,35,48,29,0,56,-56
34,35,48,85,0,54,-54
34,35,48,113,0,83,-83
34,35,48,121,0,42,-42
34,35,48,201,47,100,-53
34,35,48,453,47,42,5
34,35,51,13,24,42,-18
34,35,51,59,53,88,-35
34,35,51,87,0,34,-34
34,35,51,107,0,37,-37
34,35,51,153,0,30,-30
34,35,53,33,29,54,-25
34,37,4,13,0,46,-46
34,37,6,37,0,32,-32
34,37,6,73,0,48,-48
34,37,9,1,28,0,28
34,37,9,9,0,35,-35
34,37,12,9,0,36,-36
34,37,12,11,28,0,28
34,37,12,71,0,43,-43
34,37,12,99,28,60,-32
34,37,12,103,0,25,-25
34,37,25,17,0,42,-42
34,37,25,25,0,23,-23
34,37,32,3,0,57,-57
34,37,34,3,833,466,367
34,37,34,13,516,263,253
34,37,34,17,254,230,24
34,37,34,19,24,49,-25
34,37,34,21,0,25,-25
34,37,34,23,137,126,11
34,37,34,25,54,84,-30
34,37,34,27,2372,1954,418
34,37,34,29,76,163,-87
34,37,34,31,983,495,488
34,37,34,35,102,87,15
34,37,34,39,157,104,53
34,37,34,41,361,392,-31
34,37,36,5,37,0,37
34,37,36,47,76,71,5
34,37,36,59,34,0,34
34,37,36,61,89,86,3
34,37,36,71,152,180,-28
34,37,36,81,91,65,26
34,37,36,87,36,0,36
34,37,36,103,31,26,5
34,37,36,119,67,0,67
34,37,37,119,0,50,-50
34,37,37,183,0,62,-62
34,37,42,69,0,34,-34
34,37,42,77,0,36,-36
34,37,42,79,0,23,-23
34,37,42,89,93,159,-66
34,37,42,95,34,98,-64
34,37,42,101,27,61,-34
34,37,42,103,182,405,-223
34,37,42,127,0,47,-47
34,37,45,51,0,29,-29
34,37,48,201,0,37,-37
34,37,51,59,0,31,-31
34,39,4,13,65,108,-43
34,39,6,37,119,187,-68
34,39,6,59,62,61,1
34,39,6,71,0,34,-34
34,39,6,73,69,89,-20
34,39,6,75,0,47,-47
34,39,6,85,0,35,-35
34,39,8,31,0,33,-33
34,39,9,1,70,137,-67
34,39,9,3,59,92,-33
34,39,9,9,41,55,-14
34,39,10,1,0,52,-52
34,39,10,3,33,96,-63
34,39,10,5,0,54,-54
34,39,11,1,26,51,-25
34,39,12,9,0,43,-43
34,39,12,11,184,260,-76
34,39,12,21,0,40,-40
34,39,12,31,29,61,-32
34,39,12,35,0,86,-86
34,39,12,57,92,135,-43
34,39,12,69,0,45,-45
34,39,12,71,69,120,-51
34,39,12,81,0,32,-32
34,39,12,86,226,352,-126
34,39,12,95,132,210,-78
34,39,12,97,69,131,-62
34,39,12,99,146,242,-96
34,39,12,101,0,51,-51
34,39,12,103,28,68,-40
34,39,12,105,0,67,-67
34,39,12,111,0,79,-79
34,39,12,115,27,52,-25
34,39,12,117,0,49,-49
34,39,12,127,0,39,-39
34,39,13,63,0,42,-42
34,39,13,67,35,81,-46
34,39,13,89,25,67,-42
34,39,13,97,0,48,-48
34,39,13,121,47,126,-79
34,39,13,135,53,195,-142
34,39,13,151,0,59,-59
34,39,13,223,0,40,-40
34,39,13,313,45,0,45
34,39,15,3,23,27,-4
34,39,17,31,116,98,18
34,39,24,3,0,28,-28
34,39,24,5,47,56,-9
34,39,24,27,0,54,-54
34,39,24,31,59,94,-35
34,39,24,33,42,64,-22
34,39,24,510,29,38,-9
34,39,25,9,36,0,36
34,39,25,17,102,107,-5
34,39,25,21,36,40,-4
34,39,25,25,52,68,-16
34,39,25,27,26,46,-20
34,39,27,53,36,0,36
34,39,32,3,0,112,-112
34,39,34,1,65,79,-14
34,39,34,3,807,876,-69
34,39,34,5,191,379,-188
34,39,34,7,81,141,-60
34,39,34,11,0,30,-30
34,39,34,13,8882,6033,2849
34,39,34,15,30,94,-64
34,39,34,17,3385,1902,1483
34,39,34,19,176,417,-241
34,39,34,21,239,381,-142
34,39,34,23,4402,6086,-1684
34,39,34,25,721,1053,-332
34,39,34,27,1139,1546,-407
34,39,34,29,411,1175,-764
34,39,34,31,557,438,119
34,39,34,35,2091,3242,-1151
34,39,34,37,104,157,-53
34,39,34,41,114,263,-149
34,39,36,1,24,0,24
34,39,36,5,506,311,195
34,39,36,27,0,36,-36
34,39,36,29,28,0,28
34,39,36,47,979,557,422
34,39,36,59,128,141,-13
34,39,36,61,1063,756,307
34,39,36,71,41,71,-30
34,39,36,81,785,479,306
34,39,36,85,342,169,173
34,39,36,87,57,65,-8
34,39,36,103,115,91,24
34,39,36,119,196,129,67
34,39,37,19,0,31,-31
34,39,37,51,0,46,-46
34,39,37,63,0,56,-56
34,39,37,81,36,88,-52
34,39,37,97,0,42,-42
34,39,37,101,0,58,-58
34,39,37,119,75,327,-252
34,39,37,133,27,0,27
34,39,37,179,0,49,-49
34,39,37,183,63,262,-199
34,39,39,35,37,26,11
34,39,39,49,53,48,5
34,39,42,3,37,53,-16
34,39,42,11,0,83,-83
34,39,42,17,60,140,-80
34,39,42,29,44,57,-13
34,39,42,43,0,44,-44
34,39,42,45,40,33,7
34,39,42,71,0,42,-42
34,39,42,77,95,230,-135
34,39,42,79,33,58,-25
34,39,42,89,90,213,-123
34,39,42,91,58,90,-32
34,39,42,95,115,379,-264
34,39,42,101,171,218,-47
34,39,42,103,29,62,-33
34,39,42,127,0,29,-29
34,39,44,7,0,55,-55
34,39,45,19,0,33,-33
34,39,45,45,0,63,-63
34,39,45,51,0,30,-30
34,39,48,113,0,103,-103
34,39,48,157,0,52,-52
34,39,48,201,50,228,-178
34,39,48,439,0,92,-92
34,39,51,13,0,38,-38
34,39,51,59,64,72,-8
34,39,51,87,0,36,-36
34,39,51,810,33,63,-30
34,39,53,33,0,29,-29
34,41,4,13,0,31,-31
34,41,6,37,0,22,-22
34,41,12,11,0,38,-38
34,41,12,99,22,0,22
34,41,34,3,228,106,122
34,41,34,5,0,24,-24
34,41,34,13,365,149,216
34,41,34,17,240,92,148
34,41,34,19,691,552,139
34,41,34,21,51,45,6
34,41,34,23,366,214,152
34,41,34,25,93,78,15
34,41,34,27,1313,762,551
34,41,34,29,88,82,6
34,41,34,31,160,101,59
34,41,34,35,462,252,210
34,41,34,37,392,361,31
34,41,34,39,263,114,149
34,41,36,5,45,0,45
34,41,36,47,58,46,12
34,41,36,61,47,43,4
34,41,36,81,44,35,9
34,41,37,119,0,61,-61
34,41,37,183,0,40,-40
34,41,42,17,45,74,-29
34,41,42,25,0,30,-30
34,41,42,29,0,32,-32
34,41,42,77,115,166,-51
34,41,42,79,0,48,-48
34,41,42,89,162,214,-52
34,41,42,91,0,31,-31
34,41,42,95,768,1380,-612
34,41,42,101,0,24,-24
34,41,42,103,33,36,-3
35,1,1,89,0,37,-37
35,1,2,20,118,95,23
35,1,2,90,49,30,19
35,1,4,1,180,119,61
35,1,4,3,59,33,26
35,1,4,5,115,98,17
35,1,4,7,30,0,30
35,1,4,13,1674,1567,107
35,1,4,15,45,0,45
35,1,4,17,72,88,-16
35,1,4,19,372,494,-122
35,1,4,21,58,146,-88
35,1,4,25,51,43,8
35,1,4,27,39,29,10
35,1,5,119,62,34,28
35,1,5,143,32,0,32
35,1,6,1,141,102,39
35,1,6,13,73,59,14
35,1,6,19,59,35,24
35,1,6,29,86,104,-18
35,1,6,37,1180,592,588
35,1,6,53,42,37,5
35,1,6,59,332,179,153
35,1,6,65,262,160,102
35,1,6,67,146,123,23
35,1,6,71,259,142,117
35,1,6,73,549,431,118
35,1,6,75,102,81,21
35,1,6,77,72,0,72
35,1,6,79,38,0,38
35,1,6,81,66,55,11
35,1,6,83,77,40,37
35,1,6,85,102,121,-19
35,1,6,87,36,0,36
35,1,6,95,66,48,18
35,1,6,97,23,29,-6
35,1,6,111,105,64,41
35,1,8,1,187,194,-7
35,1,8,5,219,246,-27
35,1,8,7,0,32,-32
35,1,8,13,88,127,-39
35,1,8,14,27,35,-8
35,1,8,31,223,292,-69
35,1,8,35,34,92,-58
35,1,8,41,283,381,-98
35,1,8,59,126,176,-50
35,1,8,67,79,93,-14
35,1,8,69,98,139,-41
35,1,8,77,46,65,-19
35,1,8,83,0,38,-38
35,1,8,101,56,81,-25
35,1,8,117,34,0,34
35,1,8,123,56,78,-22
35,1,9,1,25,0,25
35,1,9,3,39,0,39
35,1,9,9,28,32,-4
35,1,11,1,87,59,28
35,1,12,5,0,34,-34
35,1,12,9,47,56,-9
35,1,12,11,78,52,26
35,1,12,31,64,49,15
35,1,12,33,24,29,-5
35,1,12,57,104,80,24
35,1,12,71,24,0,24
35,1,12,86,69,92,-23
35,1,12,91,117,165,-48
35,1,12,95,73,77,-4
35,1,12,99,56,38,18
35,1,12,101,28,0,28
35,1,12,103,49,62,-13
35,1,12,113,38,80,-42
35,1,12,115,0,34,-34
35,1,12,117,39,38,1
35,1,13,67,26,32,-6
35,1,13,89,35,34,1
35,1,13,121,22,25,-3
35,1,13,135,24,26,-2
35,1,13,185,52,81,-29
35,1,15,1,0,22,-22
35,1,15,3,154,101,53
35,1,16,1,75,67,8
35,1,17,31,249,204,45
35,1,17,43,49,0,49
35,1,17,89,33,0,33
35,1,17,97,35,33,2
35,1,17,163,0,32,-32
35,1,17,197,40,38,2
35,1,17,201,0,32,-32
35,1,18,3,30,0,30
35,1,18,57,0,44,-44
35,1,18,97,34,70,-36
35,1,19,113,0,52,-52
35,1,20,45,33,0,33
35,1,20,91,64,47,17
35,1,20,173,103,92,11
35,1,22,51,0,33,-33
35,1,22,71,0,59,-59
35,1,24,3,42,34,8
35,1,24,5,50,36,14
35,1,24,31,114,101,13
35,1,24,33,0,31,-31
35,1,24,510,33,27,6
35,1,25,17,69,97,-28
35,1,25,21,32,0,32
35,1,25,25,38,45,-7
35,1,25,27,26,0,26
35,1,26,65,33,0,33
35,1,26,81,41,0,41
35,1,26,99,33,0,33
35,1,26,125,75,0,75
35,1,26,161,28,45,-17
35,1,26,163,81,61,20
35,1,27,37,26,0,26
35,1,27,53,74,66,8
35,1,27,123,44,37,7
35,1,29,95,64,64,0
35,1,29,165,0,36,-36
35,1,29,183,0,27,-27
35,1,29,189,54,50,4
35,1,30,29,0,40,-40
35,1,30,63,29,41,-12
35,1,30,111,0,21,-21
35,1,31,55,55,42,13
35,1,32,3,638,564,74
35,1,32,31,88,53,35
35,1,34,17,27,0,27
35,1,34,23,40,26,14
35,1,34,25,25,0,25
35,1,35,5,342,288,54
35,1,35,6,545,372,173
35,1,35,7,121,43,78
35,1,35,9,155,105,50
35,1,35,13,819,637,182
35,1,35,15,241,196,45
35,1,35,17,134,84,50
35,1,35,19,60,50,10
35,1,35,25,85,134,-49
35,1,35,27,121,78,43
35,1,35,28,165,142,23
35,1,35,29,72,95,-23
35,1,35,31,1094,806,288
35,1,35,33,72,40,32
35,1,35,35,240,132,108
35,1,35,37,44,61,-17
35,1,35,39,410,230,180
35,1,35,41,65,29,36
35,1,35,43,4867,7387,-2520
35,1,35,45,716,694,22
35,1,35,47,416,255,161
35,1,35,49,1916,1463,453
35,1,35,51,49,97,-48
35,1,35,53,287,275,12
35,1,35,55,377,238,139
35,1,35,57,552,530,22
35,1,35,61,2260,2600,-340
35,1,36,45,0,28,-28
35,1,36,47,34,63,-29
35,1,36,55,33,0,33
35,1,36,61,90,95,-5
35,1,36,67,25,0,25
35,1,36,81,38,39,-1
35,1,36,103,43,31,12
35,1,37,51,73,41,32
35,1,37,63,27,0,27
35,1,37,81,0,31,-31
35,1,37,119,38,51,-13
35,1,37,133,36,29,7
35,1,37,183,45,71,-26
35,1,39,35,34,28,6
35,1,39,49,74,58,16
35,1,39,57,51,79,-28
35,1,39,61,28,33,-5
35,1,39,113,93,48,45
35,1,39,153,28,0,28
35,1,40,27,0,27,-27
35,1,40,109,80,132,-52
35,1,40,143,100,71,29
35,1,41,5,0,26,-26
35,1,41,17,0,30,-30
35,1,41,29,27,0,27
35,1,41,39,41,61,-20
35,1,41,47,45,0,45
35,1,41,51,116,147,-31
35,1,41,67,63,74,-11
35,1,42,3,60,58,2
35,1,42,91,32,0,32
35,1,42,101,0,40,-40
35,1,44,7,35,0,35
35,1,45,45,0,39,-39
35,1,45,79,0,35,-35
35,1,47,37,56,44,12
35,1,47,93,0,56,-56
35,1,47,157,39,42,-3
35,1,48,27,40,48,-8
35,1,48,29,368,359,9
35,1,48,39,0,50,-50
35,1,48,85,89,115,-26
35,1,48,113,235,250,-15
35,1,48,121,92,141,-49
35,1,48,135,0,36,-36
35,1,48,141,832,627,205
35,1,48,157,32,80,-48
35,1,48,167,41,30,11
35,1,48,187,0,38,-38
35,1,48,201,221,262,-41
35,1,48,215,31,48,-17
35,1,48,303,135,137,-2
35,1,48,329,40,32,8
35,1,48,339,27,94,-67
35,1,48,355,43,61,-18
35,1,48,375,59,66,-7
35,1,48,381,58,67,-9
35,1,48,439,285,398,-113
35,1,48,441,43,41,2
35,1,48,451,29,42,-13
35,1,48,453,182,296,-114
35,1,48,485,91,33,58
35,1,48,491,44,159,-115
35,1,49,11,36,49,-13
35,1,49,35,188,223,-35
35,1,49,49,67,75,-8
35,1,49,57,39,32,7
35,1,51,13,38,54,-16
35,1,51,59,132,166,-34
35,1,51,107,0,30,-30
35,1,51,153,0,39,-39
35,1,51,810,36,22,14
35,1,53,5,0,59,-59
35,1,53,11,34,65,-31
35,1,53,33,241,288,-47
35,1,53,35,30,40,-10
35,1,53,53,133,98,35
35,1,53,61,93,84,9
35,1,53,63,52,74,-22
35,1,53,67,0,31,-31
35,1,53,73,0,33,-33
35,1,55,25,48,58,-10
35,1,55,79,52,41,11
35,1,56,21,40,45,-5
35,3,4,13,24,0,24
35,5,4,13,153,101,52
35,5,4,19,0,28,-28
35,5,6,37,141,45,96
35,5,6,71,58,0,58
35,5,6,73,38,26,12
35,5,8,41,0,40,-40
35,5,32,3,44,0,44
35,5,35,1,288,342,-54
35,5,35,9,83,51,32
35,5,35,13,159,222,-63
35,5,35,15,346,318,28
35,5,35,25,116,134,-18
35,5,35,27,99,114,-15
35,5,35,35,75,82,-7
35,5,35,41,46,47,-1
35,5,35,43,30,65,-35
35,5,35,45,32,31,1
35,5,35,49,37,0,37
35,5,35,61,40,32,8
35,5,48,29,40,0,40
35,5,48,113,0,27,-27
35,5,48,135,0,34,-34
35,5,48,141,71,77,-6
35,5,48,303,75,107,-32
35,5,48,329,30,47,-17
35,5,48,439,42,50,-8
35,6,4,13,46,42,4
35,6,35,1,372,545,-173
35,6,35,13,0,36,-36
35,6,35,31,344,287,57
35,6,35,43,49,77,-28
35,6,35,45,34,42,-8
35,6,35,61,131,114,17
35,7,8,41,0,29,-29
35,7,8,71,63,59,4
35,7,35,1,43,121,-78
35,7,35,43,0,24,-24
35,7,35,47,0,37,-37
35,7,35,49,27,0,27
35,9,2,20,41,0,41
35,9,4,13,51,296,-245
35,9,4,19,0,93,-93
35,9,6,37,40,39,1
35,9,8,41,0,32,-32
35,9,10,1,0,48,-48
35,9,12,91,113,135,-22
35,9,12,113,87,0,87
35,9,15,3,55,0,55
35,9,16,39,0,88,-88
35,9,20,35,0,45,-45
35,9,32,3,39,157,-118
35,9,35,1,105,155,-50
35,9,35,5,51,83,-32
35,9,35,11,0,33,-33
35,9,35,13,49,44,5
35,9,35,15,29,0,29
35,9,35,25,0,71,-71
35,9,35,35,0,70,-70
35,9,35,37,120,90,30
35,9,35,41,489,391,98
35,9,35,43,0,54,-54
35,9,37,191,0,50,-50
35,9,45,79,0,29,-29
35,9,45,85,0,200,-200
35,9,46,93,0,49,-49
35,9,48,17,69,47,22
35,9,48,29,56,84,-28
35,9,48,85,0,32,-32
35,9,48,113,0,28,-28
35,9,48,141,36,72,-36
35,9,48,201,0,32,-32
35,9,48,303,80,191,-111
35,9,48,369,185,149,36
35,9,48,375,52,60,-8
35,9,48,381,37,73,-36
35,9,48,439,0,49,-49
35,9,48,441,0,59,-59
35,9,48,485,0,41,-41
35,9,49,11,0,129,-129
35,9,49,57,0,39,-39
35,13,4,3,42,58,-16
35,13,4,9,0,32,-32
35,13,4,13,465,556,-91
35,13,4,15,30,0,30
35,13,4,19,143,204,-61
35,13,4,21,0,57,-57
35,13,4,25,0,34,-34
35,13,6,29,55,42,13
35,13,6,37,278,124,154
35,13,6,59,68,39,29
35,13,6,65,100,46,54
35,13,6,67,0,43,-43
35,13,6,71,129,47,82
35,13,6,73,196,136,60
35,13,6,77,42,0,42
35,13,6,83,27,0,27
35,13,6,85,59,30,29
35,13,6,111,38,0,38
35,13,8,1,67,43,24
35,13,8,5,52,43,9
35,13,8,31,64,82,-18
35,13,8,35,31,0,31
35,13,8,41,118,131,-13
35,13,8,59,32,54,-22
35,13,8,69,0,42,-42
35,13,8,123,35,67,-32
35,13,13,121,0,25,-25
35,13,15,3,68,0,68
35,13,17,31,39,47,-8
35,13,26,163,31,0,31
35,13,29,95,0,28,-28
35,13,32,3,123,146,-23
35,13,35,1,637,819,-182
35,13,35,5,222,159,63
35,13,35,6,36,0,36
35,13,35,9,44,49,-5
35,13,35,15,165,166,-1
35,13,35,17,306,197,109
35,13,35,23,76,39,37
35,13,35,25,99,152,-53
35,13,35,27,170,117,53
35,13,35,28,0,28,-28
35,13,35,29,305,240,65
35,13,35,31,55,38,17
35,13,35,35,467,368,99
35,13,35,39,38,0,38
35,13,35,41,30,0,30
35,13,35,43,137,157,-20
35,13,35,45,132,80,52
35,13,35,47,0,38,-38
35,13,35,49,146,118,28
35,13,35,51,122,149,-27
35,13,35,53,63,43,20
35,13,35,55,46,0,46
35,13,35,61,130,131,-1
35,13,40,109,26,0,26
35,13,40,143,0,35,-35
35,13,41,51,0,36,-36
35,13,48,27,50,50,0
35,13,48,29,90,139,-49
35,13,48,85,36,46,-10
35,13,48,113,137,105,32
35,13,48,121,27,35,-8
35,13,48,135,0,83,-83
35,13,48,141,2925,2893,32
35,13,48,201,64,153,-89
35,13,48,303,27,34,-7
35,13,48,329,31,47,-16
35,13,48,439,67,117,-50
35,13,48,453,50,78,-28
35,13,48,491,0,38,-38
35,13,49,35,0,48,-48
35,13,49,49,0,29,-29
35,13,51,59,42,43,-1
35,13,53,33,46,54,-8
35,13,53,53,0,48,-48
35,15,4,13,80,53,27
35,15,4,19,37,35,2
35,15,6,73,45,0,45
35,15,32,3,32,0,32
35,15,35,1,196,241,-45
35,15,35,5,318,346,-28
35,15,35,9,0,29,-29
35,15,35,13,166,165,1
35,15,35,19,33,0,33
35,15,35,25,203,141,62
35,15,35,27,29,61,-32
35,15,35,35,72,65,7
35,15,35,41,46,35,11
35,15,35,43,45,36,9
35,15,48,113,0,38,-38
35,15,48,135,71,75,-4
35,15,48,141,147,64,83
35,15,48,201,40,0,40
35,15,48,303,95,92,3
35,15,48,329,43,63,-20
35,15,48,439,28,56,-28
35,17,4,3,60,0,60
35,17,4,9,0,68,-68
35,17,4,11,0,47,-47
35,17,4,13,100,117,-17
35,17,4,19,114,134,-20
35,17,4,21,0,37,-37
35,17,6,37,27,0,27
35,17,6,73,30,0,30
35,17,32,3,64,0,64
35,17,35,1,84,134,-50
35,17,35,13,197,306,-109
35,17,35,23,0,28,-28
35,17,35,29,70,75,-5
35,17,35,35,30,0,30
35,17,35,43,0,40,-40
35,17,35,49,31,0,31
35,17,35,51,34,25,9
35,17,48,141,44,38,6
35,19,35,1,50,60,-10
35,19,35,15,0,33,-33
35,19,35,47,28,40,-12
35,23,4,13,28,0,28
35,23,35,13,39,76,-37
35,23,35,17,28,0,28
35,25,4,13,134,52,82
35,25,6,37,49,0,49
35,25,8,1,44,0,44
35,25,32,3,40,37,3
35,25,35,1,134,85,49
35,25,35,5,134,116,18
35,25,35,9,71,0,71
35,25,35,13,152,99,53
35,25,35,15,141,203,-62
35,25,35,27,31,38,-7
35,25,35,35,47,47,0
35,25,35,41,59,45,14
35,25,35,45,0,35,-35
35,25,40,109,43,0,43
35,25,48,3,0,77,-77
35,25,48,113,54,75,-21
35,25,48,135,123,278,-155
35,25,48,141,201,90,111
35,25,48,165,82,121,-39
35,25,48,201,0,45,-45
35,25,48,303,172,251,-79
35,25,48,329,109,208,-99
35,25,48,375,0,37,-37
35,25,48,381,36,0,36
35,25,48,439,49,82,-33
35,25,48,451,0,47,-47
35,25,48,453,0,31,-31
35,25,48,501,51,56,-5
35,27,4,13,53,28,25
35,27,32,3,24,0,24
35,27,35,1,78,121,-43
35,27,35,5,114,99,15
35,27,35,13,117,170,-53
35,27,35,15,61,29,32
35,27,35,25,38,31,7
35,27,35,35,136,218,-82
35,27,48,141,98,40,58
35,27,48,303,38,39,-1
35,27,48,439,0,30,-30
35,28,4,13,0,34,-34
35,28,6,1,0,26,-26
35,28,8,69,0,27,-27
35,28,32,3,33,37,-4
35,28,35,1,142,165,-23
35,28,35,13,28,0,28
35,28,35,39,67,45,22
35,28,35,43,58,81,-23
35,28,35,49,200,211,-11
35,28,51,59,0,29,-29
35,28,53,33,0,28,-28
35,29,4,13,122,153,-31
35,29,4,19,40,33,7
35,29,32,3,44,0,44
35,29,35,1,95,72,23
35,29,35,13,240,305,-65
35,29,35,17,75,70,5
35,29,35,35,37,0,37
35,29,35,51,35,0,35
35,29,48,141,80,102,-22
35,31,4,1,1356,1496,-140
35,31,4,5,142,135,7
35,31,4,13,375,393,-18
35,31,4,17,240,283,-43
35,31,4,19,0,32,-32
35,31,6,73,0,45,-45
35,31,8,41,0,29,-29
35,31,8,67,0,37,-37
35,31,32,3,43,58,-15
35,31,35,1,806,1094,-288
35,31,35,6,287,344,-57
35,31,35,13,38,55,-17
35,31,35,43,257,246,11
35,31,35,45,3194,2364,830
35,31,35,49,0,55,-55
35,31,35,61,0,44,-44
35,31,49,35,0,40,-40
35,33,35,1,40,72,-32
35,33,35,47,87,102,-15
35,35,2,20,71,39,32
35,35,4,13,147,166,-19
35,35,4,19,55,59,-4
35,35,6,37,31,52,-21
35,35,6,71,33,0,33
35,35,6,73,51,59,-8
35,35,8,41,80,116,-36
35,35,12,91,0,39,-39
35,35,13,185,0,40,-40
35,35,15,3,0,37,-37
35,35,32,3,50,100,-50
35,35,35,1,132,240,-108
35,35,35,5,82,75,7
35,35,35,9,70,0,70
35,35,35,13,368,467,-99
35,35,35,15,65,72,-7
35,35,35,17,0,30,-30
35,35,35,25,47,47,0
35,35,35,27,218,136,82
35,35,35,29,0,37,-37
35,35,35,43,0,47,-47
35,35,48,27,0,30,-30
35,35,48,29,57,85,-28
35,35,48,141,412,309,103
35,35,48,201,28,50,-22
35,35,48,303,38,0,38
35,35,48,439,0,50,-50
35,35,48,485,27,0,27
35,37,35,1,61,44,17
35,37,35,9,90,120,-30
35,37,35,41,0,23,-23
35,37,48,381,0,28,-28
35,39,4,13,43,46,-3
35,39,6,37,32,0,32
35,39,32,3,0,29,-29
35,39,35,1,230,410,-180
35,39,35,13,0,38,-38
35,39,35,28,45,67,-22
35,39,35,43,62,135,-73
35,39,35,45,288,279,9
35,39,35,47,36,0,36
35,39,35,49,464,738,-274
35,39,35,55,114,96,18
35,41,4,13,0,49,-49
35,41,35,1,29,65,-36
35,41,35,5,47,46,1
35,41,35,9,391,489,-98
35,41,35,13,0,30,-30
35,41,35,15,35,46,-11
35,41,35,25,45,59,-14
35,41,35,37,23,0,23
35,41,48,303,28,80,-52
35,41,48,329,0,34,-34
35,43,4,13,425,375,50
35,43,4,19,72,81,-9
35,43,4,21,0,48,-48
35,43,4,25,32,0,32
35,43,6,1,0,32,-32
35,43,6,37,300,106,194
35,43,6,59,96,34,62
35,43,6,65,76,32,44
35,43,6,67,23,0,23
35,43,6,71,101,35,66
35,43,6,73,144,52,92
35,43,6,83,34,0,34
35,43,6,85,74,0,74
35,43,8,1,0,30,-30
35,43,8,5,28,44,-16
35,43,8,31,0,59,-59
35,43,8,35,42,0,42
35,43,8,41,117,57,60
35,43,8,59,35,0,35
35,43,8,69,0,28,-28
35,43,12,11,40,0,40
35,43,12,86,33,0,33
35,43,15,3,35,0,35
35,43,17,31,43,0,43
35,43,26,125,37,0,37
35,43,32,3,145,131,14
35,43,35,1,7387,4867,2520
35,43,35,5,65,30,35
35,43,35,6,77,49,28
35,43,35,7,24,0,24
35,43,35,9,54,0,54
35,43,35,13,157,137,20
35,43,35,15,36,45,-9
35,43,35,17,40,0,40
35,43,35,28,81,58,23
35,43,35,31,246,257,-11
35,43,35,35,47,0,47
35,43,35,39,135,62,73
35,43,35,45,310,387,-77
35,43,35,47,113,50,63
35,43,35,49,685,412,273
35,43,35,51,0,38,-38
35,43,35,53,27,34,-7
35,43,35,55,74,71,3
35,43,35,57,58,0,58
35,43,35,61,155,194,-39
35,43,36,103,32,0,32
35,43,41,51,0,30,-30
35,43,41,67,0,42,-42
35,43,48,27,0,41,-41
35,43,48,29,78,67,11
35,43,48,113,49,37,12
35,43,48,141,109,85,24
35,43,48,201,69,73,-4
35,43,48,303,33,32,1
35,43,48,439,98,75,23
35,43,48,453,36,59,-23
35,43,48,491,0,44,-44
35,43,49,35,0,26,-26
35,43,51,59,61,0,61
35,43,53,33,62,46,16
35,45,2,20,46,0,46
35,45,4,1,739,780,-41
35,45,4,5,152,125,27
35,45,4,13,442,411,31
35,45,4,15,38,35,3
35,45,4,17,295,181,114
35,45,4,19,93,37,56
35,45,4,21,0,28,-28
35,45,4,25,35,0,35
35,45,6,37,49,25,24
35,45,6,67,26,0,26
35,45,6,71,35,0,35
35,45,6,73,85,39,46
35,45,8,1,36,0,36
35,45,8,5,54,32,22
35,45,8,7,0,28,-28
35,45,8,31,43,50,-7
35,45,8,41,70,51,19
35,45,8,45,0,35,-35
35,45,8,59,31,27,4
35,45,8,67,394,300,94
35,45,8,77,82,154,-72
35,45,8,83,262,294,-32
35,45,8,85,36,0,36
35,45,8,101,0,35,-35
35,45,32,3,165,126,39
35,45,35,1,694,716,-22
35,45,35,5,31,32,-1
35,45,35,6,42,34,8
35,45,35,13,80,132,-52
35,45,35,25,35,0,35
35,45,35,31,2364,3194,-830
35,45,35,39,279,288,-9
35,45,35,43,387,310,77
35,45,35,49,50,50,0
35,45,35,53,42,37,5
35,45,35,61,50,47,3
35,45,40,109,0,44,-44
35,45,40,143,0,34,-34
35,45,48,113,27,0,27
35,45,48,135,0,50,-50
35,45,48,141,58,57,1
35,45,48,201,61,50,11
35,45,48,303,37,0,37
35,45,48,329,0,37,-37
35,45,48,453,0,24,-24
35,45,49,11,0,33,-33
35,45,49,35,113,90,23
35,45,49,37,269,304,-35
35,45,49,49,35,59,-24
35,45,53,33,0,38,-38
35,45,56,37,46,0,46
35,47,4,13,27,0,27
35,47,8,31,31,0,31
35,47,8,41,0,33,-33
35,47,32,3,36,30,6
35,47,35,1,255,416,-161
35,47,35,7,37,0,37
35,47,35,13,38,0,38
35,47,35,19,40,28,12
35,47,35,33,102,87,15
35,47,35,39,0,36,-36
35,47,35,43,50,113,-63
35,47,35,49,286,293,-7
35,47,35,55,23,0,23
35,47,35,61,0,35,-35
35,49,2,20,29,0,29
35,49,4,5,36,0,36
35,49,4,13,279,217,62
35,49,4,19,101,67,34
35,49,4,25,52,31,21
35,49,6,1,38,59,-21
35,49,6,13,44,0,44
35,49,6,37,219,160,59
35,49,6,41,26,0,26
35,49,6,59,70,30,40
35,49,6,65,67,28,39
35,49,6,73,114,79,35
35,49,6,75,38,45,-7
35,49,6,83,0,23,-23
35,49,6,85,38,26,12
35,49,6,87,29,0,29
35,49,6,111,32,0,32
35,49,8,1,41,34,7
35,49,8,5,44,29,15
35,49,8,13,68,62,6
35,49,8,31,99,95,4
35,49,8,41,56,65,-9
35,49,8,59,0,50,-50
35,49,8,67,29,23,6
35,49,8,69,0,27,-27
35,49,9,1,24,0,24
35,49,11,1,36,28,8
35,49,12,11,37,0,37
35,49,12,86,43,0,43
35,49,15,3,0,23,-23
35,49,17,31,80,58,22
35,49,24,31,33,0,33
35,49,25,17,29,46,-17
35,49,26,125,27,0,27
35,49,32,3,113,99,14
35,49,35,1,1463,1916,-453
35,49,35,5,0,37,-37
35,49,35,7,0,27,-27
35,49,35,13,118,146,-28
35,49,35,17,0,31,-31
35,49,35,28,211,200,11
35,49,35,31,55,0,55
35,49,35,39,738,464,274
35,49,35,43,412,685,-273
35,49,35,45,50,50,0
35,49,35,47,293,286,7
35,49,35,53,0,27,-27
35,49,35,55,168,139,29
35,49,35,57,112,143,-31
35,49,35,61,58,54,4
35,49,36,47,28,37,-9
35,49,36,61,73,61,12
35,49,37,21,0,30,-30
35,49,41,39,27,31,-4
35,49,41,51,33,72,-39
35,49,48,29,38,47,-9
35,49,48,113,104,67,37
35,49,48,141,106,82,24
35,49,48,201,62,49,13
35,49,48,439,75,39,36
35,49,48,453,53,91,-38
35,49,48,491,0,30,-30
35,49,49,35,38,0,38
35,49,51,13,36,0,36
35,49,51,59,40,32,8
35,49,53,33,70,69,1
35,51,4,13,46,0,46
35,51,4,19,31,0,31
35,51,32,3,41,0,41
35,51,35,1,97,49,48
35,51,35,13,149,122,27
35,51,35,17,25,34,-9
35,51,35,29,0,35,-35
35,51,35,43,38,0,38
35,51,35,61,29,31,-2
35,51,48,141,34,0,34
35,53,35,1,275,287,-12
35,53,35,13,43,63,-20
35,53,35,43,34,27,7
35,53,35,45,37,42,-5
35,53,35,49,27,0,27
35,53,35,61,164,194,-30
35,55,4,13,49,44,5
35,55,6,37,28,24,4
35,55,8,41,44,35,9
35,55,35,1,238,377,-139
35,55,35,13,0,46,-46
35,55,35,39,96,114,-18
35,55,35,43,71,74,-3
35,55,35,47,0,23,-23
35,55,35,49,139,168,-29
35,57,35,1,530,552,-22
35,57,35,43,0,58,-58
35,57,35,49,143,112,31
35,57,35,61,47,79,-32
35,59,48,111,32,51,-19
35,61,4,13,119,79,40
35,61,4,19,0,36,-36
35,61,4,21,0,39,-39
35,61,6,37,83,29,54
35,61,6,71,61,0,61
35,61,6,73,54,0,54
35,61,8,41,30,34,-4
35,61,9,9,34,0,34
35,61,32,3,100,56,44
35,61,35,1,2600,2260,340
35,61,35,5,32,40,-8
35,61,35,6,114,131,-17
35,61,35,13,131,130,1
35,61,35,31,44,0,44
35,61,35,43,194,155,39
35,61,35,45,47,50,-3
35,61,35,47,35,0,35
35,61,35,49,54,58,-4
35,61,35,51,31,29,2
35,61,35,53,194,164,30
35,61,35,57,79,47,32
35,61,48,141,45,41,4
36,1,4,13,60,142,-82
36,1,4,19,0,24,-24
36,1,6,1,26,26,0
36,1,6,37,41,118,-77
36,1,6,59,30,56,-26
36,1,6,73,49,107,-58
36,1,6,75,0,25,-25
36,1,6,85,34,66,-32
36,1,8,31,25,28,-3
36,1,9,1,67,85,-18
36,1,9,3,79,94,-15
36,1,9,9,52,52,0
36,1,11,1,28,73,-45
36,1,12,9,0,33,-33
36,1,12,11,42,86,-44
36,1,12,15,0,22,-22
36,1,12,31,33,32,1
36,1,12,57,39,75,-36
36,1,12,71,0,52,-52
36,1,12,81,0,33,-33
36,1,12,86,32,43,-11
36,1,12,95,57,71,-14
36,1,12,99,64,90,-26
36,1,12,101,30,33,-3
36,1,12,103,48,71,-23
36,1,12,105,0,31,-31
36,1,12,115,24,26,-2
36,1,12,117,0,20,-20
36,1,12,127,0,46,-46
36,1,13,67,0,42,-42
36,1,13,89,38,30,8
36,1,13,121,22,72,-50
36,1,13,135,34,47,-13
36,1,17,31,66,83,-17
36,1,23,5,28,22,6
36,1,24,5,43,38,5
36,1,24,27,0,39,-39
36,1,24,31,39,69,-30
36,1,24,510,0,30,-30
36,1,25,1,0,22,-22
36,1,25,3,73,70,3
36,1,25,9,0,47,-47
36,1,25,13,29,33,-4
36,1,25,15,0,26,-26
36,1,25,17,105,176,-71
36,1,25,21,43,79,-36
36,1,25,23,28,0,28
36,1,25,25,74,155,-81
36,1,25,27,36,40,-4
36,1,26,125,52,0,52
36,1,26,163,43,0,43
36,1,32,3,52,69,-17
36,1,33,11,28,24,4
36,1,34,3,53,56,-3
36,1,34,13,0,41,-41
36,1,34,17,27,85,-58
36,1,34,23,72,60,12
36,1,34,27,38,30,8
36,1,34,31,27,0,27
36,1,34,35,0,26,-26
36,1,34,39,0,24,-24
36,1,36,5,236,209,27
36,1,36,7,109,99,10
36,1,36,15,24,0,24
36,1,36,17,41,31,10
36,1,36,19,113,56,57
36,1,36,21,288,227,61
36,1,36,25,57,27,30
36,1,36,27,255,163,92
36,1,36,29,155,135,20
36,1,36,31,51,49,2
36,1,36,33,33,29,4
36,1,36,35,142,161,-19
36,1,36,39,506,474,32
36,1,36,43,96,59,37
36,1,36,45,37,0,37
36,1,36,47,456,450,6
36,1,36,51,33,0,33
36,1,36,53,36,0,36
36,1,36,55,221,154,67
36,1,36,57,195,267,-72
36,1,36,59,147,116,31
36,1,36,61,273,390,-117
36,1,36,63,22,32,-10
36,1,36,65,181,93,88
36,1,36,67,299,181,118
36,1,36,69,39,29,10
36,1,36,71,199,167,32
36,1,36,75,45,29,16
36,1,36,77,121,50,71
36,1,36,79,30,23,7
36,1,36,81,318,281,37
36,1,36,83,3983,4514,-531
36,1,36,85,59,29,30
36,1,36,87,56,66,-10
36,1,36,89,54,42,12
36,1,36,91,2261,2902,-641
36,1,36,93,2464,3047,-583
36,1,36,95,264,238,26
36,1,36,103,216,151,65
36,1,36,105,61,0,61
36,1,36,109,34,51,-17
36,1,36,111,234,132,102
36,1,36,113,165,180,-15
36,1,36,115,119,107,12
36,1,36,119,213,166,47
36,1,37,19,0,30,-30
36,1,37,51,0,27,-27
36,1,37,63,0,30,-30
36,1,37,119,50,119,-69
36,1,37,133,0,31,-31
36,1,37,183,45,93,-48
36,1,39,35,0,29,-29
36,1,39,49,41,0,41
36,1,41,51,0,41,-41
36,1,42,3,0,46,-46
36,1,42,17,27,0,27
36,1,42,45,0,25,-25
36,1,42,91,33,29,4
36,1,42,101,25,59,-34
36,1,44,7,33,30,3
36,1,45,45,0,32,-32
36,1,45,51,0,48,-48
36,1,47,37,25,0,25
36,1,48,29,0,28,-28
36,1,48,113,0,28,-28
36,1,48,201,45,68,-23
36,1,48,453,29,41,-12
36,1,50,3,48,0,48
36,1,50,7,43,60,-17
36,1,50,21,0,27,-27
36,1,51,13,0,27,-27
36,1,51,59,45,68,-23
36,1,51,510,0,34,-34
36,1,51,550,0,23,-23
36,1,51,810,0,37,-37
36,1,53,33,25,44,-19
36,3,36,9,516,485,31
36,3,36,13,29,59,-30
36,3,36,15,0,22,-22
36,3,36,29,173,145,28
36,3,36,51,95,133,-38
36,3,36,55,130,115,15
36,3,36,63,45,35,10
36,3,36,67,0,22,-22
36,3,36,101,277,272,5
36,3,36,121,103,83,20
36,3,42,83,39,44,-5
36,3,42,105,104,50,54
36,5,4,13,119,214,-95
36,5,4,19,0,27,-27
36,5,6,1,42,51,-9
36,5,6,37,331,559,-228
36,5,6,59,56,198,-142
36,5,6,65,66,123,-57
36,5,6,67,32,35,-3
36,5,6,71,40,87,-47
36,5,6,73,125,96,29
36,5,6,75,56,52,4
36,5,6,81,29,0,29
36,5,6,85,95,76,19
36,5,8,5,0,36,-36
36,5,8,31,39,24,15
36,5,8,41,0,27,-27
36,5,9,1,622,1468,-846
36,5,9,3,278,384,-106
36,5,9,5,32,71,-39
36,5,9,7,0,35,-35
36,5,9,9,410,895,-485
36,5,9,11,56,104,-48
36,5,10,1,45,53,-8
36,5,10,3,102,215,-113
36,5,10,5,0,45,-45
36,5,11,1,77,129,-52
36,5,12,1,0,45,-45
36,5,12,9,92,141,-49
36,5,12,11,535,916,-381
36,5,12,15,0,38,-38
36,5,12,17,0,28,-28
36,5,12,21,46,54,-8
36,5,12,31,128,206,-78
36,5,12,35,33,47,-14
36,5,12,53,33,75,-42
36,5,12,57,388,621,-233
36,5,12,69,62,180,-118
36,5,12,71,112,135,-23
36,5,12,81,34,31,3
36,5,12,83,38,153,-115
36,5,12,86,773,998,-225
36,5,12,95,730,1158,-428
36,5,12,97,353,646,-293
36,5,12,99,265,432,-167
36,5,12,101,46,154,-108
36,5,12,103,112,144,-32
36,5,12,105,134,367,-233
36,5,12,111,63,174,-111
36,5,12,115,24,46,-22
36,5,12,117,131,294,-163
36,5,12,127,106,184,-78
36,5,13,51,37,37,0
36,5,13,63,75,159,-84
36,5,13,67,91,202,-111
36,5,13,77,0,28,-28
36,5,13,89,180,390,-210
36,5,13,97,60,119,-59
36,5,13,121,196,377,-181
36,5,13,135,205,628,-423
36,5,13,151,0,114,-114
36,5,13,179,0,38,-38
36,5,13,217,36,71,-35
36,5,13,223,0,40,-40
36,5,13,245,0,37,-37
36,5,13,247,0,78,-78
36,5,13,297,0,36,-36
36,5,15,3,59,61,-2
36,5,17,31,214,189,25
36,5,17,43,32,0,32
36,5,18,97,52,75,-23
36,5,21,111,21,30,-9
36,5,22,51,41,57,-16
36,5,22,71,0,29,-29
36,5,24,3,30,59,-29
36,5,24,5,119,189,-70
36,5,24,25,0,46,-46
36,5,24,27,39,30,9
36,5,24,31,139,199,-60
36,5,24,33,193,350,-157
36,5,24,510,87,137,-50
36,5,25,1,26,39,-13
36,5,25,5,35,82,-47
36,5,25,9,322,505,-183
36,5,25,13,108,210,-102
36,5,25,17,159,171,-12
36,5,25,21,44,68,-24
36,5,25,25,193,297,-104
36,5,25,27,270,274,-4
36,5,26,81,58,63,-5
36,5,26,99,0,38,-38
36,5,26,125,32,32,0
36,5,26,161,30,0,30
36,5,26,163,122,78,44
36,5,27,53,64,89,-25
36,5,29,189,0,37,-37
36,5,32,3,107,265,-158
36,5,33,11,50,41,9
36,5,34,1,89,155,-66
36,5,34,3,790,2211,-1421
36,5,34,5,92,122,-30
36,5,34,7,104,169,-65
36,5,34,11,31,49,-18
36,5,34,13,819,1467,-648
36,5,34,17,945,1312,-367
36,5,34,19,0,31,-31
36,5,34,21,72,156,-84
36,5,34,23,459,792,-333
36,5,34,25,93,233,-140
36,5,34,27,119,113,6
36,5,34,29,80,117,-37
36,5,34,31,604,761,-157
36,5,34,35,59,122,-63
36,5,34,37,0,37,-37
36,5,34,39,311,506,-195
36,5,34,41,0,45,-45
36,5,36,1,209,236,-27
36,5,36,7,85,126,-41
36,5,36,13,0,44,-44
36,5,36,21,0,29,-29
36,5,36,25,0,28,-28
36,5,36,27,400,910,-510
36,5,36,29,188,189,-1
36,5,36,39,38,39,-1
36,5,36,45,44,45,-1
36,5,36,47,8172,7380,792
36,5,36,55,159,173,-14
36,5,36,57,0,34,-34
36,5,36,59,780,1176,-396
36,5,36,61,26584,17919,8665
36,5,36,63,39,0,39
36,5,36,65,75,83,-8
36,5,36,67,80,105,-25
36,5,36,71,669,2366,-1697
36,5,36,79,217,584,-367
36,5,36,81,7268,7843,-575
36,5,36,83,47,63,-16
36,5,36,85,626,968,-342
36,5,36,87,566,1212,-646
36,5,36,91,33,60,-27
36,5,36,93,85,198,-113
36,5,36,103,734,1253,-519
36,5,36,105,153,209,-56
36,5,36,109,28,38,-10
36,5,36,111,98,198,-100
36,5,36,119,6311,10985,-4674
36,5,37,25,0,57,-57
36,5,37,35,0,56,-56
36,5,37,51,89,120,-31
36,5,37,63,63,105,-42
36,5,37,67,0,65,-65
36,5,37,81,69,112,-43
36,5,37,109,0,74,-74
36,5,37,119,187,538,-351
36,5,37,133,54,72,-18
36,5,37,147,0,32,-32
36,5,37,155,27,0,27
36,5,37,179,0,50,-50
36,5,37,183,125,374,-249
36,5,39,17,33,43,-10
36,5,39,35,85,148,-63
36,5,39,49,174,162,12
36,5,39,61,49,115,-66
36,5,39,99,70,0,70
36,5,39,113,29,0,29
36,5,39,153,29,0,29
36,5,40,109,45,165,-120
36,5,41,51,0,28,-28
36,5,42,3,35,68,-33
36,5,42,11,264,532,-268
36,5,42,17,35,72,-37
36,5,42,29,23,0,23
36,5,42,43,56,158,-102
36,5,42,45,46,96,-50
36,5,42,69,56,114,-58
36,5,42,71,95,170,-75
36,5,42,75,117,86,31
36,5,42,77,495,941,-446
36,5,42,79,136,443,-307
36,5,42,89,301,731,-430
36,5,42,91,72,78,-6
36,5,42,95,128,185,-57
36,5,42,101,733,789,-56
36,5,42,103,47,232,-185
36,5,42,133,72,91,-19
36,5,44,7,416,389,27
36,5,45,13,0,66,-66
36,5,45,15,0,65,-65
36,5,45,19,40,86,-46
36,5,45,35,0,38,-38
36,5,45,41,0,32,-32
36,5,45,45,0,36,-36
36,5,45,51,0,52,-52
36,5,45,63,0,30,-30
36,5,45,75,0,43,-43
36,5,45,79,0,110,-110
36,5,45,91,0,37,-37
36,5,47,37,0,62,-62
36,5,47,157,33,37,-4
36,5,48,27,38,97,-59
36,5,48,29,47,101,-54
36,5,48,85,0,28,-28
36,5,48,113,138,304,-166
36,5,48,157,0,54,-54
36,5,48,201,161,406,-245
36,5,48,439,46,136,-90
36,5,48,453,31,68,-37
36,5,49,35,33,0,33
36,5,51,13,0,40,-40
36,5,51,41,0,70,-70
36,5,51,59,146,132,14
36,5,51,87,67,99,-32
36,5,51,107,0,45,-45
36,5,51,153,138,183,-45
36,5,51,177,0,34,-34
36,5,51,179,0,30,-30
36,5,51,510,0,78,-78
36,5,51,550,59,63,-4
36,5,51,650,36,50,-14
36,5,51,660,0,31,-31
36,5,51,700,49,72,-23
36,5,51,710,68,129,-61
36,5,51,760,35,76,-41
36,5,51,770,0,34,-34
36,5,51,810,130,122,8
36,5,53,33,91,89,2
36,5,53,53,46,55,-9
36,5,55,25,27,0,27
36,5,55,79,24,52,-28
36,7,4,13,33,63,-30
36,7,6,37,22,46,-24
36,7,6,73,32,51,-19
36,7,6,75,0,23,-23
36,7,6,85,0,37,-37
36,7,9,1,37,24,13
36,7,11,1,0,25,-25
36,7,12,9,22,28,-6
36,7,12,11,31,30,1
36,7,12,57,0,38,-38
36,7,12,71,24,42,-18
36,7,12,95,26,43,-17
36,7,12,99,34,21,13
36,7,12,101,0,34,-34
36,7,12,103,29,25,4
36,7,12,115,36,0,36
36,7,12,117,0,36,-36
36,7,12,127,25,33,-8
36,7,17,31,0,35,-35
36,7,24,31,32,26,6
36,7,24,510,0,23,-23
36,7,25,17,28,71,-43
36,7,25,21,0,27,-27
36,7,25,25,0,33,-33
36,7,32,3,0,28,-28
36,7,34,3,0,28,-28
36,7,34,13,0,31,-31
36,7,34,17,0,55,-55
36,7,34,23,31,28,3
36,7,36,1,99,109,-10
36,7,36,5,126,85,41
36,7,36,11,42,0,42
36,7,36,15,103,110,-7
36,7,36,17,562,482,80
36,7,36,23,173,183,-10
36,7,36,25,165,150,15
36,7,36,27,52,27,25
36,7,36,29,109,152,-43
36,7,36,45,47,40,7
36,7,36,47,212,216,-4
36,7,36,55,109,200,-91
36,7,36,59,47,38,9
36,7,36,61,91,130,-39
36,7,36,65,56,74,-18
36,7,36,67,223,305,-82
36,7,36,69,34,0,34
36,7,36,71,71,58,13
36,7,36,75,45,47,-2
36,7,36,77,94,122,-28
36,7,36,81,126,185,-59
36,7,36,83,29,29,0
36,7,36,85,48,30,18
36,7,36,87,26,0,26
36,7,36,89,0,33,-33
36,7,36,91,33,72,-39
36,7,36,93,38,42,-4
36,7,36,101,58,88,-30
36,7,36,103,123,41,82
36,7,36,105,41,0,41
36,7,36,107,969,1056,-87
36,7,36,109,123,193,-70
36,7,36,111,36,26,10
36,7,36,117,28,0,28
36,7,36,119,67,75,-8
36,7,37,63,0,23,-23
36,7,37,119,38,80,-42
36,7,37,133,0,29,-29
36,7,37,183,0,95,-95
36,7,39,49,0,29,-29
36,7,42,3,0,31,-31
36,7,42,15,69,57,12
36,7,42,17,0,27,-27
36,7,42,69,90,73,17
36,7,42,77,32,0,32
36,7,42,79,23,31,-8
36,7,42,91,25,24,1
36,7,42,101,29,64,-35
36,7,42,115,380,313,67
36,7,42,127,27,0,27
36,7,45,51,0,55,-55
36,7,48,201,0,43,-43
36,7,48,439,46,0,46
36,7,51,59,0,45,-45
36,7,51,810,0,30,-30
36,7,53,33,0,34,-34
36,9,4,13,0,30,-30
36,9,12,103,0,24,-24
36,9,36,3,485,516,-31
36,9,36,13,454,428,26
36,9,36,29,867,1038,-171
36,9,36,37,29,0,29
36,9,36,55,33,106,-73
36,9,36,63,78,60,18
36,9,36,67,0,31,-31
36,9,36,101,41,26,15
36,9,36,121,257,284,-27
36,9,37,119,0,29,-29
36,9,37,183,0,32,-32
36,9,42,83,154,222,-68
36,9,42,105,54,27,27
36,9,45,51,25,0,25
36,11,4,13,0,35,-35
36,11,12,101,0,32,-32
36,11,36,7,0,42,-42
36,11,36,23,145,147,-2
36,11,36,29,44,51,-7
36,11,36,45,52,27,25
36,11,36,53,37,35,2
36,11,36,55,70,128,-58
36,11,36,65,43,32,11
36,11,36,67,1120,979,141
36,11,36,69,59,74,-15
36,11,36,75,284,254,30
36,11,36,91,0,25,-25
36,11,36,99,105,148,-43
36,11,36,107,30,0,30
36,11,36,109,223,310,-87
36,11,36,117,165,160,5
36,11,37,119,0,21,-21
36,13,4,13,43,60,-17
36,13,6,37,0,23,-23
36,13,12,57,29,36,-7
36,13,12,71,26,35,-9
36,13,12,81,0,25,-25
36,13,12,95,36,28,8
36,13,12,101,31,0,31
36,13,12,103,34,47,-13
36,13,18,5,0,32,-32
36,13,32,3,24,40,-16
36,13,36,3,59,29,30
36,13,36,5,44,0,44
36,13,36,9,428,454,-26
36,13,36,29,854,848,6
36,13,36,37,0,38,-38
36,13,36,47,0,26,-26
36,13,36,55,112,120,-8
36,13,36,61,33,41,-8
36,13,36,63,62,47,15
36,13,36,67,0,34,-34
36,13,36,81,0,29,-29
36,13,37,119,0,49,-49
36,13,37,183,32,42,-10
36,13,39,35,42,34,8
36,13,42,3,31,57,-26
36,13,42,39,39,31,8
36,13,42,49,223,340,-117
36,13,42,83,33,34,-1
36,13,42,123,156,219,-63
36,15,4,13,0,30,-30
36,15,12,57,0,28,-28
36,15,12,95,36,0,36
36,15,12,101,0,26,-26
36,15,12,103,0,25,-25
36,15,12,127,26,0,26
36,15,36,1,0,24,-24
36,15,36,3,22,0,22
36,15,36,7,110,103,7
36,15,36,29,54,71,-17
36,15,36,47,0,38,-38
36,15,36,55,107,138,-31
36,15,36,61,0,34,-34
36,15,36,67,53,99,-46
36,15,36,69,0,22,-22
36,15,36,81,30,0,30
36,15,36,97,268,197,71
36,15,36,99,30,36,-6
36,15,36,101,655,679,-24
36,15,36,107,263,201,62
36,15,36,109,116,159,-43
36,15,36,123,48,29,19
36,15,37,119,0,48,-48
36,15,42,15,256,196,60
36,15,42,117,99,91,8
36,15,45,51,0,35,-35
36,15,51,59,0,22,-22
36,17,9,1,24,0,24
36,17,36,1,31,41,-10
36,17,36,7,482,562,-80
36,17,36,23,104,142,-38
36,17,36,25,296,197,99
36,17,36,29,0,39,-39
36,17,36,43,0,28,-28
36,17,36,53,195,210,-15
36,17,36,55,0,43,-43
36,17,36,65,67,74,-7
36,17,36,67,46,105,-59
36,17,36,77,387,324,63
36,17,36,103,52,0,52
36,17,36,109,0,34,-34
36,19,6,73,0,29,-29
36,19,12,99,0,34,-34
36,19,36,1,56,113,-57
36,19,36,27,28,0,28
36,19,36,29,33,60,-27
36,19,36,31,394,291,103
36,19,36,33,273,229,44
36,19,36,35,30,0,30
36,19,36,45,38,40,-2
36,19,36,47,0,27,-27
36,19,36,55,0,24,-24
36,19,36,61,0,31,-31
36,19,36,67,54,43,11
36,19,36,81,0,31,-31
36,19,36,83,29,64,-35
36,19,36,89,111,102,9
36,19,36,91,60,88,-28
36,19,36,93,30,30,0
36,19,36,111,0,22,-22
36,19,36,113,55,36,19
36,19,36,115,0,33,-33
36,19,37,183,0,50,-50
36,19,42,91,0,23,-23
36,19,50,7,107,82,25
36,19,50,11,62,38,24
36,19,50,13,43,0,43
36,21,6,37,0,26,-26
36,21,9,5,0,32,-32
36,21,25,3,91,189,-98
36,21,36,1,227,288,-61
36,21,36,5,29,0,29
36,21,36,27,572,322,250
36,21,36,39,280,247,33
36,21,36,47,82,75,7
36,21,36,55,0,24,-24
36,21,36,59,25,0,25
36,21,36,61,198,78,120
36,21,36,79,36,0,36
36,21,36,81,61,56,5
36,21,36,83,296,430,-134
36,21,36,91,24,43,-19
36,21,36,93,43,43,0
36,21,36,103,29,29,0
36,21,36,111,118,88,30
36,21,36,119,82,0,82
36,23,36,7,183,173,10
36,23,36,11,147,145,2
36,23,36,17,142,104,38
36,23,36,29,0,28,-28
36,23,36,45,28,0,28
36,23,36,53,87,69,18
36,23,36,55,30,40,-10
36,23,36,65,31,0,31
36,23,36,67,266,358,-92
36,23,36,75,49,27,22
36,23,36,101,0,29,-29
36,23,36,107,80,83,-3
36,23,36,109,424,452,-28
36,25,34,3,32,0,32
36,25,36,1,27,57,-30
36,25,36,5,28,0,28
36,25,36,7,150,165,-15
36,25,36,17,197,296,-99
36,25,36,27,36,0,36
36,25,36,39,51,38,13
36,25,36,47,82,46,36
36,25,36,59,60,33,27
36,25,36,61,56,47,9
36,25,36,67,0,31,-31
36,25,36,71,45,30,15
36,25,36,77,474,501,-27
36,25,36,81,98,49,49
36,25,36,87,28,0,28
36,25,36,95,113,130,-17
36,25,36,103,113,39,74
36,25,36,105,42,56,-14
36,25,36,111,75,90,-15
36,25,36,119,49,31,18
36,25,42,127,38,38,0
36,27,4,13,59,73,-14
36,27,6,37,80,73,7
36,27,6,73,62,94,-32
36,27,6,75,0,23,-23
36,27,6,85,0,74,-74
36,27,8,31,32,0,32
36,27,9,1,243,239,4
36,27,9,3,35,91,-56
36,27,9,5,126,201,-75
36,27,9,9,97,111,-14
36,27,9,11,23,0,23
36,27,11,1,30,31,-1
36,27,12,9,0,45,-45
36,27,12,11,65,64,1
36,27,12,17,0,34,-34
36,27,12,21,0,25,-25
36,27,12,35,0,31,-31
36,27,12,57,48,73,-25
36,27,12,71,36,47,-11
36,27,12,83,0,55,-55
36,27,12,86,27,0,27
36,27,12,95,48,52,-4
36,27,12,99,74,116,-42
36,27,12,101,0,70,-70
36,27,12,103,31,51,-20
36,27,12,105,0,29,-29
36,27,12,111,0,28,-28
36,27,12,117,34,0,34
36,27,12,127,35,30,5
36,27,13,67,0,42,-42
36,27,13,89,0,36,-36
36,27,13,121,0,35,-35
36,27,13,135,0,35,-35
36,27,17,31,24,38,-14
36,27,24,31,0,46,-46
36,27,24,510,0,31,-31
36,27,25,3,0,28,-28
36,27,25,17,60,98,-38
36,27,25,21,0,40,-40
36,27,25,25,27,93,-66
36,27,32,3,48,50,-2
36,27,33,11,0,32,-32
36,27,33,15,0,25,-25
36,27,34,3,82,79,3
36,27,34,13,46,63,-17
36,27,34,17,71,88,-17
36,27,34,23,40,55,-15
36,27,34,25,0,34,-34
36,27,34,31,33,26,7
36,27,34,39,36,0,36
36,27,36,1,163,255,-92
36,27,36,5,910,400,510
36,27,36,7,27,52,-25
36,27,36,19,0,28,-28
36,27,36,21,322,572,-250
36,27,36,25,0,36,-36
36,27,36,29,44,71,-27
36,27,36,39,34,136,-102
36,27,36,47,409,367,42
36,27,36,55,30,70,-40
36,27,36,57,0,33,-33
36,27,36,59,188,114,74
36,27,36,61,538,475,63
36,27,36,65,39,0,39
36,27,36,67,34,90,-56
36,27,36,71,961,913,48
36,27,36,75,0,27,-27
36,27,36,79,1357,549,808
36,27,36,81,451,353,98
36,27,36,83,62,131,-69
36,27,36,85,55,0,55
36,27,36,87,129,141,-12
36,27,36,89,28,33,-5
36,27,36,91,60,110,-50
36,27,36,93,57,103,-46
36,27,36,103,230,126,104
36,27,36,105,76,94,-18
36,27,36,109,0,35,-35
36,27,36,111,1339,1573,-234
36,27,36,119,2414,1130,1284
36,27,37,19,0,31,-31
36,27,37,101,0,25,-25
36,27,37,119,39,123,-84
36,27,37,129,0,23,-23
36,27,37,183,35,153,-118
36,27,39,49,0,34,-34
36,27,42,17,0,28,-28
36,27,42,91,0,56,-56
36,27,42,101,29,53,-24
36,27,42,103,0,57,-57
36,27,44,7,27,22,5
36,27,45,45,0,32,-32
36,27,45,51,0,77,-77
36,27,45,91,0,40,-40
36,27,47,37,0,23,-23
36,27,47,65,0,30,-30
36,27,48,113,30,0,30
36,27,48,201,0,50,-50
36,27,48,439,0,40,-40
36,27,48,453,55,56,-1
36,27,50,7,38,26,12
36,27,51,59,24,46,-22
36,27,51,810,0,24,-24
36,27,53,33,0,42,-42
36,29,1,73,0,43,-43
36,29,4,13,212,512,-300
36,29,4,19,88,100,-12
36,29,4,21,0,37,-37
36,29,6,1,36,46,-10
36,29,6,13,0,26,-26
36,29,6,37,206,276,-70
36,29,6,59,58,78,-20
36,29,6,65,57,50,7
36,29,6,67,30,47,-17
36,29,6,71,39,30,9
36,29,6,73,164,195,-31
36,29,6,75,23,60,-37
36,29,6,81,0,33,-33
36,29,6,85,29,122,-93
36,29,8,5,44,42,2
36,29,8,31,21,47,-26
36,29,8,41,42,36,6
36,29,8,59,0,34,-34
36,29,9,1,90,98,-8
36,29,9,3,69,81,-12
36,29,9,9,63,55,8
36,29,10,3,60,73,-13
36,29,11,1,51,97,-46
36,29,12,9,46,65,-19
36,29,12,11,180,210,-30
36,29,12,15,28,50,-22
36,29,12,21,25,77,-52
36,29,12,31,91,96,-5
36,29,12,53,0,53,-53
36,29,12,57,160,221,-61
36,29,12,69,42,78,-36
36,29,12,71,80,164,-84
36,29,12,81,61,69,-8
36,29,12,83,48,40,8
36,29,12,86,75,122,-47
36,29,12,87,0,26,-26
36,29,12,95,197,199,-2
36,29,12,97,52,38,14
36,29,12,99,141,205,-64
36,29,12,101,96,108,-12
36,29,12,103,178,218,-40
36,29,12,105,66,88,-22
36,29,12,111,29,45,-16
36,29,12,115,81,167,-86
36,29,12,117,55,64,-9
36,29,12,119,0,37,-37
36,29,12,127,85,70,15
36,29,13,63,0,24,-24
36,29,13,67,43,85,-42
36,29,13,77,0,23,-23
36,29,13,89,71,109,-38
36,29,13,121,90,128,-38
36,29,13,135,35,134,-99
36,29,15,3,68,66,2
36,29,16,1,0,30,-30
36,29,17,31,151,305,-154
36,29,17,43,40,35,5
36,29,18,57,0,27,-27
36,29,18,97,27,32,-5
36,29,20,91,0,38,-38
36,29,21,111,33,51,-18
36,29,22,71,0,33,-33
36,29,24,3,58,79,-21
36,29,24,5,78,115,-37
36,29,24,25,0,46,-46
36,29,24,27,0,32,-32
36,29,24,31,87,134,-47
36,29,24,33,39,77,-38
36,29,24,510,66,95,-29
36,29,25,5,0,39,-39
36,29,25,9,28,62,-34
36,29,25,13,50,31,19
36,29,25,17,114,181,-67
36,29,25,21,39,74,-35
36,29,25,23,26,0,26
36,29,25,25,56,138,-82
36,29,25,27,50,34,16
36,29,26,49,44,0,44
36,29,26,65,33,0,33
36,29,26,81,0,36,-36
36,29,26,99,30,31,-1
36,29,26,125,80,92,-12
36,29,26,161,61,43,18
36,29,26,163,110,104,6
36,29,27,53,45,61,-16
36,29,29,189,0,58,-58
36,29,29,510,28,0,28
36,29,32,3,191,281,-90
36,29,33,11,53,40,13
36,29,34,3,37,58,-21
36,29,34,5,43,34,9
36,29,34,7,0,41,-41
36,29,34,13,0,43,-43
36,29,34,17,72,97,-25
36,29,34,23,59,58,1
36,29,34,27,37,54,-17
36,29,34,35,0,23,-23
36,29,34,39,0,28,-28
36,29,36,1,135,155,-20
36,29,36,3,145,173,-28
36,29,36,5,189,188,1
36,29,36,7,152,109,43
36,29,36,9,1038,867,171
36,29,36,11,51,44,7
36,29,36,13,848,854,-6
36,29,36,15,71,54,17
36,29,36,17,39,0,39
36,29,36,19,60,33,27
36,29,36,23,28,0,28
36,29,36,27,71,44,27
36,29,36,37,524,524,0
36,29,36,45,116,87,29
36,29,36,47,312,429,-117
36,29,36,51,65,70,-5
36,29,36,53,47,0,47
36,29,36,55,1218,1159,59
36,29,36,59,109,99,10
36,29,36,61,262,481,-219
36,29,36,63,4512,5111,-599
36,29,36,65,99,96,3
36,29,36,67,407,387,20
36,29,36,69,135,151,-16
36,29,36,71,94,64,30
36,29,36,73,177,114,63
36,29,36,75,64,58,6
36,29,36,81,331,339,-8
36,29,36,83,54,53,1
36,29,36,85,31,32,-1
36,29,36,87,48,40,8
36,29,36,89,54,65,-11
36,29,36,91,72,101,-29
36,29,36,93,48,57,-9
36,29,36,99,30,25,5
36,29,36,101,101,69,32
36,29,36,103,123,107,16
36,29,36,105,40,0,40
36,29,36,107,31,0,31
36,29,36,109,74,46,28
36,29,36,111,73,27,46
36,29,36,117,59,49,10
36,29,36,119,109,114,-5
36,29,36,121,565,552,13
36,29,37,21,0,20,-20
36,29,37,25,0,55,-55
36,29,37,51,35,70,-35
36,29,37,63,0,45,-45
36,29,37,67,0,39,-39
36,29,37,71,28,37,-9
36,29,37,81,31,61,-30
36,29,37,97,0,74,-74
36,29,37,101,0,30,-30
36,29,37,119,154,581,-427
36,29,37,129,0,32,-32
36,29,37,133,72,67,5
36,29,37,159,0,29,-29
36,29,37,179,0,58,-58
36,29,37,183,103,310,-207
36,29,39,35,256,163,93
36,29,39,49,113,143,-30
36,29,39,61,31,53,-22
36,29,39,85,36,0,36
36,29,39,93,0,49,-49
36,29,39,95,44,0,44
36,29,39,113,0,30,-30
36,29,39,151,26,0,26
36,29,39,153,48,64,-16
36,29,41,51,0,67,-67
36,29,41,67,0,42,-42
36,29,42,3,169,222,-53
36,29,42,17,0,46,-46
36,29,42,27,42,22,20
36,29,42,29,0,41,-41
36,29,42,41,0,27,-27
36,29,42,43,0,26,-26
36,29,42,49,137,129,8
36,29,42,71,0,59,-59
36,29,42,77,45,32,13
36,29,42,79,0,26,-26
36,29,42,83,53,0,53
36,29,42,91,33,45,-12
36,29,42,101,61,112,-51
36,29,42,105,31,0,31
36,29,42,133,0,41,-41
36,29,44,7,28,40,-12
36,29,45,13,34,33,1
36,29,45,19,29,53,-24
36,29,45,35,0,37,-37
36,29,45,45,41,62,-21
36,29,45,51,42,89,-47
36,29,45,79,28,62,-34
36,29,45,91,0,56,-56
36,29,47,37,35,70,-35
36,29,47,157,34,39,-5
36,29,48,27,30,57,-27
36,29,48,29,57,96,-39
36,29,48,85,35,65,-30
36,29,48,113,55,81,-26
36,29,48,121,36,0,36
36,29,48,141,33,52,-19
36,29,48,201,109,183,-74
36,29,48,439,74,94,-20
36,29,48,453,41,49,-8
36,29,49,49,49,0,49
36,29,50,7,0,34,-34
36,29,51,13,44,64,-20
36,29,51,41,0,48,-48
36,29,51,59,95,153,-58
36,29,51,87,0,40,-40
36,29,51,107,0,57,-57
36,29,51,153,25,83,-58
36,29,51,510,0,55,-55
36,29,51,630,0,26,-26
36,29,51,650,0,31,-31
36,29,51,700,35,0,35
36,29,51,710,48,29,19
36,29,51,760,0,23,-23
36,29,51,810,73,53,20
36,29,53,33,50,118,-68
36,29,53,53,59,48,11
36,29,53,61,0,23,-23
36,29,55,25,0,39,-39
36,31,36,1,49,51,-2
36,31,36,19,291,394,-103
36,31,36,33,214,234,-20
36,31,36,45,0,26,-26
36,31,36,67,29,0,29
36,31,36,83,24,24,0
36,31,36,89,39,29,10
36,31,36,91,79,67,12
36,31,36,113,125,135,-10
36,31,36,115,55,67,-12
36,31,50,1,56,55,1
36,31,50,7,38,32,6
36,33,25,27,35,0,35
36,33,36,1,29,33,-4
36,33,36,19,229,273,-44
36,33,36,31,234,214,20
36,33,36,45,24,54,-30
36,33,36,55,24,0,24
36,33,36,65,26,0,26
36,33,36,67,52,46,6
36,33,36,83,0,25,-25
36,33,36,89,329,376,-47
36,33,36,91,42,45,-3
36,35,12,127,28,0,28
36,35,36,1,161,142,19
36,35,36,19,0,30,-30
36,35,36,41,30,49,-19
36,35,36,43,130,171,-41
36,35,36,57,878,807,71
36,35,36,65,32,54,-22
36,35,36,67,0,36,-36
36,35,36,83,56,37,19
36,35,36,91,279,222,57
36,35,36,93,195,165,30
36,35,36,95,48,0,48
36,37,36,9,0,29,-29
36,37,36,13,38,0,38
36,37,36,29,524,524,0
36,37,36,51,166,188,-22
36,37,36,55,551,767,-216
36,37,36,63,97,128,-31
36,37,36,67,0,26,-26
36,37,36,69,49,27,22
36,37,36,73,193,191,2
36,37,36,101,32,0,32
36,37,36,117,0,39,-39
36,37,36,121,376,384,-8
36,39,4,13,0,36,-36
36,39,36,1,474,506,-32
36,39,36,5,39,38,1
36,39,36,21,247,280,-33
36,39,36,25,38,51,-13
36,39,36,27,136,34,102
36,39,36,47,87,41,46
36,39,36,59,47,35,12
36,39,36,61,82,40,42
36,39,36,71,45,53,-8
36,39,36,81,120,54,66
36,39,36,83,49,85,-36
36,39,36,91,47,57,-10
36,39,36,93,0,67,-67
36,39,36,95,40,36,4
36,39,36,103,86,37,49
36,39,36,111,397,290,107
36,39,36,119,50,0,50
36,39,42,51,49,0,49
36,41,36,35,49,30,19
36,41,36,43,0,32,-32
36,41,36,91,0,30,-30
36,43,4,13,0,26,-26
36,43,36,1,59,96,-37
36,43,36,17,28,0,28
36,43,36,35,171,130,41
36,43,36,41,32,0,32
36,43,36,45,28,0,28
36,43,36,49,28,0,28
36,43,36,53,58,65,-7
36,43,36,55,0,57,-57
36,43,36,57,138,200,-62
36,43,36,65,1211,1244,-33
36,43,36,67,53,125,-72
36,43,36,75,36,0,36
36,43,36,77,185,172,13
36,43,36,83,0,25,-25
36,43,36,91,0,44,-44
36,43,36,93,0,28,-28
36,45,1,31,96,69,27
36,45,1,45,185,105,80
36,45,2,20,0,65,-65
36,45,2,90,44,71,-27
36,45,4,3,106,82,24
36,45,4,13,69,76,-7
36,45,4,19,50,36,14
36,45,6,37,80,73,7
36,45,6,53,57,34,23
36,45,6,59,33,34,-1
36,45,6,65,33,0,33
36,45,6,67,35,0,35
36,45,6,71,94,167,-73
36,45,6,73,90,50,40
36,45,6,95,37,0,37
36,45,8,41,103,238,-135
36,45,9,3,22,30,-8
36,45,12,9,0,51,-51
36,45,12,11,29,40,-11
36,45,12,31,39,46,-7
36,45,12,57,57,94,-37
36,45,12,71,36,27,9
36,45,12,86,60,0,60
36,45,12,91,59,33,26
36,45,12,95,53,55,-2
36,45,12,99,47,0,47
36,45,12,101,36,58,-22
36,45,12,103,45,41,4
36,45,12,105,29,52,-23
36,45,12,127,28,35,-7
36,45,13,51,48,71,-23
36,45,13,53,95,138,-43
36,45,13,73,0,40,-40
36,45,13,121,0,35,-35
36,45,13,179,72,89,-17
36,45,13,215,107,161,-54
36,45,13,245,92,105,-13
36,45,15,3,126,191,-65
36,45,17,31,83,65,18
36,45,18,97,0,41,-41
36,45,20,61,0,66,-66
36,45,20,103,163,108,55
36,45,20,161,0,40,-40
36,45,21,47,61,100,-39
36,45,21,93,76,92,-16
36,45,21,163,0,57,-57
36,45,22,115,37,74,-37
36,45,24,3,33,83,-50
36,45,24,5,22,35,-13
36,45,24,25,0,44,-44
36,45,24,31,0,39,-39
36,45,24,33,40,0,40
36,45,25,9,0,32,-32
36,45,25,17,0,34,-34
36,45,26,99,31,0,31
36,45,26,163,34,0,34
36,45,29,95,42,0,42
36,45,29,169,74,124,-50
36,45,32,3,45,62,-17
36,45,33,11,35,0,35
36,45,34,5,48,0,48
36,45,34,13,29,0,29
36,45,35,1,28,0,28
36,45,36,1,0,37,-37
36,45,36,5,45,44,1
36,45,36,7,40,47,-7
36,45,36,11,27,52,-25
36,45,36,19,40,38,2
36,45,36,23,0,28,-28
36,45,36,29,87,116,-29
36,45,36,31,26,0,26
36,45,36,33,54,24,30
36,45,36,43,0,28,-28
36,45,36,47,51,87,-36
36,45,36,49,526,346,180
36,45,36,55,105,151,-46
36,45,36,61,0,40,-40
36,45,36,65,115,87,28
36,45,36,67,274,383,-109
36,45,36,69,0,27,-27
36,45,36,71,43,64,-21
36,45,36,75,166,275,-109
36,45,36,81,72,40,32
36,45,36,89,621,475,146
36,45,36,91,0,40,-40
36,45,36,103,64,0,64
36,45,36,119,25,0,25
36,45,37,51,150,274,-124
36,45,37,85,0,56,-56
36,45,37,119,0,42,-42
36,45,37,183,0,63,-63
36,45,39,35,30,0,30
36,45,39,49,0,39,-39
36,45,40,31,152,170,-18
36,45,42,3,0,34,-34
36,45,42,41,0,58,-58
36,45,42,101,31,0,31
36,45,42,133,26,0,26
36,45,45,51,28,0,28
36,45,45,63,0,58,-58
36,45,45,79,93,305,-212
36,45,47,125,111,185,-74
36,45,47,157,0,39,-39
36,45,48,27,131,260,-129
36,45,48,29,178,190,-12
36,45,48,99,47,80,-33
36,45,48,113,56,51,5
36,45,48,121,0,37,-37
36,45,48,141,113,216,-103
36,45,48,201,85,101,-16
36,45,48,439,82,57,25
36,45,49,35,33,0,33
36,45,51,41,30,53,-23
36,45,51,59,61,201,-140
36,45,51,149,0,72,-72
36,45,51,153,0,55,-55
36,45,51,650,0,37,-37
36,45,51,700,45,131,-86
36,45,51,810,37,0,37
36,45,53,33,31,51,-20
36,45,53,53,99,217,-118
36,45,53,63,0,34,-34
36,45,53,67,35,104,-69
36,45,53,77,0,59,-59
36,47,1,73,53,67,-14
36,47,1,89,23,0,23
36,47,1,97,29,0,29
36,47,1,101,0,31,-31
36,47,2,20,0,39,-39
36,47,4,13,310,380,-70
36,47,4,19,108,106,2
36,47,4,21,0,34,-34
36,47,4,25,0,32,-32
36,47,5,119,31,62,-31
36,47,6,1,355,388,-33
36,47,6,13,97,93,4
36,47,6,19,24,32,-8
36,47,6,29,0,32,-32
36,47,6,37,1566,1830,-264
36,47,6,41,43,71,-28
36,47,6,53,28,0,28
36,47,6,59,224,216,8
36,47,6,65,93,92,1
36,47,6,67,91,71,20
36,47,6,71,142,70,72
36,47,6,73,442,347,95
36,47,6,75,828,759,69
36,47,6,79,24,0,24
36,47,6,81,100,91,9
36,47,6,83,68,40,28
36,47,6,85,195,226,-31
36,47,6,87,30,28,2
36,47,6,95,34,0,34
36,47,6,97,24,40,-16
36,47,6,111,56,40,16
36,47,8,5,50,69,-19
36,47,8,13,108,89,19
36,47,8,31,156,143,13
36,47,8,35,25,0,25
36,47,8,37,20,0,20
36,47,8,41,43,43,0
36,47,8,59,32,30,2
36,47,8,69,0,24,-24
36,47,9,1,741,866,-125
36,47,9,3,445,414,31
36,47,9,5,95,64,31
36,47,9,7,61,47,14
36,47,9,9,561,653,-92
36,47,9,11,229,303,-74
36,47,9,13,23,0,23
36,47,9,15,24,0,24
36,47,10,1,31,99,-68
36,47,10,3,189,278,-89
36,47,10,5,0,48,-48
36,47,11,1,671,487,184
36,47,12,1,84,37,47
36,47,12,9,116,261,-145
36,47,12,11,977,1369,-392
36,47,12,15,25,44,-19
36,47,12,17,0,61,-61
36,47,12,19,31,0,31
36,47,12,21,83,66,17
36,47,12,31,223,286,-63
36,47,12,33,23,0,23
36,47,12,35,98,103,-5
36,47,12,53,48,114,-66
36,47,12,57,400,550,-150
36,47,12,61,0,25,-25
36,47,12,69,92,134,-42
36,47,12,71,139,214,-75
36,47,12,73,81,26,55
36,47,12,81,37,35,2
36,47,12,83,107,173,-66
36,47,12,86,924,999,-75
36,47,12,95,593,835,-242
36,47,12,97,281,544,-263
36,47,12,99,559,815,-256
36,47,12,101,64,144,-80
36,47,12,103,138,220,-82
36,47,12,105,125,280,-155
36,47,12,109,25,47,-22
36,47,12,111,102,185,-83
36,47,12,115,124,100,24
36,47,12,117,143,201,-58
36,47,12,127,107,133,-26
36,47,13,51,62,99,-37
36,47,13,57,0,33,-33
36,47,13,59,41,0,41
36,47,13,63,152,264,-112
36,47,13,67,214,419,-205
36,47,13,89,363,665,-302
36,47,13,97,41,98,-57
36,47,13,113,0,39,-39
36,47,13,117,0,27,-27
36,47,13,121,423,584,-161
36,47,13,135,286,835,-549
36,47,13,151,71,324,-253
36,47,13,179,41,29,12
36,47,13,215,43,32,11
36,47,13,217,46,134,-88
36,47,13,223,0,46,-46
36,47,13,245,52,61,-9
36,47,13,247,0,163,-163
36,47,13,297,0,33,-33
36,47,15,3,148,165,-17
36,47,17,19,55,0,55
36,47,17,31,1068,840,228
36,47,17,43,106,67,39
36,47,17,97,65,48,17
36,47,18,3,40,0,40
36,47,18,89,28,0,28
36,47,18,97,69,114,-45
36,47,18,105,40,0,40
36,47,19,103,30,44,-14
36,47,19,153,42,0,42
36,47,20,91,71,40,31
36,47,20,173,22,0,22
36,47,21,47,0,33,-33
36,47,21,67,43,41,2
36,47,21,111,68,89,-21
36,47,22,33,53,0,53
36,47,22,51,33,85,-52
36,47,22,71,83,142,-59
36,47,22,115,26,0,26
36,47,23,5,122,85,37
36,47,23,31,42,0,42
36,47,24,3,85,124,-39
36,47,24,5,286,341,-55
36,47,24,17,30,32,-2
36,47,24,21,69,39,30
36,47,24,25,29,37,-8
36,47,24,27,86,75,11
36,47,24,31,479,369,110
36,47,24,33,367,456,-89
36,47,24,43,29,39,-10
36,47,24,47,23,0,23
36,47,24,510,279,287,-8
36,47,25,1,56,27,29
36,47,25,3,60,76,-16
36,47,25,5,62,38,24
36,47,25,9,222,182,40
36,47,25,11,29,25,4
36,47,25,13,165,152,13
36,47,25,15,126,102,24
36,47,25,17,928,575,353
36,47,25,19,28,0,28
36,47,25,21,336,165,171
36,47,25,23,60,57,3
36,47,25,25,736,483,253
36,47,25,27,143,139,4
36,47,26,65,48,38,10
36,47,26,77,31,0,31
36,47,26,81,57,30,27
36,47,26,99,42,46,-4
36,47,26,125,190,92,98
36,47,26,161,164,99,65
36,47,26,163,210,133,77
36,47,27,37,26,24,2
36,47,27,53,328,205,123
36,47,27,123,78,48,30
36,47,29,95,105,68,37
36,47,29,189,95,59,36
36,47,29,510,54,37,17
36,47,31,55,58,0,58
36,47,32,3,161,304,-143
36,47,32,31,28,0,28
36,47,33,9,21,33,-12
36,47,33,11,73,68,5
36,47,33,13,25,0,25
36,47,33,15,55,31,24
36,47,33,17,29,0,29
36,47,34,1,157,192,-35
36,47,34,3,924,1698,-774
36,47,34,5,223,351,-128
36,47,34,7,167,215,-48
36,47,34,9,29,38,-9
36,47,34,11,0,45,-45
36,47,34,13,1194,2003,-809
36,47,34,15,56,61,-5
36,47,34,17,1649,2401,-752
36,47,34,19,77,74,3
36,47,34,21,310,443,-133
36,47,34,23,973,1936,-963
36,47,34,25,628,1310,-682
36,47,34,27,268,322,-54
36,47,34,29,275,817,-542
36,47,34,31,366,512,-146
36,47,34,35,185,331,-146
36,47,34,37,71,76,-5
36,47,34,39,557,979,-422
36,47,34,41,46,58,-12
36,47,35,1,63,34,29
36,47,35,49,37,28,9
36,47,36,1,450,456,-6
36,47,36,5,7380,8172,-792
36,47,36,7,216,212,4
36,47,36,13,26,0,26
36,47,36,15,38,0,38
36,47,36,19,27,0,27
36,47,36,21,75,82,-7
36,47,36,25,46,82,-36
36,47,36,27,367,409,-42
36,47,36,29,429,312,117
36,47,36,39,41,87,-46
36,47,36,45,87,51,36
36,47,36,53,25,0,25
36,47,36,55,437,279,158
36,47,36,57,27,43,-16
36,47,36,59,3358,5757,-2399
36,47,36,61,27021,17212,9809
36,47,36,63,50,0,50
36,47,36,65,104,89,15
36,47,36,67,253,261,-8
36,47,36,69,0,23,-23
36,47,36,71,520,1022,-502
36,47,36,77,27,0,27
36,47,36,79,112,174,-62
36,47,36,81,22656,32029,-9373
36,47,36,83,124,134,-10
36,47,36,85,3993,10119,-6126
36,47,36,87,557,957,-400
36,47,36,89,29,25,4
36,47,36,91,82,103,-21
36,47,36,93,142,165,-23
36,47,36,103,2466,3481,-1015
36,47,36,105,176,224,-48
36,47,36,109,151,97,54
36,47,36,111,236,304,-68
36,47,36,113,23,36,-13
36,47,36,119,1652,1964,-312
36,47,37,1,0,44,-44
36,47,37,19,0,27,-27
36,47,37,21,26,78,-52
36,47,37,25,0,67,-67
36,47,37,35,0,29,-29
36,47,37,49,27,0,27
36,47,37,51,124,235,-111
36,47,37,63,121,198,-77
36,47,37,67,49,44,5
36,47,37,81,126,216,-90
36,47,37,101,0,64,-64
36,47,37,119,303,827,-524
36,47,37,127,0,30,-30
36,47,37,129,32,80,-48
36,47,37,133,101,94,7
36,47,37,135,86,69,17
36,47,37,147,0,55,-55
36,47,37,155,0,43,-43
36,47,37,179,0,111,-111
36,47,37,183,220,501,-281
36,47,37,191,0,42,-42
36,47,37,195,0,29,-29
36,47,39,17,43,26,17
36,47,39,35,289,173,116
36,47,39,49,365,239,126
36,47,39,61,134,122,12
36,47,39,85,20,0,20
36,47,39,93,38,0,38
36,47,39,95,27,0,27
36,47,39,99,41,0,41
36,47,39,113,39,0,39
36,47,39,151,38,0,38
36,47,39,153,61,0,61
36,47,40,27,23,0,23
36,47,40,109,47,70,-23
36,47,40,143,37,0,37
36,47,41,5,30,30,0
36,47,41,39,34,24,10
36,47,41,51,240,356,-116
36,47,41,67,35,51,-16
36,47,42,3,274,188,86
36,47,42,11,281,416,-135
36,47,42,17,230,214,16
36,47,42,25,0,78,-78
36,47,42,27,44,28,16
36,47,42,29,107,85,22
36,47,42,41,34,38,-4
36,47,42,43,113,166,-53
36,47,42,45,144,221,-77
36,47,42,69,78,141,-63
36,47,42,71,154,167,-13
36,47,42,75,84,61,23
36,47,42,77,336,828,-492
36,47,42,79,148,466,-318
36,47,42,89,334,903,-569
36,47,42,91,258,187,71
36,47,42,95,143,380,-237
36,47,42,101,1165,1481,-316
36,47,42,103,88,323,-235
36,47,42,127,45,75,-30
36,47,42,129,30,0,30
36,47,42,133,75,82,-7
36,47,44,3,48,0,48
36,47,44,5,46,0,46
36,47,44,7,319,256,63
36,47,44,9,38,0,38
36,47,45,13,52,59,-7
36,47,45,15,34,71,-37
36,47,45,19,71,118,-47
36,47,45,35,0,44,-44
36,47,45,41,23,40,-17
36,47,45,45,28,83,-55
36,47,45,51,36,55,-19
36,47,45,63,26,50,-24
36,47,45,75,0,37,-37
36,47,45,79,83,125,-42
36,47,45,83,0,42,-42
36,47,45,85,0,37,-37
36,47,45,91,37,47,-10
36,47,47,37,140,140,0
36,47,47,93,45,45,0
36,47,47,125,0,37,-37
36,47,47,157,80,65,15
36,47,47,187,21,0,21
36,47,48,27,84,120,-36
36,47,48,29,100,128,-28
36,47,48,85,63,89,-26
36,47,48,113,227,252,-25
36,47,48,121,47,58,-11
36,47,48,141,41,52,-11
36,47,48,157,43,139,-96
36,47,48,201,371,560,-189
36,47,48,303,34,0,34
36,47,48,339,0,30,-30
36,47,48,439,107,132,-25
36,47,48,453,301,342,-41
36,47,48,491,32,33,-1
36,47,49,35,73,36,37
36,47,49,49,41,0,41
36,47,50,1,24,0,24
36,47,50,7,109,64,45
36,47,50,25,30,31,-1
36,47,50,27,23,0,23
36,47,51,3,20,0,20
36,47,51,13,132,105,27
36,47,51,41,60,138,-78
36,47,51,59,346,249,97
36,47,51,87,62,244,-182
36,47,51,107,78,46,32
36,47,51,153,94,112,-18
36,47,51,179,0,37,-37
36,47,51,510,106,110,-4
36,47,51,540,32,28,4
36,47,51,550,39,63,-24
36,47,51,650,57,106,-49
36,47,51,700,104,123,-19
36,47,51,710,141,166,-25
36,47,51,730,29,32,-3
36,47,51,740,36,48,-12
36,47,51,760,152,189,-37
36,47,51,770,26,34,-8
36,47,51,810,160,149,11
36,47,53,33,507,375,132
36,47,53,35,39,0,39
36,47,53,53,60,93,-33
36,47,53,61,26,0,26
36,47,53,63,23,0,23
36,47,55,25,122,69,53
36,47,55,79,122,83,39
36,49,36,43,0,28,-28
36,49,36,45,346,526,-180
36,49,36,65,197,214,-17
36,49,36,67,0,35,-35
36,49,36,75,0,39,-39
36,49,36,89,37,43,-6
36,51,36,1,0,33,-33
36,51,36,3,133,95,38
36,51,36,29,70,65,5
36,51,36,37,188,166,22
36,51,36,55,1206,1403,-197
36,51,36,67,0,30,-30
36,51,36,69,192,254,-62
36,51,36,73,27,39,-12
36,51,36,101,411,310,101
36,51,36,117,85,35,50
36,51,36,121,240,211,29
36,51,36,123,0,34,-34
36,51,37,119,0,20,-20
36,51,37,183,0,36,-36
36,53,25,17,0,27,-27
36,53,36,1,0,36,-36
36,53,36,11,35,37,-2
36,53,36,17,210,195,15
36,53,36,23,69,87,-18
36,53,36,29,0,47,-47
36,53,36,43,65,58,7
36,53,36,47,0,25,-25
36,53,36,55,35,58,-23
36,53,36,61,0,38,-38
36,53,36,65,1104,992,112
36,53,36,67,1132,1165,-33
36,53,36,75,88,115,-27
36,53,36,77,72,51,21
36,53,36,109,0,30,-30
36,53,37,119,0,28,-28
36,55,1,73,39,0,39
36,55,1,89,0,56,-56
36,55,4,13,151,330,-179
36,55,4,19,57,60,-3
36,55,4,21,0,28,-28
36,55,6,1,40,80,-40
36,55,6,37,167,307,-140
36,55,6,59,71,74,-3
36,55,6,65,36,42,-6
36,55,6,67,0,36,-36
36,55,6,71,33,30,3
36,55,6,73,145,208,-63
36,55,6,75,27,79,-52
36,55,6,81,31,36,-5
36,55,6,85,58,146,-88
36,55,8,5,0,33,-33
36,55,8,13,26,49,-23
36,55,8,31,31,48,-17
36,55,8,41,29,43,-14
36,55,8,69,0,58,-58
36,55,9,1,90,83,7
36,55,9,3,98,107,-9
36,55,9,9,51,107,-56
36,55,9,11,32,45,-13
36,55,10,1,26,0,26
36,55,10,3,57,27,30
36,55,11,1,69,139,-70
36,55,12,1,32,0,32
36,55,12,9,65,98,-33
36,55,12,11,160,193,-33
36,55,12,15,25,45,-20
36,55,12,21,44,61,-17
36,55,12,31,85,94,-9
36,55,12,53,0,23,-23
36,55,12,57,206,265,-59
36,55,12,69,46,74,-28
36,55,12,71,114,126,-12
36,55,12,81,43,66,-23
36,55,12,83,31,57,-26
36,55,12,86,114,139,-25
36,55,12,95,178,173,5
36,55,12,97,35,44,-9
36,55,12,99,140,172,-32
36,55,12,101,55,71,-16
36,55,12,103,86,201,-115
36,55,12,105,61,129,-68
36,55,12,111,0,42,-42
36,55,12,115,34,67,-33
36,55,12,117,55,117,-62
36,55,12,119,0,46,-46
36,55,12,127,61,93,-32
36,55,13,51,0,25,-25
36,55,13,67,43,129,-86
36,55,13,89,73,100,-27
36,55,13,117,0,39,-39
36,55,13,121,74,132,-58
36,55,13,135,45,142,-97
36,55,15,3,55,62,-7
36,55,17,31,149,190,-41
36,55,17,43,27,62,-35
36,55,17,97,0,49,-49
36,55,18,57,0,34,-34
36,55,18,97,0,47,-47
36,55,18,141,0,24,-24
36,55,19,163,0,40,-40
36,55,20,91,0,27,-27
36,55,21,67,0,35,-35
36,55,22,71,0,28,-28
36,55,23,5,37,45,-8
36,55,23,31,25,0,25
36,55,24,3,42,63,-21
36,55,24,5,74,72,2
36,55,24,27,47,0,47
36,55,24,31,96,130,-34
36,55,24,33,33,39,-6
36,55,24,510,64,69,-5
36,55,25,3,25,0,25
36,55,25,9,70,69,1
36,55,25,13,49,0,49
36,55,25,15,46,0,46
36,55,25,17,225,285,-60
36,55,25,21,55,129,-74
36,55,25,25,96,162,-66
36,55,25,27,57,85,-28
36,55,26,65,28,0,28
36,55,26,81,25,0,25
36,55,26,99,30,0,30
36,55,26,125,79,90,-11
36,55,26,139,40,0,40
36,55,26,161,52,74,-22
36,55,26,163,35,36,-1
36,55,27,53,44,69,-25
36,55,29,95,0,25,-25
36,55,29,189,47,33,14
36,55,29,510,0,40,-40
36,55,32,3,94,240,-146
36,55,33,11,40,31,9
36,55,33,15,0,38,-38
36,55,34,3,59,72,-13
36,55,34,5,34,0,34
36,55,34,7,24,26,-2
36,55,34,13,59,51,8
36,55,34,17,59,95,-36
36,55,34,21,0,52,-52
36,55,34,23,60,93,-33
36,55,34,27,40,45,-5
36,55,34,29,31,0,31
36,55,34,31,33,28,5
36,55,34,35,0,40,-40
36,55,35,1,0,33,-33
36,55,36,1,154,221,-67
36,55,36,3,115,130,-15
36,55,36,5,173,159,14
36,55,36,7,200,109,91
36,55,36,9,106,33,73
36,55,36,11,128,70,58
36,55,36,13,120,112,8
36,55,36,15,138,107,31
36,55,36,17,43,0,43
36,55,36,19,24,0,24
36,55,36,21,24,0,24
36,55,36,23,40,30,10
36,55,36,27,70,30,40
36,55,36,29,1159,1218,-59
36,55,36,33,0,24,-24
36,55,36,37,767,551,216
36,55,36,43,57,0,57
36,55,36,45,151,105,46
36,55,36,47,279,437,-158
36,55,36,51,1403,1206,197
36,55,36,53,58,35,23
36,55,36,57,25,0,25
36,55,36,59,98,60,38
36,55,36,61,247,439,-192
36,55,36,63,254,191,63
36,55,36,65,184,114,70
36,55,36,67,665,480,185
36,55,36,69,1655,1973,-318
36,55,36,71,63,61,2
36,55,36,73,968,892,76
36,55,36,75,143,95,48
36,55,36,77,57,25,32
36,55,36,81,199,236,-37
36,55,36,83,66,51,15
36,55,36,85,34,28,6
36,55,36,87,33,45,-12
36,55,36,89,103,104,-1
36,55,36,91,107,112,-5
36,55,36,93,87,52,35
36,55,36,97,0,34,-34
36,55,36,99,128,88,40
36,55,36,101,308,198,110
36,55,36,103,173,126,47
36,55,36,105,32,0,32
36,55,36,109,143,147,-4
36,55,36,111,43,43,0
36,55,36,117,2181,2178,3
36,55,36,119,136,113,23
36,55,36,121,160,106,54
36,55,36,123,147,68,79
36,55,37,21,28,0,28
36,55,37,25,0,61,-61
36,55,37,51,38,63,-25
36,55,37,63,0,69,-69
36,55,37,67,0,66,-66
36,55,37,71,0,42,-42
36,55,37,81,52,84,-32
36,55,37,97,0,32,-32
36,55,37,119,116,441,-325
36,55,37,129,0,38,-38
36,55,37,133,63,40,23
36,55,37,135,0,45,-45
36,55,37,179,0,66,-66
36,55,37,183,134,352,-218
36,55,39,35,93,109,-16
36,55,39,49,69,95,-26
36,55,39,61,0,48,-48
36,55,39,95,40,0,40
36,55,39,113,41,26,15
36,55,39,153,0,36,-36
36,55,39,165,0,38,-38
36,55,41,51,30,53,-23
36,55,41,67,0,30,-30
36,55,42,3,122,169,-47
36,55,42,11,25,49,-24
36,55,42,17,29,66,-37
36,55,42,27,0,32,-32
36,55,42,29,34,62,-28
36,55,42,41,0,33,-33
36,55,42,43,0,38,-38
36,55,42,45,0,25,-25
36,55,42,49,78,41,37
36,55,42,71,31,61,-30
36,55,42,77,30,0,30
36,55,42,79,34,0,34
36,55,42,91,86,103,-17
36,55,42,101,97,134,-37
36,55,42,133,43,34,9
36,55,44,7,88,42,46
36,55,45,13,0,52,-52
36,55,45,19,41,37,4
36,55,45,35,0,36,-36
36,55,45,45,33,89,-56
36,55,45,51,39,41,-2
36,55,45,79,0,43,-43
36,55,45,83,0,37,-37
36,55,45,91,0,60,-60
36,55,47,37,0,48,-48
36,55,47,93,0,32,-32
36,55,47,149,0,38,-38
36,55,47,157,32,0,32
36,55,48,27,42,42,0
36,55,48,29,0,86,-86
36,55,48,85,51,91,-40
36,55,48,113,98,59,39
36,55,48,121,0,62,-62
36,55,48,141,30,0,30
36,55,48,157,0,38,-38
36,55,48,201,63,149,-86
36,55,48,439,35,45,-10
36,55,48,453,38,81,-43
36,55,48,491,0,36,-36
36,55,49,35,47,37,10
36,55,50,7,0,60,-60
36,55,51,13,0,104,-104
36,55,51,41,0,34,-34
36,55,51,59,83,184,-101
36,55,51,87,0,31,-31
36,55,51,107,0,83,-83
36,55,51,153,0,70,-70
36,55,51,510,0,67,-67
36,55,51,710,26,0,26
36,55,51,760,0,33,-33
36,55,51,810,55,72,-17
36,55,53,33,76,124,-48
36,55,53,53,0,61,-61
36,55,55,25,0,36,-36
36,55,55,79,23,0,23
36,57,4,13,0,25,-25
36,57,12,11,32,0,32
36,57,12,95,0,24,-24
36,57,12,103,0,28,-28
36,57,36,1,267,195,72
36,57,36,5,34,0,34
36,57,36,27,33,0,33
36,57,36,35,807,878,-71
36,57,36,43,200,138,62
36,57,36,47,43,27,16
36,57,36,55,0,25,-25
36,57,36,65,43,42,1
36,57,36,77,27,24,3
36,57,36,81,33,0,33
36,57,36,83,72,53,19
36,57,36,91,224,243,-19
36,57,36,93,456,371,85
36,57,36,95,163,138,25
36,57,36,103,32,34,-2
36,59,4,13,140,432,-292
36,59,4,19,27,54,-27
36,59,4,21,0,39,-39
36,59,6,1,32,61,-29
36,59,6,13,25,0,25
36,59,6,37,402,576,-174
36,59,6,59,75,164,-89
36,59,6,65,38,56,-18
36,59,6,71,0,48,-48
36,59,6,73,144,284,-140
36,59,6,75,59,100,-41
36,59,6,81,0,52,-52
36,59,6,85,42,90,-48
36,59,6,111,0,43,-43
36,59,8,5,0,29,-29
36,59,8,13,0,40,-40
36,59,8,31,45,38,7
36,59,8,41,0,41,-41
36,59,9,1,323,451,-128
36,59,9,3,130,192,-62
36,59,9,5,0,27,-27
36,59,9,7,31,34,-3
36,59,9,9,112,184,-72
36,59,9,11,30,40,-10
36,59,10,1,0,40,-40
36,59,10,3,68,132,-64
36,59,10,5,0,47,-47
36,59,11,1,121,140,-19
36,59,12,9,73,182,-109
36,59,12,11,525,785,-260
36,59,12,15,0,59,-59
36,59,12,17,0,68,-68
36,59,12,21,53,116,-63
36,59,12,31,75,137,-62
36,59,12,35,23,98,-75
36,59,12,53,44,117,-73
36,59,12,57,154,339,-185
36,59,12,61,0,62,-62
36,59,12,69,47,150,-103
36,59,12,71,62,205,-143
36,59,12,73,0,26,-26
36,59,12,81,26,78,-52
36,59,12,83,32,144,-112
36,59,12,85,55,94,-39
36,59,12,86,254,402,-148
36,59,12,87,0,28,-28
36,59,12,95,226,326,-100
36,59,12,97,54,176,-122
36,59,12,99,520,1440,-920
36,59,12,101,97,235,-138
36,59,12,103,72,194,-122
36,59,12,105,50,135,-85
36,59,12,109,0,60,-60
36,59,12,111,83,164,-81
36,59,12,115,37,123,-86
36,59,12,117,54,63,-9
36,59,12,119,0,83,-83
36,59,12,127,53,91,-38
36,59,13,51,25,24,1
36,59,13,57,0,70,-70
36,59,13,63,0,60,-60
36,59,13,67,99,253,-154
36,59,13,77,0,59,-59
36,59,13,89,79,139,-60
36,59,13,97,0,68,-68
36,59,13,113,0,62,-62
36,59,13,117,0,43,-43
36,59,13,121,109,227,-118
36,59,13,135,107,495,-388
36,59,13,139,0,47,-47
36,59,13,151,30,117,-87
36,59,13,217,0,51,-51
36,59,13,223,0,67,-67
36,59,13,245,0,28,-28
36,59,13,247,0,78,-78
36,59,15,3,65,64,1
36,59,17,31,165,261,-96
36,59,17,43,52,33,19
36,59,18,97,0,43,-43
36,59,20,173,0,35,-35
36,59,21,111,0,30,-30
36,59,22,71,0,21,-21
36,59,23,5,0,44,-44
36,59,24,3,62,57,5
36,59,24,5,104,129,-25
36,59,24,21,0,27,-27
36,59,24,27,0,68,-68
36,59,24,31,135,195,-60
36,59,24,33,87,120,-33
36,59,24,510,86,131,-45
36,59,25,1,0,34,-34
36,59,25,3,0,33,-33
36,59,25,5,0,25,-25
36,59,25,9,50,64,-14
36,59,25,13,34,40,-6
36,59,25,15,0,30,-30
36,59,25,17,177,278,-101
36,59,25,21,86,134,-48
36,59,25,23,0,49,-49
36,59,25,25,125,194,-69
36,59,25,27,39,58,-19
36,59,26,125,38,40,-2
36,59,26,161,24,29,-5
36,59,26,163,36,0,36
36,59,27,53,43,24,19
36,59,29,189,35,42,-7
36,59,31,55,0,39,-39
36,59,32,3,133,330,-197
36,59,33,11,23,53,-30
36,59,34,1,33,0,33
36,59,34,3,298,443,-145
36,59,34,5,0,61,-61
36,59,34,7,50,96,-46
36,59,34,13,177,184,-7
36,59,34,17,453,555,-102
36,59,34,19,0,39,-39
36,59,34,21,57,130,-73
36,59,34,23,253,374,-121
36,59,34,25,94,241,-147
36,59,34,27,116,111,5
36,59,34,29,74,119,-45
36,59,34,31,98,89,9
36,59,34,35,57,128,-71
36,59,34,37,0,34,-34
36,59,34,39,141,128,13
36,59,36,1,116,147,-31
36,59,36,5,1176,780,396
36,59,36,7,38,47,-9
36,59,36,21,0,25,-25
36,59,36,25,33,60,-27
36,59,36,27,114,188,-74
36,59,36,29,99,109,-10
36,59,36,39,35,47,-12
36,59,36,47,5757,3358,2399
36,59,36,55,60,98,-38
36,59,36,61,3843,4585,-742
36,59,36,65,0,52,-52
36,59,36,67,90,76,14
36,59,36,69,0,28,-28
36,59,36,71,133,289,-156
36,59,36,77,30,0,30
36,59,36,79,78,69,9
36,59,36,81,21853,11443,10410
36,59,36,83,40,31,9
36,59,36,85,350,296,54
36,59,36,87,143,223,-80
36,59,36,91,0,205,-205
36,59,36,93,44,51,-7
36,59,36,103,10042,15284,-5242
36,59,36,105,53,86,-33
36,59,36,109,29,38,-9
36,59,36,111,69,116,-47
36,59,36,113,0,41,-41
36,59,36,119,669,871,-202
36,59,37,1,0,43,-43
36,59,37,19,0,46,-46
36,59,37,25,0,69,-69
36,59,37,37,0,45,-45
36,59,37,49,0,33,-33
36,59,37,51,26,53,-27
36,59,37,63,0,124,-124
36,59,37,67,0,85,-85
36,59,37,81,32,126,-94
36,59,37,97,0,116,-116
36,59,37,101,0,67,-67
36,59,37,119,121,797,-676
36,59,37,125,0,27,-27
36,59,37,129,0,80,-80
36,59,37,133,74,71,3
36,59,37,147,0,32,-32
36,59,37,179,0,375,-375
36,59,37,183,65,827,-762
36,59,39,35,40,37,3
36,59,39,49,39,78,-39
36,59,39,61,0,29,-29
36,59,41,51,0,27,-27
36,59,42,3,42,61,-19
36,59,42,11,44,79,-35
36,59,42,17,50,104,-54
36,59,42,29,38,56,-18
36,59,42,43,26,0,26
36,59,42,45,0,64,-64
36,59,42,69,0,43,-43
36,59,42,71,24,65,-41
36,59,42,77,97,162,-65
36,59,42,79,30,94,-64
36,59,42,89,88,223,-135
36,59,42,91,63,105,-42
36,59,42,95,0,67,-67
36,59,42,101,186,279,-93
36,59,42,103,44,114,-70
36,59,42,127,0,99,-99
36,59,42,133,0,44,-44
36,59,44,3,0,28,-28
36,59,44,7,51,92,-41
36,59,45,13,0,92,-92
36,59,45,15,0,39,-39
36,59,45,19,0,69,-69
36,59,45,35,0,56,-56
36,59,45,45,0,74,-74
36,59,45,51,28,165,-137
36,59,45,63,0,31,-31
36,59,45,79,0,68,-68
36,59,45,91,0,126,-126
36,59,47,37,35,40,-5
36,59,47,149,0,41,-41
36,59,47,157,0,22,-22
36,59,48,27,0,29,-29
36,59,48,29,26,82,-56
36,59,48,85,33,118,-85
36,59,48,113,104,174,-70
36,59,48,121,0,62,-62
36,59,48,157,0,139,-139
36,59,48,201,125,457,-332
36,59,48,339,0,70,-70
36,59,48,439,55,134,-79
36,59,48,453,0,81,-81
36,59,48,491,0,26,-26
36,59,50,7,0,38,-38
36,59,51,3,0,26,-26
36,59,51,13,64,100,-36
36,59,51,41,0,90,-90
36,59,51,59,117,200,-83
36,59,51,87,0,41,-41
36,59,51,95,0,47,-47
36,59,51,107,39,85,-46
36,59,51,153,55,64,-9
36,59,51,177,0,38,-38
36,59,51,510,33,23,10
36,59,51,710,50,41,9
36,59,51,760,0,25,-25
36,59,51,810,88,106,-18
36,59,53,33,42,102,-60
36,59,55,25,37,0,37
36,61,1,73,92,88,4
36,61,1,81,39,0,39
36,61,1,89,26,43,-17
36,61,1,97,44,0,44
36,61,1,101,40,0,40
36,61,2,20,39,0,39
36,61,4,13,468,469,-1
36,61,4,19,93,119,-26
36,61,5,119,44,0,44
36,61,5,143,38,0,38
36,61,6,1,522,542,-20
36,61,6,13,237,183,54
36,61,6,19,57,28,29
36,61,6,29,35,24,11
36,61,6,37,3867,4427,-560
36,61,6,41,118,133,-15
36,61,6,53,39,54,-15
36,61,6,55,35,38,-3
36,61,6,59,728,615,113
36,61,6,61,28,0,28
36,61,6,65,126,162,-36
36,61,6,67,137,109,28
36,61,6,71,115,102,13
36,61,6,73,829,695,134
36,61,6,75,1800,1999,-199
36,61,6,77,39,0,39
36,61,6,79,33,0,33
36,61,6,81,279,324,-45
36,61,6,83,100,69,31
36,61,6,85,736,632,104
36,61,6,87,67,37,30
36,61,6,95,47,0,47
36,61,6,97,67,30,37
36,61,6,111,115,59,56
36,61,6,113,35,37,-2
36,61,8,1,29,0,29
36,61,8,5,113,74,39
36,61,8,13,136,127,9
36,61,8,31,347,349,-2
36,61,8,35,30,0,30
36,61,8,37,25,0,25
36,61,8,41,53,48,5
36,61,8,59,80,48,32
36,61,8,69,51,0,51
36,61,8,97,35,37,-2
36,61,8,117,0,23,-23
36,61,9,1,2713,2896,-183
36,61,9,3,638,406,232
36,61,9,5,158,196,-38
36,61,9,7,128,70,58
36,61,9,9,994,854,140
36,61,9,11,164,229,-65
36,61,9,13,68,24,44
36,61,9,15,30,0,30
36,61,10,1,0,28,-28
36,61,10,3,271,200,71
36,61,10,5,40,42,-2
36,61,11,1,2031,1263,768
36,61,12,1,133,75,58
36,61,12,9,96,44,52
36,61,12,11,867,859,8
36,61,12,21,82,106,-24
36,61,12,31,174,194,-20
36,61,12,33,25,30,-5
36,61,12,35,22,38,-16
36,61,12,53,0,49,-49
36,61,12,57,443,462,-19
36,61,12,61,23,37,-14
36,61,12,69,29,60,-31
36,61,12,71,118,140,-22
36,61,12,73,114,39,75
36,61,12,81,60,52,8
36,61,12,83,25,55,-30
36,61,12,85,29,31,-2
36,61,12,86,1662,1638,24
36,61,12,87,24,0,24
36,61,12,95,623,519,104
36,61,12,97,170,271,-101
36,61,12,99,743,820,-77
36,61,12,101,43,67,-24
36,61,12,103,211,187,24
36,61,12,105,74,85,-11
36,61,12,109,32,43,-11
36,61,12,111,33,106,-73
36,61,12,113,21,0,21
36,61,12,115,126,94,32
36,61,12,117,128,120,8
36,61,12,127,76,111,-35
36,61,13,21,31,0,31
36,61,13,51,69,65,4
36,61,13,57,37,0,37
36,61,13,59,41,27,14
36,61,13,63,46,46,0
36,61,13,67,261,227,34
36,61,13,89,364,368,-4
36,61,13,113,28,0,28
36,61,13,121,808,684,124
36,61,13,135,178,218,-40
36,61,13,151,0,51,-51
36,61,13,245,39,37,2
36,61,15,3,213,204,9
36,61,15,9,0,34,-34
36,61,16,1,26,0,26
36,61,17,19,87,26,61
36,61,17,31,2766,2005,761
36,61,17,43,172,84,88
36,61,17,89,43,32,11
36,61,17,97,191,75,116
36,61,17,119,23,0,23
36,61,17,197,55,0,55
36,61,18,3,26,0,26
36,61,18,57,40,39,1
36,61,18,89,33,28,5
36,61,18,97,148,98,50
36,61,18,105,93,49,44
36,61,18,141,56,37,19
36,61,18,157,33,28,5
36,61,19,103,48,48,0
36,61,19,113,26,0,26
36,61,19,153,51,40,11
36,61,20,45,38,35,3
36,61,20,91,142,51,91
36,61,20,173,39,28,11
36,61,20,177,21,0,21
36,61,21,67,57,0,57
36,61,21,111,106,80,26
36,61,21,117,0,24,-24
36,61,22,17,28,0,28
36,61,22,33,67,41,26
36,61,22,51,62,58,4
36,61,22,55,66,101,-35
36,61,22,71,128,217,-89
36,61,22,103,22,0,22
36,61,23,1,22,0,22
36,61,23,5,121,138,-17
36,61,23,19,0,23,-23
36,61,23,31,41,25,16
36,61,24,3,138,86,52
36,61,24,5,356,188,168
36,61,24,21,36,34,2
36,61,24,25,43,40,3
36,61,24,27,128,67,61
36,61,24,31,1002,670,332
36,61,24,33,210,230,-20
36,61,24,43,29,0,29
36,61,24,510,443,275,168
36,61,25,1,117,86,31
36,61,25,3,94,87,7
36,61,25,5,111,58,53
36,61,25,9,468,438,30
36,61,25,11,36,0,36
36,61,25,13,151,141,10
36,61,25,15,149,118,31
36,61,25,17,2151,1284,867
36,61,25,21,757,484,273
36,61,25,23,138,111,27
36,61,25,25,1915,1408,507
36,61,25,27,317,168,149
36,61,26,49,29,0,29
36,61,26,65,83,50,33
36,61,26,77,30,0,30
36,61,26,81,109,52,57
36,61,26,93,27,0,27
36,61,26,99,74,45,29
36,61,26,125,498,178,320
36,61,26,139,23,0,23
36,61,26,161,455,191,264
36,61,26,163,262,90,172
36,61,27,3,26,26,0
36,61,27,37,54,0,54
36,61,27,53,503,352,151
36,61,27,109,39,0,39
36,61,27,123,125,56,69
36,61,27,139,23,0,23
36,61,27,163,43,0,43
36,61,29,19,51,0,51
36,61,29,77,0,27,-27
36,61,29,95,96,66,30
36,61,29,183,28,0,28
36,61,29,189,380,119,261
36,61,29,510,91,92,-1
36,61,31,55,89,50,39
36,61,31,109,21,0,21
36,61,32,3,287,421,-134
36,61,32,31,57,22,35
36,61,33,1,25,0,25
36,61,33,9,143,75,68
36,61,33,11,125,68,57
36,61,33,13,0,29,-29
36,61,33,15,90,79,11
36,61,34,1,142,87,55
36,61,34,3,3032,4231,-1199
36,61,34,5,238,176,62
36,61,34,7,299,160,139
36,61,34,9,35,27,8
36,61,34,11,37,0,37
36,61,34,13,1585,2061,-476
36,61,34,15,44,33,11
36,61,34,17,4143,6188,-2045
36,61,34,19,137,105,32
36,61,34,21,808,529,279
36,61,34,23,1232,1196,36
36,61,34,25,1057,835,222
36,61,34,27,1001,774,227
36,61,34,29,274,216,58
36,61,34,31,768,852,-84
36,61,34,35,503,322,181
36,61,34,37,86,89,-3
36,61,34,39,756,1063,-307
36,61,34,41,43,47,-4
36,61,35,1,95,90,5
36,61,35,49,61,73,-12
36,61,36,1,390,273,117
36,61,36,5,17919,26584,-8665
36,61,36,7,130,91,39
36,61,36,13,41,33,8
36,61,36,15,34,0,34
36,61,36,19,31,0,31
36,61,36,21,78,198,-120
36,61,36,25,47,56,-9
36,61,36,27,475,538,-63
36,61,36,29,481,262,219
36,61,36,39,40,82,-42
36,61,36,45,40,0,40
36,61,36,47,17212,27021,-9809
36,61,36,53,38,0,38
36,61,36,55,439,247,192
36,61,36,59,4585,3843,742
36,61,36,63,51,0,51
36,61,36,65,118,101,17
36,61,36,67,331,166,165
36,61,36,69,32,0,32
36,61,36,71,522,800,-278
36,61,36,75,29,0,29
36,61,36,77,38,35,3
36,61,36,79,209,275,-66
36,61,36,81,12639,17058,-4419
36,61,36,83,114,61,53
36,61,36,85,1310,1366,-56
36,61,36,87,954,859,95
36,61,36,89,32,0,32
36,61,36,91,123,132,-9
36,61,36,93,118,73,45
36,61,36,103,2776,2276,500
36,61,36,105,132,172,-40
36,61,36,109,456,238,218
36,61,36,111,308,429,-121
36,61,36,113,0,32,-32
36,61,36,115,32,0,32
36,61,36,119,4573,6725,-2152
36,61,37,21,51,32,19
36,61,37,37,0,22,-22
36,61,37,51,46,68,-22
36,61,37,63,318,206,112
36,61,37,67,116,68,48
36,61,37,71,27,0,27
36,61,37,81,126,79,47
36,61,37,97,0,34,-34
36,61,37,119,505,591,-86
36,61,37,129,58,65,-7
36,61,37,133,39,36,3
36,61,37,135,144,120,24
36,61,37,147,26,0,26
36,61,37,179,0,59,-59
36,61,37,183,325,328,-3
36,61,39,9,0,20,-20
36,61,39,17,69,0,69
36,61,39,35,428,287,141
36,61,39,41,39,27,12
36,61,39,49,464,239,225
36,61,39,61,274,231,43
36,61,39,85,35,0,35
36,61,39,93,54,33,21
36,61,39,95,42,0,42
36,61,39,99,87,0,87
36,61,39,113,69,0,69
36,61,39,151,42,0,42
36,61,39,153,102,51,51
36,61,39,155,22,0,22
36,61,39,173,23,0,23
36,61,40,27,62,34,28
36,61,40,109,256,150,106
36,61,40,143,59,41,18
36,61,41,5,33,35,-2
36,61,41,39,41,53,-12
36,61,41,47,40,0,40
36,61,41,51,241,382,-141
36,61,41,67,81,35,46
36,61,42,3,654,301,353
36,61,42,11,234,207,27
36,61,42,13,24,0,24
36,61,42,17,301,249,52
36,61,42,19,41,0,41
36,61,42,27,83,31,52
36,61,42,29,248,125,123
36,61,42,41,75,30,45
36,61,42,43,110,69,41
36,61,42,45,283,175,108
36,61,42,49,46,0,46
36,61,42,69,93,72,21
36,61,42,71,151,98,53
36,61,42,75,64,45,19
36,61,42,77,450,445,5
36,61,42,79,166,239,-73
36,61,42,89,156,313,-157
36,61,42,91,581,288,293
36,61,42,95,184,162,22
36,61,42,97,27,0,27
36,61,42,101,2393,1755,638
36,61,42,103,62,137,-75
36,61,42,127,22,26,-4
36,61,42,129,48,26,22
36,61,42,133,91,53,38
36,61,44,1,30,0,30
36,61,44,3,54,32,22
36,61,44,5,63,36,27
36,61,44,7,504,399,105
36,61,44,9,62,29,33
36,61,45,13,37,71,-34
36,61,45,15,0,46,-46
36,61,45,19,107,152,-45
36,61,45,45,53,44,9
36,61,45,51,26,48,-22
36,61,45,63,0,30,-30
36,61,45,79,72,109,-37
36,61,45,83,28,76,-48
36,61,47,37,208,210,-2
36,61,47,65,24,0,24
36,61,47,93,56,32,24
36,61,47,157,165,90,75
36,61,47,187,44,0,44
36,61,48,27,34,24,10
36,61,48,29,179,122,57
36,61,48,41,50,22,28
36,61,48,85,165,119,46
36,61,48,113,585,452,133
36,61,48,121,87,66,21
36,61,48,141,61,37,24
36,61,48,157,86,75,11
36,61,48,167,23,0,23
36,61,48,201,837,754,83
36,61,48,215,37,32,5
36,61,48,303,42,0,42
36,61,48,339,43,0,43
36,61,48,439,208,149,59
36,61,48,453,449,485,-36
36,61,48,491,25,0,25
36,61,49,11,28,0,28
36,61,49,35,189,108,81
36,61,49,49,108,36,72
36,61,50,1,30,0,30
36,61,50,3,23,31,-8
36,61,50,7,92,87,5
36,61,50,21,22,24,-2
36,61,50,23,31,0,31
36,61,50,25,34,37,-3
36,61,50,27,45,45,0
36,61,51,3,104,79,25
36,61,51,13,609,329,280
36,61,51,41,60,67,-7
36,61,51,59,702,347,355
36,61,51,87,90,74,16
36,61,51,95,22,0,22
36,61,51,107,58,81,-23
36,61,51,153,70,103,-33
36,61,51,199,25,0,25
36,61,51,510,174,148,26
36,61,51,540,172,39,133
36,61,51,550,32,37,-5
36,61,51,660,0,58,-58
36,61,51,700,32,37,-5
36,61,51,710,56,72,-16
36,61,51,740,29,0,29
36,61,51,760,135,117,18
36,61,51,810,116,91,25
36,61,51,830,20,0,20
36,61,53,11,0,28,-28
36,61,53,33,851,753,98
36,61,53,35,23,0,23
36,61,53,53,81,45,36
36,61,53,61,51,29,22
36,61,53,63,28,20,8
36,61,53,73,22,0,22
36,61,55,9,25,0,25
36,61,55,25,189,120,69
36,61,55,79,131,80,51
36,61,55,87,20,0,20
36,61,55,133,57,0,57
36,63,4,13,105,71,34
36,63,6,37,24,40,-16
36,63,6,73,36,34,2
36,63,12,9,0,41,-41
36,63,12,11,30,24,6
36,63,12,57,24,58,-34
36,63,12,71,0,64,-64
36,63,12,95,31,35,-4
36,63,12,99,0,33,-33
36,63,12,101,0,33,-33
36,63,12,103,28,71,-43
36,63,12,105,0,29,-29
36,63,12,127,0,36,-36
36,63,13,121,22,0,22
36,63,17,31,32,27,5
36,63,18,3,0,77,-77
36,63,25,17,0,29,-29
36,63,25,25,0,34,-34
36,63,32,3,84,70,14
36,63,36,1,32,22,10
36,63,36,3,35,45,-10
36,63,36,5,0,39,-39
36,63,36,9,60,78,-18
36,63,36,13,47,62,-15
36,63,36,29,5111,4512,599
36,63,36,37,128,97,31
36,63,36,47,0,50,-50
36,63,36,55,191,254,-63
36,63,36,61,0,51,-51
36,63,36,65,29,0,29
36,63,36,67,33,93,-60
36,63,36,69,0,30,-30
36,63,36,73,367,258,109
36,63,36,81,53,27,26
36,63,36,101,0,26,-26
36,63,36,103,33,0,33
36,63,36,121,38,0,38
36,63,37,119,0,97,-97
36,63,37,183,0,62,-62
36,63,39,35,49,40,9
36,63,42,3,26,0,26
36,63,42,49,45,43,2
36,63,45,51,0,28,-28
36,63,48,201,0,51,-51
36,63,51,59,0,44,-44
36,65,4,13,86,64,22
36,65,6,37,28,31,-3
36,65,6,73,35,38,-3
36,65,8,31,0,26,-26
36,65,8,41,0,42,-42
36,65,9,1,0,24,-24
36,65,9,3,0,37,-37
36,65,12,9,35,68,-33
36,65,12,11,31,36,-5
36,65,12,31,28,44,-16
36,65,12,57,25,58,-33
36,65,12,71,27,46,-19
36,65,12,95,34,26,8
36,65,12,99,45,48,-3
36,65,12,101,31,35,-4
36,65,12,103,33,62,-29
36,65,12,127,33,51,-18
36,65,13,121,0,31,-31
36,65,13,135,0,37,-37
36,65,24,510,0,22,-22
36,65,25,17,68,78,-10
36,65,25,25,34,43,-9
36,65,32,3,40,50,-10
36,65,33,11,0,36,-36
36,65,36,1,93,181,-88
36,65,36,5,83,75,8
36,65,36,7,74,56,18
36,65,36,11,32,43,-11
36,65,36,17,74,67,7
36,65,36,23,0,31,-31
36,65,36,27,0,39,-39
36,65,36,29,96,99,-3
36,65,36,33,0,26,-26
36,65,36,35,54,32,22
36,65,36,43,1244,1211,33
36,65,36,45,87,115,-28
36,65,36,47,89,104,-15
36,65,36,49,214,197,17
36,65,36,53,992,1104,-112
36,65,36,55,114,184,-70
36,65,36,57,42,43,-1
36,65,36,59,52,0,52
36,65,36,61,101,118,-17
36,65,36,63,0,29,-29
36,65,36,67,486,773,-287
36,65,36,69,25,29,-4
36,65,36,71,37,0,37
36,65,36,75,225,190,35
36,65,36,77,133,106,27
36,65,36,81,93,87,6
36,65,36,83,39,78,-39
36,65,36,89,50,39,11
36,65,36,91,51,123,-72
36,65,36,93,65,39,26
36,65,36,101,0,33,-33
36,65,36,103,38,38,0
36,65,36,109,0,36,-36
36,65,36,111,40,0,40
36,65,36,113,28,0,28
36,65,36,119,0,40,-40
36,65,37,51,0,35,-35
36,65,37,119,49,86,-37
36,65,37,133,0,24,-24
36,65,37,183,0,68,-68
36,65,45,51,0,33,-33
36,65,48,201,0,27,-27
36,65,51,13,0,30,-30
36,65,51,59,0,32,-32
36,65,51,810,38,0,38
36,67,4,13,103,185,-82
36,67,4,19,36,60,-24
36,67,6,1,28,53,-25
36,67,6,37,110,163,-53
36,67,6,59,46,31,15
36,67,6,65,0,56,-56
36,67,6,73,108,138,-30
36,67,6,75,0,52,-52
36,67,6,85,24,77,-53
36,67,8,5,0,34,-34
36,67,8,31,0,49,-49
36,67,8,59,0,32,-32
36,67,9,1,56,71,-15
36,67,9,3,81,98,-17
36,67,9,9,52,51,1
36,67,9,11,0,29,-29
36,67,10,3,44,41,3
36,67,11,1,43,137,-94
36,67,12,9,39,47,-8
36,67,12,11,71,92,-21
36,67,12,21,0,36,-36
36,67,12,31,49,66,-17
36,67,12,53,38,0,38
36,67,12,57,78,202,-124
36,67,12,69,29,56,-27
36,67,12,71,43,108,-65
36,67,12,81,0,52,-52
36,67,12,83,0,52,-52
36,67,12,85,0,36,-36
36,67,12,86,38,79,-41
36,67,12,95,98,95,3
36,67,12,97,35,53,-18
36,67,12,99,112,136,-24
36,67,12,101,54,85,-31
36,67,12,103,83,75,8
36,67,12,105,26,64,-38
36,67,12,111,0,44,-44
36,67,12,115,27,83,-56
36,67,12,117,55,44,11
36,67,12,119,0,37,-37
36,67,12,127,82,51,31
36,67,13,51,32,44,-12
36,67,13,67,36,49,-13
36,67,13,89,28,48,-20
36,67,13,121,23,75,-52
36,67,13,135,43,70,-27
36,67,15,3,60,28,32
36,67,17,31,76,110,-34
36,67,17,201,0,61,-61
36,67,18,97,0,27,-27
36,67,21,111,0,59,-59
36,67,23,5,0,54,-54
36,67,24,3,41,58,-17
36,67,24,5,54,52,2
36,67,24,27,0,41,-41
36,67,24,31,71,105,-34
36,67,24,33,40,0,40
36,67,24,510,42,51,-9
36,67,25,1,0,26,-26
36,67,25,9,30,34,-4
36,67,25,13,39,70,-31
36,67,25,17,147,155,-8
36,67,25,21,29,63,-34
36,67,25,23,0,27,-27
36,67,25,25,66,132,-66
36,67,25,27,52,80,-28
36,67,26,161,27,40,-13
36,67,26,163,39,0,39
36,67,27,53,26,32,-6
36,67,32,3,49,131,-82
36,67,33,11,0,48,-48
36,67,34,3,26,51,-25
36,67,34,13,52,37,15
36,67,34,17,40,141,-101
36,67,34,21,0,25,-25
36,67,34,23,30,57,-27
36,67,34,25,33,0,33
36,67,34,27,32,28,4
36,67,34,31,0,33,-33
36,67,34,35,0,29,-29
36,67,35,1,0,25,-25
36,67,36,1,181,299,-118
36,67,36,3,22,0,22
36,67,36,5,105,80,25
36,67,36,7,305,223,82
36,67,36,9,31,0,31
36,67,36,11,979,1120,-141
36,67,36,13,34,0,34
36,67,36,15,99,53,46
36,67,36,17,105,46,59
36,67,36,19,43,54,-11
36,67,36,23,358,266,92
36,67,36,25,31,0,31
36,67,36,27,90,34,56
36,67,36,29,387,407,-20
36,67,36,31,0,29,-29
36,67,36,33,46,52,-6
36,67,36,35,36,0,36
36,67,36,37,26,0,26
36,67,36,43,125,53,72
36,67,36,45,383,274,109
36,67,36,47,261,253,8
36,67,36,49,35,0,35
36,67,36,51,30,0,30
36,67,36,53,1165,1132,33
36,67,36,55,480,665,-185
36,67,36,59,76,90,-14
36,67,36,61,166,331,-165
36,67,36,63,93,33,60
36,67,36,65,773,486,287
36,67,36,69,106,150,-44
36,67,36,71,61,65,-4
36,67,36,75,2604,2471,133
36,67,36,77,53,32,21
36,67,36,81,160,174,-14
36,67,36,83,83,71,12
36,67,36,87,52,21,31
36,67,36,89,183,133,50
36,67,36,91,105,149,-44
36,67,36,93,68,86,-18
36,67,36,99,76,36,40
36,67,36,101,67,56,11
36,67,36,103,152,74,78
36,67,36,105,40,0,40
36,67,36,107,41,0,41
36,67,36,109,195,139,56
36,67,36,111,40,43,-3
36,67,36,117,123,114,9
36,67,36,119,77,110,-33
36,67,37,21,0,34,-34
36,67,37,51,50,39,11
36,67,37,81,25,35,-10
36,67,37,119,78,259,-181
36,67,37,129,0,35,-35
36,67,37,133,29,38,-9
36,67,37,183,60,161,-101
36,67,39,35,62,39,23
36,67,39,49,80,60,20
36,67,41,51,0,27,-27
36,67,42,3,60,76,-16
36,67,42,17,49,28,21
36,67,42,29,45,45,0
36,67,42,41,0,39,-39
36,67,42,45,29,32,-3
36,67,42,69,31,25,6
36,67,42,71,0,34,-34
36,67,42,79,36,36,0
36,67,42,89,25,0,25
36,67,42,91,63,69,-6
36,67,42,101,71,134,-63
36,67,42,133,0,31,-31
36,67,44,7,32,60,-28
36,67,45,19,0,47,-47
36,67,45,45,0,49,-49
36,67,45,51,0,78,-78
36,67,45,91,0,60,-60
36,67,47,37,0,36,-36
36,67,47,157,31,0,31
36,67,48,29,34,46,-12
36,67,48,113,23,35,-12
36,67,48,201,30,104,-74
36,67,48,439,50,58,-8
36,67,48,453,0,35,-35
36,67,50,7,0,58,-58
36,67,51,13,26,95,-69
36,67,51,41,0,44,-44
36,67,51,59,106,144,-38
36,67,51,87,0,24,-24
36,67,51,107,0,44,-44
36,67,51,153,28,33,-5
36,67,51,510,27,49,-22
36,67,51,700,0,24,-24
36,67,51,710,0,39,-39
36,67,51,760,23,0,23
36,67,51,810,35,47,-12
36,67,53,33,40,73,-33
36,67,53,61,0,29,-29
36,69,4,13,0,35,-35
36,69,6,73,37,0,37
36,69,12,95,0,28,-28
36,69,12,99,35,0,35
36,69,12,103,38,0,38
36,69,12,127,22,0,22
36,69,17,31,0,46,-46
36,69,25,21,0,26,-26
36,69,36,1,29,39,-10
36,69,36,7,0,34,-34
36,69,36,11,74,59,15
36,69,36,15,22,0,22
36,69,36,29,151,135,16
36,69,36,37,27,49,-22
36,69,36,45,27,0,27
36,69,36,47,23,0,23
36,69,36,51,254,192,62
36,69,36,55,1973,1655,318
36,69,36,59,28,0,28
36,69,36,61,0,32,-32
36,69,36,63,30,0,30
36,69,36,65,29,25,4
36,69,36,67,150,106,44
36,69,36,75,27,30,-3
36,69,36,81,0,25,-25
36,69,36,99,453,384,69
36,69,36,101,175,169,6
36,69,36,109,26,42,-16
36,69,36,117,816,857,-41
36,69,36,121,0,23,-23
36,69,36,123,418,350,68
36,69,37,119,0,23,-23
36,69,37,183,0,46,-46
36,71,1,31,0,116,-116
36,71,1,45,0,35,-35
36,71,4,13,68,116,-48
36,71,4,19,0,41,-41
36,71,6,37,70,103,-33
36,71,6,53,36,0,36
36,71,6,59,59,45,14
36,71,6,73,65,104,-39
36,71,6,85,45,0,45
36,71,8,41,56,49,7
36,71,9,1,105,133,-28
36,71,9,3,0,65,-65
36,71,9,9,44,71,-27
36,71,11,1,0,56,-56
36,71,12,9,32,48,-16
36,71,12,11,87,128,-41
36,71,12,31,30,66,-36
36,71,12,35,0,52,-52
36,71,12,53,0,37,-37
36,71,12,57,77,119,-42
36,71,12,61,0,31,-31
36,71,12,69,0,52,-52
36,71,12,71,26,85,-59
36,71,12,83,0,58,-58
36,71,12,85,0,29,-29
36,71,12,86,37,94,-57
36,71,12,95,79,89,-10
36,71,12,97,42,73,-31
36,71,12,99,98,159,-61
36,71,12,101,35,70,-35
36,71,12,103,59,86,-27
36,71,12,105,0,42,-42
36,71,12,109,0,35,-35
36,71,12,111,36,57,-21
36,71,12,115,0,51,-51
36,71,12,117,0,52,-52
36,71,12,119,0,28,-28
36,71,12,127,39,110,-71
36,71,13,51,0,30,-30
36,71,13,53,0,100,-100
36,71,13,67,40,48,-8
36,71,13,121,0,39,-39
36,71,13,135,0,92,-92
36,71,13,215,0,60,-60
36,71,15,3,55,87,-32
36,71,17,31,34,55,-21
36,71,20,103,0,153,-153
36,71,20,161,0,28,-28
36,71,21,93,0,34,-34
36,71,24,3,37,53,-16
36,71,24,21,0,27,-27
36,71,24,31,52,49,3
36,71,24,33,30,27,3
36,71,25,1,22,0,22
36,71,25,9,0,33,-33
36,71,25,17,77,56,21
36,71,25,21,0,31,-31
36,71,25,25,27,58,-31
36,71,25,27,0,29,-29
36,71,27,53,0,37,-37
36,71,29,169,0,44,-44
36,71,32,3,55,112,-57
36,71,34,1,0,27,-27
36,71,34,3,685,490,195
36,71,34,5,51,0,51
36,71,34,13,93,87,6
36,71,34,15,0,36,-36
36,71,34,17,204,159,45
36,71,34,21,22,0,22
36,71,34,23,89,81,8
36,71,34,25,155,97,58
36,71,34,27,92,91,1
36,71,34,29,63,54,9
36,71,34,31,263,169,94
36,71,34,35,28,44,-16
36,71,34,37,180,152,28
36,71,34,39,71,41,30
36,71,36,1,167,199,-32
36,71,36,5,2366,669,1697
36,71,36,7,58,71,-13
36,71,36,25,30,45,-15
36,71,36,27,913,961,-48
36,71,36,29,64,94,-30
36,71,36,39,53,45,8
36,71,36,45,64,43,21
36,71,36,47,1022,520,502
36,71,36,55,61,63,-2
36,71,36,59,289,133,156
36,71,36,61,800,522,278
36,71,36,65,0,37,-37
36,71,36,67,65,61,4
36,71,36,75,0,48,-48
36,71,36,77,0,44,-44
36,71,36,79,106,100,6
36,71,36,81,1210,541,669
36,71,36,83,30,64,-34
36,71,36,85,251,87,164
36,71,36,87,1935,1027,908
36,71,36,91,62,115,-53
36,71,36,93,39,40,-1
36,71,36,103,245,255,-10
36,71,36,105,1041,1409,-368
36,71,36,111,1307,1692,-385
36,71,36,113,0,38,-38
36,71,36,119,1159,736,423
36,71,37,19,0,48,-48
36,71,37,51,45,120,-75
36,71,37,63,0,36,-36
36,71,37,67,0,26,-26
36,71,37,81,0,64,-64
36,71,37,101,0,35,-35
36,71,37,119,42,107,-65
36,71,37,133,40,32,8
36,71,37,179,0,66,-66
36,71,37,183,49,165,-116
36,71,39,49,0,30,-30
36,71,40,31,0,35,-35
36,71,42,3,0,28,-28
36,71,42,17,32,50,-18
36,71,42,29,0,56,-56
36,71,42,41,0,36,-36
36,71,42,69,0,38,-38
36,71,42,71,0,49,-49
36,71,42,77,0,38,-38
36,71,42,79,0,38,-38
36,71,42,89,46,57,-11
36,71,42,91,0,34,-34
36,71,42,95,0,32,-32
36,71,42,101,47,52,-5
36,71,42,103,269,654,-385
36,71,42,127,0,59,-59
36,71,45,13,0,38,-38
36,71,45,19,0,39,-39
36,71,45,45,0,56,-56
36,71,45,51,0,145,-145
36,71,45,79,0,43,-43
36,71,45,91,0,29,-29
36,71,47,125,48,47,1
36,71,48,27,85,93,-8
36,71,48,29,60,68,-8
36,71,48,99,0,25,-25
36,71,48,113,0,56,-56
36,71,48,141,44,78,-34
36,71,48,201,55,122,-67
36,71,48,439,37,59,-22
36,71,51,59,32,131,-99
36,71,51,107,38,0,38
36,71,51,153,0,44,-44
36,71,51,710,0,24,-24
36,71,51,810,0,59,-59
36,71,53,33,35,0,35
36,71,53,53,34,74,-40
36,71,53,67,0,25,-25
36,73,36,29,114,177,-63
36,73,36,37,191,193,-2
36,73,36,51,39,27,12
36,73,36,55,892,968,-76
36,73,36,63,258,367,-109
36,75,4,13,0,39,-39
36,75,12,99,28,0,28
36,75,12,101,27,39,-12
36,75,12,105,0,27,-27
36,75,12,127,30,0,30
36,75,36,1,29,45,-16
36,75,36,7,47,45,2
36,75,36,11,254,284,-30
36,75,36,23,27,49,-22
36,75,36,27,27,0,27
36,75,36,29,58,64,-6
36,75,36,43,0,36,-36
36,75,36,45,275,166,109
36,75,36,49,39,0,39
36,75,36,53,115,88,27
36,75,36,55,95,143,-48
36,75,36,61,0,29,-29
36,75,36,65,190,225,-35
36,75,36,67,2471,2604,-133
36,75,36,69,30,27,3
36,75,36,71,48,0,48
36,75,36,81,0,26,-26
36,75,36,89,73,87,-14
36,75,36,91,41,34,7
36,75,36,101,0,34,-34
36,75,36,109,0,20,-20
36,75,36,117,59,75,-16
36,75,37,119,0,36,-36
36,75,51,59,0,26,-26
36,77,36,1,50,121,-71
36,77,36,7,122,94,28
36,77,36,17,324,387,-63
36,77,36,25,501,474,27
36,77,36,43,172,185,-13
36,77,36,47,0,27,-27
36,77,36,53,51,72,-21
36,77,36,55,25,57,-32
36,77,36,57,24,27,-3
36,77,36,59,0,30,-30
36,77,36,61,35,38,-3
36,77,36,65,106,133,-27
36,77,36,67,32,53,-21
36,77,36,71,44,0,44
36,77,36,81,36,27,9
36,77,36,83,35,25,10
36,77,36,91,32,42,-10
36,77,36,93,27,60,-33
36,77,36,95,114,121,-7
36,77,36,103,108,40,68
36,77,36,111,33,24,9
36,77,36,119,0,30,-30
36,79,6,37,0,24,-24
36,79,6,73,0,22,-22
36,79,9,1,261,522,-261
36,79,9,3,0,33,-33
36,79,9,5,0,67,-67
36,79,9,9,50,61,-11
36,79,12,99,0,36,-36
36,79,25,17,0,36,-36
36,79,25,25,0,32,-32
36,79,34,3,32,0,32
36,79,34,17,0,29,-29
36,79,36,1,23,30,-7
36,79,36,5,584,217,367
36,79,36,21,0,36,-36
36,79,36,27,549,1357,-808
36,79,36,47,174,112,62
36,79,36,59,69,78,-9
36,79,36,61,275,209,66
36,79,36,71,100,106,-6
36,79,36,81,230,140,90
36,79,36,87,70,71,-1
36,79,36,103,55,47,8
36,79,36,111,58,65,-7
36,79,36,119,2522,1495,1027
36,79,37,19,0,28,-28
36,79,37,183,0,35,-35
36,79,45,51,0,36,-36
36,81,1,73,35,42,-7
36,81,1,89,0,39,-39
36,81,2,20,0,33,-33
36,81,4,13,257,479,-222
36,81,4,19,49,68,-19
36,81,6,1,182,203,-21
36,81,6,13,56,61,-5
36,81,6,29,26,32,-6
36,81,6,37,1051,1394,-343
36,81,6,41,21,0,21
36,81,6,59,170,206,-36
36,81,6,65,82,112,-30
36,81,6,67,56,58,-2
36,81,6,71,95,106,-11
36,81,6,73,297,431,-134
36,81,6,75,239,289,-50
36,81,6,77,24,0,24
36,81,6,81,115,105,10
36,81,6,83,22,0,22
36,81,6,85,157,171,-14
36,81,6,111,39,33,6
36,81,6,113,22,0,22
36,81,8,1,0,39,-39
36,81,8,5,73,63,10
36,81,8,13,36,41,-5
36,81,8,31,65,69,-4
36,81,8,41,49,38,11
36,81,8,59,28,29,-1
36,81,9,1,682,1121,-439
36,81,9,3,395,407,-12
36,81,9,5,68,105,-37
36,81,9,7,61,54,7
36,81,9,9,453,620,-167
36,81,9,11,172,237,-65
36,81,9,13,42,0,42
36,81,9,15,29,0,29
36,81,10,1,25,126,-101
36,81,10,3,142,196,-54
36,81,11,1,213,206,7
36,81,12,1,47,41,6
36,81,12,9,124,203,-79
36,81,12,11,1114,1595,-481
36,81,12,15,30,64,-34
36,81,12,17,0,40,-40
36,81,12,19,0,48,-48
36,81,12,21,76,104,-28
36,81,12,31,154,225,-71
36,81,12,33,0,28,-28
36,81,12,35,58,133,-75
36,81,12,53,48,111,-63
36,81,12,57,368,676,-308
36,81,12,61,0,38,-38
36,81,12,69,163,274,-111
36,81,12,71,162,297,-135
36,81,12,73,49,31,18
36,81,12,81,34,63,-29
36,81,12,83,140,251,-111
36,81,12,85,26,52,-26
36,81,12,86,1039,1217,-178
36,81,12,95,852,1273,-421
36,81,12,97,369,811,-442
36,81,12,99,611,926,-315
36,81,12,101,86,221,-135
36,81,12,103,151,262,-111
36,81,12,105,111,381,-270
36,81,12,109,0,66,-66
36,81,12,111,92,244,-152
36,81,12,115,57,128,-71
36,81,12,117,179,258,-79
36,81,12,119,0,39,-39
36,81,12,127,120,90,30
36,81,13,51,36,51,-15
36,81,13,57,0,35,-35
36,81,13,63,110,209,-99
36,81,13,67,181,403,-222
36,81,13,77,0,41,-41
36,81,13,89,195,423,-228
36,81,13,97,28,137,-109
36,81,13,113,0,68,-68
36,81,13,117,0,46,-46
36,81,13,121,183,408,-225
36,81,13,135,323,1012,-689
36,81,13,139,0,40,-40
36,81,13,151,59,226,-167
36,81,13,217,0,92,-92
36,81,13,223,0,88,-88
36,81,13,245,0,36,-36
36,81,13,247,0,105,-105
36,81,13,297,0,61,-61
36,81,15,3,149,129,20
36,81,16,1,28,0,28
36,81,17,19,27,0,27
36,81,17,31,596,634,-38
36,81,17,43,61,75,-14
36,81,17,97,34,28,6
36,81,17,197,0,52,-52
36,81,18,3,0,48,-48
36,81,18,97,105,82,23
36,81,18,105,36,0,36
36,81,18,157,30,0,30
36,81,19,163,0,42,-42
36,81,20,91,40,32,8
36,81,21,67,24,29,-5
36,81,21,111,37,35,2
36,81,22,33,25,0,25
36,81,22,51,46,78,-32
36,81,22,71,27,55,-28
36,81,23,5,36,72,-36
36,81,24,3,87,140,-53
36,81,24,5,230,275,-45
36,81,24,21,27,0,27
36,81,24,25,42,36,6
36,81,24,27,62,134,-72
36,81,24,31,292,401,-109
36,81,24,33,203,294,-91
36,81,24,510,144,204,-60
36,81,25,1,63,30,33
36,81,25,3,40,0,40
36,81,25,5,65,36,29
36,81,25,7,24,0,24
36,81,25,9,125,132,-7
36,81,25,13,120,126,-6
36,81,25,15,61,41,20
36,81,25,17,493,438,55
36,81,25,19,34,0,34
36,81,25,21,195,198,-3
36,81,25,23,77,76,1
36,81,25,25,454,270,184
36,81,25,27,151,127,24
36,81,26,81,25,0,25
36,81,26,99,80,38,42
36,81,26,125,126,65,61
36,81,26,161,91,56,35
36,81,26,163,208,108,100
36,81,27,37,0,43,-43
36,81,27,53,155,102,53
36,81,27,123,33,32,1
36,81,29,95,49,32,17
36,81,29,189,74,73,1
36,81,29,510,37,25,12
36,81,31,55,39,34,5
36,81,32,3,274,583,-309
36,81,32,31,0,38,-38
36,81,33,11,71,70,1
36,81,33,13,22,0,22
36,81,33,15,48,28,20
36,81,34,1,189,173,16
36,81,34,3,1262,2640,-1378
36,81,34,5,136,208,-72
36,81,34,7,185,158,27
36,81,34,11,44,0,44
36,81,34,13,710,1312,-602
36,81,34,15,48,61,-13
36,81,34,17,1766,2850,-1084
36,81,34,19,34,35,-1
36,81,34,21,174,336,-162
36,81,34,23,885,1826,-941
36,81,34,25,321,512,-191
36,81,34,27,310,288,22
36,81,34,29,239,267,-28
36,81,34,31,328,560,-232
36,81,34,35,222,251,-29
36,81,34,37,65,91,-26
36,81,34,39,479,785,-306
36,81,34,41,35,44,-9
36,81,35,1,39,38,1
36,81,36,1,281,318,-37
36,81,36,5,7843,7268,575
36,81,36,7,185,126,59
36,81,36,13,29,0,29
36,81,36,15,0,30,-30
36,81,36,19,31,0,31
36,81,36,21,56,61,-5
36,81,36,25,49,98,-49
36,81,36,27,353,451,-98
36,81,36,29,339,331,8
36,81,36,39,54,120,-66
36,81,36,45,40,72,-32
36,81,36,47,32029,22656,9373
36,81,36,55,236,199,37
36,81,36,57,0,33,-33
36,81,36,59,11443,21853,-10410
36,81,36,61,17058,12639,4419
36,81,36,63,27,53,-26
36,81,36,65,87,93,-6
36,81,36,67,174,160,14
36,81,36,69,25,0,25
36,81,36,71,541,1210,-669
36,81,36,75,26,0,26
36,81,36,77,27,36,-9
36,81,36,79,140,230,-90
36,81,36,83,60,58,2
36,81,36,85,1287,1903,-616
36,81,36,87,405,599,-194
36,81,36,91,78,106,-28
36,81,36,93,162,356,-194
36,81,36,103,4661,7417,-2756
36,81,36,105,141,193,-52
36,81,36,109,103,90,13
36,81,36,111,170,241,-71
36,81,36,113,31,0,31
36,81,36,119,1867,2544,-677
36,81,37,1,0,54,-54
36,81,37,21,0,33,-33
36,81,37,25,0,95,-95
36,81,37,49,35,0,35
36,81,37,51,56,140,-84
36,81,37,63,65,164,-99
36,81,37,67,51,76,-25
36,81,37,71,0,38,-38
36,81,37,81,89,218,-129
36,81,37,97,0,55,-55
36,81,37,101,0,56,-56
36,81,37,119,215,950,-735
36,81,37,129,0,42,-42
36,81,37,133,102,90,12
36,81,37,135,41,0,41
36,81,37,147,0,45,-45
36,81,37,179,0,173,-173
36,81,37,183,184,593,-409
36,81,39,17,0,46,-46
36,81,39,35,135,138,-3
36,81,39,49,142,177,-35
36,81,39,61,72,67,5
36,81,39,95,27,0,27
36,81,39,113,52,28,24
36,81,39,153,31,33,-2
36,81,40,109,43,46,-3
36,81,40,143,27,43,-16
36,81,41,51,63,107,-44
36,81,41,67,26,48,-22
36,81,42,3,207,144,63
36,81,42,11,193,307,-114
36,81,42,17,160,184,-24
36,81,42,25,0,51,-51
36,81,42,27,32,52,-20
36,81,42,29,64,64,0
36,81,42,41,36,0,36
36,81,42,43,67,116,-49
36,81,42,45,118,176,-58
36,81,42,69,37,99,-62
36,81,42,71,101,168,-67
36,81,42,75,66,36,30
36,81,42,77,278,458,-180
36,81,42,79,145,275,-130
36,81,42,89,294,895,-601
36,81,42,91,209,191,18
36,81,42,95,144,238,-94
36,81,42,101,575,846,-271
36,81,42,103,87,315,-228
36,81,42,107,0,43,-43
36,81,42,127,0,93,-93
36,81,42,129,23,26,-3
36,81,42,133,45,48,-3
36,81,44,5,27,0,27
36,81,44,7,208,198,10
36,81,44,9,32,0,32
36,81,45,3,0,36,-36
36,81,45,13,31,55,-24
36,81,45,15,0,53,-53
36,81,45,19,25,70,-45
36,81,45,35,0,46,-46
36,81,45,41,0,42,-42
36,81,45,45,48,92,-44
36,81,45,51,32,109,-77
36,81,45,79,64,107,-43
36,81,45,91,0,101,-101
36,81,47,37,88,103,-15
36,81,47,93,0,31,-31
36,81,47,125,30,46,-16
36,81,47,157,53,70,-17
36,81,48,27,27,77,-50
36,81,48,29,92,129,-37
36,81,48,85,83,155,-72
36,81,48,113,238,280,-42
36,81,48,121,33,84,-51
36,81,48,141,53,0,53
36,81,48,157,0,165,-165
36,81,48,201,248,666,-418
36,81,48,339,0,40,-40
36,81,48,439,93,274,-181
36,81,48,453,80,169,-89
36,81,48,491,0,66,-66
36,81,49,35,53,57,-4
36,81,49,49,38,0,38
36,81,50,7,44,37,7
36,81,51,3,0,29,-29
36,81,51,13,73,117,-44
36,81,51,41,34,110,-76
36,81,51,59,251,349,-98
36,81,51,87,78,138,-60
36,81,51,107,48,125,-77
36,81,51,153,107,158,-51
36,81,51,510,48,101,-53
36,81,51,550,29,64,-35
36,81,51,650,34,32,2
36,81,51,700,70,83,-13
36,81,51,710,92,126,-34
36,81,51,760,54,62,-8
36,81,51,810,152,211,-59
36,81,53,33,189,267,-78
36,81,53,53,38,58,-20
36,81,53,61,0,67,-67
36,81,54,61,30,0,30
36,81,55,25,59,34,25
36,81,55,79,64,54,10
36,83,4,13,0,41,-41
36,83,6,1,0,27,-27
36,83,6,37,21,44,-23
36,83,6,73,39,25,14
36,83,6,85,0,41,-41
36,83,9,3,46,42,4
36,83,9,9,41,0,41
36,83,11,1,0,23,-23
36,83,12,57,0,30,-30
36,83,12,95,0,29,-29
36,83,12,99,0,27,-27
36,83,12,101,0,40,-40
36,83,12,103,23,38,-15
36,83,12,115,0,27,-27
36,83,17,31,0,26,-26
36,83,24,31,0,24,-24
36,83,25,3,129,79,50
36,83,25,9,0,25,-25
36,83,25,13,38,0,38
36,83,25,17,52,85,-33
36,83,25,21,0,41,-41
36,83,25,25,26,37,-11
36,83,32,3,0,33,-33
36,83,34,3,0,32,-32
36,83,34,17,0,31,-31
36,83,36,1,4514,3983,531
36,83,36,5,63,47,16
36,83,36,7,29,29,0
36,83,36,19,64,29,35
36,83,36,21,430,296,134
36,83,36,27,131,62,69
36,83,36,29,53,54,-1
36,83,36,31,24,24,0
36,83,36,33,25,0,25
36,83,36,35,37,56,-19
36,83,36,39,85,49,36
36,83,36,43,25,0,25
36,83,36,47,134,124,10
36,83,36,55,51,66,-15
36,83,36,57,53,72,-19
36,83,36,59,31,40,-9
36,83,36,61,61,114,-53
36,83,36,65,78,39,39
36,83,36,67,71,83,-12
36,83,36,71,64,30,34
36,83,36,77,25,35,-10
36,83,36,81,58,60,-2
36,83,36,91,1215,1445,-230
36,83,36,93,511,662,-151
36,83,36,95,42,64,-22
36,83,36,103,71,46,25
36,83,36,111,69,40,29
36,83,36,113,74,60,14
36,83,36,115,186,204,-18
36,83,36,119,63,51,12
36,83,37,119,0,48,-48
36,83,48,201,0,48,-48
36,83,50,3,178,169,9
36,83,53,33,0,33,-33
36,85,4,13,50,115,-65
36,85,6,1,35,0,35
36,85,6,37,107,133,-26
36,85,6,73,32,78,-46
36,85,9,1,40,73,-33
36,85,9,3,34,46,-12
36,85,9,9,47,57,-10
36,85,10,1,0,36,-36
36,85,10,3,0,70,-70
36,85,10,5,0,31,-31
36,85,12,11,157,217,-60
36,85,12,15,0,34,-34
36,85,12,21,0,36,-36
36,85,12,31,0,31,-31
36,85,12,35,0,51,-51
36,85,12,53,0,69,-69
36,85,12,57,65,125,-60
36,85,12,69,0,33,-33
36,85,12,71,75,99,-24
36,85,12,81,0,35,-35
36,85,12,83,0,45,-45
36,85,12,86,84,94,-10
36,85,12,95,64,110,-46
36,85,12,97,0,79,-79
36,85,12,99,115,209,-94
36,85,12,101,65,65,0
36,85,12,103,40,62,-22
36,85,12,105,0,40,-40
36,85,12,111,0,78,-78
36,85,12,115,0,48,-48
36,85,12,117,0,59,-59
36,85,12,119,0,31,-31
36,85,12,127,41,57,-16
36,85,13,89,0,43,-43
36,85,13,121,26,36,-10
36,85,13,135,27,47,-20
36,85,15,3,26,0,26
36,85,17,31,48,42,6
36,85,24,3,35,0,35
36,85,24,5,0,31,-31
36,85,24,31,0,76,-76
36,85,24,33,0,29,-29
36,85,25,17,23,40,-17
36,85,25,25,31,33,-2
36,85,32,3,47,85,-38
36,85,34,3,155,302,-147
36,85,34,5,45,74,-29
36,85,34,7,0,58,-58
36,85,34,13,176,161,15
36,85,34,17,291,394,-103
36,85,34,19,0,34,-34
36,85,34,21,43,55,-12
36,85,34,23,510,1128,-618
36,85,34,25,388,1381,-993
36,85,34,27,60,122,-62
36,85,34,29,248,750,-502
36,85,34,31,59,70,-11
36,85,34,35,55,188,-133
36,85,34,39,169,342,-173
36,85,36,1,29,59,-30
36,85,36,5,968,626,342
36,85,36,7,30,48,-18
36,85,36,27,0,55,-55
36,85,36,29,32,31,1
36,85,36,47,10119,3993,6126
36,85,36,55,28,34,-6
36,85,36,59,296,350,-54
36,85,36,61,1366,1310,56
36,85,36,71,87,251,-164
36,85,36,81,1903,1287,616
36,85,36,87,55,52,3
36,85,36,91,0,37,-37
36,85,36,103,228,294,-66
36,85,36,105,0,53,-53
36,85,36,111,39,61,-22
36,85,36,119,151,185,-34
36,85,37,51,0,30,-30
36,85,37,119,0,47,-47
36,85,37,183,23,93,-70
36,85,39,49,0,29,-29
36,85,42,11,0,39,-39
36,85,42,17,35,43,-8
36,85,42,69,0,32,-32
36,85,42,71,33,41,-8
36,85,42,77,0,112,-112
36,85,42,79,0,73,-73
36,85,42,89,149,183,-34
36,85,42,91,0,40,-40
36,85,42,95,0,82,-82
36,85,42,101,75,102,-27
36,85,42,103,66,137,-71
36,85,42,127,30,31,-1
36,85,48,113,0,45,-45
36,85,48,201,47,80,-33
36,85,51,59,37,53,-16
36,85,51,710,31,28,3
36,85,51,810,0,34,-34
36,87,4,13,48,93,-45
36,87,6,37,99,83,16
36,87,6,59,0,24,-24
36,87,6,73,30,47,-17
36,87,6,75,0,34,-34
36,87,9,1,115,210,-95
36,87,9,3,30,41,-11
36,87,9,9,58,29,29
36,87,10,3,24,32,-8
36,87,12,11,117,137,-20
36,87,12,57,39,61,-22
36,87,12,71,0,28,-28
36,87,12,83,0,43,-43
36,87,12,86,80,67,13
36,87,12,95,36,67,-31
36,87,12,97,0,26,-26
36,87,12,99,110,259,-149
36,87,12,101,0,28,-28
36,87,12,103,0,29,-29
36,87,12,111,0,50,-50
36,87,13,67,0,61,-61
36,87,13,89,0,27,-27
36,87,13,121,0,37,-37
36,87,13,135,0,84,-84
36,87,17,31,58,35,23
36,87,24,31,0,30,-30
36,87,24,33,0,26,-26
36,87,24,510,0,27,-27
36,87,25,17,60,54,6
36,87,25,21,0,25,-25
36,87,25,25,0,45,-45
36,87,26,163,35,0,35
36,87,32,3,38,90,-52
36,87,34,3,979,1142,-163
36,87,34,13,118,140,-22
36,87,34,17,220,268,-48
36,87,34,21,0,39,-39
36,87,34,23,61,111,-50
36,87,34,25,38,81,-43
36,87,34,27,99,151,-52
36,87,34,29,97,181,-84
36,87,34,31,161,257,-96
36,87,34,35,51,47,4
36,87,34,37,0,36,-36
36,87,34,39,65,57,8
36,87,36,1,66,56,10
36,87,36,5,1212,566,646
36,87,36,7,0,26,-26
36,87,36,25,0,28,-28
36,87,36,27,141,129,12
36,87,36,29,40,48,-8
36,87,36,47,957,557,400
36,87,36,55,45,33,12
36,87,36,59,223,143,80
36,87,36,61,859,954,-95
36,87,36,67,21,52,-31
36,87,36,71,1027,1935,-908
36,87,36,79,71,70,1
36,87,36,81,599,405,194
36,87,36,85,52,55,-3
36,87,36,91,0,33,-33
36,87,36,103,125,123,2
36,87,36,105,59,109,-50
36,87,36,111,66,114,-48
36,87,36,119,1209,929,280
36,87,37,19,0,43,-43
36,87,37,119,0,107,-107
36,87,37,129,0,40,-40
36,87,37,183,31,99,-68
36,87,42,3,0,24,-24
36,87,42,11,0,26,-26
36,87,42,77,0,46,-46
36,87,42,89,0,73,-73
36,87,42,91,0,29,-29
36,87,42,101,58,64,-6
36,87,42,103,26,52,-26
36,87,45,13,0,31,-31
36,87,45,51,0,44,-44
36,87,45,79,0,38,-38
36,87,48,201,0,32,-32
36,87,51,13,0,31,-31
36,87,51,59,0,41,-41
36,87,53,33,0,40,-40
36,89,12,103,0,23,-23
36,89,12,105,0,45,-45
36,89,25,17,28,30,-2
36,89,36,1,42,54,-12
36,89,36,7,33,0,33
36,89,36,19,102,111,-9
36,89,36,27,33,28,5
36,89,36,29,65,54,11
36,89,36,31,29,39,-10
36,89,36,33,376,329,47
36,89,36,45,475,621,-146
36,89,36,47,25,29,-4
36,89,36,49,43,37,6
36,89,36,55,104,103,1
36,89,36,61,0,32,-32
36,89,36,65,39,50,-11
36,89,36,67,133,183,-50
36,89,36,75,87,73,14
36,89,36,91,31,46,-15
36,89,36,93,40,0,40
36,89,36,111,34,0,34
36,89,36,113,24,0,24
36,89,37,119,0,24,-24
36,89,42,3,0,28,-28
36,89,50,7,31,39,-8
36,91,4,13,54,98,-44
36,91,6,1,0,36,-36
36,91,6,37,59,76,-17
36,91,6,59,32,0,32
36,91,6,73,99,93,6
36,91,6,85,0,49,-49
36,91,8,13,0,34,-34
36,91,9,1,65,43,22
36,91,9,3,50,55,-5
36,91,9,9,64,54,10
36,91,9,11,47,95,-48
36,91,10,3,0,33,-33
36,91,12,9,0,36,-36
36,91,12,11,52,0,52
36,91,12,31,0,49,-49
36,91,12,57,43,51,-8
36,91,12,71,0,26,-26
36,91,12,81,0,29,-29
36,91,12,83,0,44,-44
36,91,12,86,25,37,-12
36,91,12,95,45,37,8
36,91,12,99,63,61,2
36,91,12,101,31,37,-6
36,91,12,103,38,64,-26
36,91,12,115,0,29,-29
36,91,12,119,0,27,-27
36,91,12,127,43,34,9
36,91,13,39,0,36,-36
36,91,13,121,21,0,21
36,91,15,3,30,90,-60
36,91,17,31,0,60,-60
36,91,23,5,30,0,30
36,91,24,3,32,0,32
36,91,24,31,0,32,-32
36,91,24,510,0,31,-31
36,91,25,3,32,0,32
36,91,25,5,25,0,25
36,91,25,9,34,44,-10
36,91,25,13,44,39,5
36,91,25,17,52,114,-62
36,91,25,21,43,43,0
36,91,25,25,43,78,-35
36,91,25,27,47,57,-10
36,91,27,53,27,0,27
36,91,32,3,0,46,-46
36,91,33,15,0,35,-35
36,91,34,3,29,0,29
36,91,34,17,26,33,-7
36,91,34,27,35,0,35
36,91,34,31,25,0,25
36,91,36,1,2902,2261,641
36,91,36,5,60,33,27
36,91,36,7,72,33,39
36,91,36,11,25,0,25
36,91,36,19,88,60,28
36,91,36,21,43,24,19
36,91,36,27,110,60,50
36,91,36,29,101,72,29
36,91,36,31,67,79,-12
36,91,36,33,45,42,3
36,91,36,35,222,279,-57
36,91,36,39,57,47,10
36,91,36,41,30,0,30
36,91,36,43,44,0,44
36,91,36,45,40,0,40
36,91,36,47,103,82,21
36,91,36,55,112,107,5
36,91,36,57,243,224,19
36,91,36,59,205,0,205
36,91,36,61,132,123,9
36,91,36,65,123,51,72
36,91,36,67,149,105,44
36,91,36,71,115,62,53
36,91,36,75,34,41,-7
36,91,36,77,42,32,10
36,91,36,81,106,78,28
36,91,36,83,1445,1215,230
36,91,36,85,37,0,37
36,91,36,87,33,0,33
36,91,36,89,46,31,15
36,91,36,93,1484,1334,150
36,91,36,95,57,40,17
36,91,36,103,182,61,121
36,91,36,111,104,50,54
36,91,36,113,1343,1301,42
36,91,36,115,812,855,-43
36,91,36,119,109,51,58
36,91,37,63,0,24,-24
36,91,37,119,0,55,-55
36,91,37,133,30,40,-10
36,91,37,183,23,61,-38
36,91,42,3,32,37,-5
36,91,42,29,0,46,-46
36,91,42,91,0,41,-41
36,91,42,101,26,28,-2
36,91,44,7,22,27,-5
36,91,45,15,492,0,492
36,91,45,19,34,0,34
36,91,45,45,0,55,-55
36,91,45,51,0,53,-53
36,91,48,201,36,52,-16
36,91,50,3,39,0,39
36,91,50,7,0,47,-47
36,91,50,21,39,0,39
36,91,51,41,29,0,29
36,91,51,59,32,37,-5
36,91,51,550,0,37,-37
36,91,51,650,0,36,-36
36,91,51,700,37,30,7
36,91,51,710,0,46,-46
36,91,51,810,53,64,-11
36,91,53,33,30,0,30
36,91,53,35,69,97,-28
36,93,4,13,0,57,-57
36,93,6,37,42,48,-6
36,93,6,73,0,45,-45
36,93,9,1,34,0,34
36,93,9,3,29,25,4
36,93,9,9,27,34,-7
36,93,11,1,0,22,-22
36,93,12,9,0,28,-28
36,93,12,11,0,36,-36
36,93,12,31,0,24,-24
36,93,12,95,31,38,-7
36,93,12,99,24,25,-1
36,93,12,103,24,52,-28
36,93,13,67,0,34,-34
36,93,13,121,0,26,-26
36,93,17,31,22,42,-20
36,93,24,31,0,27,-27
36,93,25,17,52,67,-15
36,93,25,21,0,21,-21
36,93,25,25,0,40,-40
36,93,34,17,0,26,-26
36,93,36,1,3047,2464,583
36,93,36,5,198,85,113
36,93,36,7,42,38,4
36,93,36,19,30,30,0
36,93,36,21,43,43,0
36,93,36,27,103,57,46
36,93,36,29,57,48,9
36,93,36,35,165,195,-30
36,93,36,39,67,0,67
36,93,36,43,28,0,28
36,93,36,47,165,142,23
36,93,36,55,52,87,-35
36,93,36,57,371,456,-85
36,93,36,59,51,44,7
36,93,36,61,73,118,-45
36,93,36,65,39,65,-26
36,93,36,67,86,68,18
36,93,36,71,40,39,1
36,93,36,77,60,27,33
36,93,36,81,356,162,194
36,93,36,83,662,511,151
36,93,36,89,0,40,-40
36,93,36,91,1334,1484,-150
36,93,36,95,203,238,-35
36,93,36,103,52,41,11
36,93,36,109,28,0,28
36,93,36,111,61,60,1
36,93,36,113,65,56,9
36,93,36,115,53,44,9
36,93,36,119,35,28,7
36,93,37,119,0,56,-56
36,93,37,183,0,57,-57
36,93,42,3,29,0,29
36,93,42,101,0,29,-29
36,93,45,45,0,48,-48
36,93,45,51,0,29,-29
36,95,36,1,238,264,-26
36,95,36,25,130,113,17
36,95,36,35,0,48,-48
36,95,36,39,36,40,-4
36,95,36,57,138,163,-25
36,95,36,77,121,114,7
36,95,36,83,64,42,22
36,95,36,91,40,57,-17
36,95,36,93,238,203,35
36,95,36,103,91,27,64
36,95,36,111,0,25,-25
36,95,36,119,29,0,29
36,97,36,15,197,268,-71
36,97,36,55,34,0,34
36,97,36,99,51,62,-11
36,97,36,101,197,177,20
36,97,36,107,31,24,7
36,97,36,109,166,163,3
36,97,36,123,60,76,-16
36,99,36,11,148,105,43
36,99,36,15,36,30,6
36,99,36,29,25,30,-5
36,99,36,55,88,128,-40
36,99,36,67,36,76,-40
36,99,36,69,384,453,-69
36,99,36,97,62,51,11
36,99,36,101,24,0,24
36,99,36,109,142,150,-8
36,99,36,117,214,175,39
36,99,36,123,54,61,-7
36,101,4,13,0,32,-32
36,101,6,73,36,25,11
36,101,12,105,0,38,-38
36,101,36,3,272,277,-5
36,101,36,7,88,58,30
36,101,36,9,26,41,-15
36,101,36,15,679,655,24
36,101,36,23,29,0,29
36,101,36,29,69,101,-32
36,101,36,37,0,32,-32
36,101,36,51,310,411,-101
36,101,36,55,198,308,-110
36,101,36,63,26,0,26
36,101,36,65,33,0,33
36,101,36,67,56,67,-11
36,101,36,69,169,175,-6
36,101,36,75,34,0,34
36,101,36,97,177,197,-20
36,101,36,99,0,24,-24
36,101,36,107,32,53,-21
36,101,36,109,46,57,-11
36,101,36,117,66,32,34
36,101,36,123,118,161,-43
36,101,37,119,0,43,-43
36,101,37,133,30,0,30
36,101,37,183,0,48,-48
36,101,42,15,52,34,18
36,101,42,117,176,150,26
36,103,1,89,0,29,-29
36,103,1,97,0,27,-27
36,103,4,13,229,594,-365
36,103,4,19,32,94,-62
36,103,4,21,0,69,-69
36,103,4,25,0,39,-39
36,103,6,1,57,107,-50
36,103,6,13,0,58,-58
36,103,6,37,348,482,-134
36,103,6,59,114,190,-76
36,103,6,65,35,96,-61
36,103,6,67,27,40,-13
36,103,6,71,52,30,22
36,103,6,73,217,366,-149
36,103,6,75,52,115,-63
36,103,6,81,0,42,-42
36,103,6,83,22,23,-1
36,103,6,85,70,109,-39
36,103,6,111,33,0,33
36,103,8,5,0,43,-43
36,103,8,13,0,66,-66
36,103,8,31,20,44,-24
36,103,8,41,46,69,-23
36,103,8,59,0,29,-29
36,103,8,69,27,39,-12
36,103,9,1,329,381,-52
36,103,9,3,128,203,-75
36,103,9,5,33,84,-51
36,103,9,7,46,70,-24
36,103,9,9,219,230,-11
36,103,9,11,48,134,-86
36,103,9,13,0,33,-33
36,103,10,1,49,74,-25
36,103,10,3,75,111,-36
36,103,10,5,25,68,-43
36,103,11,1,82,132,-50
36,103,12,9,147,354,-207
36,103,12,11,518,588,-70
36,103,12,15,43,95,-52
36,103,12,17,72,171,-99
36,103,12,19,0,48,-48
36,103,12,21,93,157,-64
36,103,12,31,50,160,-110
36,103,12,35,66,214,-148
36,103,12,53,188,281,-93
36,103,12,57,227,522,-295
36,103,12,61,55,137,-82
36,103,12,69,50,155,-105
36,103,12,71,183,436,-253
36,103,12,73,0,28,-28
36,103,12,81,57,153,-96
36,103,12,83,78,231,-153
36,103,12,85,69,157,-88
36,103,12,86,283,417,-134
36,103,12,87,0,46,-46
36,103,12,95,373,411,-38
36,103,12,97,121,211,-90
36,103,12,99,552,1107,-555
36,103,12,101,166,405,-239
36,103,12,103,184,262,-78
36,103,12,105,89,172,-83
36,103,12,109,29,167,-138
36,103,12,111,199,390,-191
36,103,12,115,95,187,-92
36,103,12,117,113,161,-48
36,103,12,119,0,176,-176
36,103,12,127,127,286,-159
36,103,13,51,31,74,-43
36,103,13,57,0,69,-69
36,103,13,63,0,75,-75
36,103,13,67,84,180,-96
36,103,13,89,69,157,-88
36,103,13,97,0,46,-46
36,103,13,113,0,62,-62
36,103,13,117,0,108,-108
36,103,13,121,70,213,-143
36,103,13,135,86,371,-285
36,103,13,139,0,35,-35
36,103,13,151,0,104,-104
36,103,13,223,0,57,-57
36,103,13,247,0,36,-36
36,103,15,3,72,106,-34
36,103,17,31,201,238,-37
36,103,17,43,44,26,18
36,103,18,97,0,84,-84
36,103,20,91,33,0,33
36,103,21,111,0,35,-35
36,103,22,71,0,33,-33
36,103,23,5,0,75,-75
36,103,23,31,30,0,30
36,103,24,3,54,62,-8
36,103,24,5,74,127,-53
36,103,24,21,0,44,-44
36,103,24,25,0,33,-33
36,103,24,27,36,41,-5
36,103,24,31,113,193,-80
36,103,24,33,81,104,-23
36,103,24,45,0,33,-33
36,103,24,510,53,82,-29
36,103,25,1,0,35,-35
36,103,25,3,24,0,24
36,103,25,5,0,28,-28
36,103,25,9,52,69,-17
36,103,25,13,64,39,25
36,103,25,15,0,37,-37
36,103,25,17,192,283,-91
36,103,25,21,92,127,-35
36,103,25,23,42,48,-6
36,103,25,25,134,244,-110
36,103,25,27,86,92,-6
36,103,26,81,0,36,-36
36,103,26,125,31,33,-2
36,103,26,161,0,28,-28
36,103,26,163,36,0,36
36,103,27,53,38,46,-8
36,103,29,95,25,0,25
36,103,32,3,174,360,-186
36,103,33,5,0,27,-27
36,103,33,11,44,47,-3
36,103,33,15,33,46,-13
36,103,34,1,32,0,32
36,103,34,3,294,264,30
36,103,34,5,44,87,-43
36,103,34,7,46,69,-23
36,103,34,13,193,132,61
36,103,34,15,0,32,-32
36,103,34,17,310,445,-135
36,103,34,19,0,49,-49
36,103,34,21,91,90,1
36,103,34,23,196,272,-76
36,103,34,25,117,171,-54
36,103,34,27,123,177,-54
36,103,34,29,79,87,-8
36,103,34,31,106,101,5
36,103,34,35,76,97,-21
36,103,34,37,26,31,-5
36,103,34,39,91,115,-24
36,103,35,1,31,43,-12
36,103,35,43,0,32,-32
36,103,36,1,151,216,-65
36,103,36,5,1253,734,519
36,103,36,7,41,123,-82
36,103,36,17,0,52,-52
36,103,36,21,29,29,0
36,103,36,25,39,113,-74
36,103,36,27,126,230,-104
36,103,36,29,107,123,-16
36,103,36,39,37,86,-49
36,103,36,45,0,64,-64
36,103,36,47,3481,2466,1015
36,103,36,55,126,173,-47
36,103,36,57,34,32,2
36,103,36,59,15284,10042,5242
36,103,36,61,2276,2776,-500
36,103,36,63,0,33,-33
36,103,36,65,38,38,0
36,103,36,67,74,152,-78
36,103,36,71,255,245,10
36,103,36,77,40,108,-68
36,103,36,79,47,55,-8
36,103,36,81,7417,4661,2756
36,103,36,83,46,71,-25
36,103,36,85,294,228,66
36,103,36,87,123,125,-2
36,103,36,91,61,182,-121
36,103,36,93,41,52,-11
36,103,36,95,27,91,-64
36,103,36,105,53,65,-12
36,103,36,109,72,34,38
36,103,36,111,112,159,-47
36,103,36,113,0,59,-59
36,103,36,115,0,59,-59
36,103,36,119,724,619,105
36,103,37,1,0,90,-90
36,103,37,19,0,124,-124
36,103,37,21,0,47,-47
36,103,37,25,0,192,-192
36,103,37,27,0,31,-31
36,103,37,31,0,27,-27
36,103,37,35,0,71,-71
36,103,37,37,0,45,-45
36,103,37,49,0,53,-53
36,103,37,51,40,90,-50
36,103,37,57,0,38,-38
36,103,37,63,45,81,-36
36,103,37,67,0,124,-124
36,103,37,69,0,67,-67
36,103,37,71,0,61,-61
36,103,37,81,44,188,-144
36,103,37,85,0,31,-31
36,103,37,97,28,410,-382
36,103,37,101,0,204,-204
36,103,37,109,0,82,-82
36,103,37,119,206,1214,-1008
36,103,37,129,52,148,-96
36,103,37,133,94,96,-2
36,103,37,135,0,32,-32
36,103,37,141,0,79,-79
36,103,37,147,0,42,-42
36,103,37,159,0,41,-41
36,103,37,179,0,491,-491
36,103,37,183,126,1200,-1074
36,103,39,35,40,65,-25
36,103,39,49,51,67,-16
36,103,39,61,23,0,23
36,103,40,143,0,31,-31
36,103,41,51,0,47,-47
36,103,42,3,65,84,-19
36,103,42,11,68,83,-15
36,103,42,17,77,153,-76
36,103,42,25,0,33,-33
36,103,42,29,55,99,-44
36,103,42,41,0,73,-73
36,103,42,43,0,46,-46
36,103,42,45,55,51,4
36,103,42,69,32,60,-28
36,103,42,71,59,108,-49
36,103,42,77,91,206,-115
36,103,42,79,55,116,-61
36,103,42,89,72,203,-131
36,103,42,91,88,80,8
36,103,42,95,42,122,-80
36,103,42,101,145,195,-50
36,103,42,103,36,153,-117
36,103,42,127,40,106,-66
36,103,42,133,35,66,-31
36,103,44,5,0,24,-24
36,103,44,7,89,89,0
36,103,45,7,0,55,-55
36,103,45,13,37,142,-105
36,103,45,15,0,67,-67
36,103,45,19,43,74,-31
36,103,45,35,0,71,-71
36,103,45,41,0,31,-31
36,103,45,45,32,161,-129
36,103,45,51,63,278,-215
36,103,45,57,0,50,-50
36,103,45,63,34,52,-18
36,103,45,79,0,53,-53
36,103,45,83,0,46,-46
36,103,45,91,0,189,-189
36,103,47,37,34,41,-7
36,103,47,93,0,45,-45
36,103,47,157,40,56,-16
36,103,48,27,42,71,-29
36,103,48,29,39,117,-78
36,103,48,85,37,119,-82
36,103,48,113,104,115,-11
36,103,48,121,28,82,-54
36,103,48,157,0,94,-94
36,103,48,201,153,432,-279
36,103,48,339,0,51,-51
36,103,48,439,49,137,-88
36,103,48,453,42,88,-46
36,103,48,491,0,63,-63
36,103,49,35,43,63,-20
36,103,50,7,28,53,-25
36,103,50,27,0,32,-32
36,103,51,3,0,39,-39
36,103,51,13,34,93,-59
36,103,51,41,0,101,-101
36,103,51,59,102,154,-52
36,103,51,65,0,34,-34
36,103,51,85,0,27,-27
36,103,51,87,39,71,-32
36,103,51,95,0,32,-32
36,103,51,107,45,84,-39
36,103,51,153,50,81,-31
36,103,51,510,0,31,-31
36,103,51,550,42,43,-1
36,103,51,650,0,52,-52
36,103,51,700,39,52,-13
36,103,51,710,65,43,22
36,103,51,760,0,40,-40
36,103,51,810,86,145,-59
36,103,53,33,92,142,-50
36,103,53,53,37,35,2
36,103,53,61,0,42,-42
36,103,55,25,0,28,-28
36,105,4,13,0,25,-25
36,105,6,37,0,22,-22
36,105,12,11,0,25,-25
36,105,12,95,0,39,-39
36,105,12,99,27,62,-35
36,105,12,127,0,36,-36
36,105,32,3,0,33,-33
36,105,34,3,42,32,10
36,105,34,17,30,27,3
36,105,36,1,0,61,-61
36,105,36,5,209,153,56
36,105,36,7,0,41,-41
36,105,36,25,56,42,14
36,105,36,27,94,76,18
36,105,36,29,0,40,-40
36,105,36,47,224,176,48
36,105,36,55,0,32,-32
36,105,36,59,86,53,33
36,105,36,61,172,132,40
36,105,36,67,0,40,-40
36,105,36,71,1409,1041,368
36,105,36,81,193,141,52
36,105,36,85,53,0,53
36,105,36,87,109,59,50
36,105,36,103,65,53,12
36,105,36,111,320,313,7
36,105,36,119,122,80,42
36,105,42,103,52,100,-48
36,105,42,127,46,117,-71
36,105,45,51,0,49,-49
36,107,36,7,1056,969,87
36,107,36,11,0,30,-30
36,107,36,15,201,263,-62
36,107,36,23,83,80,3
36,107,36,29,0,31,-31
36,107,36,67,0,41,-41
36,107,36,97,24,31,-7
36,107,36,101,53,32,21
36,107,36,109,232,230,2
36,107,37,183,0,25,-25
36,107,42,15,352,374,-22
36,107,42,79,23,0,23
36,107,42,115,36,41,-5
36,109,4,13,34,38,-4
36,109,6,1,39,44,-5
36,109,6,37,82,110,-28
36,109,6,73,74,50,24
36,109,6,75,40,49,-9
36,109,6,81,0,28,-28
36,109,6,85,42,110,-68
36,109,9,1,0,37,-37
36,109,9,9,33,0,33
36,109,10,3,0,27,-27
36,109,11,1,58,57,1
36,109,12,86,29,27,2
36,109,12,103,0,28,-28
36,109,13,121,0,28,-28
36,109,17,31,88,117,-29
36,109,24,31,60,58,2
36,109,24,510,30,22,8
36,109,25,17,146,166,-20
36,109,25,21,32,38,-6
36,109,25,25,57,97,-40
36,109,25,27,25,0,25
36,109,26,161,29,39,-10
36,109,27,53,24,42,-18
36,109,32,3,29,24,5
36,109,34,3,0,42,-42
36,109,34,17,0,109,-109
36,109,34,21,0,29,-29
36,109,34,23,0,49,-49
36,109,34,27,24,24,0
36,109,36,1,51,34,17
36,109,36,5,38,28,10
36,109,36,7,193,123,70
36,109,36,11,310,223,87
36,109,36,15,159,116,43
36,109,36,17,34,0,34
36,109,36,23,452,424,28
36,109,36,27,35,0,35
36,109,36,29,46,74,-28
36,109,36,47,97,151,-54
36,109,36,53,30,0,30
36,109,36,55,147,143,4
36,109,36,59,38,29,9
36,109,36,61,238,456,-218
36,109,36,65,36,0,36
36,109,36,67,139,195,-56
36,109,36,69,42,26,16
36,109,36,75,20,0,20
36,109,36,81,90,103,-13
36,109,36,93,0,28,-28
36,109,36,97,163,166,-3
36,109,36,99,150,142,8
36,109,36,101,57,46,11
36,109,36,103,34,72,-38
36,109,36,107,230,232,-2
36,109,36,117,28,0,28
36,109,36,119,42,37,5
36,109,36,123,38,0,38
36,109,37,183,0,27,-27
36,109,39,35,29,0,29
36,109,39,49,28,0,28
36,109,41,51,0,34,-34
36,109,42,3,38,40,-2
36,109,42,15,28,27,1
36,109,42,29,29,0,29
36,109,42,91,23,0,23
36,109,42,101,50,51,-1
36,109,48,201,0,45,-45
36,109,48,453,0,37,-37
36,109,50,7,24,0,24
36,109,51,13,0,26,-26
36,109,51,59,28,48,-20
36,109,53,33,52,95,-43
36,109,55,25,0,33,-33
36,111,4,13,36,54,-18
36,111,6,37,48,0,48
36,111,6,73,0,42,-42
36,111,9,1,57,44,13
36,111,9,3,32,0,32
36,111,12,9,0,32,-32
36,111,12,11,0,24,-24
36,111,12,57,0,34,-34
36,111,12,71,0,40,-40
36,111,12,86,0,24,-24
36,111,12,95,46,37,9
36,111,12,97,0,38,-38
36,111,12,99,28,56,-28
36,111,12,101,0,30,-30
36,111,12,103,0,50,-50
36,111,12,105,0,29,-29
36,111,12,115,0,27,-27
36,111,12,127,0,40,-40
36,111,25,17,40,40,0
36,111,25,25,0,34,-34
36,111,32,3,0,37,-37
36,111,34,3,86,48,38
36,111,34,13,30,0,30
36,111,34,17,0,39,-39
36,111,34,23,0,26,-26
36,111,34,27,0,33,-33
36,111,34,31,35,36,-1
36,111,36,1,132,234,-102
36,111,36,5,198,98,100
36,111,36,7,26,36,-10
36,111,36,19,22,0,22
36,111,36,21,88,118,-30
36,111,36,25,90,75,15
36,111,36,27,1573,1339,234
36,111,36,29,27,73,-46
36,111,36,39,290,397,-107
36,111,36,47,304,236,68
36,111,36,55,43,43,0
36,111,36,59,116,69,47
36,111,36,61,429,308,121
36,111,36,65,0,40,-40
36,111,36,67,43,40,3
36,111,36,71,1692,1307,385
36,111,36,77,24,33,-9
36,111,36,79,65,58,7
36,111,36,81,241,170,71
36,111,36,83,40,69,-29
36,111,36,85,61,39,22
36,111,36,87,114,66,48
36,111,36,89,0,34,-34
36,111,36,91,50,104,-54
36,111,36,93,60,61,-1
36,111,36,95,25,0,25
36,111,36,103,159,112,47
36,111,36,105,313,320,-7
36,111,36,119,245,150,95
36,111,37,119,0,34,-34
36,111,37,183,0,109,-109
36,111,42,3,0,35,-35
36,111,42,91,0,32,-32
36,111,42,101,0,53,-53
36,111,42,103,0,48,-48
36,111,45,51,0,42,-42
36,111,48,453,0,25,-25
36,111,51,59,0,32,-32
36,111,51,810,0,25,-25
36,113,4,13,0,31,-31
36,113,9,1,27,0,27
36,113,25,17,0,35,-35
36,113,25,25,0,20,-20
36,113,34,3,35,0,35
36,113,36,1,180,165,15
36,113,36,19,36,55,-19
36,113,36,31,135,125,10
36,113,36,47,36,23,13
36,113,36,59,41,0,41
36,113,36,61,32,0,32
36,113,36,65,0,28,-28
36,113,36,71,38,0,38
36,113,36,81,0,31,-31
36,113,36,83,60,74,-14
36,113,36,89,0,24,-24
36,113,36,91,1301,1343,-42
36,113,36,93,56,65,-9
36,113,36,103,59,0,59
36,113,36,115,1172,1146,26
36,113,36,119,24,0,24
36,113,50,7,0,33,-33
36,113,50,21,38,27,11
36,115,36,1,107,119,-12
36,115,36,19,33,0,33
36,115,36,31,67,55,12
36,115,36,61,0,32,-32
36,115,36,83,204,186,18
36,115,36,91,855,812,43
36,115,36,93,44,53,-9
36,115,36,103,59,0,59
36,115,36,113,1146,1172,-26
36,115,50,3,99,86,13
36,115,50,21,211,137,74
36,117,4,13,0,30,-30
36,117,6,73,26,0,26
36,117,12,103,25,0,25
36,117,36,7,0,28,-28
36,117,36,11,160,165,-5
36,117,36,29,49,59,-10
36,117,36,37,39,0,39
36,117,36,51,35,85,-50
36,117,36,55,2178,2181,-3
36,117,36,67,114,123,-9
36,117,36,69,857,816,41
36,117,36,75,75,59,16
36,117,36,99,175,214,-39
36,117,36,101,32,66,-34
36,117,36,109,0,28,-28
36,117,36,123,37,38,-1
36,117,37,183,0,38,-38
36,119,4,13,97,253,-156
36,119,4,19,45,51,-6
36,119,6,1,77,109,-32
36,119,6,13,60,54,6
36,119,6,19,0,33,-33
36,119,6,37,441,505,-64
36,119,6,41,34,35,-1
36,119,6,59,88,119,-31
36,119,6,65,43,46,-3
36,119,6,71,38,44,-6
36,119,6,73,150,226,-76
36,119,6,75,106,114,-8
36,119,6,81,47,37,10
36,119,6,83,39,0,39
36,119,6,85,87,167,-80
36,119,8,13,35,38,-3
36,119,8,31,34,47,-13
36,119,9,1,2383,4503,-2120
36,119,9,3,174,224,-50
36,119,9,5,78,180,-102
36,119,9,7,0,67,-67
36,119,9,9,377,657,-280
36,119,9,11,95,74,21
36,119,10,1,0,77,-77
36,119,10,3,60,90,-30
36,119,10,5,0,49,-49
36,119,11,1,159,197,-38
36,119,12,1,24,0,24
36,119,12,9,42,75,-33
36,119,12,11,356,408,-52
36,119,12,17,0,29,-29
36,119,12,21,43,130,-87
36,119,12,31,33,111,-78
36,119,12,35,0,67,-67
36,119,12,53,0,54,-54
36,119,12,57,90,218,-128
36,119,12,61,0,41,-41
36,119,12,69,0,57,-57
36,119,12,71,65,148,-83
36,119,12,81,25,44,-19
36,119,12,83,0,46,-46
36,119,12,85,0,44,-44
36,119,12,86,289,334,-45
36,119,12,95,147,309,-162
36,119,12,97,57,111,-54
36,119,12,99,333,631,-298
36,119,12,101,39,88,-49
36,119,12,103,38,121,-83
36,119,12,105,0,77,-77
36,119,12,109,0,63,-63
36,119,12,111,57,115,-58
36,119,12,115,35,118,-83
36,119,12,117,64,56,8
36,119,12,119,0,26,-26
36,119,12,127,24,73,-49
36,119,13,51,0,33,-33
36,119,13,63,0,45,-45
36,119,13,67,91,158,-67
36,119,13,89,85,146,-61
36,119,13,121,106,203,-97
36,119,13,135,55,265,-210
36,119,13,151,0,29,-29
36,119,13,247,0,34,-34
36,119,15,3,43,39,4
36,119,17,31,271,285,-14
36,119,17,43,44,0,44
36,119,18,97,0,26,-26
36,119,20,91,32,0,32
36,119,22,71,0,25,-25
36,119,23,5,0,61,-61
36,119,24,3,0,31,-31
36,119,24,5,48,101,-53
36,119,24,27,0,38,-38
36,119,24,31,208,161,47
36,119,24,33,40,91,-51
36,119,24,510,47,75,-28
36,119,25,1,34,70,-36
36,119,25,3,0,42,-42
36,119,25,5,0,42,-42
36,119,25,9,57,88,-31
36,119,25,13,47,0,47
36,119,25,15,28,47,-19
36,119,25,17,321,295,26
36,119,25,21,120,114,6
36,119,25,23,27,32,-5
36,119,25,25,198,206,-8
36,119,25,27,73,81,-8
36,119,26,125,58,42,16
36,119,26,161,60,0,60
36,119,26,163,36,30,6
36,119,27,53,59,63,-4
36,119,29,189,38,0,38
36,119,32,3,82,114,-32
36,119,33,11,34,31,3
36,119,33,15,26,37,-11
36,119,34,1,0,35,-35
36,119,34,3,520,693,-173
36,119,34,5,42,48,-6
36,119,34,7,48,41,7
36,119,34,13,252,279,-27
36,119,34,17,501,482,19
36,119,34,21,65,153,-88
36,119,34,23,271,329,-58
36,119,34,25,114,149,-35
36,119,34,27,123,225,-102
36,119,34,29,80,114,-34
36,119,34,31,152,158,-6
36,119,34,35,67,102,-35
36,119,34,37,0,67,-67
36,119,34,39,129,196,-67
36,119,36,1,166,213,-47
36,119,36,5,10985,6311,4674
36,119,36,7,75,67,8
36,119,36,21,0,82,-82
36,119,36,25,31,49,-18
36,119,36,27,1130,2414,-1284
36,119,36,29,114,109,5
36,119,36,39,0,50,-50
36,119,36,45,0,25,-25
36,119,36,47,1964,1652,312
36,119,36,55,113,136,-23
36,119,36,59,871,669,202
36,119,36,61,6725,4573,2152
36,119,36,65,40,0,40
36,119,36,67,110,77,33
36,119,36,71,736,1159,-423
36,119,36,77,30,0,30
36,119,36,79,1495,2522,-1027
36,119,36,81,2544,1867,677
36,119,36,83,51,63,-12
36,119,36,85,185,151,34
36,119,36,87,929,1209,-280
36,119,36,91,51,109,-58
36,119,36,93,28,35,-7
36,119,36,95,0,29,-29
36,119,36,103,619,724,-105
36,119,36,105,80,122,-42
36,119,36,109,37,42,-5
36,119,36,111,150,245,-95
36,119,36,113,0,24,-24
36,119,37,19,0,36,-36
36,119,37,25,0,65,-65
36,119,37,51,0,52,-52
36,119,37,63,54,61,-7
36,119,37,67,0,44,-44
36,119,37,81,37,135,-98
36,119,37,119,124,302,-178
36,119,37,129,0,31,-31
36,119,37,133,32,48,-16
36,119,37,135,0,44,-44
36,119,37,179,0,92,-92
36,119,37,183,106,329,-223
36,119,39,35,0,55,-55
36,119,39,49,53,100,-47
36,119,40,143,0,30,-30
36,119,41,51,23,40,-17
36,119,42,3,96,51,45
36,119,42,11,26,83,-57
36,119,42,17,44,86,-42
36,119,42,29,32,74,-42
36,119,42,43,0,31,-31
36,119,42,45,48,54,-6
36,119,42,69,0,32,-32
36,119,42,71,0,36,-36
36,119,42,77,44,108,-64
36,119,42,79,39,64,-25
36,119,42,89,70,97,-27
36,119,42,91,92,72,20
36,119,42,95,32,61,-29
36,119,42,101,176,225,-49
36,119,42,103,0,70,-70
36,119,44,7,117,76,41
36,119,44,9,0,57,-57
36,119,45,13,0,50,-50
36,119,45,19,0,64,-64
36,119,45,45,0,38,-38
36,119,45,47,121,0,121
36,119,45,51,0,110,-110
36,119,45,79,0,62,-62
36,119,45,91,0,45,-45
36,119,47,157,0,48,-48
36,119,48,29,0,36,-36
36,119,48,85,23,65,-42
36,119,48,113,76,140,-64
36,119,48,121,0,36,-36
36,119,48,157,0,70,-70
36,119,48,201,105,208,-103
36,119,48,245,0,43,-43
36,119,48,439,36,76,-40
36,119,48,453,93,85,8
36,119,49,35,0,26,-26
36,119,50,3,0,37,-37
36,119,50,7,38,61,-23
36,119,50,25,0,24,-24
36,119,51,13,54,86,-32
36,119,51,41,0,36,-36
36,119,51,59,109,122,-13
36,119,51,87,0,85,-85
36,119,51,107,0,31,-31
36,119,51,153,46,54,-8
36,119,51,510,23,44,-21
36,119,51,700,0,26,-26
36,119,51,710,47,0,47
36,119,51,760,0,56,-56
36,119,51,810,42,48,-6
36,119,53,33,84,121,-37
36,119,55,25,0,36,-36
36,119,55,79,30,35,-5
36,121,36,3,83,103,-20
36,121,36,9,284,257,27
36,121,36,29,552,565,-13
36,121,36,37,384,376,8
36,121,36,51,211,240,-29
36,121,36,55,106,160,-54
36,121,36,63,0,38,-38
36,121,36,69,23,0,23
36,123,36,15,29,48,-19
36,123,36,51,34,0,34
36,123,36,55,68,147,-79
36,123,36,69,350,418,-68
36,123,36,97,76,60,16
36,123,36,99,61,54,7
36,123,36,101,161,118,43
36,123,36,109,0,38,-38
36,123,36,117,38,37,1
37,1,6,37,45,33,12
37,1,6,73,0,25,-25
37,1,9,9,32,0,32
37,1,12,11,56,0,56
37,1,12,57,34,0,34
37,1,12,86,40,0,40
37,1,12,95,55,0,55
37,1,12,97,30,0,30
37,1,12,99,35,0,35
37,1,13,121,0,26,-26
37,1,24,33,25,0,25
37,1,36,47,44,0,44
37,1,36,59,43,0,43
37,1,36,81,54,0,54
37,1,36,103,90,0,90
37,1,37,19,36,47,-11
37,1,37,21,64,54,10
37,1,37,31,0,32,-32
37,1,37,33,398,300,98
37,1,37,37,224,158,66
37,1,37,49,0,37,-37
37,1,37,51,37,36,1
37,1,37,57,84,80,4
37,1,37,63,616,347,269
37,1,37,67,186,227,-41
37,1,37,77,38,0,38
37,1,37,81,1745,1701,44
37,1,37,85,32,0,32
37,1,37,87,0,32,-32
37,1,37,97,0,43,-43
37,1,37,101,58,49,9
37,1,37,105,36,28,8
37,1,37,119,163,156,7
37,1,37,125,30,0,30
37,1,37,129,74,102,-28
37,1,37,133,37,46,-9
37,1,37,135,1115,701,414
37,1,37,145,77,74,3
37,1,37,147,53,36,17
37,1,37,151,201,148,53
37,1,37,157,194,145,49
37,1,37,159,0,33,-33
37,1,37,183,483,428,55
37,1,37,191,28,0,28
37,1,45,51,32,32,0
37,1,48,201,0,42,-42
37,1,51,59,50,0,50
37,1,51,143,39,0,39
37,3,37,23,65,61,4
37,3,37,25,33,0,33
37,3,37,27,157,187,-30
37,3,37,35,624,666,-42
37,3,37,97,364,415,-51
37,3,37,109,36,35,1
37,3,37,119,47,42,5
37,3,37,193,103,81,22
37,5,12,86,31,0,31
37,5,37,9,69,36,33
37,5,37,67,40,35,5
37,5,37,171,42,87,-45
37,5,37,193,54,69,-15
37,5,51,77,69,55,14
37,7,37,25,0,28,-28
37,7,37,67,0,26,-26
37,7,37,81,32,40,-8
37,7,37,119,119,124,-5
37,7,37,123,39,0,39
37,7,37,153,93,115,-22
37,7,37,167,73,93,-20
37,7,37,179,298,302,-4
37,7,37,183,0,25,-25
37,7,45,25,84,106,-22
37,9,37,5,36,69,-33
37,9,37,21,0,30,-30
37,9,37,35,0,25,-25
37,9,37,67,36,0,36
37,9,37,81,0,24,-24
37,9,37,97,32,0,32
37,9,37,119,38,0,38
37,9,37,183,27,0,27
37,9,37,189,221,143,78
37,9,37,193,90,102,-12
37,9,47,91,0,36,-36
37,9,51,77,29,38,-9
37,11,37,21,0,28,-28
37,11,37,23,55,47,8
37,11,37,121,55,55,0
37,11,37,189,141,200,-59
37,11,47,19,58,88,-30
37,13,24,31,26,0,26
37,13,37,31,48,0,48
37,13,37,49,146,167,-21
37,13,37,65,41,0,41
37,13,37,95,82,32,50
37,13,37,101,35,0,35
37,13,37,117,133,135,-2
37,13,37,127,28,0,28
37,13,37,129,0,28,-28
37,13,37,137,51,51,0
37,13,37,147,687,879,-192
37,13,37,183,104,94,10
37,13,37,187,41,64,-23
37,15,37,41,43,46,-3
37,15,37,83,27,0,27
37,15,37,91,304,267,37
37,15,37,117,52,104,-52
37,15,37,131,57,46,11
37,15,37,147,68,107,-39
37,15,37,183,0,61,-61
37,15,51,550,35,0,35
37,17,37,19,58,44,14
37,17,37,47,258,186,72
37,17,37,51,328,351,-23
37,17,37,81,40,30,10
37,17,37,85,0,29,-29
37,17,37,119,29,50,-21
37,17,37,129,91,81,10
37,17,37,141,31,0,31
37,17,37,155,233,251,-18
37,17,37,163,98,79,19
37,17,37,183,39,50,-11
37,19,4,13,36,0,36
37,19,6,37,25,0,25
37,19,9,1,52,0,52
37,19,9,3,33,0,33
37,19,9,9,43,0,43
37,19,12,86,38,0,38
37,19,24,3,69,0,69
37,19,24,17,32,0,32
37,19,24,21,45,0,45
37,19,24,31,48,0,48
37,19,24,33,31,0,31
37,19,24,45,40,0,40
37,19,25,17,42,0,42
37,19,34,5,56,0,56
37,19,34,7,42,0,42
37,19,34,21,25,0,25
37,19,34,23,57,0,57
37,19,34,25,51,0,51
37,19,34,27,44,0,44
37,19,34,29,35,0,35
37,19,34,35,34,0,34
37,19,34,39,31,0,31
37,19,36,1,30,0,30
37,19,36,27,31,0,31
37,19,36,47,27,0,27
37,19,36,59,46,0,46
37,19,36,71,48,0,48
37,19,36,79,28,0,28
37,19,36,87,43,0,43
37,19,36,103,124,0,124
37,19,36,119,36,0,36
37,19,37,1,47,36,11
37,19,37,17,44,58,-14
37,19,37,21,37,33,4
37,19,37,25,78,48,30
37,19,37,35,42,39,3
37,19,37,47,218,296,-78
37,19,37,51,186,87,99
37,19,37,57,33,30,3
37,19,37,61,39,0,39
37,19,37,63,51,34,17
37,19,37,67,109,50,59
37,19,37,71,84,58,26
37,19,37,81,134,124,10
37,19,37,85,31,0,31
37,19,37,97,47,0,47
37,19,37,101,36,42,-6
37,19,37,119,234,146,88
37,19,37,125,33,29,4
37,19,37,129,2957,1475,1482
37,19,37,133,68,73,-5
37,19,37,141,221,213,8
37,19,37,147,37,26,11
37,19,37,151,46,0,46
37,19,37,155,69,37,32
37,19,37,157,37,0,37
37,19,37,159,30,0,30
37,19,37,161,0,33,-33
37,19,37,163,24,0,24
37,19,37,165,29,0,29
37,19,37,179,77,70,7
37,19,37,183,325,228,97
37,19,37,191,39,0,39
37,19,39,49,31,0,31
37,19,42,3,54,0,54
37,19,42,17,36,0,36
37,19,42,91,34,0,34
37,19,45,19,44,25,19
37,19,45,45,0,33,-33
37,19,45,51,395,459,-64
37,19,45,83,29,0,29
37,19,45,91,0,60,-60
37,19,51,13,27,0,27
37,19,51,41,29,0,29
37,19,51,59,165,0,165
37,19,51,107,37,0,37
37,19,51,153,48,0,48
37,21,1,73,34,0,34
37,21,4,13,68,55,13
37,21,6,1,29,22,7
37,21,6,37,139,56,83
37,21,6,59,30,0,30
37,21,6,65,32,0,32
37,21,6,73,84,70,14
37,21,6,75,34,0,34
37,21,8,13,22,35,-13
37,21,8,31,29,27,2
37,21,8,41,0,24,-24
37,21,8,69,35,0,35
37,21,9,9,33,0,33
37,21,11,1,29,29,0
37,21,12,1,52,26,26
37,21,12,9,56,37,19
37,21,12,11,213,56,157
37,21,12,21,81,31,50
37,21,12,31,85,50,35
37,21,12,33,31,26,5
37,21,12,57,133,63,70
37,21,12,69,69,0,69
37,21,12,71,144,47,97
37,21,12,73,48,0,48
37,21,12,81,53,0,53
37,21,12,83,25,0,25
37,21,12,85,32,28,4
37,21,12,86,210,31,179
37,21,12,87,34,0,34
37,21,12,95,136,49,87
37,21,12,99,158,47,111
37,21,12,101,55,34,21
37,21,12,103,164,70,94
37,21,12,105,38,0,38
37,21,12,109,60,46,14
37,21,12,111,23,0,23
37,21,12,115,98,0,98
37,21,12,117,71,30,41
37,21,12,127,83,42,41
37,21,13,51,32,30,2
37,21,13,59,43,0,43
37,21,13,67,69,33,36
37,21,13,73,40,0,40
37,21,13,89,117,63,54
37,21,13,121,98,73,25
37,21,13,135,73,32,41
37,21,13,139,27,0,27
37,21,13,245,25,0,25
37,21,15,3,0,32,-32
37,21,17,31,77,95,-18
37,21,21,111,26,25,1
37,21,22,71,26,0,26
37,21,23,5,0,26,-26
37,21,24,3,0,22,-22
37,21,24,31,79,31,48
37,21,24,33,33,0,33
37,21,24,510,31,0,31
37,21,25,17,32,22,10
37,21,25,21,30,0,30
37,21,25,25,0,23,-23
37,21,26,49,26,0,26
37,21,26,55,31,0,31
37,21,26,77,29,0,29
37,21,26,99,31,0,31
37,21,26,125,36,32,4
37,21,26,161,27,0,27
37,21,26,163,34,0,34
37,21,27,53,24,0,24
37,21,32,3,0,35,-35
37,21,34,25,33,0,33
37,21,34,27,25,0,25
37,21,34,29,42,0,42
37,21,35,49,30,0,30
37,21,36,29,20,0,20
37,21,36,47,78,26,52
37,21,36,55,0,28,-28
37,21,36,61,32,51,-19
37,21,36,67,34,0,34
37,21,36,81,33,0,33
37,21,36,103,47,0,47
37,21,37,1,54,64,-10
37,21,37,9,30,0,30
37,21,37,11,28,0,28
37,21,37,19,33,37,-4
37,21,37,23,117,84,33
37,21,37,25,49,61,-12
37,21,37,27,47,37,10
37,21,37,31,24,0,24
37,21,37,35,109,132,-23
37,21,37,37,26,31,-5
37,21,37,39,34,0,34
37,21,37,45,69,52,17
37,21,37,51,51,69,-18
37,21,37,55,28,0,28
37,21,37,57,0,45,-45
37,21,37,63,108,90,18
37,21,37,67,148,126,22
37,21,37,71,51,101,-50
37,21,37,81,182,185,-3
37,21,37,87,624,694,-70
37,21,37,89,1664,2404,-740
37,21,37,97,40,53,-13
37,21,37,99,190,159,31
37,21,37,111,268,538,-270
37,21,37,113,79,61,18
37,21,37,115,662,718,-56
37,21,37,119,369,494,-125
37,21,37,121,51,33,18
37,21,37,129,129,114,15
37,21,37,133,30,30,0
37,21,37,135,108,116,-8
37,21,37,147,48,0,48
37,21,37,149,68,88,-20
37,21,37,159,32,0,32
37,21,37,161,74,134,-60
37,21,37,173,88,55,33
37,21,37,175,171,178,-7
37,21,37,179,61,43,18
37,21,37,183,397,343,54
37,21,37,189,142,94,48
37,21,37,199,168,165,3
37,21,39,35,27,0,27
37,21,39,49,42,29,13
37,21,39,61,40,0,40
37,21,41,51,31,55,-24
37,21,42,3,29,31,-2
37,21,42,101,40,27,13
37,21,42,133,27,0,27
37,21,45,7,34,75,-41
37,21,45,13,47,30,17
37,21,45,15,39,0,39
37,21,45,19,140,120,20
37,21,45,35,0,38,-38
37,21,45,41,24,0,24
37,21,45,45,183,339,-156
37,21,45,51,75,90,-15
37,21,45,63,52,56,-4
37,21,45,73,24,0,24
37,21,45,77,0,52,-52
37,21,45,79,78,50,28
37,21,45,83,73,156,-83
37,21,45,91,57,53,4
37,21,47,37,58,38,20
37,21,47,59,0,44,-44
37,21,47,65,26,73,-47
37,21,47,93,90,116,-26
37,21,47,149,27,0,27
37,21,47,157,41,0,41
37,21,47,163,50,51,-1
37,21,47,171,30,26,4
37,21,47,179,72,99,-27
37,21,48,113,32,38,-6
37,21,48,201,75,53,22
37,21,48,439,32,0,32
37,21,48,453,31,42,-11
37,21,50,7,30,0,30
37,21,51,3,27,0,27
37,21,51,59,77,36,41
37,21,51,810,65,0,65
37,21,53,33,81,54,27
37,23,37,3,61,65,-4
37,23,37,11,47,55,-8
37,23,37,21,84,117,-33
37,23,37,27,745,786,-41
37,23,37,35,1403,1213,190
37,23,37,45,45,78,-33
37,23,37,57,0,31,-31
37,23,37,67,36,31,5
37,23,37,71,48,58,-10
37,23,37,81,49,61,-12
37,23,37,97,80,64,16
37,23,37,109,98,60,38
37,23,37,111,366,282,84
37,23,37,119,131,132,-1
37,23,37,129,34,29,5
37,23,37,151,39,0,39
37,23,37,161,71,47,24
37,23,37,183,61,73,-12
37,23,37,189,36,61,-25
37,23,37,193,0,36,-36
37,25,4,13,32,45,-13
37,25,6,37,68,0,68
37,25,6,71,46,0,46
37,25,6,73,52,24,28
37,25,9,3,37,0,37
37,25,9,9,50,0,50
37,25,12,9,50,0,50
37,25,12,11,157,27,130
37,25,12,31,0,182,-182
37,25,12,57,92,0,92
37,25,12,71,43,0,43
37,25,12,86,133,0,133
37,25,12,95,64,0,64
37,25,12,99,64,0,64
37,25,12,103,44,0,44
37,25,12,111,44,0,44
37,25,12,127,65,0,65
37,25,13,67,50,0,50
37,25,13,121,58,27,31
37,25,13,245,33,0,33
37,25,17,31,27,0,27
37,25,21,111,0,47,-47
37,25,24,5,61,0,61
37,25,24,31,37,0,37
37,25,24,33,117,0,117
37,25,25,17,36,0,36
37,25,26,125,32,0,32
37,25,26,163,42,0,42
37,25,32,3,31,0,31
37,25,34,3,40,0,40
37,25,34,13,31,0,31
37,25,34,21,42,0,42
37,25,34,23,60,0,60
37,25,34,25,68,0,68
37,25,34,31,79,0,79
37,25,34,35,33,0,33
37,25,36,5,57,0,57
37,25,36,29,55,0,55
37,25,36,47,67,0,67
37,25,36,55,61,0,61
37,25,36,59,69,0,69
37,25,36,81,95,0,95
37,25,36,103,192,0,192
37,25,36,119,65,0,65
37,25,37,3,0,33,-33
37,25,37,7,28,0,28
37,25,37,19,48,78,-30
37,25,37,21,61,49,12
37,25,37,27,24,0,24
37,25,37,35,66,100,-34
37,25,37,45,62,46,16
37,25,37,51,73,71,2
37,25,37,57,50,99,-49
37,25,37,63,57,31,26
37,25,37,67,159,165,-6
37,25,37,71,214,255,-41
37,25,37,81,149,146,3
37,25,37,85,25,0,25
37,25,37,89,40,0,40
37,25,37,97,447,331,116
37,25,37,109,99,150,-51
37,25,37,119,5825,3250,2575
37,25,37,123,0,37,-37
37,25,37,129,90,51,39
37,25,37,133,39,0,39
37,25,37,135,0,41,-41
37,25,37,147,32,0,32
37,25,37,151,33,0,33
37,25,37,159,1984,2580,-596
37,25,37,161,0,29,-29
37,25,37,167,547,552,-5
37,25,37,179,296,388,-92
37,25,37,183,166,175,-9
37,25,39,35,41,0,41
37,25,39,113,36,0,36
37,25,42,3,46,0,46
37,25,42,101,37,0,37
37,25,44,7,38,0,38
37,25,45,19,34,44,-10
37,25,45,45,23,37,-14
37,25,45,51,51,65,-14
37,25,45,63,0,35,-35
37,25,45,79,50,32,18
37,25,45,83,37,0,37
37,25,45,91,99,226,-127
37,25,47,37,29,0,29
37,25,51,41,47,90,-43
37,25,51,59,53,0,53
37,25,51,87,0,34,-34
37,25,51,153,42,0,42
37,25,51,810,40,0,40
37,27,4,13,35,0,35
37,27,12,11,34,0,34
37,27,12,105,28,0,28
37,27,36,103,31,0,31
37,27,37,3,187,157,30
37,27,37,21,37,47,-10
37,27,37,23,786,745,41
37,27,37,25,0,24,-24
37,27,37,35,867,874,-7
37,27,37,45,0,33,-33
37,27,37,67,39,42,-3
37,27,37,71,54,72,-18
37,27,37,81,37,50,-13
37,27,37,97,71,71,0
37,27,37,109,53,59,-6
37,27,37,111,48,0,48
37,27,37,119,50,103,-53
37,27,37,133,27,0,27
37,27,37,179,32,0,32
37,27,37,183,62,66,-4
37,27,37,189,139,64,75
37,27,37,193,93,137,-44
37,27,45,51,45,0,45
37,29,37,53,125,58,67
37,29,37,55,38,37,1
37,29,37,139,223,269,-46
37,29,37,143,0,56,-56
37,29,51,550,129,31,98
37,29,51,810,152,40,112
37,31,6,73,72,45,27
37,31,12,11,29,0,29
37,31,15,3,32,0,32
37,31,36,103,27,0,27
37,31,37,1,32,0,32
37,31,37,13,0,48,-48
37,31,37,21,0,24,-24
37,31,37,49,748,729,19
37,31,37,51,53,46,7
37,31,37,63,62,60,2
37,31,37,67,56,0,56
37,31,37,69,0,29,-29
37,31,37,81,63,56,7
37,31,37,101,37,61,-24
37,31,37,107,74,31,43
37,31,37,119,52,52,0
37,31,37,127,50,46,4
37,31,37,129,89,142,-53
37,31,37,133,497,591,-94
37,31,37,135,0,28,-28
37,31,37,141,0,30,-30
37,31,37,147,176,173,3
37,31,37,183,267,251,16
37,31,37,191,40,49,-9
37,31,37,195,51,29,22
37,31,45,51,0,25,-25
37,31,51,59,28,0,28
37,31,51,810,42,35,7
37,33,37,1,300,398,-98
37,33,37,63,30,0,30
37,33,37,81,126,131,-5
37,33,37,135,56,0,56
37,33,37,145,93,125,-32
37,33,37,157,185,178,7
37,33,37,183,33,0,33
37,33,51,143,117,103,14
37,33,51,590,209,188,21
37,35,4,13,41,51,-10
37,35,6,19,0,43,-43
37,35,6,37,53,0,53
37,35,6,67,0,32,-32
37,35,12,9,38,0,38
37,35,12,11,65,0,65
37,35,12,31,37,0,37
37,35,12,69,42,0,42
37,35,12,71,62,0,62
37,35,12,95,31,0,31
37,35,12,99,52,0,52
37,35,12,101,33,0,33
37,35,12,103,50,0,50
37,35,12,127,31,0,31
37,35,13,67,41,0,41
37,35,13,121,0,30,-30
37,35,13,135,35,34,1
37,35,34,23,106,0,106
37,35,34,29,29,0,29
37,35,36,5,56,0,56
37,35,36,47,29,0,29
37,35,36,103,71,0,71
37,35,37,3,666,624,42
37,35,37,9,25,0,25
37,35,37,19,39,42,-3
37,35,37,21,132,109,23
37,35,37,23,1213,1403,-190
37,35,37,25,100,66,34
37,35,37,27,874,867,7
37,35,37,45,131,136,-5
37,35,37,51,32,40,-8
37,35,37,57,36,0,36
37,35,37,63,36,45,-9
37,35,37,67,112,136,-24
37,35,37,71,232,268,-36
37,35,37,81,103,149,-46
37,35,37,89,0,32,-32
37,35,37,97,630,475,155
37,35,37,109,1133,816,317
37,35,37,111,79,0,79
37,35,37,119,611,558,53
37,35,37,129,30,47,-17
37,35,37,133,34,0,34
37,35,37,135,0,36,-36
37,35,37,147,29,26,3
37,35,37,159,63,58,5
37,35,37,161,27,0,27
37,35,37,171,0,38,-38
37,35,37,179,44,39,5
37,35,37,183,127,202,-75
37,35,37,189,81,124,-43
37,35,37,193,72,74,-2
37,35,42,101,26,0,26
37,35,45,19,0,55,-55
37,35,45,45,29,52,-23
37,35,45,51,26,72,-46
37,35,45,83,0,40,-40
37,35,45,91,0,49,-49
37,35,47,93,31,0,31
37,35,47,163,0,38,-38
37,35,48,439,0,35,-35
37,35,51,153,40,0,40
37,37,6,37,36,30,6
37,37,9,1,29,0,29
37,37,12,99,31,0,31
37,37,17,31,31,0,31
37,37,24,31,30,0,30
37,37,36,59,45,0,45
37,37,36,61,22,0,22
37,37,36,103,45,0,45
37,37,37,1,158,224,-66
37,37,37,21,31,26,5
37,37,37,51,64,0,64
37,37,37,63,567,543,24
37,37,37,67,46,29,17
37,37,37,77,0,36,-36
37,37,37,81,131,166,-35
37,37,37,85,174,168,6
37,37,37,101,45,0,45
37,37,37,105,318,607,-289
37,37,37,119,71,49,22
37,37,37,125,62,83,-21
37,37,37,129,30,36,-6
37,37,37,135,901,625,276
37,37,37,147,32,0,32
37,37,37,151,207,312,-105
37,37,37,183,1413,660,753
37,37,51,59,56,0,56
37,39,12,11,31,0,31
37,39,12,57,32,0,32
37,39,12,71,58,0,58
37,39,12,86,32,0,32
37,39,12,99,59,0,59
37,39,13,111,46,53,-7
37,39,13,291,67,34,33
37,39,37,21,0,34,-34
37,39,37,43,116,209,-93
37,39,37,75,83,45,38
37,39,37,99,0,25,-25
37,39,37,113,47,31,16
37,39,37,183,0,33,-33
37,39,47,139,36,33,3
37,41,37,15,46,43,3
37,41,37,73,38,0,38
37,41,37,139,93,98,-5
37,41,37,143,101,97,4
37,41,37,147,28,67,-39
37,41,37,183,0,47,-47
37,41,37,187,28,33,-5
37,41,51,550,29,0,29
37,41,51,810,27,0,27
37,43,13,67,36,0,36
37,43,13,281,96,110,-14
37,43,13,291,49,0,49
37,43,37,39,209,116,93
37,45,12,71,25,0,25
37,45,12,81,64,0,64
37,45,12,115,32,0,32
37,45,37,21,52,69,-17
37,45,37,23,78,45,33
37,45,37,25,46,62,-16
37,45,37,27,33,0,33
37,45,37,35,136,131,5
37,45,37,67,33,30,3
37,45,37,71,1514,1421,93
37,45,37,81,41,56,-15
37,45,37,97,55,0,55
37,45,37,109,324,259,65
37,45,37,119,381,413,-32
37,45,37,129,0,30,-30
37,45,37,161,555,433,122
37,45,37,179,37,37,0
37,45,37,183,50,64,-14
37,45,45,21,201,214,-13
37,45,45,45,38,71,-33
37,45,45,51,45,0,45
37,45,45,83,90,94,-4
37,45,45,91,131,94,37
37,47,37,17,186,258,-72
37,47,37,19,296,218,78
37,47,37,51,66,74,-8
37,47,37,67,0,31,-31
37,47,37,81,29,38,-9
37,47,37,119,48,67,-19
37,47,37,129,236,211,25
37,47,37,141,33,0,33
37,47,37,155,97,165,-68
37,47,37,183,42,86,-44
37,47,45,51,359,358,1
37,47,45,67,0,45,-45
37,49,4,13,36,61,-25
37,49,4,27,112,163,-51
37,49,6,37,48,42,6
37,49,6,59,58,0,58
37,49,6,65,39,38,1
37,49,6,71,156,111,45
37,49,6,73,286,306,-20
37,49,8,41,0,32,-32
37,49,11,1,32,0,32
37,49,12,11,47,26,21
37,49,12,31,38,35,3
37,49,12,33,192,90,102
37,49,12,57,30,49,-19
37,49,12,86,33,25,8
37,49,12,95,32,33,-1
37,49,12,103,0,31,-31
37,49,12,113,31,53,-22
37,49,13,59,23,0,23
37,49,13,67,31,0,31
37,49,13,121,0,35,-35
37,49,15,3,95,172,-77
37,49,17,31,42,39,3
37,49,24,3,51,0,51
37,49,24,31,46,0,46
37,49,24,33,54,0,54
37,49,24,37,0,63,-63
37,49,25,17,39,0,39
37,49,26,163,50,0,50
37,49,28,75,60,0,60
37,49,32,3,0,43,-43
37,49,34,27,32,0,32
37,49,34,29,23,0,23
37,49,36,47,0,27,-27
37,49,36,59,33,0,33
37,49,36,81,0,35,-35
37,49,36,103,53,0,53
37,49,37,1,37,0,37
37,49,37,13,167,146,21
37,49,37,31,729,748,-19
37,49,37,51,83,75,8
37,49,37,57,32,0,32
37,49,37,61,0,33,-33
37,49,37,63,25,62,-37
37,49,37,67,36,42,-6
37,49,37,81,57,84,-27
37,49,37,85,0,30,-30
37,49,37,101,37,58,-21
37,49,37,103,170,229,-59
37,49,37,107,131,147,-16
37,49,37,119,75,134,-59
37,49,37,127,35,0,35
37,49,37,129,100,131,-31
37,49,37,133,492,591,-99
37,49,37,135,35,44,-9
37,49,37,137,264,239,25
37,49,37,147,281,485,-204
37,49,37,183,218,416,-198
37,49,37,191,63,50,13
37,49,37,195,0,29,-29
37,49,39,35,0,31,-31
37,49,39,49,27,46,-19
37,49,42,91,29,0,29
37,49,45,13,113,177,-64
37,49,45,19,0,27,-27
37,49,48,29,28,28,0
37,49,48,201,52,45,7
37,49,48,439,47,86,-39
37,49,51,59,55,58,-3
37,49,51,107,34,0,34
37,49,51,153,110,102,8
37,49,51,177,41,0,41
37,49,51,179,101,84,17
37,49,51,550,0,59,-59
37,49,51,700,33,0,33
37,49,51,710,52,43,9
37,49,51,810,114,95,19
37,49,53,29,59,0,59
37,51,1,31,82,83,-1
37,51,1,45,105,111,-6
37,51,1,73,56,50,6
37,51,1,81,45,0,45
37,51,1,89,70,79,-9
37,51,1,97,36,44,-8
37,51,1,101,66,57,9
37,51,1,113,43,0,43
37,51,2,20,142,142,0
37,51,2,90,122,144,-22
37,51,4,3,242,169,73
37,51,4,13,232,202,30
37,51,4,19,140,142,-2
37,51,4,21,0,32,-32
37,51,5,85,0,79,-79
37,51,5,119,36,146,-110
37,51,6,1,33,21,12
37,51,6,19,49,0,49
37,51,6,29,38,39,-1
37,51,6,37,255,241,14
37,51,6,53,124,98,26
37,51,6,59,78,67,11
37,51,6,65,103,75,28
37,51,6,67,71,48,23
37,51,6,71,227,177,50
37,51,6,73,185,158,27
37,51,6,77,35,0,35
37,51,6,83,34,0,34
37,51,6,85,37,26,11
37,51,6,95,45,41,4
37,51,6,99,49,0,49
37,51,6,111,27,25,2
37,51,8,5,27,0,27
37,51,8,31,29,0,29
37,51,8,41,412,509,-97
37,51,8,59,23,0,23
37,51,8,69,31,0,31
37,51,9,1,0,39,-39
37,51,9,3,38,0,38
37,51,9,9,56,0,56
37,51,10,1,24,57,-33
37,51,10,3,44,0,44
37,51,11,1,63,93,-30
37,51,12,1,32,33,-1
37,51,12,5,42,31,11
37,51,12,9,103,81,22
37,51,12,11,194,105,89
37,51,12,15,30,0,30
37,51,12,19,31,30,1
37,51,12,31,150,118,32
37,51,12,33,55,56,-1
37,51,12,57,276,369,-93
37,51,12,71,70,42,28
37,51,12,73,39,0,39
37,51,12,81,31,0,31
37,51,12,83,36,35,1
37,51,12,86,223,173,50
37,51,12,87,0,33,-33
37,51,12,91,164,150,14
37,51,12,95,156,98,58
37,51,12,97,0,49,-49
37,51,12,99,99,80,19
37,51,12,101,43,61,-18
37,51,12,103,98,96,2
37,51,12,105,89,64,25
37,51,12,113,0,52,-52
37,51,12,115,43,0,43
37,51,12,117,60,50,10
37,51,12,127,73,54,19
37,51,13,19,0,50,-50
37,51,13,51,158,120,38
37,51,13,53,165,109,56
37,51,13,63,82,62,20
37,51,13,67,95,86,9
37,51,13,73,80,37,43
37,51,13,89,98,93,5
37,51,13,97,29,0,29
37,51,13,121,73,109,-36
37,51,13,135,135,106,29
37,51,13,151,43,50,-7
37,51,13,153,48,34,14
37,51,13,173,0,107,-107
37,51,13,179,228,103,125
37,51,13,185,32,812,-780
37,51,13,215,368,218,150
37,51,13,245,274,170,104
37,51,15,3,379,410,-31
37,51,16,1,40,0,40
37,51,17,31,160,120,40
37,51,17,43,0,24,-24
37,51,17,97,33,0,33
37,51,17,119,0,31,-31
37,51,17,163,36,41,-5
37,51,17,201,0,37,-37
37,51,18,3,53,0,53
37,51,18,89,26,0,26
37,51,18,97,62,55,7
37,51,20,61,70,177,-107
37,51,20,91,27,35,-8
37,51,20,103,207,209,-2
37,51,20,161,65,57,8
37,51,21,47,251,198,53
37,51,21,67,25,0,25
37,51,21,93,176,99,77
37,51,21,111,56,39,17
37,51,22,15,36,0,36
37,51,22,33,0,28,-28
37,51,22,115,177,104,73
37,51,23,5,27,0,27
37,51,24,3,150,141,9
37,51,24,5,89,67,22
37,51,24,17,30,39,-9
37,51,24,21,42,58,-16
37,51,24,25,114,71,43
37,51,24,27,35,40,-5
37,51,24,31,95,84,11
37,51,24,33,200,137,63
37,51,24,510,63,38,25
37,51,25,5,37,0,37
37,51,25,9,37,34,3
37,51,25,13,38,0,38
37,51,25,17,56,60,-4
37,51,25,23,32,0,32
37,51,25,25,33,0,33
37,51,25,27,41,43,-2
37,51,26,49,37,0,37
37,51,26,81,35,0,35
37,51,26,99,77,26,51
37,51,26,125,69,28,41
37,51,26,145,35,0,35
37,51,26,163,81,62,19
37,51,28,47,30,45,-15
37,51,29,77,38,0,38
37,51,29,95,36,31,5
37,51,29,169,149,87,62
37,51,29,189,42,36,6
37,51,32,3,92,142,-50
37,51,32,31,0,29,-29
37,51,33,11,0,41,-41
37,51,34,3,31,0,31
37,51,34,5,62,79,-17
37,51,34,7,34,0,34
37,51,34,13,56,53,3
37,51,34,17,41,39,2
37,51,34,23,56,0,56
37,51,34,25,63,0,63
37,51,34,29,32,0,32
37,51,34,35,31,0,31
37,51,34,39,46,0,46
37,51,35,1,41,73,-32
37,51,36,1,27,0,27
37,51,36,5,120,89,31
37,51,36,29,70,35,35
37,51,36,45,274,150,124
37,51,36,47,235,124,111
37,51,36,55,63,38,25
37,51,36,59,53,26,27
37,51,36,61,68,46,22
37,51,36,65,35,0,35
37,51,36,67,39,50,-11
37,51,36,71,120,45,75
37,51,36,81,140,56,84
37,51,36,85,30,0,30
37,51,36,103,90,40,50
37,51,36,119,52,0,52
37,51,37,1,36,37,-1
37,51,37,17,351,328,23
37,51,37,19,87,186,-99
37,51,37,21,69,51,18
37,51,37,25,71,73,-2
37,51,37,31,46,53,-7
37,51,37,35,40,32,8
37,51,37,37,0,64,-64
37,51,37,47,74,66,8
37,51,37,49,75,83,-8
37,51,37,57,0,32,-32
37,51,37,61,53,59,-6
37,51,37,63,182,183,-1
37,51,37,67,131,142,-11
37,51,37,71,44,0,44
37,51,37,81,250,331,-81
37,51,37,83,23,0,23
37,51,37,85,1705,3225,-1520
37,51,37,89,0,32,-32
37,51,37,93,1868,2580,-712
37,51,37,97,28,53,-25
37,51,37,101,154,155,-1
37,51,37,105,227,245,-18
37,51,37,119,278,534,-256
37,51,37,125,223,410,-187
37,51,37,127,42,47,-5
37,51,37,129,176,271,-95
37,51,37,133,167,204,-37
37,51,37,135,44,85,-41
37,51,37,139,41,0,41
37,51,37,141,38,29,9
37,51,37,147,156,189,-33
37,51,37,151,49,36,13
37,51,37,153,80,55,25
37,51,37,155,1121,1105,16
37,51,37,157,0,29,-29
37,51,37,159,50,62,-12
37,51,37,163,489,481,8
37,51,37,165,127,133,-6
37,51,37,179,49,43,6
37,51,37,183,628,1178,-550
37,51,37,189,30,27,3
37,51,37,191,142,77,65
37,51,37,195,56,50,6
37,51,39,35,85,49,36
37,51,39,49,108,74,34
37,51,39,61,41,0,41
37,51,39,93,33,0,33
37,51,39,99,45,0,45
37,51,39,113,58,51,7
37,51,39,151,34,0,34
37,51,39,153,44,0,44
37,51,39,155,33,0,33
37,51,40,31,271,170,101
37,51,40,109,49,39,10
37,51,40,143,0,41,-41
37,51,42,3,102,75,27
37,51,42,17,26,0,26
37,51,42,29,27,0,27
37,51,42,41,73,82,-9
37,51,42,45,51,0,51
37,51,42,49,38,0,38
37,51,42,71,50,0,50
37,51,42,79,0,23,-23
37,51,42,91,39,40,-1
37,51,42,101,110,93,17
37,51,42,129,25,0,25
37,51,42,133,40,0,40
37,51,44,7,50,0,50
37,51,45,13,53,38,15
37,51,45,15,42,60,-18
37,51,45,19,78,119,-41
37,51,45,31,38,0,38
37,51,45,33,41,35,6
37,51,45,35,44,56,-12
37,51,45,41,48,43,5
37,51,45,45,54,71,-17
37,51,45,51,74,110,-36
37,51,45,63,66,75,-9
37,51,45,79,335,392,-57
37,51,45,83,0,33,-33
37,51,45,85,66,66,0
37,51,45,91,25,33,-8
37,51,47,37,32,42,-10
37,51,47,65,45,0,45
37,51,47,93,0,31,-31
37,51,47,125,433,689,-256
37,51,47,149,44,0,44
37,51,47,157,58,63,-5
37,51,47,179,0,23,-23
37,51,48,27,570,453,117
37,51,48,29,439,368,71
37,51,48,39,0,33,-33
37,51,48,85,48,0,48
37,51,48,99,105,104,1
37,51,48,113,107,71,36
37,51,48,121,29,0,29
37,51,48,141,691,381,310
37,51,48,167,26,0,26
37,51,48,201,235,200,35
37,51,48,215,0,36,-36
37,51,48,355,43,48,-5
37,51,48,423,49,0,49
37,51,48,439,113,81,32
37,51,48,453,49,50,-1
37,51,48,485,66,0,66
37,51,48,491,0,40,-40
37,51,49,11,0,45,-45
37,51,49,35,34,30,4
37,51,51,13,31,46,-15
37,51,51,41,77,82,-5
37,51,51,59,266,393,-127
37,51,51,87,50,45,5
37,51,51,149,134,83,51
37,51,51,153,147,154,-7
37,51,51,177,41,0,41
37,51,51,179,32,74,-42
37,51,51,199,43,34,9
37,51,51,510,30,53,-23
37,51,51,550,84,62,22
37,51,51,650,79,71,8
37,51,51,700,187,176,11
37,51,51,710,88,99,-11
37,51,51,730,47,43,4
37,51,51,740,52,0,52
37,51,51,760,0,27,-27
37,51,51,810,217,130,87
37,51,53,33,62,73,-11
37,51,53,53,400,608,-208
37,51,53,61,29,43,-14
37,51,53,63,36,0,36
37,51,53,67,103,272,-169
37,51,55,79,52,39,13
37,53,37,29,58,125,-67
37,53,37,55,355,229,126
37,53,37,139,129,172,-43
37,53,37,143,0,29,-29
37,53,37,183,0,24,-24
37,53,51,550,291,145,146
37,53,51,710,56,53,3
37,53,51,740,0,26,-26
37,53,51,810,444,199,245
37,55,17,43,26,0,26
37,55,37,21,0,28,-28
37,55,37,29,37,38,-1
37,55,37,53,229,355,-126
37,55,37,81,0,32,-32
37,55,37,95,32,41,-9
37,55,37,129,38,67,-29
37,55,37,139,86,31,55
37,55,37,147,47,100,-53
37,55,37,177,39,0,39
37,55,37,183,66,105,-39
37,55,37,187,0,30,-30
37,55,45,19,0,34,-34
37,55,51,41,27,25,2
37,55,51,59,74,24,50
37,55,51,87,41,0,41
37,55,51,550,78,55,23
37,55,51,710,24,0,24
37,55,51,740,37,0,37
37,55,51,810,91,65,26
37,57,12,86,32,0,32
37,57,12,99,35,0,35
37,57,34,29,41,0,41
37,57,36,103,38,0,38
37,57,37,1,80,84,-4
37,57,37,19,30,33,-3
37,57,37,21,45,0,45
37,57,37,23,31,0,31
37,57,37,25,99,50,49
37,57,37,35,0,36,-36
37,57,37,49,0,32,-32
37,57,37,51,32,0,32
37,57,37,59,176,124,52
37,57,37,63,50,55,-5
37,57,37,67,2202,1760,442
37,57,37,71,46,31,15
37,57,37,81,2377,2082,295
37,57,37,97,87,67,20
37,57,37,101,0,31,-31
37,57,37,119,140,209,-69
37,57,37,123,0,43,-43
37,57,37,129,46,34,12
37,57,37,133,28,0,28
37,57,37,135,0,29,-29
37,57,37,147,40,0,40
37,57,37,151,1177,1089,88
37,57,37,157,72,89,-17
37,57,37,159,349,305,44
37,57,37,167,42,65,-23
37,57,37,169,95,105,-10
37,57,37,171,83,80,3
37,57,37,179,34,0,34
37,57,37,183,93,153,-60
37,57,37,193,40,0,40
37,57,37,197,80,69,11
37,57,45,51,43,100,-57
37,57,45,63,0,27,-27
37,57,51,810,33,0,33
37,59,37,57,124,176,-52
37,59,37,67,937,671,266
37,59,37,81,105,79,26
37,59,37,97,169,184,-15
37,59,37,119,90,88,2
37,59,37,129,26,0,26
37,59,37,147,0,25,-25
37,59,37,159,214,192,22
37,59,37,169,26,47,-21
37,59,37,171,35,0,35
37,59,37,183,42,32,10
37,59,37,197,146,132,14
37,61,37,19,0,39,-39
37,61,37,49,33,0,33
37,61,37,51,59,53,6
37,61,37,63,0,38,-38
37,61,37,81,34,0,34
37,61,37,101,0,42,-42
37,61,37,107,190,189,1
37,61,37,129,133,164,-31
37,61,37,133,272,184,88
37,61,37,141,208,151,57
37,61,37,147,41,73,-32
37,61,37,163,305,343,-38
37,61,37,183,58,114,-56
37,61,37,191,305,354,-49
37,61,51,59,34,0,34
37,63,1,73,54,38,16
37,63,4,13,89,97,-8
37,63,4,19,39,0,39
37,63,6,1,71,59,12
37,63,6,13,36,0,36
37,63,6,37,247,132,115
37,63,6,59,83,63,20
37,63,6,67,0,36,-36
37,63,6,71,54,0,54
37,63,6,73,133,73,60
37,63,6,75,59,70,-11
37,63,6,81,33,29,4
37,63,6,85,101,116,-15
37,63,6,111,37,0,37
37,63,8,13,0,35,-35
37,63,8,31,33,33,0
37,63,9,1,59,0,59
37,63,9,3,35,54,-19
37,63,9,9,76,65,11
37,63,9,11,25,0,25
37,63,10,3,39,34,5
37,63,11,1,168,178,-10
37,63,12,1,69,39,30
37,63,12,9,34,34,0
37,63,12,11,130,31,99
37,63,12,31,46,70,-24
37,63,12,57,57,54,3
37,63,12,71,46,0,46
37,63,12,73,44,40,4
37,63,12,81,27,0,27
37,63,12,86,181,117,64
37,63,12,95,78,73,5
37,63,12,99,86,66,20
37,63,12,103,38,0,38
37,63,12,117,29,0,29
37,63,13,59,34,0,34
37,63,13,67,80,80,0
37,63,13,89,120,128,-8
37,63,13,121,91,173,-82
37,63,13,135,58,37,21
37,63,15,3,58,37,21
37,63,17,19,26,0,26
37,63,17,31,222,207,15
37,63,17,97,29,27,2
37,63,18,97,40,0,40
37,63,21,111,37,36,1
37,63,22,71,22,0,22
37,63,23,5,24,0,24
37,63,24,3,44,33,11
37,63,24,5,82,0,82
37,63,24,27,25,0,25
37,63,24,31,164,136,28
37,63,24,33,143,101,42
37,63,24,510,78,88,-10
37,63,25,9,38,0,38
37,63,25,17,237,164,73
37,63,25,21,73,48,25
37,63,25,23,30,0,30
37,63,25,25,145,131,14
37,63,25,27,38,0,38
37,63,26,65,33,0,33
37,63,26,77,20,0,20
37,63,26,81,35,0,35
37,63,26,125,69,0,69
37,63,26,161,73,55,18
37,63,26,163,71,27,44
37,63,27,53,36,57,-21
37,63,29,95,0,30,-30
37,63,29,189,41,28,13
37,63,29,510,30,0,30
37,63,32,3,37,33,4
37,63,33,11,76,0,76
37,63,34,5,31,0,31
37,63,34,7,27,0,27
37,63,34,13,112,67,45
37,63,34,17,75,53,22
37,63,34,21,50,22,28
37,63,34,23,73,50,23
37,63,34,25,47,0,47
37,63,34,27,54,0,54
37,63,34,31,38,0,38
37,63,34,39,56,0,56
37,63,35,1,0,27,-27
37,63,36,1,30,0,30
37,63,36,5,105,63,42
37,63,36,7,23,0,23
37,63,36,29,45,0,45
37,63,36,47,198,121,77
37,63,36,55,69,0,69
37,63,36,59,124,0,124
37,63,36,61,206,318,-112
37,63,36,71,36,0,36
37,63,36,81,164,65,99
37,63,36,91,24,0,24
37,63,36,103,81,45,36
37,63,36,119,61,54,7
37,63,37,1,347,616,-269
37,63,37,19,34,51,-17
37,63,37,21,90,108,-18
37,63,37,25,31,57,-26
37,63,37,31,60,62,-2
37,63,37,33,0,30,-30
37,63,37,35,45,36,9
37,63,37,37,543,567,-24
37,63,37,49,62,25,37
37,63,37,51,183,182,1
37,63,37,57,55,50,5
37,63,37,61,38,0,38
37,63,37,65,24,0,24
37,63,37,67,252,191,61
37,63,37,69,106,143,-37
37,63,37,71,44,47,-3
37,63,37,77,691,728,-37
37,63,37,81,561,509,52
37,63,37,83,44,23,21
37,63,37,85,84,90,-6
37,63,37,87,22,0,22
37,63,37,97,24,0,24
37,63,37,101,235,324,-89
37,63,37,105,56,55,1
37,63,37,107,62,0,62
37,63,37,119,458,776,-318
37,63,37,125,53,0,53
37,63,37,127,61,58,3
37,63,37,129,211,167,44
37,63,37,133,84,53,31
37,63,37,135,3303,2685,618
37,63,37,139,37,0,37
37,63,37,141,36,0,36
37,63,37,145,347,518,-171
37,63,37,147,221,180,41
37,63,37,151,32,31,1
37,63,37,155,67,30,37
37,63,37,159,63,42,21
37,63,37,163,36,42,-6
37,63,37,179,0,65,-65
37,63,37,181,127,80,47
37,63,37,183,5050,5501,-451
37,63,37,185,34,39,-5
37,63,37,189,49,0,49
37,63,37,191,137,52,85
37,63,37,195,55,76,-21
37,63,39,35,93,50,43
37,63,39,49,111,81,30
37,63,39,61,36,34,2
37,63,39,113,41,0,41
37,63,39,153,30,0,30
37,63,41,51,32,42,-10
37,63,41,67,38,0,38
37,63,42,3,109,71,38
37,63,42,17,0,24,-24
37,63,42,29,32,36,-4
37,63,42,45,23,0,23
37,63,42,77,26,0,26
37,63,42,91,85,61,24
37,63,42,101,113,112,1
37,63,45,19,69,88,-19
37,63,45,45,41,37,4
37,63,45,51,47,52,-5
37,63,45,63,35,0,35
37,63,45,79,70,60,10
37,63,45,83,0,35,-35
37,63,45,91,0,38,-38
37,63,47,37,37,67,-30
37,63,47,93,27,52,-25
37,63,47,157,53,45,8
37,63,48,29,35,47,-12
37,63,48,85,28,33,-5
37,63,48,113,70,76,-6
37,63,48,201,128,140,-12
37,63,48,439,63,49,14
37,63,48,453,51,114,-63
37,63,49,35,40,0,40
37,63,49,49,41,0,41
37,63,50,7,34,0,34
37,63,51,3,36,0,36
37,63,51,13,82,57,25
37,63,51,41,50,41,9
37,63,51,59,239,124,115
37,63,51,83,28,0,28
37,63,51,87,62,0,62
37,63,51,107,46,0,46
37,63,51,153,43,0,43
37,63,51,510,52,27,25
37,63,51,540,48,0,48
37,63,51,590,37,0,37
37,63,51,650,42,0,42
37,63,51,700,45,50,-5
37,63,51,710,33,0,33
37,63,51,760,44,60,-16
37,63,51,810,44,52,-8
37,63,53,33,99,119,-20
37,63,55,25,52,37,15
37,63,55,79,29,0,29
37,65,24,33,45,0,45
37,65,37,13,0,41,-41
37,65,37,63,0,24,-24
37,65,37,81,48,63,-15
37,65,37,83,272,156,116
37,65,37,117,71,49,22
37,65,37,119,0,41,-41
37,65,37,127,2258,2419,-161
37,65,37,147,230,263,-33
37,65,37,183,176,229,-53
37,65,37,195,180,220,-40
37,67,1,73,42,0,42
37,67,4,13,113,80,33
37,67,4,19,32,0,32
37,67,6,1,0,30,-30
37,67,6,37,189,109,80
37,67,6,59,53,45,8
37,67,6,65,42,0,42
37,67,6,71,28,0,28
37,67,6,73,50,102,-52
37,67,6,111,34,0,34
37,67,8,41,0,40,-40
37,67,9,1,51,0,51
37,67,9,3,35,38,-3
37,67,9,9,35,30,5
37,67,10,3,28,0,28
37,67,11,1,64,83,-19
37,67,12,9,38,0,38
37,67,12,11,156,61,95
37,67,12,21,33,0,33
37,67,12,31,63,87,-24
37,67,12,57,84,59,25
37,67,12,71,48,45,3
37,67,12,83,28,0,28
37,67,12,86,149,46,103
37,67,12,95,127,55,72
37,67,12,97,49,0,49
37,67,12,99,82,31,51
37,67,12,101,35,0,35
37,67,12,103,86,24,62
37,67,12,105,45,0,45
37,67,12,117,62,0,62
37,67,12,127,50,26,24
37,67,13,21,64,0,64
37,67,13,51,41,31,10
37,67,13,67,58,68,-10
37,67,13,89,78,89,-11
37,67,13,121,103,134,-31
37,67,13,135,48,80,-32
37,67,13,245,25,0,25
37,67,15,3,0,35,-35
37,67,17,31,88,72,16
37,67,18,97,0,37,-37
37,67,21,111,30,38,-8
37,67,24,3,39,44,-5
37,67,24,5,69,0,69
37,67,24,31,51,84,-33
37,67,24,33,52,36,16
37,67,24,510,28,22,6
37,67,25,9,35,0,35
37,67,25,17,46,54,-8
37,67,25,25,45,0,45
37,67,25,27,42,0,42
37,67,26,49,30,0,30
37,67,26,81,32,0,32
37,67,26,125,63,0,63
37,67,26,163,62,0,62
37,67,27,53,36,0,36
37,67,32,3,43,51,-8
37,67,34,5,53,0,53
37,67,34,13,28,0,28
37,67,34,17,36,20,16
37,67,34,23,48,0,48
37,67,34,25,33,0,33
37,67,34,29,39,0,39
37,67,36,5,65,0,65
37,67,36,29,39,0,39
37,67,36,47,44,49,-5
37,67,36,55,66,0,66
37,67,36,59,85,0,85
37,67,36,61,68,116,-48
37,67,36,71,26,0,26
37,67,36,81,76,51,25
37,67,36,103,124,0,124
37,67,36,119,44,0,44
37,67,37,1,227,186,41
37,67,37,5,35,40,-5
37,67,37,7,26,0,26
37,67,37,9,0,36,-36
37,67,37,19,50,109,-59
37,67,37,21,126,148,-22
37,67,37,23,31,36,-5
37,67,37,25,165,159,6
37,67,37,27,42,39,3
37,67,37,31,0,56,-56
37,67,37,35,136,112,24
37,67,37,37,29,46,-17
37,67,37,45,30,33,-3
37,67,37,47,31,0,31
37,67,37,49,42,36,6
37,67,37,51,142,131,11
37,67,37,57,1760,2202,-442
37,67,37,59,671,937,-266
37,67,37,63,191,252,-61
37,67,37,71,64,103,-39
37,67,37,77,29,0,29
37,67,37,81,3038,2706,332
37,67,37,85,33,25,8
37,67,37,89,36,29,7
37,67,37,97,226,212,14
37,67,37,99,0,28,-28
37,67,37,101,36,36,0
37,67,37,105,25,35,-10
37,67,37,109,0,30,-30
37,67,37,119,730,1008,-278
37,67,37,125,49,44,5
37,67,37,127,45,43,2
37,67,37,129,159,193,-34
37,67,37,133,95,102,-7
37,67,37,135,125,103,22
37,67,37,147,113,73,40
37,67,37,151,198,239,-41
37,67,37,153,40,0,40
37,67,37,157,232,224,8
37,67,37,159,211,165,46
37,67,37,165,38,0,38
37,67,37,167,31,0,31
37,67,37,169,1279,1253,26
37,67,37,171,479,574,-95
37,67,37,179,70,77,-7
37,67,37,183,524,575,-51
37,67,37,189,109,82,27
37,67,37,191,40,31,9
37,67,37,193,158,102,56
37,67,37,195,34,31,3
37,67,37,197,582,598,-16
37,67,39,35,42,41,1
37,67,39,49,82,70,12
37,67,39,61,32,0,32
37,67,41,51,0,24,-24
37,67,42,3,62,41,21
37,67,42,77,25,0,25
37,67,42,101,66,51,15
37,67,45,13,32,28,4
37,67,45,19,48,67,-19
37,67,45,41,25,0,25
37,67,45,45,72,83,-11
37,67,45,51,84,111,-27
37,67,45,63,29,0,29
37,67,45,79,74,60,14
37,67,45,83,56,40,16
37,67,45,91,69,92,-23
37,67,47,37,43,68,-25
37,67,47,93,54,44,10
37,67,47,157,49,53,-4
37,67,47,179,34,0,34
37,67,48,29,50,37,13
37,67,48,85,0,31,-31
37,67,48,113,33,52,-19
37,67,48,201,64,54,10
37,67,48,453,50,55,-5
37,67,49,35,0,58,-58
37,67,51,3,23,32,-9
37,67,51,13,30,35,-5
37,67,51,35,31,0,31
37,67,51,41,31,40,-9
37,67,51,59,93,76,17
37,67,51,87,49,40,9
37,67,51,89,53,0,53
37,67,51,107,0,32,-32
37,67,51,121,30,34,-4
37,67,51,153,50,26,24
37,67,51,161,0,38,-38
37,67,51,550,25,0,25
37,67,51,650,27,0,27
37,67,51,710,29,35,-6
37,67,51,760,0,32,-32
37,67,51,770,0,36,-36
37,67,51,810,72,50,22
37,67,53,33,56,38,18
37,67,54,39,31,0,31
37,69,24,33,30,0,30
37,69,36,103,67,0,67
37,69,37,31,29,0,29
37,69,37,63,143,106,37
37,69,37,77,171,229,-58
37,69,37,81,0,42,-42
37,69,37,85,0,36,-36
37,69,37,101,127,141,-14
37,69,37,127,260,213,47
37,69,37,129,0,31,-31
37,69,37,181,437,391,46
37,69,37,183,2573,1589,984
37,69,37,185,110,59,51
37,69,37,195,44,47,-3
37,69,51,810,0,33,-33
37,71,4,13,40,0,40
37,71,6,37,62,0,62
37,71,6,71,31,0,31
37,71,6,73,0,28,-28
37,71,12,11,123,0,123
37,71,12,31,0,38,-38
37,71,12,57,48,0,48
37,71,12,81,37,0,37
37,71,12,86,108,38,70
37,71,12,95,101,0,101
37,71,12,99,46,0,46
37,71,12,101,33,0,33
37,71,12,103,50,0,50
37,71,12,111,40,0,40
37,71,12,127,44,0,44
37,71,13,67,0,25,-25
37,71,13,89,26,0,26
37,71,13,135,39,0,39
37,71,24,31,0,35,-35
37,71,24,33,48,0,48
37,71,26,163,45,0,45
37,71,29,189,41,0,41
37,71,34,3,39,0,39
37,71,34,31,46,0,46
37,71,36,29,37,28,9
37,71,36,55,42,0,42
37,71,36,61,0,27,-27
37,71,36,81,38,0,38
37,71,36,103,61,0,61
37,71,37,19,58,84,-26
37,71,37,21,101,51,50
37,71,37,23,58,48,10
37,71,37,25,255,214,41
37,71,37,27,72,54,18
37,71,37,35,268,232,36
37,71,37,45,1421,1514,-93
37,71,37,51,0,44,-44
37,71,37,57,31,46,-15
37,71,37,63,47,44,3
37,71,37,67,103,64,39
37,71,37,81,103,114,-11
37,71,37,97,121,95,26
37,71,37,99,28,0,28
37,71,37,109,1150,1161,-11
37,71,37,119,4257,2560,1697
37,71,37,129,46,81,-35
37,71,37,133,52,30,22
37,71,37,147,0,27,-27
37,71,37,151,43,0,43
37,71,37,159,77,82,-5
37,71,37,161,94,44,50
37,71,37,179,121,134,-13
37,71,37,183,128,107,21
37,71,37,189,43,39,4
37,71,39,49,25,0,25
37,71,42,3,68,0,68
37,71,42,7,25,0,25
37,71,42,101,38,0,38
37,71,45,19,35,42,-7
37,71,45,21,68,79,-11
37,71,45,23,0,41,-41
37,71,45,45,44,70,-26
37,71,45,51,68,95,-27
37,71,45,57,34,26,8
37,71,45,79,50,39,11
37,71,45,83,67,80,-13
37,71,45,91,588,733,-145
37,71,51,59,37,0,37
37,71,51,710,38,0,38
37,71,51,810,50,0,50
37,73,37,41,0,38,-38
37,73,37,91,32,94,-62
37,73,37,139,31,50,-19
37,73,51,550,79,55,24
37,73,51,710,43,29,14
37,73,51,740,56,34,22
37,73,51,800,176,99,77
37,73,51,810,123,30,93
37,75,37,39,45,83,-38
37,75,37,173,0,58,-58
37,77,24,5,41,0,41
37,77,37,1,0,38,-38
37,77,37,37,36,0,36
37,77,37,63,728,691,37
37,77,37,67,0,29,-29
37,77,37,69,229,171,58
37,77,37,81,54,39,15
37,77,37,101,40,49,-9
37,77,37,119,44,42,2
37,77,37,129,36,0,36
37,77,37,135,90,76,14
37,77,37,145,145,94,51
37,77,37,181,524,393,131
37,77,37,183,810,588,222
37,77,37,185,67,42,25
37,77,51,117,0,46,-46
37,79,37,107,250,268,-18
37,79,37,147,322,366,-44
37,79,37,183,41,69,-28
37,79,37,191,111,168,-57
37,79,37,195,97,94,3
37,81,4,13,143,89,54
37,81,4,19,32,0,32
37,81,6,1,33,41,-8
37,81,6,37,163,100,63
37,81,6,59,90,68,22
37,81,6,65,61,30,31
37,81,6,71,78,0,78
37,81,6,73,79,78,1
37,81,6,85,33,27,6
37,81,8,5,0,29,-29
37,81,8,31,27,0,27
37,81,8,41,37,0,37
37,81,9,1,44,0,44
37,81,9,3,55,30,25
37,81,9,9,58,33,25
37,81,10,1,61,0,61
37,81,10,3,51,36,15
37,81,11,1,100,71,29
37,81,12,1,33,0,33
37,81,12,9,72,44,28
37,81,12,11,320,114,206
37,81,12,21,33,0,33
37,81,12,31,98,144,-46
37,81,12,57,121,62,59
37,81,12,69,37,0,37
37,81,12,71,83,38,45
37,81,12,81,46,28,18
37,81,12,86,233,77,156
37,81,12,95,148,99,49
37,81,12,97,35,0,35
37,81,12,99,181,71,110
37,81,12,101,36,0,36
37,81,12,103,106,35,71
37,81,12,105,66,27,39
37,81,12,117,27,0,27
37,81,12,127,40,0,40
37,81,13,51,69,25,44
37,81,13,63,57,35,22
37,81,13,67,75,93,-18
37,81,13,89,106,120,-14
37,81,13,117,0,47,-47
37,81,13,121,101,168,-67
37,81,13,135,102,154,-52
37,81,13,151,0,32,-32
37,81,13,245,39,0,39
37,81,15,3,31,0,31
37,81,17,31,135,107,28
37,81,17,43,0,31,-31
37,81,18,3,30,0,30
37,81,18,97,59,57,2
37,81,20,173,37,0,37
37,81,21,67,31,0,31
37,81,21,111,0,36,-36
37,81,24,3,62,35,27
37,81,24,5,90,67,23
37,81,24,21,30,0,30
37,81,24,25,39,0,39
37,81,24,27,45,41,4
37,81,24,31,122,77,45
37,81,24,33,179,75,104
37,81,24,510,66,64,2
37,81,25,13,40,0,40
37,81,25,17,77,64,13
37,81,25,25,31,43,-12
37,81,25,27,55,0,55
37,81,26,81,45,0,45
37,81,26,99,26,0,26
37,81,26,125,76,46,30
37,81,26,163,125,0,125
37,81,27,53,54,43,11
37,81,29,189,0,47,-47
37,81,32,3,80,64,16
37,81,33,11,33,0,33
37,81,34,1,45,0,45
37,81,34,3,80,0,80
37,81,34,5,55,0,55
37,81,34,7,50,24,26
37,81,34,13,127,44,83
37,81,34,15,34,0,34
37,81,34,17,75,0,75
37,81,34,21,36,0,36
37,81,34,23,114,34,80
37,81,34,25,63,0,63
37,81,34,27,82,0,82
37,81,34,31,52,32,20
37,81,34,35,75,0,75
37,81,34,39,88,36,52
37,81,35,1,31,0,31
37,81,36,5,112,69,43
37,81,36,29,61,31,30
37,81,36,47,216,126,90
37,81,36,55,84,52,32
37,81,36,59,126,32,94
37,81,36,61,79,126,-47
37,81,36,67,35,25,10
37,81,36,71,64,0,64
37,81,36,81,218,89,129
37,81,36,103,188,44,144
37,81,36,119,135,37,98
37,81,37,1,1701,1745,-44
37,81,37,7,40,32,8
37,81,37,9,24,0,24
37,81,37,17,30,40,-10
37,81,37,19,124,134,-10
37,81,37,21,185,182,3
37,81,37,23,61,49,12
37,81,37,25,146,149,-3
37,81,37,27,50,37,13
37,81,37,31,56,63,-7
37,81,37,33,131,126,5
37,81,37,35,149,103,46
37,81,37,37,166,131,35
37,81,37,45,56,41,15
37,81,37,47,38,29,9
37,81,37,49,84,57,27
37,81,37,51,331,250,81
37,81,37,55,32,0,32
37,81,37,57,2082,2377,-295
37,81,37,59,79,105,-26
37,81,37,61,0,34,-34
37,81,37,63,509,561,-52
37,81,37,65,63,48,15
37,81,37,67,2706,3038,-332
37,81,37,69,42,0,42
37,81,37,71,114,103,11
37,81,37,77,39,54,-15
37,81,37,83,70,25,45
37,81,37,85,73,72,1
37,81,37,87,20,0,20
37,81,37,89,40,49,-9
37,81,37,91,40,0,40
37,81,37,97,142,171,-29
37,81,37,101,97,106,-9
37,81,37,105,59,30,29
37,81,37,107,39,0,39
37,81,37,109,23,39,-16
37,81,37,119,996,1488,-492
37,81,37,123,91,47,44
37,81,37,125,98,69,29
37,81,37,127,92,88,4
37,81,37,129,265,337,-72
37,81,37,131,37,0,37
37,81,37,133,167,121,46
37,81,37,135,286,354,-68
37,81,37,139,37,0,37
37,81,37,141,46,59,-13
37,81,37,145,76,47,29
37,81,37,147,202,166,36
37,81,37,151,2337,2543,-206
37,81,37,153,56,73,-17
37,81,37,155,72,73,-1
37,81,37,157,1366,1400,-34
37,81,37,159,148,140,8
37,81,37,161,25,45,-20
37,81,37,163,49,36,13
37,81,37,165,61,0,61
37,81,37,167,50,36,14
37,81,37,169,145,121,24
37,81,37,171,116,54,62
37,81,37,179,107,113,-6
37,81,37,181,54,31,23
37,81,37,183,1052,1324,-272
37,81,37,185,30,0,30
37,81,37,189,90,104,-14
37,81,37,191,123,55,68
37,81,37,193,51,58,-7
37,81,37,195,32,45,-13
37,81,37,197,60,57,3
37,81,39,17,31,0,31
37,81,39,35,72,47,25
37,81,39,49,98,60,38
37,81,39,61,44,45,-1
37,81,39,113,39,0,39
37,81,39,153,34,0,34
37,81,39,173,29,0,29
37,81,42,3,104,52,52
37,81,42,11,28,0,28
37,81,42,29,34,0,34
37,81,42,41,30,0,30
37,81,42,43,34,51,-17
37,81,42,49,26,0,26
37,81,42,91,69,47,22
37,81,42,101,82,42,40
37,81,42,133,41,0,41
37,81,45,7,0,26,-26
37,81,45,13,49,50,-1
37,81,45,15,0,33,-33
37,81,45,19,74,147,-73
37,81,45,33,42,0,42
37,81,45,35,41,38,3
37,81,45,41,37,0,37
37,81,45,43,0,25,-25
37,81,45,45,79,116,-37
37,81,45,51,102,184,-82
37,81,45,63,31,66,-35
37,81,45,69,37,0,37
37,81,45,75,22,0,22
37,81,45,77,0,24,-24
37,81,45,79,119,102,17
37,81,45,83,129,50,79
37,81,45,91,55,108,-53
37,81,47,37,43,74,-31
37,81,47,65,53,0,53
37,81,47,93,51,50,1
37,81,47,157,61,43,18
37,81,47,179,26,44,-18
37,81,48,27,0,45,-45
37,81,48,29,66,43,23
37,81,48,85,40,50,-10
37,81,48,113,62,88,-26
37,81,48,121,0,45,-45
37,81,48,201,59,117,-58
37,81,48,439,68,67,1
37,81,48,453,56,47,9
37,81,51,3,28,29,-1
37,81,51,13,27,47,-20
37,81,51,19,33,0,33
37,81,51,41,83,74,9
37,81,51,59,118,113,5
37,81,51,67,29,29,0
37,81,51,87,111,45,66
37,81,51,89,103,88,15
37,81,51,107,43,39,4
37,81,51,121,40,37,3
37,81,51,143,86,49,37
37,81,51,153,72,52,20
37,81,51,161,42,43,-1
37,81,51,510,0,50,-50
37,81,51,550,79,44,35
37,81,51,590,198,57,141
37,81,51,650,35,42,-7
37,81,51,680,51,48,3
37,81,51,690,48,0,48
37,81,51,700,68,32,36
37,81,51,710,96,58,38
37,81,51,760,43,24,19
37,81,51,770,110,0,110
37,81,51,810,97,95,2
37,81,53,33,28,104,-76
37,81,53,61,0,49,-49
37,81,54,39,33,30,3
37,81,54,55,36,0,36
37,81,55,79,37,0,37
37,83,11,1,38,0,38
37,83,24,33,57,0,57
37,83,37,15,0,27,-27
37,83,37,51,0,23,-23
37,83,37,63,23,44,-21
37,83,37,65,156,272,-116
37,83,37,81,25,70,-45
37,83,37,119,0,31,-31
37,83,37,127,311,508,-197
37,83,37,129,27,0,27
37,83,37,131,505,411,94
37,83,37,147,63,88,-25
37,83,37,183,109,188,-79
37,83,37,185,105,66,39
37,83,37,195,0,30,-30
37,83,51,25,41,0,41
37,83,51,595,0,30,-30
37,83,51,810,34,0,34
37,85,5,119,0,39,-39
37,85,6,37,35,41,-6
37,85,8,41,54,37,17
37,85,12,57,52,37,15
37,85,12,91,40,57,-17
37,85,12,95,36,0,36
37,85,12,105,32,0,32
37,85,12,113,0,48,-48
37,85,13,19,0,42,-42
37,85,13,185,0,214,-214
37,85,13,215,55,0,55
37,85,15,3,40,42,-2
37,85,20,103,48,0,48
37,85,24,3,41,0,41
37,85,24,33,30,0,30
37,85,32,3,37,40,-3
37,85,34,23,33,0,33
37,85,36,45,56,0,56
37,85,36,103,31,0,31
37,85,37,1,0,32,-32
37,85,37,17,29,0,29
37,85,37,19,0,31,-31
37,85,37,25,0,25,-25
37,85,37,37,168,174,-6
37,85,37,49,30,0,30
37,85,37,51,3225,1705,1520
37,85,37,63,90,84,6
37,85,37,67,25,33,-8
37,85,37,69,36,0,36
37,85,37,81,72,73,-1
37,85,37,93,181,102,79
37,85,37,97,30,0,30
37,85,37,101,755,750,5
37,85,37,105,785,902,-117
37,85,37,119,86,88,-2
37,85,37,125,145,216,-71
37,85,37,129,67,61,6
37,85,37,133,50,48,2
37,85,37,135,45,22,23
37,85,37,147,45,45,0
37,85,37,155,63,62,1
37,85,37,163,286,344,-58
37,85,37,183,1598,1219,379
37,85,37,191,53,45,8
37,85,45,51,0,32,-32
37,85,45,79,49,0,49
37,85,47,125,86,54,32
37,85,48,27,52,37,15
37,85,48,29,60,0,60
37,85,48,141,54,43,11
37,85,51,59,47,37,10
37,85,51,153,38,0,38
37,85,53,53,59,81,-22
37,85,55,79,36,0,36
37,87,12,9,32,0,32
37,87,12,11,43,0,43
37,87,12,31,32,0,32
37,87,12,57,51,0,51
37,87,12,71,56,0,56
37,87,12,95,60,0,60
37,87,12,99,38,0,38
37,87,12,103,46,31,15
37,87,12,117,37,0,37
37,87,12,127,42,0,42
37,87,37,1,32,0,32
37,87,37,21,694,624,70
37,87,37,63,0,22,-22
37,87,37,81,0,20,-20
37,87,37,89,92,107,-15
37,87,37,99,195,203,-8
37,87,37,113,0,29,-29
37,87,37,115,0,44,-44
37,87,37,119,46,35,11
37,87,37,173,33,58,-25
37,87,37,175,0,43,-43
37,87,37,183,36,43,-7
37,87,45,45,40,38,2
37,89,4,13,37,0,37
37,89,6,37,34,0,34
37,89,6,73,41,0,41
37,89,12,9,55,31,24
37,89,12,11,86,0,86
37,89,12,21,43,0,43
37,89,12,57,43,45,-2
37,89,12,71,75,0,75
37,89,12,81,49,0,49
37,89,12,86,51,0,51
37,89,12,95,69,22,47
37,89,12,99,105,43,62
37,89,12,101,39,0,39
37,89,12,103,87,0,87
37,89,12,105,56,0,56
37,89,12,115,30,0,30
37,89,12,127,71,0,71
37,89,13,67,0,34,-34
37,89,13,121,0,31,-31
37,89,13,135,0,41,-41
37,89,37,21,2404,1664,740
37,89,37,25,0,40,-40
37,89,37,35,32,0,32
37,89,37,51,32,0,32
37,89,37,67,29,36,-7
37,89,37,81,49,40,9
37,89,37,87,107,92,15
37,89,37,99,65,51,14
37,89,37,111,46,67,-21
37,89,37,115,31,40,-9
37,89,37,119,170,175,-5
37,89,37,129,37,36,1
37,89,37,147,23,0,23
37,89,37,149,144,184,-40
37,89,37,161,106,118,-12
37,89,37,175,357,338,19
37,89,37,183,49,72,-23
37,89,37,189,40,26,14
37,89,45,7,0,37,-37
37,89,45,13,30,0,30
37,89,45,19,60,25,35
37,89,45,45,115,198,-83
37,89,45,77,32,38,-6
37,89,45,79,0,24,-24
37,89,45,83,78,137,-59
37,89,45,91,0,31,-31
37,89,47,37,0,23,-23
37,89,48,201,0,39,-39
37,91,37,15,267,304,-37
37,91,37,73,94,32,62
37,91,37,81,0,40,-40
37,91,37,131,141,128,13
37,91,37,139,37,0,37
37,91,37,147,66,85,-19
37,91,37,183,44,76,-32
37,91,51,175,34,32,2
37,91,51,700,33,24,9
37,91,51,710,32,0,32
37,91,51,740,36,0,36
37,93,8,41,0,45,-45
37,93,13,179,50,0,50
37,93,13,215,47,0,47
37,93,15,3,38,36,2
37,93,37,51,2580,1868,712
37,93,37,85,102,181,-79
37,93,37,119,33,55,-22
37,93,37,125,224,232,-8
37,93,37,153,37,46,-9
37,93,37,155,303,325,-22
37,93,37,165,104,109,-5
37,93,37,183,51,76,-25
37,93,40,31,47,0,47
37,93,45,79,38,0,38
37,93,47,125,62,86,-24
37,93,48,27,49,0,49
37,93,48,29,42,52,-10
37,93,48,141,51,0,51
37,93,53,53,52,32,20
37,95,37,13,32,82,-50
37,95,37,55,41,32,9
37,95,37,147,43,41,2
37,97,4,13,52,41,11
37,97,6,37,93,0,93
37,97,6,59,78,0,78
37,97,6,73,33,0,33
37,97,9,1,42,0,42
37,97,9,3,33,0,33
37,97,12,9,31,0,31
37,97,12,11,122,0,122
37,97,12,31,0,29,-29
37,97,12,57,40,43,-3
37,97,12,71,49,0,49
37,97,12,81,38,0,38
37,97,12,86,73,0,73
37,97,12,95,56,0,56
37,97,12,99,92,0,92
37,97,12,103,79,37,42
37,97,12,115,29,0,29
37,97,12,127,73,0,73
37,97,13,121,0,37,-37
37,97,13,135,39,42,-3
37,97,17,31,56,0,56
37,97,18,97,34,0,34
37,97,24,3,34,0,34
37,97,24,25,34,0,34
37,97,25,27,45,0,45
37,97,26,125,90,0,90
37,97,26,163,41,0,41
37,97,32,3,63,0,63
37,97,34,23,44,0,44
37,97,34,25,46,0,46
37,97,34,27,42,0,42
37,97,34,29,53,0,53
37,97,34,39,42,0,42
37,97,36,29,74,0,74
37,97,36,55,32,0,32
37,97,36,59,116,0,116
37,97,36,61,34,0,34
37,97,36,81,55,0,55
37,97,36,103,410,28,382
37,97,37,1,43,0,43
37,97,37,3,415,364,51
37,97,37,9,0,32,-32
37,97,37,19,0,47,-47
37,97,37,21,53,40,13
37,97,37,23,64,80,-16
37,97,37,25,331,447,-116
37,97,37,27,71,71,0
37,97,37,35,475,630,-155
37,97,37,45,0,55,-55
37,97,37,51,53,28,25
37,97,37,57,67,87,-20
37,97,37,59,184,169,15
37,97,37,63,0,24,-24
37,97,37,67,212,226,-14
37,97,37,71,95,121,-26
37,97,37,81,171,142,29
37,97,37,85,0,30,-30
37,97,37,109,173,250,-77
37,97,37,119,2211,1690,521
37,97,37,129,35,58,-23
37,97,37,133,48,26,22
37,97,37,147,35,24,11
37,97,37,151,0,31,-31
37,97,37,159,559,823,-264
37,97,37,167,0,41,-41
37,97,37,171,80,47,33
37,97,37,179,84,83,1
37,97,37,183,97,152,-55
37,97,37,189,48,41,7
37,97,37,193,239,113,126
37,97,37,197,96,78,18
37,97,39,49,60,0,60
37,97,39,153,27,0,27
37,97,42,11,35,0,35
37,97,45,19,39,63,-24
37,97,45,45,47,42,5
37,97,45,51,30,60,-30
37,97,45,63,0,34,-34
37,97,45,79,31,44,-13
37,97,45,91,52,85,-33
37,97,47,93,31,0,31
37,97,48,201,37,36,1
37,97,54,47,0,41,-41
37,97,54,55,0,30,-30
37,99,12,103,29,0,29
37,99,12,105,32,0,32
37,99,37,21,159,190,-31
37,99,37,39,25,0,25
37,99,37,67,28,0,28
37,99,37,71,0,28,-28
37,99,37,87,203,195,8
37,99,37,89,51,65,-14
37,99,37,113,185,178,7
37,99,37,119,43,48,-5
37,99,37,133,23,0,23
37,99,37,173,404,309,95
37,99,37,175,47,42,5
37,99,37,183,47,68,-21
37,99,45,73,0,37,-37
37,101,4,13,47,0,47
37,101,6,37,74,0,74
37,101,6,73,37,0,37
37,101,9,1,32,0,32
37,101,9,9,38,0,38
37,101,11,1,0,25,-25
37,101,12,11,97,0,97
37,101,12,57,82,0,82
37,101,12,71,56,0,56
37,101,12,86,106,0,106
37,101,12,95,67,0,67
37,101,12,99,55,0,55
37,101,12,101,31,0,31
37,101,12,127,24,0,24
37,101,13,135,0,32,-32
37,101,24,3,44,0,44
37,101,24,5,36,0,36
37,101,24,31,35,0,35
37,101,24,33,74,0,74
37,101,25,17,39,0,39
37,101,25,23,36,0,36
37,101,25,27,35,0,35
37,101,32,3,40,0,40
37,101,33,11,32,0,32
37,101,34,13,54,0,54
37,101,34,23,42,0,42
37,101,34,29,61,0,61
37,101,34,31,50,0,50
37,101,34,39,58,0,58
37,101,36,27,25,0,25
37,101,36,29,30,0,30
37,101,36,47,64,0,64
37,101,36,59,67,0,67
37,101,36,71,35,0,35
37,101,36,81,56,0,56
37,101,36,103,204,0,204
37,101,37,1,49,58,-9
37,101,37,13,0,35,-35
37,101,37,19,42,36,6
37,101,37,31,61,37,24
37,101,37,37,0,45,-45
37,101,37,49,58,37,21
37,101,37,51,155,154,1
37,101,37,57,31,0,31
37,101,37,61,42,0,42
37,101,37,63,324,235,89
37,101,37,67,36,36,0
37,101,37,69,141,127,14
37,101,37,77,49,40,9
37,101,37,81,106,97,9
37,101,37,85,750,755,-5
37,101,37,105,44,48,-4
37,101,37,107,38,52,-14
37,101,37,119,81,71,10
37,101,37,125,0,35,-35
37,101,37,127,241,211,30
37,101,37,129,144,109,35
37,101,37,133,90,103,-13
37,101,37,135,39,61,-22
37,101,37,141,27,47,-20
37,101,37,147,113,119,-6
37,101,37,155,32,51,-19
37,101,37,163,214,231,-17
37,101,37,181,44,0,44
37,101,37,183,5526,3464,2062
37,101,37,191,600,449,151
37,101,37,195,321,286,35
37,101,45,51,58,32,26
37,101,48,201,0,29,-29
37,101,51,59,40,0,40
37,101,51,153,47,0,47
37,101,51,710,34,0,34
37,101,51,810,31,0,31
37,103,37,49,229,170,59
37,103,37,107,182,202,-20
37,103,37,133,163,165,-2
37,103,37,147,32,0,32
37,105,6,73,24,0,24
37,105,37,1,28,36,-8
37,105,37,37,607,318,289
37,105,37,51,245,227,18
37,105,37,63,55,56,-1
37,105,37,67,35,25,10
37,105,37,81,30,59,-29
37,105,37,85,902,785,117
37,105,37,101,48,44,4
37,105,37,119,0,65,-65
37,105,37,125,215,190,25
37,105,37,129,45,58,-13
37,105,37,135,32,35,-3
37,105,37,151,47,0,47
37,105,37,183,326,400,-74
37,107,24,33,0,31,-31
37,107,37,31,31,74,-43
37,107,37,49,147,131,16
37,107,37,61,189,190,-1
37,107,37,63,0,62,-62
37,107,37,79,268,250,18
37,107,37,81,0,39,-39
37,107,37,101,52,38,14
37,107,37,103,202,182,20
37,107,37,119,0,59,-59
37,107,37,129,50,72,-22
37,107,37,133,110,79,31
37,107,37,147,374,450,-76
37,107,37,183,122,180,-58
37,107,37,191,338,383,-45
37,109,6,37,36,48,-12
37,109,12,11,54,0,54
37,109,12,95,43,0,43
37,109,12,99,59,0,59
37,109,12,127,38,0,38
37,109,36,5,74,0,74
37,109,36,103,82,0,82
37,109,37,3,35,36,-1
37,109,37,23,60,98,-38
37,109,37,25,150,99,51
37,109,37,27,59,53,6
37,109,37,35,816,1133,-317
37,109,37,45,259,324,-65
37,109,37,67,30,0,30
37,109,37,71,1161,1150,11
37,109,37,81,39,23,16
37,109,37,97,250,173,77
37,109,37,119,1412,650,762
37,109,37,159,66,55,11
37,109,37,179,94,49,45
37,109,37,183,32,46,-14
37,109,42,101,72,23,49
37,109,45,91,58,56,2
37,111,37,21,538,268,270
37,111,37,23,282,366,-84
37,111,37,27,0,48,-48
37,111,37,35,0,79,-79
37,111,37,89,67,46,21
37,111,37,119,62,35,27
37,111,37,121,74,89,-15
37,111,37,161,79,98,-19
37,111,37,183,37,29,8
37,111,37,199,47,40,7
37,113,12,9,34,0,34
37,113,12,11,49,0,49
37,113,12,57,31,0,31
37,113,12,69,35,0,35
37,113,12,71,51,0,51
37,113,12,95,36,29,7
37,113,12,99,36,0,36
37,113,12,103,57,0,57
37,113,12,115,33,0,33
37,113,13,241,150,79,71
37,113,37,21,61,79,-18
37,113,37,39,31,47,-16
37,113,37,87,29,0,29
37,113,37,99,178,185,-7
37,113,37,119,0,26,-26
37,113,37,173,0,36,-36
37,113,37,183,0,25,-25
37,115,37,21,718,662,56
37,115,37,87,44,0,44
37,115,37,89,40,31,9
37,115,37,199,0,50,-50
37,117,37,13,135,133,2
37,117,37,15,104,52,52
37,117,37,65,49,71,-22
37,117,37,147,363,439,-76
37,117,37,183,0,65,-65
37,117,37,187,107,82,25
37,119,1,3,30,0,30
37,119,1,73,174,134,40
37,119,1,81,32,0,32
37,119,1,89,56,36,20
37,119,1,97,37,50,-13
37,119,1,101,55,0,55
37,119,1,117,50,45,5
37,119,1,125,36,21,15
37,119,2,20,0,46,-46
37,119,4,13,481,330,151
37,119,4,19,75,46,29
37,119,4,21,41,0,41
37,119,5,7,27,36,-9
37,119,5,119,79,0,79
37,119,6,1,107,104,3
37,119,6,13,111,70,41
37,119,6,29,31,0,31
37,119,6,37,734,452,282
37,119,6,59,366,218,148
37,119,6,61,39,0,39
37,119,6,65,147,63,84
37,119,6,67,161,51,110
37,119,6,71,149,76,73
37,119,6,73,454,190,264
37,119,6,75,62,100,-38
37,119,6,77,31,0,31
37,119,6,81,58,36,22
37,119,6,83,0,32,-32
37,119,6,85,118,110,8
37,119,6,111,81,34,47
37,119,8,1,0,43,-43
37,119,8,5,95,98,-3
37,119,8,13,31,0,31
37,119,8,31,74,106,-32
37,119,8,35,57,78,-21
37,119,8,41,98,74,24
37,119,8,59,0,64,-64
37,119,9,1,427,106,321
37,119,9,3,269,124,145
37,119,9,5,38,0,38
37,119,9,7,37,0,37
37,119,9,9,274,127,147
37,119,9,11,33,0,33
37,119,9,15,26,0,26
37,119,10,1,39,0,39
37,119,10,3,184,104,80
37,119,10,5,32,0,32
37,119,11,1,240,226,14
37,119,12,1,94,38,56
37,119,12,5,43,0,43
37,119,12,9,148,71,77
37,119,12,11,1233,317,916
37,119,12,15,37,41,-4
37,119,12,19,50,34,16
37,119,12,21,101,57,44
37,119,12,31,354,350,4
37,119,12,33,60,38,22
37,119,12,53,35,30,5
37,119,12,57,514,298,216
37,119,12,61,42,36,6
37,119,12,69,54,63,-9
37,119,12,71,260,92,168
37,119,12,73,132,46,86
37,119,12,81,99,54,45
37,119,12,83,68,64,4
37,119,12,85,52,0,52
37,119,12,86,1178,322,856
37,119,12,91,43,37,6
37,119,12,95,689,329,360
37,119,12,97,162,84,78
37,119,12,99,726,323,403
37,119,12,101,143,74,69
37,119,12,103,268,144,124
37,119,12,105,144,88,56
37,119,12,109,98,63,35
37,119,12,111,110,72,38
37,119,12,113,28,0,28
37,119,12,115,120,61,59
37,119,12,117,275,103,172
37,119,12,127,208,68,140
37,119,13,21,45,0,45
37,119,13,31,29,0,29
37,119,13,51,143,143,0
37,119,13,57,74,87,-13
37,119,13,59,71,30,41
37,119,13,63,91,101,-10
37,119,13,67,384,330,54
37,119,13,73,58,42,16
37,119,13,77,55,0,55
37,119,13,89,390,372,18
37,119,13,97,46,53,-7
37,119,13,113,26,0,26
37,119,13,117,78,101,-23
37,119,13,121,578,594,-16
37,119,13,135,353,329,24
37,119,13,139,42,58,-16
37,119,13,151,81,78,3
37,119,13,153,0,43,-43
37,119,13,179,50,0,50
37,119,13,185,23,0,23
37,119,13,215,50,28,22
37,119,13,245,111,74,37
37,119,13,247,33,0,33
37,119,15,3,109,52,57
37,119,16,1,35,37,-2
37,119,17,19,37,0,37
37,119,17,31,626,441,185
37,119,17,43,128,89,39
37,119,17,89,58,0,58
37,119,17,97,99,49,50
37,119,17,113,48,0,48
37,119,17,143,21,0,21
37,119,17,161,54,0,54
37,119,17,197,53,0,53
37,119,18,3,43,0,43
37,119,18,57,77,93,-16
37,119,18,63,40,0,40
37,119,18,89,31,35,-4
37,119,18,97,182,77,105
37,119,18,105,40,0,40
37,119,18,141,40,0,40
37,119,18,157,39,0,39
37,119,19,153,81,34,47
37,119,19,163,25,146,-121
37,119,20,45,27,0,27
37,119,20,91,67,64,3
37,119,21,15,28,0,28
37,119,21,67,87,34,53
37,119,21,111,120,102,18
37,119,21,117,37,0,37
37,119,22,33,62,59,3
37,119,22,51,67,68,-1
37,119,22,71,53,77,-24
37,119,23,5,63,34,29
37,119,23,31,38,0,38
37,119,24,3,215,91,124
37,119,24,5,346,99,247
37,119,24,17,53,0,53
37,119,24,21,96,0,96
37,119,24,25,67,0,67
37,119,24,27,118,108,10
37,119,24,31,452,248,204
37,119,24,33,457,172,285
37,119,24,37,43,0,43
37,119,24,43,23,0,23
37,119,24,45,29,0,29
37,119,24,510,238,81,157
37,119,25,1,49,0,49
37,119,25,3,27,0,27
37,119,25,5,96,31,65
37,119,25,9,179,55,124
37,119,25,13,123,54,69
37,119,25,17,267,156,111
37,119,25,21,137,76,61
37,119,25,23,95,0,95
37,119,25,25,293,133,160
37,119,25,27,167,64,103
37,119,26,45,27,0,27
37,119,26,49,131,0,131
37,119,26,65,79,0,79
37,119,26,77,66,0,66
37,119,26,81,134,40,94
37,119,26,93,35,0,35
37,119,26,99,121,33,88
37,119,26,115,43,0,43
37,119,26,125,412,125,287
37,119,26,139,43,0,43
37,119,26,145,46,0,46
37,119,26,147,45,0,45
37,119,26,161,135,47,88
37,119,26,163,436,76,360
37,119,27,37,29,36,-7
37,119,27,53,244,151,93
37,119,27,123,58,28,30
37,119,28,47,0,26,-26
37,119,28,49,37,0,37
37,119,29,19,25,0,25
37,119,29,95,43,51,-8
37,119,29,189,158,124,34
37,119,29,510,38,26,12
37,119,31,55,71,29,42
37,119,32,3,226,228,-2
37,119,32,31,28,0,28
37,119,33,11,60,27,33
37,119,33,15,49,0,49
37,119,34,3,288,101,187
37,119,34,5,142,41,101
37,119,34,7,118,60,58
37,119,34,13,306,121,185
37,119,34,15,47,0,47
37,119,34,17,363,138,225
37,119,34,19,45,0,45
37,119,34,21,87,0,87
37,119,34,23,357,169,188
37,119,34,25,181,77,104
37,119,34,27,196,76,120
37,119,34,29,137,32,105
37,119,34,31,212,45,167
37,119,34,35,146,41,105
37,119,34,37,50,0,50
37,119,34,39,327,75,252
37,119,34,41,61,0,61
37,119,35,1,51,38,13
37,119,36,1,119,50,69
37,119,36,5,538,187,351
37,119,36,7,80,38,42
37,119,36,9,29,0,29
37,119,36,11,21,0,21
37,119,36,13,49,0,49
37,119,36,15,48,0,48
37,119,36,27,123,39,84
37,119,36,29,581,154,427
37,119,36,45,42,0,42
37,119,36,47,827,303,524
37,119,36,51,20,0,20
37,119,36,53,28,0,28
37,119,36,55,441,116,325
37,119,36,59,797,121,676
37,119,36,61,591,505,86
37,119,36,63,97,0,97
37,119,36,65,86,49,37
37,119,36,67,259,78,181
37,119,36,69,23,0,23
37,119,36,71,107,42,65
37,119,36,75,36,0,36
37,119,36,81,950,215,735
37,119,36,83,48,0,48
37,119,36,85,47,0,47
37,119,36,87,107,0,107
37,119,36,89,24,0,24
37,119,36,91,55,0,55
37,119,36,93,56,0,56
37,119,36,101,43,0,43
37,119,36,103,1214,206,1008
37,119,36,111,34,0,34
37,119,36,119,302,124,178
37,119,37,1,156,163,-7
37,119,37,3,42,47,-5
37,119,37,7,124,119,5
37,119,37,9,0,38,-38
37,119,37,17,50,29,21
37,119,37,19,146,234,-88
37,119,37,21,494,369,125
37,119,37,23,132,131,1
37,119,37,25,3250,5825,-2575
37,119,37,27,103,50,53
37,119,37,31,52,52,0
37,119,37,35,558,611,-53
37,119,37,37,49,71,-22
37,119,37,45,413,381,32
37,119,37,47,67,48,19
37,119,37,49,134,75,59
37,119,37,51,534,278,256
37,119,37,57,209,140,69
37,119,37,59,88,90,-2
37,119,37,63,776,458,318
37,119,37,65,41,0,41
37,119,37,67,1008,730,278
37,119,37,71,2560,4257,-1697
37,119,37,77,42,44,-2
37,119,37,81,1488,996,492
37,119,37,83,31,0,31
37,119,37,85,88,86,2
37,119,37,87,35,46,-11
37,119,37,89,175,170,5
37,119,37,93,55,33,22
37,119,37,97,1690,2211,-521
37,119,37,99,48,43,5
37,119,37,101,71,81,-10
37,119,37,105,65,0,65
37,119,37,107,59,0,59
37,119,37,109,650,1412,-762
37,119,37,111,35,62,-27
37,119,37,113,26,0,26
37,119,37,123,73,95,-22
37,119,37,125,127,83,44
37,119,37,127,87,57,30
37,119,37,129,473,471,2
37,119,37,133,263,157,106
37,119,37,135,297,251,46
37,119,37,141,30,41,-11
37,119,37,145,36,0,36
37,119,37,147,229,133,96
37,119,37,149,0,40,-40
37,119,37,151,144,81,63
37,119,37,153,105,105,0
37,119,37,155,140,93,47
37,119,37,157,55,47,8
37,119,37,159,568,840,-272
37,119,37,161,121,89,32
37,119,37,163,54,0,54
37,119,37,165,98,45,53
37,119,37,167,360,467,-107
37,119,37,169,32,0,32
37,119,37,171,76,83,-7
37,119,37,175,36,26,10
37,119,37,179,4154,7173,-3019
37,119,37,181,25,27,-2
37,119,37,183,1667,1716,-49
37,119,37,189,185,163,22
37,119,37,191,124,35,89
37,119,37,193,122,69,53
37,119,37,195,57,34,23
37,119,37,197,31,0,31
37,119,39,17,70,37,33
37,119,39,25,39,0,39
37,119,39,35,488,112,376
37,119,39,41,52,38,14
37,119,39,45,35,0,35
37,119,39,49,475,235,240
37,119,39,57,32,0,32
37,119,39,61,246,101,145
37,119,39,85,75,0,75
37,119,39,89,32,0,32
37,119,39,93,96,60,36
37,119,39,95,128,49,79
37,119,39,99,100,0,100
37,119,39,103,36,0,36
37,119,39,113,125,53,72
37,119,39,133,44,0,44
37,119,39,151,103,26,77
37,119,39,153,276,49,227
37,119,39,155,60,0,60
37,119,39,157,24,0,24
37,119,39,165,44,32,12
37,119,39,173,42,0,42
37,119,40,109,37,46,-9
37,119,40,143,44,71,-27
37,119,41,51,49,68,-19
37,119,41,67,39,40,-1
37,119,42,3,503,192,311
37,119,42,7,66,0,66
37,119,42,11,55,28,27
37,119,42,17,146,33,113
37,119,42,19,52,29,23
37,119,42,21,23,0,23
37,119,42,27,52,0,52
37,119,42,29,112,64,48
37,119,42,41,26,38,-12
37,119,42,43,59,41,18
37,119,42,45,103,54,49
37,119,42,49,116,52,64
37,119,42,69,39,28,11
37,119,42,71,57,50,7
37,119,42,77,68,0,68
37,119,42,79,47,0,47
37,119,42,81,28,0,28
37,119,42,85,39,0,39
37,119,42,89,42,0,42
37,119,42,91,185,89,96
37,119,42,95,30,0,30
37,119,42,101,385,289,96
37,119,42,129,35,0,35
37,119,42,133,58,47,11
37,119,44,3,41,0,41
37,119,44,7,240,80,160
37,119,45,3,95,77,18
37,119,45,7,70,91,-21
37,119,45,13,192,173,19
37,119,45,15,139,131,8
37,119,45,19,520,545,-25
37,119,45,21,50,60,-10
37,119,45,23,100,122,-22
37,119,45,25,106,92,14
37,119,45,31,73,73,0
37,119,45,33,34,31,3
37,119,45,35,122,130,-8
37,119,45,39,0,35,-35
37,119,45,41,194,137,57
37,119,45,43,63,76,-13
37,119,45,45,576,501,75
37,119,45,47,37,33,4
37,119,45,51,319,376,-57
37,119,45,55,85,48,37
37,119,45,57,246,1288,-1042
37,119,45,59,32,0,32
37,119,45,63,327,152,175
37,119,45,67,36,0,36
37,119,45,69,28,0,28
37,119,45,73,43,46,-3
37,119,45,75,107,65,42
37,119,45,77,103,35,68
37,119,45,79,796,512,284
37,119,45,83,250,223,27
37,119,45,85,113,107,6
37,119,45,89,37,0,37
37,119,45,91,2393,5812,-3419
37,119,47,37,173,175,-2
37,119,47,65,108,77,31
37,119,47,93,180,168,12
37,119,47,125,45,0,45
37,119,47,149,42,45,-3
37,119,47,157,239,114,125
37,119,47,163,23,0,23
37,119,47,165,0,42,-42
37,119,47,179,88,43,45
37,119,47,187,65,58,7
37,119,48,27,53,54,-1
37,119,48,29,147,123,24
37,119,48,85,133,156,-23
37,119,48,113,292,359,-67
37,119,48,121,78,127,-49
37,119,48,141,50,36,14
37,119,48,157,62,66,-4
37,119,48,201,320,460,-140
37,119,48,339,0,50,-50
37,119,48,439,166,166,0
37,119,48,453,119,156,-37
37,119,48,491,29,57,-28
37,119,49,35,54,73,-19
37,119,49,49,36,0,36
37,119,50,7,52,31,21
37,119,51,3,74,30,44
37,119,51,13,201,109,92
37,119,51,23,34,0,34
37,119,51,41,229,137,92
37,119,51,59,631,285,346
37,119,51,69,31,0,31
37,119,51,85,35,0,35
37,119,51,87,253,150,103
37,119,51,95,44,0,44
37,119,51,107,160,117,43
37,119,51,121,92,43,49
37,119,51,153,223,90,133
37,119,51,161,83,43,40
37,119,51,177,51,0,51
37,119,51,179,83,0,83
37,119,51,510,141,64,77
37,119,51,540,43,0,43
37,119,51,550,111,60,51
37,119,51,590,45,0,45
37,119,51,650,165,42,123
37,119,51,660,48,0,48
37,119,51,680,46,0,46
37,119,51,683,44,0,44
37,119,51,690,39,0,39
37,119,51,700,173,31,142
37,119,51,710,207,76,131
37,119,51,740,45,0,45
37,119,51,750,28,0,28
37,119,51,760,152,95,57
37,119,51,770,100,56,44
37,119,51,800,32,0,32
37,119,51,810,326,141,185
37,119,53,11,44,0,44
37,119,53,33,182,219,-37
37,119,53,53,62,61,1
37,119,53,61,0,42,-42
37,119,53,73,0,25,-25
37,119,54,11,29,0,29
37,119,54,39,92,62,30
37,119,54,55,37,0,37
37,119,54,61,43,27,16
37,119,54,81,29,0,29
37,119,54,107,28,0,28
37,119,55,25,56,27,29
37,119,55,79,121,70,51
37,119,55,133,41,0,41
37,121,37,11,55,55,0
37,121,37,21,33,51,-18
37,121,37,111,89,74,15
37,121,37,199,189,146,43
37,121,47,179,0,31,-31
37,123,37,7,0,39,-39
37,123,37,25,37,0,37
37,123,37,57,43,0,43
37,123,37,81,47,91,-44
37,123,37,119,95,73,22
37,123,37,125,161,160,1
37,123,37,151,189,232,-43
37,123,37,153,76,63,13
37,123,37,159,0,35,-35
37,123,37,167,168,193,-25
37,123,37,179,0,42,-42
37,123,37,183,0,36,-36
37,125,6,37,26,0,26
37,125,8,41,40,42,-2
37,125,12,11,51,0,51
37,125,12,95,31,0,31
37,125,12,99,53,0,53
37,125,13,215,34,0,34
37,125,26,125,28,0,28
37,125,36,59,27,0,27
37,125,37,1,0,30,-30
37,125,37,19,29,33,-4
37,125,37,37,83,62,21
37,125,37,51,410,223,187
37,125,37,63,0,53,-53
37,125,37,67,44,49,-5
37,125,37,81,69,98,-29
37,125,37,85,216,145,71
37,125,37,93,232,224,8
37,125,37,101,35,0,35
37,125,37,105,190,215,-25
37,125,37,119,83,127,-44
37,125,37,123,160,161,-1
37,125,37,129,59,84,-25
37,125,37,133,31,29,2
37,125,37,135,0,38,-38
37,125,37,147,0,42,-42
37,125,37,151,112,179,-67
37,125,37,153,220,208,12
37,125,37,155,86,39,47
37,125,37,165,158,93,65
37,125,37,167,26,0,26
37,125,37,183,181,315,-134
37,125,37,189,0,23,-23
37,125,45,51,34,46,-12
37,125,47,125,60,0,60
37,125,48,27,35,0,35
37,125,51,59,60,29,31
37,125,53,53,46,0,46
37,127,11,1,30,27,3
37,127,24,33,91,38,53
37,127,34,13,34,0,34
37,127,34,29,31,0,31
37,127,36,47,30,0,30
37,127,37,13,0,28,-28
37,127,37,31,46,50,-4
37,127,37,49,0,35,-35
37,127,37,51,47,42,5
37,127,37,63,58,61,-3
37,127,37,65,2419,2258,161
37,127,37,67,43,45,-2
37,127,37,69,213,260,-47
37,127,37,81,88,92,-4
37,127,37,83,508,311,197
37,127,37,101,211,241,-30
37,127,37,119,57,87,-30
37,127,37,129,42,48,-6
37,127,37,131,40,0,40
37,127,37,133,0,35,-35
37,127,37,147,154,192,-38
37,127,37,183,718,849,-131
37,127,37,185,36,32,4
37,127,37,191,75,97,-22
37,127,37,195,794,851,-57
37,127,51,810,31,0,31
37,129,1,89,0,21,-21
37,129,4,13,73,48,25
37,129,6,37,96,59,37
37,129,6,59,57,24,33
37,129,6,73,103,105,-2
37,129,6,85,53,0,53
37,129,8,31,0,22,-22
37,129,8,41,0,31,-31
37,129,9,1,88,0,88
37,129,9,3,25,0,25
37,129,9,9,42,0,42
37,129,11,1,26,20,6
37,129,12,9,0,45,-45
37,129,12,11,77,60,17
37,129,12,31,42,26,16
37,129,12,57,28,70,-42
37,129,12,71,27,0,27
37,129,12,86,56,29,27
37,129,12,95,52,37,15
37,129,12,99,68,42,26
37,129,12,103,0,33,-33
37,129,12,117,0,36,-36
37,129,12,127,33,0,33
37,129,13,51,41,0,41
37,129,13,67,54,60,-6
37,129,13,89,45,52,-7
37,129,13,121,58,61,-3
37,129,13,135,0,52,-52
37,129,15,3,33,32,1
37,129,17,31,74,46,28
37,129,24,3,54,56,-2
37,129,24,5,37,30,7
37,129,24,21,26,0,26
37,129,24,31,96,31,65
37,129,24,510,32,0,32
37,129,25,13,34,0,34
37,129,25,17,0,31,-31
37,129,25,25,25,22,3
37,129,26,125,47,0,47
37,129,29,189,25,0,25
37,129,32,3,35,26,9
37,129,33,15,30,0,30
37,129,34,3,23,0,23
37,129,34,5,26,0,26
37,129,34,17,0,33,-33
37,129,34,23,25,0,25
37,129,34,25,41,0,41
37,129,34,31,29,0,29
37,129,36,27,23,0,23
37,129,36,29,32,0,32
37,129,36,47,80,32,48
37,129,36,55,38,0,38
37,129,36,59,80,0,80
37,129,36,61,65,58,7
37,129,36,67,35,0,35
37,129,36,81,42,0,42
37,129,36,87,40,0,40
37,129,36,103,148,52,96
37,129,36,119,31,0,31
37,129,37,1,102,74,28
37,129,37,13,28,0,28
37,129,37,17,81,91,-10
37,129,37,19,1475,2957,-1482
37,129,37,21,114,129,-15
37,129,37,23,29,34,-5
37,129,37,25,51,90,-39
37,129,37,31,142,89,53
37,129,37,35,47,30,17
37,129,37,37,36,30,6
37,129,37,45,30,0,30
37,129,37,47,211,236,-25
37,129,37,49,131,100,31
37,129,37,51,271,176,95
37,129,37,55,67,38,29
37,129,37,57,34,46,-12
37,129,37,59,0,26,-26
37,129,37,61,164,133,31
37,129,37,63,167,211,-44
37,129,37,67,193,159,34
37,129,37,69,31,0,31
37,129,37,71,81,46,35
37,129,37,77,0,36,-36
37,129,37,81,337,265,72
37,129,37,83,0,27,-27
37,129,37,85,61,67,-6
37,129,37,89,36,37,-1
37,129,37,97,58,35,23
37,129,37,101,109,144,-35
37,129,37,105,58,45,13
37,129,37,107,72,50,22
37,129,37,119,471,473,-2
37,129,37,125,84,59,25
37,129,37,127,48,42,6
37,129,37,133,477,411,66
37,129,37,135,124,109,15
37,129,37,139,29,0,29
37,129,37,141,1255,1939,-684
37,129,37,145,26,0,26
37,129,37,147,221,188,33
37,129,37,151,47,43,4
37,129,37,153,49,0,49
37,129,37,155,75,95,-20
37,129,37,157,55,0,55
37,129,37,159,61,61,0
37,129,37,163,79,99,-20
37,129,37,165,29,0,29
37,129,37,167,24,0,24
37,129,37,171,27,31,-4
37,129,37,179,71,76,-5
37,129,37,181,0,23,-23
37,129,37,183,983,1119,-136
37,129,37,189,55,63,-8
37,129,37,191,120,92,28
37,129,37,195,52,0,52
37,129,39,35,37,31,6
37,129,39,49,45,40,5
37,129,39,61,37,0,37
37,129,39,151,29,0,29
37,129,42,3,62,49,13
37,129,42,17,27,0,27
37,129,42,29,34,0,34
37,129,42,43,23,0,23
37,129,42,49,27,0,27
37,129,42,101,42,38,4
37,129,45,13,0,33,-33
37,129,45,19,70,125,-55
37,129,45,45,40,53,-13
37,129,45,51,159,153,6
37,129,45,79,38,62,-24
37,129,45,91,50,56,-6
37,129,47,37,39,0,39
37,129,47,65,28,0,28
37,129,47,93,0,47,-47
37,129,47,157,38,0,38
37,129,48,113,38,0,38
37,129,48,157,0,40,-40
37,129,48,201,37,51,-14
37,129,48,439,0,30,-30
37,129,48,453,0,23,-23
37,129,51,13,0,39,-39
37,129,51,41,49,29,20
37,129,51,59,144,72,72
37,129,51,87,27,0,27
37,129,51,107,56,0,56
37,129,51,153,34,32,2
37,129,51,510,29,0,29
37,129,51,550,37,0,37
37,129,51,710,32,40,-8
37,129,51,760,23,32,-9
37,129,51,810,49,54,-5
37,131,37,15,46,57,-11
37,131,37,81,0,37,-37
37,131,37,83,411,505,-94
37,131,37,91,128,141,-13
37,131,37,127,0,40,-40
37,131,37,147,0,48,-48
37,131,37,183,44,49,-5
37,133,1,3,26,0,26
37,133,1,73,30,47,-17
37,133,1,81,0,30,-30
37,133,1,89,0,52,-52
37,133,1,97,46,43,3
37,133,1,101,0,31,-31
37,133,1,125,25,0,25
37,133,4,13,110,140,-30
37,133,4,19,31,40,-9
37,133,4,27,117,154,-37
37,133,6,1,23,29,-6
37,133,6,19,0,35,-35
37,133,6,29,47,45,2
37,133,6,37,155,154,1
37,133,6,53,78,78,0
37,133,6,59,105,95,10
37,133,6,65,106,133,-27
37,133,6,67,42,34,8
37,133,6,71,398,376,22
37,133,6,73,1059,982,77
37,133,6,77,0,35,-35
37,133,6,85,0,59,-59
37,133,8,1,35,0,35
37,133,8,5,33,62,-29
37,133,8,31,26,0,26
37,133,8,41,77,67,10
37,133,8,59,25,0,25
37,133,9,1,58,42,16
37,133,9,3,66,46,20
37,133,9,9,56,56,0
37,133,9,11,40,42,-2
37,133,10,1,0,26,-26
37,133,10,3,42,54,-12
37,133,11,1,72,46,26
37,133,12,5,35,0,35
37,133,12,9,90,89,1
37,133,12,11,137,178,-41
37,133,12,15,27,0,27
37,133,12,19,76,64,12
37,133,12,21,41,0,41
37,133,12,31,174,200,-26
37,133,12,33,362,166,196
37,133,12,57,167,163,4
37,133,12,69,0,39,-39
37,133,12,71,33,50,-17
37,133,12,73,27,0,27
37,133,12,83,37,54,-17
37,133,12,86,211,178,33
37,133,12,91,97,67,30
37,133,12,95,100,127,-27
37,133,12,97,37,38,-1
37,133,12,99,98,92,6
37,133,12,101,64,48,16
37,133,12,103,79,82,-3
37,133,12,105,59,72,-13
37,133,12,109,43,34,9
37,133,12,111,37,32,5
37,133,12,113,176,87,89
37,133,12,117,35,74,-39
37,133,12,127,53,51,2
37,133,13,39,165,47,118
37,133,13,51,0,47,-47
37,133,13,57,0,35,-35
37,133,13,67,79,79,0
37,133,13,73,0,42,-42
37,133,13,89,0,37,-37
37,133,13,95,69,64,5
37,133,13,121,45,54,-9
37,133,13,135,61,79,-18
37,133,13,153,0,37,-37
37,133,13,177,0,52,-52
37,133,13,179,0,38,-38
37,133,13,215,0,47,-47
37,133,13,245,39,47,-8
37,133,15,3,342,512,-170
37,133,17,31,102,146,-44
37,133,17,43,35,51,-16
37,133,17,97,76,79,-3
37,133,17,119,32,0,32
37,133,17,163,44,0,44
37,133,17,197,34,38,-4
37,133,18,3,28,0,28
37,133,18,89,0,25,-25
37,133,18,97,56,29,27
37,133,20,91,0,41,-41
37,133,20,173,0,32,-32
37,133,21,67,31,42,-11
37,133,21,93,76,51,25
37,133,21,111,42,55,-13
37,133,22,19,43,22,21
37,133,22,33,30,24,6
37,133,22,51,0,40,-40
37,133,22,71,38,52,-14
37,133,22,103,32,44,-12
37,133,22,109,0,39,-39
37,133,23,1,0,37,-37
37,133,24,3,148,104,44
37,133,24,5,63,58,5
37,133,24,13,36,30,6
37,133,24,17,72,124,-52
37,133,24,21,37,25,12
37,133,24,25,68,49,19
37,133,24,31,106,118,-12
37,133,24,33,108,87,21
37,133,24,37,75,0,75
37,133,24,43,35,29,6
37,133,24,510,30,0,30
37,133,25,5,55,24,31
37,133,25,9,50,30,20
37,133,25,13,63,39,24
37,133,25,17,103,115,-12
37,133,25,21,0,29,-29
37,133,25,23,61,51,10
37,133,25,25,0,29,-29
37,133,25,27,59,72,-13
37,133,26,81,23,0,23
37,133,26,99,70,63,7
37,133,26,125,97,64,33
37,133,26,145,30,0,30
37,133,26,163,114,76,38
37,133,27,37,0,33,-33
37,133,28,47,46,52,-6
37,133,29,37,0,53,-53
37,133,29,77,0,32,-32
37,133,29,95,0,78,-78
37,133,29,169,94,132,-38
37,133,29,183,40,0,40
37,133,29,189,35,30,5
37,133,31,55,0,45,-45
37,133,32,3,60,74,-14
37,133,33,11,38,33,5
37,133,33,15,0,24,-24
37,133,34,3,31,66,-35
37,133,34,5,59,27,32
37,133,34,7,0,27,-27
37,133,34,13,54,26,28
37,133,34,17,47,32,15
37,133,34,23,45,27,18
37,133,34,25,43,62,-19
37,133,34,27,0,29,-29
37,133,34,29,31,42,-11
37,133,34,31,42,47,-5
37,133,34,39,0,27,-27
37,133,35,1,29,36,-7
37,133,36,1,31,0,31
37,133,36,5,72,54,18
37,133,36,7,29,0,29
37,133,36,29,67,72,-5
37,133,36,47,94,101,-7
37,133,36,55,40,63,-23
37,133,36,59,71,74,-3
37,133,36,61,36,39,-3
37,133,36,65,24,0,24
37,133,36,67,38,29,9
37,133,36,71,32,40,-8
37,133,36,81,90,102,-12
37,133,36,91,40,30,10
37,133,36,101,0,30,-30
37,133,36,103,96,94,2
37,133,36,119,48,32,16
37,133,37,1,46,37,9
37,133,37,19,73,68,5
37,133,37,21,30,30,0
37,133,37,25,0,39,-39
37,133,37,27,0,27,-27
37,133,37,31,591,497,94
37,133,37,35,0,34,-34
37,133,37,49,591,492,99
37,133,37,51,204,167,37
37,133,37,57,0,28,-28
37,133,37,61,184,272,-88
37,133,37,63,53,84,-31
37,133,37,67,102,95,7
37,133,37,71,30,52,-22
37,133,37,81,121,167,-46
37,133,37,85,48,50,-2
37,133,37,97,26,48,-22
37,133,37,99,0,23,-23
37,133,37,101,103,90,13
37,133,37,103,165,163,2
37,133,37,107,79,110,-31
37,133,37,119,157,263,-106
37,133,37,125,29,31,-2
37,133,37,127,35,0,35
37,133,37,129,411,477,-66
37,133,37,135,28,29,-1
37,133,37,139,35,0,35
37,133,37,141,358,421,-63
37,133,37,147,147,222,-75
37,133,37,151,44,0,44
37,133,37,157,33,0,33
37,133,37,159,42,30,12
37,133,37,163,34,39,-5
37,133,37,179,0,44,-44
37,133,37,183,263,429,-166
37,133,37,191,50,109,-59
37,133,39,7,25,0,25
37,133,39,17,44,37,7
37,133,39,25,0,30,-30
37,133,39,35,84,116,-32
37,133,39,49,113,76,37
37,133,39,61,46,46,0
37,133,39,93,0,32,-32
37,133,39,95,53,29,24
37,133,39,99,33,0,33
37,133,39,103,0,27,-27
37,133,39,113,70,45,25
37,133,39,133,0,29,-29
37,133,39,151,38,0,38
37,133,39,153,67,41,26
37,133,40,31,78,76,2
37,133,40,109,0,44,-44
37,133,41,51,0,24,-24
37,133,42,3,85,104,-19
37,133,42,11,30,28,2
37,133,42,17,42,82,-40
37,133,42,29,30,37,-7
37,133,42,43,37,51,-14
37,133,42,45,29,38,-9
37,133,42,49,41,35,6
37,133,42,55,27,32,-5
37,133,42,69,0,28,-28
37,133,42,71,56,55,1
37,133,42,77,28,34,-6
37,133,42,79,29,0,29
37,133,42,91,54,54,0
37,133,42,101,66,62,4
37,133,42,125,0,37,-37
37,133,42,129,35,47,-12
37,133,42,133,64,70,-6
37,133,44,5,50,91,-41
37,133,44,7,0,34,-34
37,133,45,3,0,27,-27
37,133,45,7,30,0,30
37,133,45,13,524,682,-158
37,133,45,15,55,84,-29
37,133,45,19,32,60,-28
37,133,45,35,30,74,-44
37,133,45,45,79,59,20
37,133,45,51,102,49,53
37,133,45,63,57,44,13
37,133,45,79,33,80,-47
37,133,45,83,50,35,15
37,133,45,91,0,38,-38
37,133,47,37,36,36,0
37,133,47,65,0,27,-27
37,133,47,93,43,52,-9
37,133,47,125,57,38,19
37,133,47,157,63,64,-1
37,133,47,189,0,38,-38
37,133,48,27,36,0,36
37,133,48,29,168,158,10
37,133,48,85,38,30,8
37,133,48,113,119,92,27
37,133,48,121,0,34,-34
37,133,48,141,79,50,29
37,133,48,157,0,31,-31
37,133,48,167,0,29,-29
37,133,48,201,186,241,-55
37,133,48,215,0,56,-56
37,133,48,339,57,0,57
37,133,48,355,44,64,-20
37,133,48,439,133,242,-109
37,133,48,451,80,39,41
37,133,48,453,44,54,-10
37,133,48,485,0,32,-32
37,133,48,491,31,35,-4
37,133,49,35,30,0,30
37,133,51,13,35,40,-5
37,133,51,41,45,35,10
37,133,51,59,152,206,-54
37,133,51,87,0,43,-43
37,133,51,107,39,56,-17
37,133,51,153,466,625,-159
37,133,51,177,154,169,-15
37,133,51,179,455,508,-53
37,133,51,199,46,0,46
37,133,51,510,0,44,-44
37,133,51,550,129,133,-4
37,133,51,630,0,44,-44
37,133,51,650,47,58,-11
37,133,51,700,93,40,53
37,133,51,710,175,125,50
37,133,51,740,89,67,22
37,133,51,800,46,0,46
37,133,51,810,305,306,-1
37,133,53,33,64,58,6
37,133,53,35,77,39,38
37,133,53,53,55,42,13
37,133,53,61,30,33,-3
37,133,54,107,39,0,39
37,133,55,79,41,39,2
37,135,1,73,0,33,-33
37,135,4,13,94,38,56
37,135,6,1,29,55,-26
37,135,6,13,32,0,32
37,135,6,37,120,83,37
37,135,6,59,60,33,27
37,135,6,73,95,45,50
37,135,6,75,62,70,-8
37,135,6,85,44,65,-21
37,135,8,31,0,28,-28
37,135,9,1,30,0,30
37,135,9,3,33,0,33
37,135,9,9,0,32,-32
37,135,11,1,102,113,-11
37,135,12,11,35,0,35
37,135,12,31,28,0,28
37,135,12,57,44,0,44
37,135,12,73,35,0,35
37,135,12,86,40,38,2
37,135,12,95,32,0,32
37,135,12,99,35,0,35
37,135,13,67,28,41,-13
37,135,13,89,38,59,-21
37,135,13,121,58,76,-18
37,135,17,31,67,111,-44
37,135,19,103,31,0,31
37,135,24,5,38,0,38
37,135,24,31,61,94,-33
37,135,24,33,42,0,42
37,135,24,510,38,36,2
37,135,25,17,119,89,30
37,135,25,21,45,28,17
37,135,25,25,47,85,-38
37,135,25,27,51,0,51
37,135,26,125,46,0,46
37,135,26,161,64,36,28
37,135,26,163,31,0,31
37,135,27,53,37,0,37
37,135,29,189,42,0,42
37,135,34,23,38,0,38
37,135,36,47,69,86,-17
37,135,36,55,45,0,45
37,135,36,61,120,144,-24
37,135,36,81,0,41,-41
37,135,36,103,32,0,32
37,135,36,119,44,0,44
37,135,37,1,701,1115,-414
37,135,37,21,116,108,8
37,135,37,25,41,0,41
37,135,37,31,28,0,28
37,135,37,33,0,56,-56
37,135,37,35,36,0,36
37,135,37,37,625,901,-276
37,135,37,49,44,35,9
37,135,37,51,85,44,41
37,135,37,57,29,0,29
37,135,37,63,2685,3303,-618
37,135,37,67,103,125,-22
37,135,37,77,76,90,-14
37,135,37,81,354,286,68
37,135,37,85,22,45,-23
37,135,37,101,61,39,22
37,135,37,105,35,32,3
37,135,37,119,251,297,-46
37,135,37,125,38,0,38
37,135,37,129,109,124,-15
37,135,37,133,29,28,1
37,135,37,145,113,181,-68
37,135,37,147,70,75,-5
37,135,37,151,37,0,37
37,135,37,159,35,0,35
37,135,37,181,26,31,-5
37,135,37,183,1069,1252,-183
37,135,37,189,38,44,-6
37,135,39,35,77,0,77
37,135,39,49,42,34,8
37,135,41,51,24,42,-18
37,135,42,3,80,42,38
37,135,42,91,24,0,24
37,135,42,101,24,41,-17
37,135,45,19,52,39,13
37,135,45,79,35,0,35
37,135,47,37,28,47,-19
37,135,48,201,65,38,27
37,135,48,453,42,42,0
37,135,49,35,0,39,-39
37,135,51,3,35,0,35
37,135,51,13,36,43,-7
37,135,51,59,63,49,14
37,135,51,510,22,24,-2
37,135,51,760,0,34,-34
37,135,51,810,32,0,32
37,135,53,33,60,88,-28
37,135,55,25,34,0,34
37,137,37,13,51,51,0
37,137,37,49,239,264,-25
37,137,37,147,0,34,-34
37,137,37,183,29,0,29
37,139,1,97,0,35,-35
37,139,12,103,0,30,-30
37,139,15,3,0,30,-30
37,139,24,33,0,35,-35
37,139,37,29,269,223,46
37,139,37,41,98,93,5
37,139,37,51,0,41,-41
37,139,37,53,172,129,43
37,139,37,55,31,86,-55
37,139,37,63,0,37,-37
37,139,37,73,50,31,19
37,139,37,81,0,37,-37
37,139,37,91,0,37,-37
37,139,37,129,0,29,-29
37,139,37,133,0,35,-35
37,139,37,143,252,421,-169
37,139,37,147,0,67,-67
37,139,37,183,73,110,-37
37,139,51,550,240,153,87
37,139,51,710,122,49,73
37,139,51,740,95,41,54
37,139,51,800,64,0,64
37,139,51,810,318,92,226
37,141,12,33,36,0,36
37,141,36,103,79,0,79
37,141,37,17,0,31,-31
37,141,37,19,213,221,-8
37,141,37,31,30,0,30
37,141,37,47,0,33,-33
37,141,37,51,29,38,-9
37,141,37,61,151,208,-57
37,141,37,63,0,36,-36
37,141,37,81,59,46,13
37,141,37,101,47,27,20
37,141,37,119,41,30,11
37,141,37,129,1939,1255,684
37,141,37,133,421,358,63
37,141,37,147,0,45,-45
37,141,37,163,37,44,-7
37,141,37,183,101,145,-44
37,141,51,59,28,0,28
37,143,37,29,56,0,56
37,143,37,41,97,101,-4
37,143,37,53,29,0,29
37,143,37,139,421,252,169
37,143,37,147,0,38,-38
37,143,51,550,66,0,66
37,143,51,800,30,0,30
37,143,51,810,56,0,56
37,145,37,1,74,77,-3
37,145,37,33,125,93,32
37,145,37,63,518,347,171
37,145,37,77,94,145,-51
37,145,37,81,47,76,-29
37,145,37,119,0,36,-36
37,145,37,129,0,26,-26
37,145,37,135,181,113,68
37,145,37,183,119,168,-49
37,145,51,83,94,71,23
37,147,4,13,0,29,-29
37,147,6,37,41,27,14
37,147,6,73,33,0,33
37,147,9,9,51,0,51
37,147,11,1,0,36,-36
37,147,12,11,47,0,47
37,147,12,31,38,33,5
37,147,12,57,40,34,6
37,147,12,86,30,0,30
37,147,12,95,38,0,38
37,147,12,103,0,22,-22
37,147,13,51,0,28,-28
37,147,13,89,0,39,-39
37,147,13,135,39,0,39
37,147,17,31,0,23,-23
37,147,24,3,32,0,32
37,147,24,31,28,38,-10
37,147,24,33,60,0,60
37,147,24,510,30,0,30
37,147,26,125,38,0,38
37,147,34,13,38,0,38
37,147,34,23,44,0,44
37,147,34,31,37,0,37
37,147,36,5,32,0,32
37,147,36,47,55,0,55
37,147,36,59,32,0,32
37,147,36,61,0,26,-26
37,147,36,81,45,0,45
37,147,36,103,42,0,42
37,147,37,1,36,53,-17
37,147,37,13,879,687,192
37,147,37,15,107,68,39
37,147,37,19,26,37,-11
37,147,37,21,0,48,-48
37,147,37,25,0,32,-32
37,147,37,31,173,176,-3
37,147,37,35,26,29,-3
37,147,37,37,0,32,-32
37,147,37,41,67,28,39
37,147,37,49,485,281,204
37,147,37,51,189,156,33
37,147,37,55,100,47,53
37,147,37,57,0,40,-40
37,147,37,59,25,0,25
37,147,37,61,73,41,32
37,147,37,63,180,221,-41
37,147,37,65,263,230,33
37,147,37,67,73,113,-40
37,147,37,71,27,0,27
37,147,37,79,366,322,44
37,147,37,81,166,202,-36
37,147,37,83,88,63,25
37,147,37,85,45,45,0
37,147,37,89,0,23,-23
37,147,37,91,85,66,19
37,147,37,95,41,43,-2
37,147,37,97,24,35,-11
37,147,37,101,119,113,6
37,147,37,103,0,32,-32
37,147,37,107,450,374,76
37,147,37,117,439,363,76
37,147,37,119,133,229,-96
37,147,37,125,42,0,42
37,147,37,127,192,154,38
37,147,37,129,188,221,-33
37,147,37,131,48,0,48
37,147,37,133,222,147,75
37,147,37,135,75,70,5
37,147,37,137,34,0,34
37,147,37,139,67,0,67
37,147,37,141,45,0,45
37,147,37,143,38,0,38
37,147,37,155,44,37,7
37,147,37,163,36,30,6
37,147,37,179,0,28,-28
37,147,37,183,656,942,-286
37,147,37,187,97,63,34
37,147,37,191,295,149,146
37,147,37,195,250,205,45
37,147,39,49,38,0,38
37,147,42,3,42,0,42
37,147,42,101,23,0,23
37,147,45,19,0,49,-49
37,147,45,51,0,36,-36
37,147,45,79,0,36,-36
37,147,47,37,0,32,-32
37,147,48,201,30,27,3
37,147,51,41,26,0,26
37,147,51,59,55,38,17
37,147,51,87,0,31,-31
37,147,51,550,60,0,60
37,147,51,650,39,0,39
37,147,51,700,31,0,31
37,147,51,710,38,33,5
37,147,51,760,0,24,-24
37,147,51,810,74,78,-4
37,149,37,21,88,68,20
37,149,37,89,184,144,40
37,149,37,119,40,0,40
37,149,37,161,131,147,-16
37,149,45,45,64,48,16
37,149,45,83,180,273,-93
37,151,12,11,76,0,76
37,151,37,1,148,201,-53
37,151,37,19,0,46,-46
37,151,37,23,0,39,-39
37,151,37,25,0,33,-33
37,151,37,37,312,207,105
37,151,37,51,36,49,-13
37,151,37,57,1089,1177,-88
37,151,37,63,31,32,-1
37,151,37,67,239,198,41
37,151,37,71,0,43,-43
37,151,37,81,2543,2337,206
37,151,37,97,31,0,31
37,151,37,105,0,47,-47
37,151,37,119,81,144,-63
37,151,37,123,232,189,43
37,151,37,125,179,112,67
37,151,37,129,43,47,-4
37,151,37,133,0,44,-44
37,151,37,135,0,37,-37
37,151,37,153,0,36,-36
37,151,37,157,110,104,6
37,151,37,159,0,54,-54
37,151,37,167,56,35,21
37,151,37,171,0,34,-34
37,151,37,179,47,0,47
37,151,37,183,117,149,-32
37,151,37,189,0,32,-32
37,151,45,51,49,58,-9
37,153,37,7,115,93,22
37,153,37,51,55,80,-25
37,153,37,67,0,40,-40
37,153,37,81,73,56,17
37,153,37,93,46,37,9
37,153,37,119,105,105,0
37,153,37,123,63,76,-13
37,153,37,125,208,220,-12
37,153,37,129,0,49,-49
37,153,37,151,36,0,36
37,153,37,155,54,59,-5
37,153,37,165,239,257,-18
37,153,37,167,0,32,-32
37,153,37,179,0,43,-43
37,153,37,183,53,84,-31
37,153,45,25,44,0,44
37,153,45,51,0,43,-43
37,153,45,69,76,60,16
37,155,6,37,0,37,-37
37,155,36,5,0,27,-27
37,155,36,47,43,0,43
37,155,37,17,251,233,18
37,155,37,19,37,69,-32
37,155,37,47,165,97,68
37,155,37,51,1105,1121,-16
37,155,37,63,30,67,-37
37,155,37,81,73,72,1
37,155,37,85,62,63,-1
37,155,37,93,325,303,22
37,155,37,101,51,32,19
37,155,37,119,93,140,-47
37,155,37,125,39,86,-47
37,155,37,129,95,75,20
37,155,37,147,37,44,-7
37,155,37,153,59,54,5
37,155,37,165,330,386,-56
37,155,37,183,82,190,-108
37,155,45,33,92,88,4
37,155,45,51,53,53,0
37,155,45,69,37,34,3
37,157,37,1,145,194,-49
37,157,37,19,0,37,-37
37,157,37,33,178,185,-7
37,157,37,51,29,0,29
37,157,37,57,89,72,17
37,157,37,67,224,232,-8
37,157,37,81,1400,1366,34
37,157,37,119,47,55,-8
37,157,37,129,0,55,-55
37,157,37,133,0,33,-33
37,157,37,151,104,110,-6
37,157,37,169,205,222,-17
37,157,37,183,72,92,-20
37,157,51,67,0,44,-44
37,157,51,89,286,169,117
37,157,51,143,86,90,-4
37,157,51,590,109,72,37
37,157,51,690,47,0,47
37,159,6,37,42,0,42
37,159,12,11,55,0,55
37,159,12,57,42,0,42
37,159,12,86,55,0,55
37,159,24,33,38,0,38
37,159,36,29,29,0,29
37,159,36,103,41,0,41
37,159,37,1,33,0,33
37,159,37,19,0,30,-30
37,159,37,21,0,32,-32
37,159,37,25,2580,1984,596
37,159,37,35,58,63,-5
37,159,37,51,62,50,12
37,159,37,57,305,349,-44
37,159,37,59,192,214,-22
37,159,37,63,42,63,-21
37,159,37,67,165,211,-46
37,159,37,71,82,77,5
37,159,37,81,140,148,-8
37,159,37,97,823,559,264
37,159,37,109,55,66,-11
37,159,37,119,840,568,272
37,159,37,123,35,0,35
37,159,37,129,61,61,0
37,159,37,133,30,42,-12
37,159,37,135,0,35,-35
37,159,37,151,54,0,54
37,159,37,167,205,188,17
37,159,37,179,68,87,-19
37,159,37,183,88,141,-53
37,159,45,19,39,32,7
37,159,45,45,34,0,34
37,159,45,51,39,64,-25
37,159,45,79,38,0,38
37,159,45,91,76,0,76
37,161,12,11,49,0,49
37,161,12,99,42,0,42
37,161,12,115,31,0,31
37,161,37,19,33,0,33
37,161,37,21,134,74,60
37,161,37,23,47,71,-24
37,161,37,25,29,0,29
37,161,37,35,0,27,-27
37,161,37,45,433,555,-122
37,161,37,71,44,94,-50
37,161,37,81,45,25,20
37,161,37,89,118,106,12
37,161,37,111,98,79,19
37,161,37,119,89,121,-32
37,161,37,149,147,131,16
37,161,37,183,0,23,-23
37,161,45,21,40,65,-25
37,161,45,45,33,25,8
37,161,45,83,188,235,-47
37,163,37,17,79,98,-19
37,163,37,19,0,24,-24
37,163,37,51,481,489,-8
37,163,37,61,343,305,38
37,163,37,63,42,36,6
37,163,37,81,36,49,-13
37,163,37,85,344,286,58
37,163,37,101,231,214,17
37,163,37,119,0,54,-54
37,163,37,129,99,79,20
37,163,37,133,39,34,5
37,163,37,141,44,37,7
37,163,37,147,30,36,-6
37,163,37,183,112,195,-83
37,163,37,191,125,168,-43
37,165,37,19,0,29,-29
37,165,37,51,133,127,6
37,165,37,67,0,38,-38
37,165,37,81,0,61,-61
37,165,37,93,109,104,5
37,165,37,119,45,98,-53
37,165,37,125,93,158,-65
37,165,37,129,0,29,-29
37,165,37,153,257,239,18
37,165,37,155,386,330,56
37,165,37,183,0,92,-92
37,165,45,51,27,57,-30
37,165,45,69,157,157,0
37,167,37,7,93,73,20
37,167,37,25,552,547,5
37,167,37,57,65,42,23
37,167,37,67,0,31,-31
37,167,37,81,36,50,-14
37,167,37,97,41,0,41
37,167,37,119,467,360,107
37,167,37,123,193,168,25
37,167,37,125,0,26,-26
37,167,37,129,0,24,-24
37,167,37,151,35,56,-21
37,167,37,153,32,0,32
37,167,37,159,188,205,-17
37,167,37,179,211,148,63
37,167,37,183,38,44,-6
37,167,45,51,0,31,-31
37,169,37,57,105,95,10
37,169,37,59,47,26,21
37,169,37,67,1253,1279,-26
37,169,37,81,121,145,-24
37,169,37,119,0,32,-32
37,169,37,157,222,205,17
37,169,37,171,307,325,-18
37,169,37,183,0,33,-33
37,169,37,197,100,76,24
37,171,37,5,87,42,45
37,171,37,35,38,0,38
37,171,37,57,80,83,-3
37,171,37,59,0,35,-35
37,171,37,67,574,479,95
37,171,37,81,54,116,-62
37,171,37,97,47,80,-33
37,171,37,119,83,76,7
37,171,37,129,31,27,4
37,171,37,151,34,0,34
37,171,37,169,325,307,18
37,171,37,183,28,65,-37
37,171,37,189,29,0,29
37,171,37,193,191,244,-53
37,171,37,197,289,375,-86
37,171,51,35,237,190,47
37,171,51,141,104,128,-24
37,173,37,21,55,88,-33
37,173,37,75,58,0,58
37,173,37,87,58,33,25
37,173,37,99,309,404,-95
37,173,37,113,36,0,36
37,175,12,99,34,0,34
37,175,12,127,27,0,27
37,175,37,21,178,171,7
37,175,37,87,43,0,43
37,175,37,89,338,357,-19
37,175,37,99,42,47,-5
37,175,37,119,26,36,-10
37,175,45,45,34,74,-40
37,175,45,77,0,43,-43
37,175,45,83,0,40,-40
37,177,37,55,0,39,-39
37,177,37,187,39,91,-52
37,179,4,13,99,71,28
37,179,6,37,113,38,75
37,179,6,59,47,0,47
37,179,6,65,61,0,61
37,179,6,73,51,0,51
37,179,9,1,66,0,66
37,179,9,3,53,0,53
37,179,9,9,54,0,54
37,179,10,3,42,0,42
37,179,12,11,350,55,295
37,179,12,31,61,44,17
37,179,12,57,56,0,56
37,179,12,81,34,0,34
37,179,12,86,147,23,124
37,179,12,95,94,59,35
37,179,12,99,219,0,219
37,179,12,101,41,0,41
37,179,12,105,35,0,35
37,179,12,115,0,33,-33
37,179,12,117,105,37,68
37,179,13,67,44,49,-5
37,179,13,121,38,0,38
37,179,17,31,50,0,50
37,179,24,3,45,0,45
37,179,24,5,38,0,38
37,179,24,27,47,0,47
37,179,24,31,90,0,90
37,179,24,33,98,0,98
37,179,25,13,41,0,41
37,179,25,17,54,0,54
37,179,25,21,26,0,26
37,179,32,3,58,34,24
37,179,34,3,86,0,86
37,179,34,13,40,0,40
37,179,34,17,78,0,78
37,179,34,21,44,0,44
37,179,34,23,88,0,88
37,179,34,25,62,0,62
37,179,34,27,100,0,100
37,179,34,29,76,0,76
37,179,34,31,61,0,61
37,179,34,35,40,0,40
37,179,34,39,49,0,49
37,179,36,5,50,0,50
37,179,36,29,58,0,58
37,179,36,47,111,0,111
37,179,36,55,66,0,66
37,179,36,59,375,0,375
37,179,36,61,59,0,59
37,179,36,71,66,0,66
37,179,36,81,173,0,173
37,179,36,103,491,0,491
37,179,36,119,92,0,92
37,179,37,7,302,298,4
37,179,37,19,70,77,-7
37,179,37,21,43,61,-18
37,179,37,25,388,296,92
37,179,37,27,0,32,-32
37,179,37,35,39,44,-5
37,179,37,45,37,37,0
37,179,37,51,43,49,-6
37,179,37,57,0,34,-34
37,179,37,63,65,0,65
37,179,37,67,77,70,7
37,179,37,71,134,121,13
37,179,37,81,113,107,6
37,179,37,97,83,84,-1
37,179,37,109,49,94,-45
37,179,37,119,7173,4154,3019
37,179,37,123,42,0,42
37,179,37,129,76,71,5
37,179,37,133,44,0,44
37,179,37,147,28,0,28
37,179,37,151,0,47,-47
37,179,37,153,43,0,43
37,179,37,159,87,68,19
37,179,37,167,148,211,-63
37,179,37,183,180,173,7
37,179,37,189,0,40,-40
37,179,39,35,29,0,29
37,179,42,101,69,0,69
37,179,45,19,60,35,25
37,179,45,25,236,330,-94
37,179,45,45,41,62,-21
37,179,45,51,61,123,-62
37,179,45,57,149,380,-231
37,179,45,63,0,39,-39
37,179,45,79,74,43,31
37,179,45,91,252,494,-242
37,179,47,93,31,0,31
37,179,48,439,34,0,34
37,179,51,41,49,0,49
37,179,51,59,90,0,90
37,179,51,107,66,0,66
37,179,51,153,34,0,34
37,179,51,810,76,0,76
37,181,34,13,29,0,29
37,181,37,63,80,127,-47
37,181,37,69,391,437,-46
37,181,37,77,393,524,-131
37,181,37,81,31,54,-23
37,181,37,101,0,44,-44
37,181,37,119,27,25,2
37,181,37,129,23,0,23
37,181,37,135,31,26,5
37,181,37,183,222,306,-84
37,181,37,185,373,380,-7
37,181,51,117,50,25,25
37,183,1,73,68,55,13
37,183,1,81,28,0,28
37,183,1,89,47,40,7
37,183,1,97,32,0,32
37,183,1,101,34,0,34
37,183,1,117,36,41,-5
37,183,2,20,45,0,45
37,183,4,13,460,311,149
37,183,4,19,116,67,49
37,183,5,7,0,49,-49
37,183,5,119,49,0,49
37,183,5,143,40,0,40
37,183,6,1,223,134,89
37,183,6,13,123,50,73
37,183,6,29,32,0,32
37,183,6,37,749,327,422
37,183,6,59,362,104,258
37,183,6,61,33,0,33
37,183,6,65,150,61,89
37,183,6,67,71,51,20
37,183,6,71,96,71,25
37,183,6,73,426,252,174
37,183,6,75,69,72,-3
37,183,6,77,39,0,39
37,183,6,81,88,37,51
37,183,6,83,41,0,41
37,183,6,85,400,306,94
37,183,6,97,37,0,37
37,183,6,111,128,45,83
37,183,8,1,28,0,28
37,183,8,5,50,36,14
37,183,8,13,55,50,5
37,183,8,31,67,61,6
37,183,8,35,41,0,41
37,183,8,41,108,82,26
37,183,8,59,36,70,-34
37,183,8,69,47,55,-8
37,183,9,1,342,99,243
37,183,9,3,232,48,184
37,183,9,5,66,0,66
37,183,9,9,263,65,198
37,183,9,11,80,0,80
37,183,9,13,31,0,31
37,183,10,1,40,0,40
37,183,10,3,202,69,133
37,183,11,1,216,227,-11
37,183,12,1,111,39,72
37,183,12,5,47,0,47
37,183,12,9,148,146,2
37,183,12,11,896,196,700
37,183,12,17,39,0,39
37,183,12,19,41,40,1
37,183,12,21,92,0,92
37,183,12,31,261,211,50
37,183,12,33,49,26,23
37,183,12,57,328,244,84
37,183,12,69,74,0,74
37,183,12,71,243,61,182
37,183,12,73,113,50,63
37,183,12,81,109,46,63
37,183,12,83,76,31,45
37,183,12,85,47,27,20
37,183,12,86,687,211,476
37,183,12,91,26,0,26
37,183,12,95,456,287,169
37,183,12,97,57,51,6
37,183,12,99,550,144,406
37,183,12,101,148,56,92
37,183,12,103,249,115,134
37,183,12,105,111,76,35
37,183,12,109,40,36,4
37,183,12,111,53,34,19
37,183,12,115,133,65,68
37,183,12,117,184,74,110
37,183,12,127,126,60,66
37,183,13,51,106,82,24
37,183,13,57,77,50,27
37,183,13,59,61,34,27
37,183,13,63,56,42,14
37,183,13,67,230,265,-35
37,183,13,73,56,33,23
37,183,13,77,0,41,-41
37,183,13,89,246,191,55
37,183,13,117,31,47,-16
37,183,13,121,285,344,-59
37,183,13,135,296,205,91
37,183,13,151,39,0,39
37,183,13,179,33,0,33
37,183,13,215,0,42,-42
37,183,13,245,36,44,-8
37,183,15,3,122,80,42
37,183,17,19,42,33,9
37,183,17,31,389,307,82
37,183,17,43,118,98,20
37,183,17,89,54,0,54
37,183,17,97,108,44,64
37,183,17,113,30,0,30
37,183,17,143,82,58,24
37,183,17,197,58,34,24
37,183,18,3,31,0,31
37,183,18,57,92,63,29
37,183,18,81,37,0,37
37,183,18,89,26,0,26
37,183,18,97,76,61,15
37,183,18,141,29,0,29
37,183,18,157,50,28,22
37,183,19,153,28,41,-13
37,183,19,163,55,50,5
37,183,20,91,106,47,59
37,183,20,173,41,0,41
37,183,20,177,32,0,32
37,183,21,67,77,55,22
37,183,21,111,89,52,37
37,183,22,33,47,0,47
37,183,22,51,49,31,18
37,183,22,71,37,65,-28
37,183,23,5,58,37,21
37,183,23,19,29,0,29
37,183,24,3,284,82,202
37,183,24,5,388,96,292
37,183,24,13,51,0,51
37,183,24,17,86,0,86
37,183,24,21,111,46,65
37,183,24,25,82,0,82
37,183,24,27,175,73,102
37,183,24,31,567,235,332
37,183,24,33,522,172,350
37,183,24,37,38,0,38
37,183,24,43,32,0,32
37,183,24,45,71,0,71
37,183,24,510,134,56,78
37,183,25,1,83,0,83
37,183,25,5,121,0,121
37,183,25,9,180,66,114
37,183,25,13,63,0,63
37,183,25,17,776,193,583
37,183,25,21,278,50,228
37,183,25,23,122,0,122
37,183,25,25,204,103,101
37,183,25,27,520,101,419
37,183,26,21,27,0,27
37,183,26,49,70,0,70
37,183,26,65,73,29,44
37,183,26,75,26,0,26
37,183,26,77,59,0,59
37,183,26,81,111,0,111
37,183,26,99,129,0,129
37,183,26,125,367,74,293
37,183,26,161,109,39,70
37,183,26,163,288,80,208
37,183,27,37,47,0,47
37,183,27,53,133,69,64
37,183,27,109,58,0,58
37,183,27,123,58,0,58
37,183,29,95,55,0,55
37,183,29,183,0,57,-57
37,183,29,189,147,59,88
37,183,31,55,48,0,48
37,183,31,109,28,0,28
37,183,32,3,262,137,125
37,183,32,31,32,0,32
37,183,33,11,409,63,346
37,183,33,13,42,0,42
37,183,33,15,109,0,109
37,183,34,1,30,0,30
37,183,34,3,299,60,239
37,183,34,5,122,37,85
37,183,34,7,103,48,55
37,183,34,13,322,86,236
37,183,34,15,53,0,53
37,183,34,17,229,78,151
37,183,34,19,95,0,95
37,183,34,21,143,0,143
37,183,34,23,402,106,296
37,183,34,25,213,39,174
37,183,34,27,237,51,186
37,183,34,29,154,0,154
37,183,34,31,178,0,178
37,183,34,35,161,0,161
37,183,34,37,62,0,62
37,183,34,39,262,63,199
37,183,34,41,40,0,40
37,183,35,1,71,45,26
37,183,36,1,93,45,48
37,183,36,5,374,125,249
37,183,36,7,95,0,95
37,183,36,9,32,0,32
37,183,36,13,42,32,10
37,183,36,19,50,0,50
37,183,36,27,153,35,118
37,183,36,29,310,103,207
37,183,36,45,63,0,63
37,183,36,47,501,220,281
37,183,36,51,36,0,36
37,183,36,55,352,134,218
37,183,36,59,827,65,762
37,183,36,61,328,325,3
37,183,36,63,62,0,62
37,183,36,65,68,0,68
37,183,36,67,161,60,101
37,183,36,69,46,0,46
37,183,36,71,165,49,116
37,183,36,79,35,0,35
37,183,36,81,593,184,409
37,183,36,85,93,23,70
37,183,36,87,99,31,68
37,183,36,91,61,23,38
37,183,36,93,57,0,57
37,183,36,101,48,0,48
37,183,36,103,1200,126,1074
37,183,36,107,25,0,25
37,183,36,109,27,0,27
37,183,36,111,109,0,109
37,183,36,117,38,0,38
37,183,36,119,329,106,223
37,183,37,1,428,483,-55
37,183,37,7,25,0,25
37,183,37,9,0,27,-27
37,183,37,13,94,104,-10
37,183,37,15,61,0,61
37,183,37,17,50,39,11
37,183,37,19,228,325,-97
37,183,37,21,343,397,-54
37,183,37,23,73,61,12
37,183,37,25,175,166,9
37,183,37,27,66,62,4
37,183,37,31,251,267,-16
37,183,37,33,0,33,-33
37,183,37,35,202,127,75
37,183,37,37,660,1413,-753
37,183,37,39,33,0,33
37,183,37,41,47,0,47
37,183,37,45,64,50,14
37,183,37,47,86,42,44
37,183,37,49,416,218,198
37,183,37,51,1178,628,550
37,183,37,53,24,0,24
37,183,37,55,105,66,39
37,183,37,57,153,93,60
37,183,37,59,32,42,-10
37,183,37,61,114,58,56
37,183,37,63,5501,5050,451
37,183,37,65,229,176,53
37,183,37,67,575,524,51
37,183,37,69,1589,2573,-984
37,183,37,71,107,128,-21
37,183,37,77,588,810,-222
37,183,37,79,69,41,28
37,183,37,81,1324,1052,272
37,183,37,83,188,109,79
37,183,37,85,1219,1598,-379
37,183,37,87,43,36,7
37,183,37,89,72,49,23
37,183,37,91,76,44,32
37,183,37,93,76,51,25
37,183,37,97,152,97,55
37,183,37,99,68,47,21
37,183,37,101,3464,5526,-2062
37,183,37,105,400,326,74
37,183,37,107,180,122,58
37,183,37,109,46,32,14
37,183,37,111,29,37,-8
37,183,37,113,25,0,25
37,183,37,117,65,0,65
37,183,37,119,1716,1667,49
37,183,37,123,36,0,36
37,183,37,125,315,181,134
37,183,37,127,849,718,131
37,183,37,129,1119,983,136
37,183,37,131,49,44,5
37,183,37,133,429,263,166
37,183,37,135,1252,1069,183
37,183,37,137,0,29,-29
37,183,37,139,110,73,37
37,183,37,141,145,101,44
37,183,37,145,168,119,49
37,183,37,147,942,656,286
37,183,37,151,149,117,32
37,183,37,153,84,53,31
37,183,37,155,190,82,108
37,183,37,157,92,72,20
37,183,37,159,141,88,53
37,183,37,161,23,0,23
37,183,37,163,195,112,83
37,183,37,165,92,0,92
37,183,37,167,44,38,6
37,183,37,169,33,0,33
37,183,37,171,65,28,37
37,183,37,179,173,180,-7
37,183,37,181,306,222,84
37,183,37,185,140,100,40
37,183,37,187,38,0,38
37,183,37,189,178,163,15
37,183,37,191,537,322,215
37,183,37,193,50,38,12
37,183,37,195,400,380,20
37,183,37,197,40,46,-6
37,183,39,17,59,0,59
37,183,39,25,32,0,32
37,183,39,35,212,98,114
37,183,39,41,64,38,26
37,183,39,49,308,176,132
37,183,39,61,121,61,60
37,183,39,85,38,0,38
37,183,39,93,54,0,54
37,183,39,95,88,0,88
37,183,39,99,52,0,52
37,183,39,103,33,0,33
37,183,39,113,107,0,107
37,183,39,133,39,0,39
37,183,39,151,62,0,62
37,183,39,153,119,38,81
37,183,39,155,42,0,42
37,183,39,165,38,0,38
37,183,39,173,27,0,27
37,183,40,109,38,0,38
37,183,40,143,57,30,27
37,183,41,51,50,68,-18
37,183,41,67,53,47,6
37,183,42,3,345,139,206
37,183,42,7,30,0,30
37,183,42,11,77,0,77
37,183,42,13,33,0,33
37,183,42,17,111,43,68
37,183,42,19,68,0,68
37,183,42,27,52,0,52
37,183,42,29,180,66,114
37,183,42,41,48,0,48
37,183,42,43,64,29,35
37,183,42,45,131,27,104
37,183,42,49,101,34,67
37,183,42,69,49,0,49
37,183,42,71,48,30,18
37,183,42,75,26,0,26
37,183,42,77,103,0,103
37,183,42,79,37,0,37
37,183,42,89,45,0,45
37,183,42,91,206,70,136
37,183,42,95,73,0,73
37,183,42,101,206,133,73
37,183,42,125,35,0,35
37,183,42,129,56,0,56
37,183,42,133,82,47,35
37,183,44,3,48,0,48
37,183,44,7,253,50,203
37,183,44,9,52,0,52
37,183,45,3,34,34,0
37,183,45,7,50,25,25
37,183,45,13,89,109,-20
37,183,45,15,69,80,-11
37,183,45,19,204,202,2
37,183,45,31,26,0,26
37,183,45,35,54,71,-17
37,183,45,41,82,60,22
37,183,45,43,38,0,38
37,183,45,45,189,197,-8
37,183,45,51,243,251,-8
37,183,45,63,81,80,1
37,183,45,77,51,26,25
37,183,45,79,232,141,91
37,183,45,83,75,37,38
37,183,45,85,46,0,46
37,183,45,91,118,90,28
37,183,47,37,91,131,-40
37,183,47,65,45,67,-22
37,183,47,93,123,71,52
37,183,47,125,41,51,-10
37,183,47,157,149,64,85
37,183,47,163,0,33,-33
37,183,47,179,53,0,53
37,183,47,187,43,59,-16
37,183,48,27,53,52,1
37,183,48,29,87,121,-34
37,183,48,41,37,0,37
37,183,48,85,153,145,8
37,183,48,113,191,216,-25
37,183,48,121,166,75,91
37,183,48,141,72,0,72
37,183,48,157,0,82,-82
37,183,48,201,191,292,-101
37,183,48,215,42,0,42
37,183,48,339,46,37,9
37,183,48,439,202,201,1
37,183,48,453,182,192,-10
37,183,48,491,68,41,27
37,183,49,35,122,56,66
37,183,49,49,81,32,49
37,183,50,7,80,30,50
37,183,51,3,62,42,20
37,183,51,13,178,115,63
37,183,51,41,264,134,130
37,183,51,59,886,348,538
37,183,51,67,27,0,27
37,183,51,87,260,145,115
37,183,51,95,32,57,-25
37,183,51,107,286,146,140
37,183,51,117,52,46,6
37,183,51,121,88,28,60
37,183,51,153,357,133,224
37,183,51,161,63,43,20
37,183,51,177,57,27,30
37,183,51,179,38,50,-12
37,183,51,199,30,27,3
37,183,51,510,109,82,27
37,183,51,540,30,0,30
37,183,51,550,141,87,54
37,183,51,590,43,32,11
37,183,51,650,105,50,55
37,183,51,680,71,29,42
37,183,51,683,45,0,45
37,183,51,700,154,59,95
37,183,51,710,181,84,97
37,183,51,740,55,0,55
37,183,51,760,118,101,17
37,183,51,770,55,29,26
37,183,51,800,59,0,59
37,183,51,810,388,160,228
37,183,53,33,162,245,-83
37,183,53,53,70,0,70
37,183,53,61,62,34,28
37,183,54,11,28,0,28
37,183,54,39,56,0,56
37,183,54,61,46,0,46
37,183,55,25,60,49,11
37,183,55,79,69,30,39
37,183,55,133,43,43,0
37,185,37,63,39,34,5
37,185,37,69,59,110,-51
37,185,37,77,42,67,-25
37,185,37,81,0,30,-30
37,185,37,83,66,105,-39
37,185,37,127,32,36,-4
37,185,37,181,380,373,7
37,185,37,183,100,140,-40
37,185,51,117,57,31,26
37,187,37,13,64,41,23
37,187,37,41,33,28,5
37,187,37,55,30,0,30
37,187,37,117,82,107,-25
37,187,37,147,63,97,-34
37,187,37,177,91,39,52
37,187,37,183,0,38,-38
37,189,12,71,33,0,33
37,189,12,99,48,0,48
37,189,13,121,0,25,-25
37,189,37,9,143,221,-78
37,189,37,11,200,141,59
37,189,37,21,94,142,-48
37,189,37,23,61,36,25
37,189,37,27,64,139,-75
37,189,37,35,124,81,43
37,189,37,51,27,30,-3
37,189,37,63,0,49,-49
37,189,37,67,82,109,-27
37,189,37,71,39,43,-4
37,189,37,81,104,90,14
37,189,37,89,26,40,-14
37,189,37,97,41,48,-7
37,189,37,119,163,185,-22
37,189,37,125,23,0,23
37,189,37,129,63,55,8
37,189,37,135,44,38,6
37,189,37,151,32,0,32
37,189,37,171,0,29,-29
37,189,37,179,40,0,40
37,189,37,183,163,178,-15
37,189,37,193,74,96,-22
37,189,45,19,0,30,-30
37,189,45,45,0,24,-24
37,189,47,19,0,29,-29
37,189,47,91,103,104,-1
37,189,47,179,0,27,-27
37,191,2,20,80,47,33
37,191,2,90,38,0,38
37,191,4,13,0,49,-49
37,191,4,19,51,0,51
37,191,8,41,37,40,-3
37,191,11,1,39,0,39
37,191,12,5,0,42,-42
37,191,12,11,0,23,-23
37,191,12,31,34,0,34
37,191,12,33,96,0,96
37,191,12,57,0,40,-40
37,191,12,91,32,59,-27
37,191,13,153,50,0,50
37,191,13,185,31,0,31
37,191,15,3,38,37,1
37,191,16,39,0,112,-112
37,191,24,33,30,29,1
37,191,32,3,38,80,-42
37,191,35,9,50,0,50
37,191,36,47,42,0,42
37,191,37,1,0,28,-28
37,191,37,19,0,39,-39
37,191,37,31,49,40,9
37,191,37,49,50,63,-13
37,191,37,51,77,142,-65
37,191,37,61,354,305,49
37,191,37,63,52,137,-85
37,191,37,67,31,40,-9
37,191,37,79,168,111,57
37,191,37,81,55,123,-68
37,191,37,85,45,53,-8
37,191,37,101,449,600,-151
37,191,37,107,383,338,45
37,191,37,119,35,124,-89
37,191,37,127,97,75,22
37,191,37,129,92,120,-28
37,191,37,133,109,50,59
37,191,37,147,149,295,-146
37,191,37,163,168,125,43
37,191,37,183,322,537,-215
37,191,37,195,249,267,-18
37,191,42,101,41,0,41
37,191,45,51,0,29,-29
37,191,45,85,34,0,34
37,191,48,27,0,37,-37
37,191,48,29,0,76,-76
37,191,48,201,0,49,-49
37,191,48,465,33,0,33
37,191,48,485,40,0,40
37,191,51,59,28,33,-5
37,191,51,650,34,0,34
37,191,51,700,34,0,34
37,191,51,810,32,30,2
37,193,6,37,43,0,43
37,193,37,3,81,103,-22
37,193,37,5,69,54,15
37,193,37,9,102,90,12
37,193,37,23,36,0,36
37,193,37,27,137,93,44
37,193,37,35,74,72,2
37,193,37,57,0,40,-40
37,193,37,67,102,158,-56
37,193,37,81,58,51,7
37,193,37,97,113,239,-126
37,193,37,119,69,122,-53
37,193,37,171,244,191,53
37,193,37,183,38,50,-12
37,193,37,189,96,74,22
37,193,37,197,200,229,-29
37,195,11,1,26,0,26
37,195,24,33,53,0,53
37,195,36,47,29,0,29
37,195,37,31,29,51,-22
37,195,37,49,29,0,29
37,195,37,51,50,56,-6
37,195,37,63,76,55,21
37,195,37,65,220,180,40
37,195,37,67,31,34,-3
37,195,37,69,47,44,3
37,195,37,79,94,97,-3
37,195,37,81,45,32,13
37,195,37,83,30,0,30
37,195,37,101,286,321,-35
37,195,37,119,34,57,-23
37,195,37,127,851,794,57
37,195,37,129,0,52,-52
37,195,37,147,205,250,-45
37,195,37,183,380,400,-20
37,195,37,191,267,249,18
37,195,51,810,37,0,37
37,197,37,57,69,80,-11
37,197,37,59,132,146,-14
37,197,37,67,598,582,16
37,197,37,81,57,60,-3
37,197,37,97,78,96,-18
37,197,37,119,0,31,-31
37,197,37,169,76,100,-24
37,197,37,171,375,289,86
37,197,37,183,46,40,6
37,197,37,193,229,200,29
37,199,37,21,165,168,-3
37,199,37,111,40,47,-7
37,199,37,115,50,0,50
37,199,37,121,146,189,-43
38,3,38,15,25,52,-27
38,3,38,17,124,215,-91
38,3,38,45,28,0,28
38,3,38,73,25,33,-8
38,3,38,93,42,95,-53
38,5,38,17,0,44,-44
38,5,38,35,0,43,-43
38,5,38,71,91,139,-48
38,9,38,15,0,25,-25
38,9,38,17,0,29,-29
38,9,38,75,29,0,29
38,9,38,101,78,80,-2
38,11,38,15,0,22,-22
38,11,38,89,32,0,32
38,13,38,101,0,75,-75
38,15,4,13,70,58,12
38,15,6,37,23,0,23
38,15,8,31,0,23,-23
38,15,27,27,32,44,-12
38,15,27,37,31,38,-7
38,15,27,53,129,130,-1
38,15,27,123,26,43,-17
38,15,27,145,0,21,-21
38,15,30,31,0,20,-20
38,15,30,111,28,42,-14
38,15,32,3,0,29,-29
38,15,38,3,52,25,27
38,15,38,9,25,0,25
38,15,38,11,22,0,22
38,15,38,17,469,492,-23
38,15,38,29,84,26,58
38,15,38,35,208,139,69
38,15,38,37,29,0,29
38,15,38,43,76,64,12
38,15,38,47,30,0,30
38,15,38,49,29,0,29
38,15,38,51,41,25,16
38,15,38,53,28,0,28
38,15,38,55,182,168,14
38,15,38,57,178,118,60
38,15,38,59,1308,1334,-26
38,15,38,61,76,68,8
38,15,38,65,69,22,47
38,15,38,69,27,0,27
38,15,38,71,40,0,40
38,15,38,77,32,0,32
38,15,38,79,63,45,18
38,15,38,83,28,0,28
38,15,38,85,104,67,37
38,15,38,89,212,109,103
38,15,38,93,88,131,-43
38,15,38,101,298,157,141
38,15,38,103,60,0,60
38,15,38,105,98,82,16
38,15,46,13,31,0,31
38,15,46,31,57,0,57
38,15,46,99,45,0,45
38,15,46,103,32,51,-19
38,15,48,29,0,34,-34
38,15,53,33,0,22,-22
38,15,56,5,0,25,-25
38,17,4,13,79,208,-129
38,17,6,37,40,22,18
38,17,6,59,0,27,-27
38,17,6,73,36,54,-18
38,17,8,5,0,32,-32
38,17,8,31,0,32,-32
38,17,8,69,0,28,-28
38,17,12,103,0,31,-31
38,17,16,1,0,34,-34
38,17,17,31,33,0,33
38,17,19,113,0,20,-20
38,17,19,153,37,25,12
38,17,27,3,76,76,0
38,17,27,5,292,188,104
38,17,27,7,106,56,50
38,17,27,9,27,0,27
38,17,27,21,40,43,-3
38,17,27,27,1781,2074,-293
38,17,27,35,33,33,0
38,17,27,37,106,151,-45
38,17,27,41,110,47,63
38,17,27,53,348,512,-164
38,17,27,57,50,45,5
38,17,27,61,22,26,-4
38,17,27,67,26,0,26
38,17,27,87,30,0,30
38,17,27,89,50,0,50
38,17,27,97,26,0,26
38,17,27,107,131,91,40
38,17,27,109,61,43,18
38,17,27,111,320,231,89
38,17,27,113,63,31,32
38,17,27,119,137,55,82
38,17,27,123,64,181,-117
38,17,27,135,56,37,19
38,17,27,137,71,83,-12
38,17,27,141,24,0,24
38,17,27,145,89,80,9
38,17,27,153,21,0,21
38,17,27,159,42,0,42
38,17,27,163,40,38,2
38,17,27,167,63,62,1
38,17,27,171,56,42,14
38,17,30,31,0,26,-26
38,17,30,111,30,34,-4
38,17,31,55,32,56,-24
38,17,32,3,43,65,-22
38,17,38,3,215,124,91
38,17,38,5,44,0,44
38,17,38,9,29,0,29
38,17,38,15,492,469,23
38,17,38,19,45,0,45
38,17,38,21,57,0,57
38,17,38,27,22,0,22
38,17,38,31,45,28,17
38,17,38,35,711,429,282
38,17,38,39,71,27,44
38,17,38,45,66,0,66
38,17,38,49,0,28,-28
38,17,38,53,0,29,-29
38,17,38,55,21,34,-13
38,17,38,57,42,39,3
38,17,38,59,133,135,-2
38,17,38,61,24,0,24
38,17,38,63,29,24,5
38,17,38,67,86,43,43
38,17,38,69,28,0,28
38,17,38,71,110,80,30
38,17,38,73,129,60,69
38,17,38,77,443,236,207
38,17,38,79,88,47,41
38,17,38,81,82,0,82
38,17,38,89,166,75,91
38,17,38,91,36,30,6
38,17,38,93,279,136,143
38,17,38,95,25,0,25
38,17,38,97,181,132,49
38,17,38,99,119,45,74
38,17,38,101,256,148,108
38,17,38,103,44,29,15
38,17,38,105,75,79,-4
38,17,46,11,35,28,7
38,17,46,13,69,33,36
38,17,46,29,25,0,25
38,17,46,99,103,103,0
38,17,46,109,46,0,46
38,17,48,201,0,23,-23
38,17,48,439,0,33,-33
38,17,53,33,29,71,-42
38,17,55,25,0,32,-32
38,19,38,17,0,45,-45
38,19,38,35,0,33,-33
38,19,38,71,0,25,-25
38,21,38,17,0,57,-57
38,21,38,45,23,0,23
38,21,38,81,0,34,-34
38,21,38,93,0,34,-34
38,21,46,13,47,22,25
38,25,38,89,53,85,-32
38,27,38,17,0,22,-22
38,27,38,31,0,34,-34
38,29,38,15,26,84,-58
38,31,38,17,28,45,-17
38,31,38,27,34,0,34
38,31,38,93,26,27,-1
38,33,38,89,0,26,-26
38,35,2,20,0,36,-36
38,35,4,13,44,105,-61
38,35,4,19,55,0,55
38,35,6,37,35,28,7
38,35,6,73,39,31,8
38,35,8,31,0,30,-30
38,35,8,41,42,40,2
38,35,8,69,0,25,-25
38,35,15,3,53,0,53
38,35,16,1,0,26,-26
38,35,17,31,0,34,-34
38,35,20,173,0,39,-39
38,35,27,3,29,36,-7
38,35,27,7,42,36,6
38,35,27,27,62,48,14
38,35,27,37,53,89,-36
38,35,27,41,30,0,30
38,35,27,53,137,225,-88
38,35,27,69,27,0,27
38,35,27,89,92,35,57
38,35,27,109,36,37,-1
38,35,27,111,0,28,-28
38,35,27,113,94,37,57
38,35,27,119,563,558,5
38,35,27,123,0,55,-55
38,35,27,125,27,0,27
38,35,27,135,41,27,14
38,35,27,137,32,66,-34
38,35,27,145,29,30,-1
38,35,27,163,33,26,7
38,35,32,3,34,44,-10
38,35,38,5,43,0,43
38,35,38,15,139,208,-69
38,35,38,17,429,711,-282
38,35,38,19,33,0,33
38,35,38,59,0,63,-63
38,35,38,63,47,27,20
38,35,38,67,129,75,54
38,35,38,71,111,53,58
38,35,38,77,32,0,32
38,35,38,79,124,72,52
38,35,38,89,22,0,22
38,35,38,93,56,21,35
38,35,38,97,145,158,-13
38,35,38,99,224,140,84
38,35,38,101,109,112,-3
38,35,38,105,52,42,10
38,35,46,99,0,56,-56
38,35,48,29,38,47,-9
38,35,48,439,0,47,-47
38,35,53,33,0,35,-35
38,37,38,15,0,29,-29
38,37,38,59,0,39,-39
38,39,38,17,27,71,-44
38,41,38,89,49,56,-7
38,43,38,15,64,76,-12
38,45,38,3,0,28,-28
38,45,38,17,0,66,-66
38,45,38,21,0,23,-23
38,45,38,93,0,33,-33
38,49,38,15,0,29,-29
38,49,38,17,28,0,28
38,49,38,101,161,150,11
38,51,38,15,25,41,-16
38,53,38,15,0,28,-28
38,53,38,17,29,0,29
38,53,38,105,47,33,14
38,55,38,15,168,182,-14
38,55,38,17,34,21,13
38,55,38,59,41,42,-1
38,55,38,61,32,43,-11
38,55,38,101,96,74,22
38,57,38,15,118,178,-60
38,57,38,17,39,42,-3
38,57,38,59,29,46,-17
38,57,38,89,28,0,28
38,59,27,53,24,22,2
38,59,38,15,1334,1308,26
38,59,38,17,135,133,2
38,59,38,35,63,0,63
38,59,38,37,39,0,39
38,59,38,55,42,41,1
38,59,38,57,46,29,17
38,59,38,89,80,74,6
38,59,38,101,78,63,15
38,61,38,15,68,76,-8
38,61,38,17,0,24,-24
38,61,38,55,43,32,11
38,61,38,101,76,98,-22
38,63,38,17,24,29,-5
38,63,38,35,27,47,-20
38,63,38,71,0,29,-29
38,65,38,15,22,0,22
38,67,8,41,0,30,-30
38,67,38,17,43,86,-43
38,67,38,35,75,129,-54
38,67,38,99,29,34,-5
38,69,38,15,0,27,-27
38,69,38,17,0,28,-28
38,69,38,79,37,0,37
38,69,38,101,39,45,-6
38,71,38,5,139,91,48
38,71,38,15,0,40,-40
38,71,38,17,80,110,-30
38,71,38,19,25,0,25
38,71,38,35,53,111,-58
38,71,38,63,29,0,29
38,71,38,95,32,27,5
38,71,38,101,35,29,6
38,73,38,3,33,25,8
38,73,38,17,60,129,-69
38,73,38,81,57,35,22
38,75,38,9,0,29,-29
38,75,38,101,90,125,-35
38,77,27,27,36,55,-19
38,77,27,111,0,43,-43
38,77,27,167,171,170,1
38,77,38,15,0,32,-32
38,77,38,17,236,443,-207
38,77,38,35,0,32,-32
38,77,38,81,0,25,-25
38,77,38,101,34,0,34
38,77,46,109,28,0,28
38,79,38,15,45,63,-18
38,79,38,17,47,88,-41
38,79,38,35,72,124,-52
38,79,38,69,0,37,-37
38,79,38,101,82,92,-10
38,81,38,17,0,82,-82
38,81,38,21,34,0,34
38,81,38,73,35,57,-22
38,81,38,77,25,0,25
38,83,38,15,0,28,-28
38,85,38,15,67,104,-37
38,89,38,7,32,30,2
38,89,38,11,0,32,-32
38,89,38,15,109,212,-103
38,89,38,17,75,166,-91
38,89,38,25,85,53,32
38,89,38,33,26,0,26
38,89,38,35,0,22,-22
38,89,38,41,56,49,7
38,89,38,57,0,28,-28
38,89,38,59,74,80,-6
38,89,38,101,40,50,-10
38,89,38,105,47,48,-1
38,91,38,17,30,36,-6
38,93,27,53,0,35,-35
38,93,38,3,95,42,53
38,93,38,15,131,88,43
38,93,38,17,136,279,-143
38,93,38,21,34,0,34
38,93,38,31,27,26,1
38,93,38,35,21,56,-35
38,93,38,45,33,0,33
38,93,38,101,31,0,31
38,95,38,17,0,25,-25
38,95,38,71,27,32,-5
38,97,38,17,132,181,-49
38,97,38,35,158,145,13
38,99,38,17,45,119,-74
38,99,38,35,140,224,-84
38,99,38,67,34,29,5
38,101,2,20,45,66,-21
38,101,2,90,43,0,43
38,101,4,13,38,92,-54
38,101,4,19,0,53,-53
38,101,6,37,46,38,8
38,101,6,73,0,31,-31
38,101,6,83,118,77,41
38,101,8,41,38,89,-51
38,101,15,3,45,0,45
38,101,22,15,58,48,10
38,101,27,53,31,54,-23
38,101,31,153,0,44,-44
38,101,32,3,52,62,-10
38,101,38,9,80,78,2
38,101,38,13,75,0,75
38,101,38,15,157,298,-141
38,101,38,17,148,256,-108
38,101,38,35,112,109,3
38,101,38,49,150,161,-11
38,101,38,55,74,96,-22
38,101,38,59,63,78,-15
38,101,38,61,98,76,22
38,101,38,69,45,39,6
38,101,38,71,29,35,-6
38,101,38,75,125,90,35
38,101,38,77,0,34,-34
38,101,38,79,92,82,10
38,101,38,89,50,40,10
38,101,38,93,0,31,-31
38,101,38,103,21,0,21
38,101,38,105,117,100,17
38,101,48,29,52,73,-21
38,101,48,201,0,28,-28
38,101,48,485,53,0,53
38,101,51,59,0,36,-36
38,101,53,33,23,0,23
38,101,53,63,0,33,-33
38,101,56,21,0,40,-40
38,103,38,15,0,60,-60
38,103,38,17,29,44,-15
38,103,38,101,0,21,-21
38,105,30,83,25,35,-10
38,105,30,85,0,43,-43
38,105,30,111,0,32,-32
38,105,38,15,82,98,-16
38,105,38,17,79,75,4
38,105,38,35,42,52,-10
38,105,38,53,33,47,-14
38,105,38,89,48,47,1
38,105,38,101,100,117,-17
39,1,21,161,0,63,-63
39,1,39,15,231,227,4
39,1,39,17,51,36,15
39,1,39,25,183,168,15
39,1,39,27,62,0,62
39,1,39,49,0,39,-39
39,1,39,57,27,25,2
39,1,39,61,64,59,5
39,1,39,71,172,180,-8
39,1,39,113,39,0,39
39,1,39,131,50,42,8
39,1,39,145,114,140,-26
39,1,39,165,38,34,4
39,3,17,31,0,40,-40
39,3,18,3,43,107,-64
39,3,26,125,26,0,26
39,3,26,163,56,48,8
39,3,39,11,688,754,-66
39,3,39,17,0,46,-46
39,3,39,35,26,43,-17
39,3,39,39,34,0,34
39,3,39,41,0,44,-44
39,3,39,49,232,479,-247
39,3,39,57,0,39,-39
39,3,39,61,63,73,-10
39,3,39,63,252,264,-12
39,3,39,65,307,298,9
39,3,39,91,123,129,-6
39,3,39,95,87,126,-39
39,3,39,107,64,82,-18
39,3,39,109,57,31,26
39,3,39,113,76,85,-9
39,3,39,137,424,372,52
39,3,39,147,36,26,10
39,3,39,149,102,43,59
39,3,39,151,0,25,-25
39,3,39,161,288,240,48
39,3,39,165,0,45,-45
39,3,39,173,62,76,-14
39,5,39,33,31,36,-5
39,5,39,35,109,124,-15
39,5,39,41,31,36,-5
39,5,39,49,82,217,-135
39,5,39,75,91,94,-3
39,5,39,77,181,121,60
39,5,39,83,54,82,-28
39,5,39,93,229,182,47
39,5,39,103,212,186,26
39,5,39,133,0,29,-29
39,5,39,139,709,594,115
39,5,39,151,44,46,-2
39,5,39,153,54,60,-6
39,5,39,169,325,372,-47
39,7,4,13,25,50,-25
39,7,12,105,0,32,-32
39,7,32,3,0,25,-25
39,7,37,133,0,25,-25
39,7,39,35,371,443,-72
39,7,39,49,50,142,-92
39,7,39,55,361,286,75
39,7,39,85,982,1112,-130
39,7,39,93,24,34,-10
39,7,39,99,78,91,-13
39,7,39,103,32,24,8
39,7,39,133,81,84,-3
39,7,39,151,0,30,-30
39,7,39,153,86,108,-22
39,7,39,155,321,351,-30
39,7,42,3,35,42,-7
39,7,42,39,93,58,35
39,7,42,49,216,163,53
39,7,42,85,0,39,-39
39,7,49,35,0,37,-37
39,9,6,37,0,34,-34
39,9,6,73,0,27,-27
39,9,17,31,27,38,-11
39,9,36,61,20,0,20
39,9,39,17,25,25,0
39,9,39,35,97,103,-6
39,9,39,41,38,52,-14
39,9,39,45,150,155,-5
39,9,39,49,282,445,-163
39,9,39,53,32,0,32
39,9,39,57,33,32,1
39,9,39,61,56,61,-5
39,9,39,73,231,277,-46
39,9,39,79,23,70,-47
39,9,39,85,0,28,-28
39,9,39,89,59,41,18
39,9,39,93,0,25,-25
39,9,39,105,295,224,71
39,9,39,109,27,0,27
39,9,39,113,46,46,0
39,9,39,115,34,57,-23
39,9,39,119,28,0,28
39,9,39,127,57,84,-27
39,9,39,141,31,43,-12
39,9,39,151,32,30,2
39,9,39,153,47,26,21
39,9,39,163,71,54,17
39,9,39,167,151,195,-44
39,9,54,107,68,85,-17
39,11,39,3,754,688,66
39,11,39,17,0,29,-29
39,11,39,37,27,36,-9
39,11,39,49,67,154,-87
39,11,39,57,0,39,-39
39,11,39,61,0,37,-37
39,11,39,65,34,47,-13
39,11,39,91,131,67,64
39,11,39,95,34,27,7
39,11,39,107,403,301,102
39,11,39,109,60,65,-5
39,11,39,113,50,78,-28
39,11,39,137,33,0,33
39,11,39,149,288,385,-97
39,11,39,161,69,31,38
39,13,39,35,0,27,-27
39,13,39,49,168,269,-101
39,13,39,59,97,108,-11
39,13,39,67,78,84,-6
39,13,39,81,242,397,-155
39,13,39,111,157,137,20
39,13,39,119,34,28,6
39,13,39,121,31,0,31
39,13,39,153,0,28,-28
39,13,39,157,25,0,25
39,13,42,3,37,53,-16
39,13,42,125,23,57,-34
39,13,54,9,31,30,1
39,13,54,29,33,0,33
39,13,54,51,276,140,136
39,13,54,69,517,505,12
39,15,21,37,0,27,-27
39,15,21,117,36,29,7
39,15,21,161,114,115,-1
39,15,39,1,227,231,-4
39,15,39,17,51,77,-26
39,15,39,25,1514,1443,71
39,15,39,27,114,108,6
39,15,39,61,333,324,9
39,15,39,71,221,213,8
39,15,39,165,91,78,13
39,17,1,73,0,35,-35
39,17,4,13,93,139,-46
39,17,6,37,82,95,-13
39,17,6,59,37,31,6
39,17,6,71,43,0,43
39,17,6,73,73,74,-1
39,17,8,41,34,0,34
39,17,11,1,0,23,-23
39,17,12,9,0,42,-42
39,17,12,11,46,37,9
39,17,12,21,0,28,-28
39,17,12,31,33,35,-2
39,17,12,57,53,84,-31
39,17,12,71,67,60,7
39,17,12,81,28,0,28
39,17,12,86,36,52,-16
39,17,12,95,53,68,-15
39,17,12,99,46,0,46
39,17,12,101,37,39,-2
39,17,12,103,39,87,-48
39,17,12,115,36,29,7
39,17,12,117,31,25,6
39,17,13,67,37,63,-26
39,17,13,121,24,67,-43
39,17,13,135,55,52,3
39,17,15,3,37,28,9
39,17,17,31,128,225,-97
39,17,17,43,33,41,-8
39,17,18,3,32,0,32
39,17,18,29,131,161,-30
39,17,18,41,29,0,29
39,17,18,47,107,125,-18
39,17,18,57,44,105,-61
39,17,18,89,28,0,28
39,17,18,95,35,0,35
39,17,18,97,103,110,-7
39,17,18,105,26,0,26
39,17,18,137,39,0,39
39,17,18,157,30,0,30
39,17,18,161,115,83,32
39,17,18,177,38,58,-20
39,17,20,91,0,38,-38
39,17,21,15,168,252,-84
39,17,21,37,137,132,5
39,17,21,67,81,110,-29
39,17,21,81,0,38,-38
39,17,21,111,89,96,-7
39,17,21,117,254,289,-35
39,17,21,125,0,31,-31
39,17,21,151,32,46,-14
39,17,21,203,0,30,-30
39,17,24,31,0,33,-33
39,17,24,33,0,28,-28
39,17,26,99,64,0,64
39,17,26,125,97,23,74
39,17,26,161,49,0,49
39,17,26,163,93,55,38
39,17,27,53,47,51,-4
39,17,29,189,39,36,3
39,17,32,3,37,78,-41
39,17,34,23,36,0,36
39,17,36,5,43,33,10
39,17,36,47,26,43,-17
39,17,36,61,0,69,-69
39,17,36,81,46,0,46
39,17,37,81,0,31,-31
39,17,37,119,37,70,-33
39,17,37,133,37,44,-7
39,17,37,183,0,59,-59
39,17,39,1,36,51,-15
39,17,39,3,46,0,46
39,17,39,9,25,25,0
39,17,39,11,29,0,29
39,17,39,15,77,51,26
39,17,39,23,91,77,14
39,17,39,25,909,821,88
39,17,39,27,112,150,-38
39,17,39,35,90,134,-44
39,17,39,41,67,54,13
39,17,39,45,41,0,41
39,17,39,49,397,509,-112
39,17,39,57,178,166,12
39,17,39,61,9217,7403,1814
39,17,39,71,50,64,-14
39,17,39,85,24,0,24
39,17,39,89,0,43,-43
39,17,39,93,27,0,27
39,17,39,95,111,53,58
39,17,39,99,24,0,24
39,17,39,103,32,0,32
39,17,39,109,114,67,47
39,17,39,113,1307,1133,174
39,17,39,135,437,548,-111
39,17,39,145,31,27,4
39,17,39,151,42,0,42
39,17,39,153,85,51,34
39,17,39,165,3097,3699,-602
39,17,39,173,47,0,47
39,17,40,109,0,35,-35
39,17,42,3,46,64,-18
39,17,45,45,0,47,-47
39,17,45,51,0,35,-35
39,17,47,37,35,49,-14
39,17,47,93,43,55,-12
39,17,47,149,0,67,-67
39,17,47,157,0,29,-29
39,17,48,29,0,55,-55
39,17,48,85,0,34,-34
39,17,48,113,31,41,-10
39,17,48,201,61,100,-39
39,17,48,439,0,30,-30
39,17,48,453,0,47,-47
39,17,51,13,0,24,-24
39,17,51,59,39,0,39
39,17,53,33,0,47,-47
39,17,53,53,0,32,-32
39,17,55,133,0,36,-36
39,19,39,29,180,164,16
39,19,39,35,0,25,-25
39,19,39,49,30,28,2
39,19,39,67,91,0,91
39,19,39,81,101,49,52
39,19,39,99,48,0,48
39,19,39,151,750,933,-183
39,19,39,153,87,67,20
39,19,39,157,176,213,-37
39,21,39,23,805,691,114
39,21,39,41,31,0,31
39,21,39,49,300,204,96
39,21,39,57,70,84,-14
39,21,39,65,28,28,0
39,21,39,91,336,312,24
39,21,39,97,97,70,27
39,21,39,109,198,178,20
39,21,39,113,110,128,-18
39,21,39,149,48,71,-23
39,21,39,159,237,222,15
39,23,4,13,31,36,-5
39,23,12,57,31,0,31
39,23,12,81,0,29,-29
39,23,12,103,25,0,25
39,23,12,105,0,36,-36
39,23,17,31,28,31,-3
39,23,26,163,0,28,-28
39,23,39,17,77,91,-14
39,23,39,21,691,805,-114
39,23,39,27,0,46,-46
39,23,39,35,34,31,3
39,23,39,37,27,0,27
39,23,39,45,40,30,10
39,23,39,47,40,32,8
39,23,39,49,421,646,-225
39,23,39,57,844,964,-120
39,23,39,61,73,112,-39
39,23,39,71,0,37,-37
39,23,39,91,118,109,9
39,23,39,95,0,44,-44
39,23,39,97,246,237,9
39,23,39,109,235,289,-54
39,23,39,113,1189,1234,-45
39,23,39,141,28,31,-3
39,23,39,149,33,0,33
39,23,39,159,39,43,-4
39,23,39,165,71,69,2
39,25,4,13,64,91,-27
39,25,6,37,48,45,3
39,25,6,73,35,0,35
39,25,12,31,0,38,-38
39,25,12,57,0,51,-51
39,25,12,71,34,49,-15
39,25,12,99,31,30,1
39,25,12,103,0,41,-41
39,25,12,115,34,31,3
39,25,17,31,39,58,-19
39,25,18,29,41,51,-10
39,25,18,57,0,44,-44
39,25,18,97,41,32,9
39,25,21,15,150,217,-67
39,25,21,23,0,28,-28
39,25,21,37,235,299,-64
39,25,21,67,42,37,5
39,25,21,81,27,0,27
39,25,21,111,44,32,12
39,25,21,117,326,430,-104
39,25,21,161,30,41,-11
39,25,26,163,27,0,27
39,25,32,3,35,43,-8
39,25,37,119,0,39,-39
39,25,37,133,30,0,30
39,25,37,183,0,32,-32
39,25,39,1,168,183,-15
39,25,39,15,1443,1514,-71
39,25,39,17,821,909,-88
39,25,39,27,288,293,-5
39,25,39,35,77,28,49
39,25,39,41,33,38,-5
39,25,39,49,152,232,-80
39,25,39,57,61,43,18
39,25,39,61,5612,4318,1294
39,25,39,71,214,226,-12
39,25,39,95,31,0,31
39,25,39,113,139,124,15
39,25,39,153,31,0,31
39,25,39,165,822,1093,-271
39,25,42,3,30,0,30
39,25,47,37,0,26,-26
39,25,48,201,0,31,-31
39,27,39,1,0,62,-62
39,27,39,15,108,114,-6
39,27,39,17,150,112,38
39,27,39,23,46,0,46
39,27,39,25,293,288,5
39,27,39,47,233,164,69
39,27,39,49,136,92,44
39,27,39,57,264,173,91
39,27,39,61,126,140,-14
39,27,39,71,650,556,94
39,27,39,113,152,182,-30
39,27,39,141,37,42,-5
39,27,39,165,495,493,2
39,29,4,13,34,42,-8
39,29,12,71,0,34,-34
39,29,12,103,0,30,-30
39,29,39,19,164,180,-16
39,29,39,35,57,67,-10
39,29,39,49,72,144,-72
39,29,39,61,0,28,-28
39,29,39,81,137,144,-7
39,29,39,85,0,44,-44
39,29,39,99,975,1154,-179
39,29,39,133,65,113,-48
39,29,39,151,502,584,-82
39,29,39,153,99,90,9
39,29,39,155,102,108,-6
39,29,39,157,30,0,30
39,29,42,3,78,116,-38
39,29,42,7,284,174,110
39,29,42,73,35,49,-14
39,29,42,85,36,0,36
39,29,54,29,261,230,31
39,31,39,35,57,51,6
39,31,39,49,86,152,-66
39,31,39,59,32,64,-32
39,31,39,75,171,160,11
39,31,39,83,89,120,-31
39,31,39,89,112,163,-51
39,31,39,119,173,202,-29
39,31,39,151,0,34,-34
39,31,39,153,0,32,-32
39,31,39,157,324,287,37
39,31,39,169,36,48,-12
39,33,39,5,36,31,5
39,33,39,41,36,92,-56
39,33,39,49,111,213,-102
39,33,39,63,31,28,3
39,33,39,77,82,77,5
39,33,39,83,37,0,37
39,33,39,95,0,25,-25
39,33,39,101,273,275,-2
39,33,39,117,187,177,10
39,33,39,139,703,691,12
39,33,39,147,47,116,-69
39,33,39,175,209,190,19
39,35,1,73,86,104,-18
39,35,1,89,44,62,-18
39,35,1,97,0,46,-46
39,35,1,101,29,40,-11
39,35,2,20,39,37,2
39,35,4,13,350,809,-459
39,35,4,19,62,156,-94
39,35,4,21,0,42,-42
39,35,5,119,0,41,-41
39,35,6,1,74,83,-9
39,35,6,13,40,39,1
39,35,6,37,379,501,-122
39,35,6,41,0,27,-27
39,35,6,59,99,152,-53
39,35,6,65,50,80,-30
39,35,6,67,0,101,-101
39,35,6,71,83,103,-20
39,35,6,73,241,355,-114
39,35,6,75,76,124,-48
39,35,6,81,33,50,-17
39,35,6,83,0,23,-23
39,35,6,85,77,150,-73
39,35,6,95,42,0,42
39,35,6,111,35,42,-7
39,35,8,1,0,31,-31
39,35,8,5,43,60,-17
39,35,8,13,43,51,-8
39,35,8,31,66,131,-65
39,35,8,35,0,60,-60
39,35,8,41,48,89,-41
39,35,8,59,0,50,-50
39,35,8,69,0,37,-37
39,35,8,117,0,29,-29
39,35,9,1,90,73,17
39,35,9,3,49,98,-49
39,35,9,9,91,41,50
39,35,9,11,41,0,41
39,35,10,3,0,47,-47
39,35,11,1,87,204,-117
39,35,12,1,33,45,-12
39,35,12,5,0,28,-28
39,35,12,9,41,95,-54
39,35,12,11,221,254,-33
39,35,12,15,27,52,-25
39,35,12,17,0,34,-34
39,35,12,21,84,118,-34
39,35,12,31,105,145,-40
39,35,12,35,0,26,-26
39,35,12,53,0,32,-32
39,35,12,57,128,307,-179
39,35,12,61,26,0,26
39,35,12,69,0,70,-70
39,35,12,71,160,255,-95
39,35,12,73,35,59,-24
39,35,12,81,50,58,-8
39,35,12,83,30,46,-16
39,35,12,85,0,28,-28
39,35,12,86,176,167,9
39,35,12,91,0,32,-32
39,35,12,95,191,319,-128
39,35,12,97,53,116,-63
39,35,12,99,150,316,-166
39,35,12,101,46,101,-55
39,35,12,103,142,222,-80
39,35,12,105,66,110,-44
39,35,12,109,0,27,-27
39,35,12,111,0,48,-48
39,35,12,115,70,130,-60
39,35,12,117,49,86,-37
39,35,12,127,42,67,-25
39,35,13,21,0,57,-57
39,35,13,51,0,66,-66
39,35,13,63,56,88,-32
39,35,13,67,141,149,-8
39,35,13,89,139,220,-81
39,35,13,97,0,28,-28
39,35,13,117,0,32,-32
39,35,13,121,132,347,-215
39,35,13,135,93,172,-79
39,35,13,151,39,72,-33
39,35,13,215,0,37,-37
39,35,13,245,0,39,-39
39,35,15,3,76,75,1
39,35,17,19,43,0,43
39,35,17,31,686,1245,-559
39,35,17,43,111,143,-32
39,35,17,89,44,53,-9
39,35,17,97,72,75,-3
39,35,17,113,29,0,29
39,35,17,197,37,72,-35
39,35,17,201,0,30,-30
39,35,18,3,36,74,-38
39,35,18,57,72,60,12
39,35,18,89,37,34,3
39,35,18,97,161,152,9
39,35,18,105,38,28,10
39,35,18,141,29,42,-13
39,35,18,157,37,0,37
39,35,19,103,29,0,29
39,35,19,153,39,57,-18
39,35,19,163,0,29,-29
39,35,20,91,45,37,8
39,35,21,15,28,28,0
39,35,21,67,36,43,-7
39,35,21,111,123,161,-38
39,35,21,117,0,28,-28
39,35,22,33,0,28,-28
39,35,22,51,0,42,-42
39,35,22,71,0,36,-36
39,35,23,5,0,26,-26
39,35,24,3,37,74,-37
39,35,24,5,84,94,-10
39,35,24,17,0,24,-24
39,35,24,21,0,28,-28
39,35,24,27,0,63,-63
39,35,24,31,108,230,-122
39,35,24,33,67,84,-17
39,35,24,510,68,98,-30
39,35,25,5,0,38,-38
39,35,25,9,54,31,23
39,35,25,17,188,188,0
39,35,25,21,52,86,-34
39,35,25,25,63,129,-66
39,35,25,27,0,39,-39
39,35,26,49,39,52,-13
39,35,26,65,56,0,56
39,35,26,77,49,31,18
39,35,26,81,69,56,13
39,35,26,93,37,0,37
39,35,26,99,103,110,-7
39,35,26,115,26,0,26
39,35,26,125,359,293,66
39,35,26,145,30,0,30
39,35,26,161,166,163,3
39,35,26,163,344,288,56
39,35,27,37,0,45,-45
39,35,27,53,111,131,-20
39,35,27,123,0,63,-63
39,35,28,47,0,31,-31
39,35,29,19,0,31,-31
39,35,29,95,48,54,-6
39,35,29,183,0,31,-31
39,35,29,189,82,136,-54
39,35,29,510,32,60,-28
39,35,31,55,45,31,14
39,35,32,3,231,558,-327
39,35,32,31,0,37,-37
39,35,34,3,38,47,-9
39,35,34,5,27,34,-7
39,35,34,13,56,51,5
39,35,34,17,63,86,-23
39,35,34,21,22,30,-8
39,35,34,23,92,108,-16
39,35,34,25,0,28,-28
39,35,34,27,40,57,-17
39,35,34,29,0,37,-37
39,35,34,31,37,0,37
39,35,34,35,0,29,-29
39,35,34,39,26,37,-11
39,35,35,1,28,34,-6
39,35,36,1,29,0,29
39,35,36,5,148,85,63
39,35,36,13,34,42,-8
39,35,36,29,163,256,-93
39,35,36,45,0,30,-30
39,35,36,47,173,289,-116
39,35,36,55,109,93,16
39,35,36,59,37,40,-3
39,35,36,61,287,428,-141
39,35,36,63,40,49,-9
39,35,36,67,39,62,-23
39,35,36,81,138,135,3
39,35,36,103,65,40,25
39,35,36,109,0,29,-29
39,35,36,119,55,0,55
39,35,37,21,0,27,-27
39,35,37,25,0,41,-41
39,35,37,49,31,0,31
39,35,37,51,49,85,-36
39,35,37,63,50,93,-43
39,35,37,67,41,42,-1
39,35,37,81,47,72,-25
39,35,37,119,112,488,-376
39,35,37,129,31,37,-6
39,35,37,133,116,84,32
39,35,37,135,0,77,-77
39,35,37,179,0,29,-29
39,35,37,183,98,212,-114
39,35,39,3,43,26,17
39,35,39,5,124,109,15
39,35,39,7,443,371,72
39,35,39,9,103,97,6
39,35,39,13,27,0,27
39,35,39,17,134,90,44
39,35,39,19,25,0,25
39,35,39,23,31,34,-3
39,35,39,25,28,77,-49
39,35,39,29,67,57,10
39,35,39,31,51,57,-6
39,35,39,39,20,0,20
39,35,39,41,123,202,-79
39,35,39,43,273,249,24
39,35,39,45,37,56,-19
39,35,39,49,1533,2049,-516
39,35,39,55,935,1598,-663
39,35,39,57,100,101,-1
39,35,39,59,31,32,-1
39,35,39,61,400,455,-55
39,35,39,63,58,43,15
39,35,39,77,105,131,-26
39,35,39,81,34,44,-10
39,35,39,83,25,36,-11
39,35,39,85,3605,5590,-1985
39,35,39,89,60,90,-30
39,35,39,93,4211,6481,-2270
39,35,39,95,565,319,246
39,35,39,99,430,250,180
39,35,39,103,2554,4671,-2117
39,35,39,113,320,249,71
39,35,39,121,0,34,-34
39,35,39,123,65,123,-58
39,35,39,133,1229,1857,-628
39,35,39,139,150,121,29
39,35,39,143,52,0,52
39,35,39,147,34,0,34
39,35,39,151,560,490,70
39,35,39,153,3777,5547,-1770
39,35,39,155,421,228,193
39,35,39,157,84,45,39
39,35,39,165,53,112,-59
39,35,39,167,30,0,30
39,35,39,169,224,253,-29
39,35,39,173,234,179,55
39,35,40,109,29,58,-29
39,35,40,143,0,29,-29
39,35,41,39,0,35,-35
39,35,41,51,63,91,-28
39,35,41,67,0,38,-38
39,35,42,3,440,471,-31
39,35,42,7,25,26,-1
39,35,42,17,35,46,-11
39,35,42,19,32,47,-15
39,35,42,27,43,0,43
39,35,42,29,0,71,-71
39,35,42,39,38,34,4
39,35,42,43,43,0,43
39,35,42,45,34,32,2
39,35,42,49,170,155,15
39,35,42,51,0,36,-36
39,35,42,71,0,34,-34
39,35,42,77,45,41,4
39,35,42,79,23,0,23
39,35,42,85,54,32,22
39,35,42,91,52,64,-12
39,35,42,101,112,131,-19
39,35,42,125,32,37,-5
39,35,42,129,52,52,0
39,35,44,7,49,47,2
39,35,45,13,32,71,-39
39,35,45,19,57,68,-11
39,35,45,35,0,38,-38
39,35,45,45,30,60,-30
39,35,45,51,38,96,-58
39,35,45,79,0,59,-59
39,35,45,83,0,40,-40
39,35,45,91,0,30,-30
39,35,47,37,122,154,-32
39,35,47,65,0,28,-28
39,35,47,93,41,62,-21
39,35,47,125,0,58,-58
39,35,47,149,0,38,-38
39,35,47,157,78,173,-95
39,35,47,187,0,43,-43
39,35,48,27,76,71,5
39,35,48,29,58,153,-95
39,35,48,39,0,59,-59
39,35,48,85,64,90,-26
39,35,48,113,137,231,-94
39,35,48,121,0,98,-98
39,35,48,141,0,40,-40
39,35,48,157,0,58,-58
39,35,48,167,0,28,-28
39,35,48,201,184,368,-184
39,35,48,339,0,67,-67
39,35,48,439,97,116,-19
39,35,48,453,44,122,-78
39,35,48,491,0,27,-27
39,35,49,35,82,47,35
39,35,49,49,85,0,85
39,35,51,13,48,106,-58
39,35,51,41,33,0,33
39,35,51,59,132,191,-59
39,35,51,87,67,53,14
39,35,51,107,0,53,-53
39,35,51,153,31,57,-26
39,35,51,179,0,33,-33
39,35,51,510,36,65,-29
39,35,51,550,0,56,-56
39,35,51,650,29,47,-18
39,35,51,700,37,0,37
39,35,51,710,100,85,15
39,35,51,760,34,28,6
39,35,51,810,73,89,-16
39,35,53,33,110,242,-132
39,35,53,53,31,57,-26
39,35,53,61,32,41,-9
39,35,54,39,38,54,-16
39,35,55,25,57,78,-21
39,35,55,79,86,131,-45
39,35,55,133,42,0,42
39,37,18,135,286,223,63
39,37,18,177,0,64,-64
39,37,39,11,36,27,9
39,37,39,23,0,27,-27
39,37,39,49,45,75,-30
39,37,39,57,62,72,-10
39,37,39,61,0,29,-29
39,37,39,107,116,145,-29
39,37,39,109,441,489,-48
39,37,39,113,313,358,-45
39,37,39,135,164,150,14
39,37,39,149,130,127,3
39,39,18,3,82,149,-67
39,39,18,33,32,30,2
39,39,39,3,0,34,-34
39,39,39,35,0,20,-20
39,39,39,49,29,50,-21
39,39,39,51,118,92,26
39,39,39,61,0,24,-24
39,39,39,63,0,38,-38
39,39,39,69,246,219,27
39,39,39,95,82,99,-17
39,39,39,113,0,25,-25
39,39,39,125,348,274,74
39,39,39,137,91,70,21
39,39,39,161,0,34,-34
39,39,39,171,355,255,100
39,39,39,173,56,52,4
39,41,4,13,106,113,-7
39,41,6,37,58,42,16
39,41,6,65,40,0,40
39,41,6,73,76,32,44
39,41,8,31,0,27,-27
39,41,8,35,0,44,-44
39,41,12,11,32,0,32
39,41,12,57,31,0,31
39,41,12,71,33,51,-18
39,41,12,95,33,33,0
39,41,12,103,25,0,25
39,41,12,115,28,0,28
39,41,17,31,63,107,-44
39,41,17,97,86,0,86
39,41,18,57,0,74,-74
39,41,18,97,33,53,-20
39,41,21,67,28,0,28
39,41,24,31,0,36,-36
39,41,26,125,78,34,44
39,41,26,163,76,0,76
39,41,32,3,26,53,-27
39,41,36,61,27,39,-12
39,41,37,119,38,52,-14
39,41,37,183,38,64,-26
39,41,39,3,44,0,44
39,41,39,5,36,31,5
39,41,39,9,52,38,14
39,41,39,17,54,67,-13
39,41,39,21,0,31,-31
39,41,39,25,38,33,5
39,41,39,33,92,36,56
39,41,39,35,202,123,79
39,41,39,45,220,131,89
39,41,39,49,8152,5500,2652
39,41,39,57,67,28,39
39,41,39,61,123,83,40
39,41,39,63,51,0,51
39,41,39,83,212,199,13
39,41,39,85,39,0,39
39,41,39,89,283,230,53
39,41,39,91,36,49,-13
39,41,39,93,60,42,18
39,41,39,95,104,30,74
39,41,39,97,69,62,7
39,41,39,99,70,0,70
39,41,39,101,412,369,43
39,41,39,103,110,41,69
39,41,39,109,44,0,44
39,41,39,113,99,47,52
39,41,39,117,315,371,-56
39,41,39,119,40,0,40
39,41,39,129,32,29,3
39,41,39,139,73,97,-24
39,41,39,145,32,0,32
39,41,39,147,29,0,29
39,41,39,151,70,58,12
39,41,39,153,164,70,94
39,41,39,157,27,0,27
39,41,39,159,329,394,-65
39,41,39,165,72,108,-36
39,41,39,169,38,35,3
39,41,39,173,49,0,49
39,41,42,3,45,39,6
39,41,48,29,0,33,-33
39,41,48,85,0,39,-39
39,41,48,113,33,0,33
39,41,48,121,0,49,-49
39,41,48,201,41,41,0
39,41,51,59,41,47,-6
39,41,53,33,0,32,-32
39,43,4,13,0,45,-45
39,43,12,71,0,35,-35
39,43,12,95,0,30,-30
39,43,17,31,0,31,-31
39,43,26,163,30,0,30
39,43,32,3,0,26,-26
39,43,39,35,249,273,-24
39,43,39,49,135,216,-81
39,43,39,61,27,33,-6
39,43,39,63,0,25,-25
39,43,39,77,927,821,106
39,43,39,93,691,741,-50
39,43,39,95,111,107,4
39,43,39,103,40,0,40
39,43,39,123,257,159,98
39,43,39,133,27,32,-5
39,43,39,139,69,37,32
39,43,39,143,316,300,16
39,43,39,147,72,52,20
39,43,39,151,31,36,-5
39,43,39,153,81,48,33
39,43,39,173,79,71,8
39,45,4,13,50,54,-4
39,45,12,57,0,26,-26
39,45,12,71,29,0,29
39,45,12,95,37,0,37
39,45,12,99,26,0,26
39,45,12,103,34,26,8
39,45,12,105,25,0,25
39,45,17,31,0,27,-27
39,45,32,3,32,0,32
39,45,37,119,0,35,-35
39,45,39,9,155,150,5
39,45,39,17,0,41,-41
39,45,39,23,30,40,-10
39,45,39,35,56,37,19
39,45,39,41,131,220,-89
39,45,39,49,5220,4384,836
39,45,39,57,24,30,-6
39,45,39,61,43,43,0
39,45,39,73,485,422,63
39,45,39,83,45,41,4
39,45,39,89,796,847,-51
39,45,39,93,0,26,-26
39,45,39,95,33,0,33
39,45,39,97,32,37,-5
39,45,39,113,69,56,13
39,45,39,119,157,94,63
39,45,39,127,412,507,-95
39,45,39,129,453,429,24
39,45,39,139,25,0,25
39,45,39,141,104,103,1
39,45,39,151,42,0,42
39,45,39,153,32,45,-13
39,45,39,159,53,32,21
39,45,39,163,30,0,30
39,45,39,165,32,0,32
39,45,39,167,29,0,29
39,45,42,3,34,31,3
39,47,39,23,32,40,-8
39,47,39,27,164,233,-69
39,47,39,49,259,243,16
39,47,39,57,68,101,-33
39,47,39,61,0,39,-39
39,47,39,71,357,288,69
39,47,39,97,103,101,2
39,47,39,113,56,47,9
39,47,39,129,184,146,38
39,47,39,141,166,207,-41
39,49,1,73,55,74,-19
39,49,1,89,37,103,-66
39,49,1,97,0,28,-28
39,49,2,20,34,35,-1
39,49,2,90,27,0,27
39,49,4,13,493,871,-378
39,49,4,19,81,149,-68
39,49,4,21,0,43,-43
39,49,5,7,0,60,-60
39,49,5,119,47,32,15
39,49,6,1,84,162,-78
39,49,6,13,58,44,14
39,49,6,37,596,734,-138
39,49,6,41,0,30,-30
39,49,6,53,28,42,-14
39,49,6,59,181,183,-2
39,49,6,65,117,124,-7
39,49,6,67,83,85,-2
39,49,6,71,127,98,29
39,49,6,73,382,380,2
39,49,6,75,85,125,-40
39,49,6,77,0,35,-35
39,49,6,81,40,48,-8
39,49,6,83,24,24,0
39,49,6,85,93,186,-93
39,49,6,111,39,56,-17
39,49,8,5,80,107,-27
39,49,8,13,0,43,-43
39,49,8,31,75,185,-110
39,49,8,35,31,59,-28
39,49,8,41,88,100,-12
39,49,8,59,29,48,-19
39,49,8,69,0,52,-52
39,49,9,1,74,82,-8
39,49,9,3,78,91,-13
39,49,9,5,0,32,-32
39,49,9,9,72,44,28
39,49,9,11,0,32,-32
39,49,10,3,143,108,35
39,49,11,1,118,162,-44
39,49,12,1,43,50,-7
39,49,12,5,0,36,-36
39,49,12,9,58,91,-33
39,49,12,11,201,198,3
39,49,12,15,0,82,-82
39,49,12,17,32,0,32
39,49,12,19,0,28,-28
39,49,12,21,80,99,-19
39,49,12,31,154,233,-79
39,49,12,33,30,40,-10
39,49,12,57,254,271,-17
39,49,12,61,25,27,-2
39,49,12,69,45,65,-20
39,49,12,71,173,277,-104
39,49,12,73,47,55,-8
39,49,12,81,50,60,-10
39,49,12,83,41,55,-14
39,49,12,86,152,151,1
39,49,12,91,21,33,-12
39,49,12,95,182,219,-37
39,49,12,97,38,59,-21
39,49,12,99,171,184,-13
39,49,12,101,88,59,29
39,49,12,103,222,253,-31
39,49,12,105,85,109,-24
39,49,12,109,0,28,-28
39,49,12,111,34,42,-8
39,49,12,115,78,130,-52
39,49,12,117,97,108,-11
39,49,12,127,84,82,2
39,49,13,51,55,65,-10
39,49,13,57,0,36,-36
39,49,13,63,32,80,-48
39,49,13,67,135,221,-86
39,49,13,77,0,43,-43
39,49,13,89,218,226,-8
39,49,13,97,35,0,35
39,49,13,113,0,33,-33
39,49,13,117,0,37,-37
39,49,13,121,198,316,-118
39,49,13,135,137,163,-26
39,49,13,151,0,46,-46
39,49,13,215,28,21,7
39,49,15,3,106,98,8
39,49,16,1,0,27,-27
39,49,17,19,53,49,4
39,49,17,31,1003,1269,-266
39,49,17,43,184,189,-5
39,49,17,89,53,63,-10
39,49,17,91,0,29,-29
39,49,17,97,226,126,100
39,49,17,113,48,0,48
39,49,17,143,24,36,-12
39,49,17,161,39,0,39
39,49,17,163,26,0,26
39,49,17,197,65,61,4
39,49,17,201,34,0,34
39,49,18,3,155,124,31
39,49,18,5,0,40,-40
39,49,18,35,37,0,37
39,49,18,57,121,170,-49
39,49,18,59,0,38,-38
39,49,18,63,40,38,2
39,49,18,81,36,37,-1
39,49,18,89,64,82,-18
39,49,18,97,339,369,-30
39,49,18,105,46,50,-4
39,49,18,141,55,0,55
39,49,18,157,68,50,18
39,49,18,163,28,0,28
39,49,18,167,27,0,27
39,49,18,177,69,0,69
39,49,19,103,0,38,-38
39,49,19,153,49,53,-4
39,49,19,163,32,93,-61
39,49,20,91,66,100,-34
39,49,20,173,35,0,35
39,49,21,15,102,102,0
39,49,21,19,34,51,-17
39,49,21,37,40,36,4
39,49,21,43,34,0,34
39,49,21,67,189,160,29
39,49,21,89,34,43,-9
39,49,21,93,22,38,-16
39,49,21,111,231,277,-46
39,49,21,117,104,120,-16
39,49,21,159,0,28,-28
39,49,21,227,23,0,23
39,49,22,33,0,37,-37
39,49,22,51,30,36,-6
39,49,22,71,0,71,-71
39,49,23,5,77,28,49
39,49,24,3,73,76,-3
39,49,24,5,79,93,-14
39,49,24,21,35,42,-7
39,49,24,27,57,80,-23
39,49,24,31,177,218,-41
39,49,24,33,97,140,-43
39,49,24,510,61,84,-23
39,49,25,3,23,0,23
39,49,25,9,43,38,5
39,49,25,13,25,0,25
39,49,25,17,132,227,-95
39,49,25,21,61,84,-23
39,49,25,25,90,121,-31
39,49,25,27,51,60,-9
39,49,26,21,83,59,24
39,49,26,25,36,0,36
39,49,26,49,100,35,65
39,49,26,65,94,36,58
39,49,26,75,45,0,45
39,49,26,77,80,34,46
39,49,26,81,160,40,120
39,49,26,91,31,0,31
39,49,26,93,30,0,30
39,49,26,99,115,53,62
39,49,26,115,46,33,13
39,49,26,121,35,0,35
39,49,26,125,322,263,59
39,49,26,139,35,48,-13
39,49,26,145,63,29,34
39,49,26,147,22,0,22
39,49,26,161,187,88,99
39,49,26,163,504,217,287
39,49,27,37,49,54,-5
39,49,27,53,221,259,-38
39,49,27,123,76,69,7
39,49,27,163,30,0,30
39,49,29,19,30,0,30
39,49,29,77,31,29,2
39,49,29,95,63,67,-4
39,49,29,183,0,43,-43
39,49,29,189,183,150,33
39,49,29,510,77,61,16
39,49,31,55,67,68,-1
39,49,31,79,0,29,-29
39,49,31,109,43,28,15
39,49,31,153,58,0,58
39,49,32,3,247,268,-21
39,49,32,31,45,24,21
39,49,33,11,79,44,35
39,49,33,15,29,0,29
39,49,34,3,75,61,14
39,49,34,5,40,44,-4
39,49,34,7,45,29,16
39,49,34,13,80,82,-2
39,49,34,17,135,129,6
39,49,34,21,34,59,-25
39,49,34,23,174,138,36
39,49,34,25,37,0,37
39,49,34,27,74,31,43
39,49,34,35,51,36,15
39,49,34,39,48,53,-5
39,49,35,1,58,74,-16
39,49,36,1,0,41,-41
39,49,36,5,162,174,-12
39,49,36,7,29,0,29
39,49,36,27,34,0,34
39,49,36,29,143,113,30
39,49,36,45,39,0,39
39,49,36,47,239,365,-126
39,49,36,55,95,69,26
39,49,36,59,78,39,39
39,49,36,61,239,464,-225
39,49,36,67,60,80,-20
39,49,36,71,30,0,30
39,49,36,81,177,142,35
39,49,36,85,29,0,29
39,49,36,103,67,51,16
39,49,36,109,0,28,-28
39,49,36,119,100,53,47
39,49,37,19,0,31,-31
39,49,37,21,29,42,-13
39,49,37,49,46,27,19
39,49,37,51,74,108,-34
39,49,37,63,81,111,-30
39,49,37,67,70,82,-12
39,49,37,71,0,25,-25
39,49,37,81,60,98,-38
39,49,37,97,0,60,-60
39,49,37,119,235,475,-240
39,49,37,129,40,45,-5
39,49,37,133,76,113,-37
39,49,37,135,34,42,-8
39,49,37,147,0,38,-38
39,49,37,183,176,308,-132
39,49,39,1,39,0,39
39,49,39,3,479,232,247
39,49,39,5,217,82,135
39,49,39,7,142,50,92
39,49,39,9,445,282,163
39,49,39,11,154,67,87
39,49,39,13,269,168,101
39,49,39,17,509,397,112
39,49,39,19,28,30,-2
39,49,39,21,204,300,-96
39,49,39,23,646,421,225
39,49,39,25,232,152,80
39,49,39,27,92,136,-44
39,49,39,29,144,72,72
39,49,39,31,152,86,66
39,49,39,33,213,111,102
39,49,39,35,2049,1533,516
39,49,39,37,75,45,30
39,49,39,39,50,29,21
39,49,39,41,5500,8152,-2652
39,49,39,43,216,135,81
39,49,39,45,4384,5220,-836
39,49,39,47,243,259,-16
39,49,39,51,71,0,71
39,49,39,53,117,103,14
39,49,39,55,73,40,33
39,49,39,57,564,417,147
39,49,39,59,148,136,12
39,49,39,61,1227,993,234
39,49,39,63,235,127,108
39,49,39,65,105,65,40
39,49,39,69,54,0,54
39,49,39,71,95,103,-8
39,49,39,73,247,315,-68
39,49,39,75,39,0,39
39,49,39,77,126,58,68
39,49,39,79,144,119,25
39,49,39,81,187,97,90
39,49,39,83,554,635,-81
39,49,39,85,250,195,55
39,49,39,87,89,120,-31
39,49,39,89,3410,4111,-701
39,49,39,91,305,256,49
39,49,39,93,550,215,335
39,49,39,95,979,504,475
39,49,39,97,1461,1632,-171
39,49,39,99,695,280,415
39,49,39,101,422,385,37
39,49,39,103,275,216,59
39,49,39,105,69,50,19
39,49,39,107,119,53,66
39,49,39,109,250,139,111
39,49,39,113,1556,924,632
39,49,39,115,82,67,15
39,49,39,117,335,502,-167
39,49,39,119,512,335,177
39,49,39,121,28,0,28
39,49,39,123,80,49,31
39,49,39,125,25,0,25
39,49,39,127,246,310,-64
39,49,39,129,1584,1975,-391
39,49,39,131,120,153,-33
39,49,39,133,243,125,118
39,49,39,135,25,0,25
39,49,39,137,83,41,42
39,49,39,139,768,392,376
39,49,39,141,623,400,223
39,49,39,143,108,48,60
39,49,39,145,224,259,-35
39,49,39,147,127,41,86
39,49,39,149,154,68,86
39,49,39,151,774,385,389
39,49,39,153,1055,645,410
39,49,39,155,488,142,346
39,49,39,157,178,114,64
39,49,39,159,1014,1429,-415
39,49,39,161,62,49,13
39,49,39,163,95,70,25
39,49,39,165,346,376,-30
39,49,39,167,213,126,87
39,49,39,169,225,138,87
39,49,39,171,55,0,55
39,49,39,173,399,175,224
39,49,39,175,81,25,56
39,49,40,27,0,24,-24
39,49,40,109,51,41,10
39,49,40,143,66,81,-15
39,49,41,39,0,39,-39
39,49,41,47,0,32,-32
39,49,41,51,50,129,-79
39,49,41,67,62,96,-34
39,49,42,3,464,465,-1
39,49,42,7,45,53,-8
39,49,42,11,41,0,41
39,49,42,17,58,54,4
39,49,42,19,45,40,5
39,49,42,27,49,0,49
39,49,42,29,56,79,-23
39,49,42,41,36,59,-23
39,49,42,43,52,53,-1
39,49,42,45,47,49,-2
39,49,42,49,114,31,83
39,49,42,71,51,30,21
39,49,42,73,32,0,32
39,49,42,77,50,35,15
39,49,42,79,33,0,33
39,49,42,85,27,0,27
39,49,42,91,62,72,-10
39,49,42,101,147,147,0
39,49,42,125,41,57,-16
39,49,42,129,78,51,27
39,49,44,7,56,35,21
39,49,45,13,39,76,-37
39,49,45,15,0,74,-74
39,49,45,19,76,102,-26
39,49,45,35,0,28,-28
39,49,45,45,60,97,-37
39,49,45,51,45,75,-30
39,49,45,63,0,38,-38
39,49,45,79,0,77,-77
39,49,45,83,32,0,32
39,49,45,91,31,55,-24
39,49,46,99,34,0,34
39,49,47,3,46,33,13
39,49,47,37,185,204,-19
39,49,47,93,79,82,-3
39,49,47,125,33,50,-17
39,49,47,149,40,78,-38
39,49,47,155,0,30,-30
39,49,47,157,116,138,-22
39,49,47,165,0,28,-28
39,49,47,179,0,41,-41
39,49,47,187,0,49,-49
39,49,48,27,56,84,-28
39,49,48,29,113,182,-69
39,49,48,41,31,0,31
39,49,48,85,111,215,-104
39,49,48,113,154,281,-127
39,49,48,121,83,101,-18
39,49,48,141,50,75,-25
39,49,48,157,0,47,-47
39,49,48,167,0,33,-33
39,49,48,201,227,383,-156
39,49,48,215,29,0,29
39,49,48,303,24,0,24
39,49,48,339,0,57,-57
39,49,48,355,0,25,-25
39,49,48,439,135,214,-79
39,49,48,453,76,192,-116
39,49,48,491,0,62,-62
39,49,49,5,27,0,27
39,49,49,11,35,0,35
39,49,49,35,122,108,14
39,49,49,49,130,46,84
39,49,51,3,27,0,27
39,49,51,13,81,94,-13
39,49,51,41,0,51,-51
39,49,51,59,204,240,-36
39,49,51,87,74,45,29
39,49,51,107,63,78,-15
39,49,51,153,82,91,-9
39,49,51,510,60,61,-1
39,49,51,550,36,26,10
39,49,51,650,29,25,4
39,49,51,700,47,50,-3
39,49,51,710,52,62,-10
39,49,51,760,36,43,-7
39,49,51,810,100,89,11
39,49,53,11,32,0,32
39,49,53,33,196,336,-140
39,49,53,35,0,37,-37
39,49,53,53,54,77,-23
39,49,53,61,41,71,-30
39,49,53,67,0,42,-42
39,49,54,11,91,68,23
39,49,54,33,35,0,35
39,49,54,39,111,92,19
39,49,54,45,0,28,-28
39,49,54,53,0,46,-46
39,49,54,59,0,67,-67
39,49,54,61,32,46,-14
39,49,54,69,37,58,-21
39,49,54,79,42,0,42
39,49,54,81,28,0,28
39,49,54,99,27,31,-4
39,49,54,107,97,65,32
39,49,55,25,64,103,-39
39,49,55,59,38,0,38
39,49,55,79,109,80,29
39,49,55,133,43,59,-16
39,51,4,13,0,34,-34
39,51,26,59,28,36,-8
39,51,26,91,164,106,58
39,51,39,39,92,118,-26
39,51,39,49,0,71,-71
39,51,39,69,309,324,-15
39,51,39,95,962,902,60
39,51,39,143,32,0,32
39,51,39,171,243,267,-24
39,51,39,173,136,191,-55
39,53,39,9,0,32,-32
39,53,39,49,103,117,-14
39,53,39,79,194,177,17
39,53,39,87,106,129,-23
39,53,39,105,111,126,-15
39,53,39,141,0,39,-39
39,53,39,145,27,30,-3
39,53,54,11,60,32,28
39,53,54,53,147,185,-38
39,55,4,13,0,48,-48
39,55,6,37,0,24,-24
39,55,12,71,0,37,-37
39,55,17,31,0,49,-49
39,55,32,3,0,32,-32
39,55,39,7,286,361,-75
39,55,39,35,1598,935,663
39,55,39,49,40,73,-33
39,55,39,85,1014,984,30
39,55,39,93,34,42,-8
39,55,39,103,24,61,-37
39,55,39,133,371,378,-7
39,55,39,153,229,207,22
39,55,39,155,204,262,-58
39,57,1,89,0,38,-38
39,57,1,101,0,54,-54
39,57,2,20,47,28,19
39,57,4,13,85,74,11
39,57,4,19,0,46,-46
39,57,6,37,77,74,3
39,57,6,65,0,38,-38
39,57,6,73,33,40,-7
39,57,6,83,37,0,37
39,57,8,5,31,0,31
39,57,8,41,80,117,-37
39,57,11,1,0,33,-33
39,57,12,9,27,0,27
39,57,12,11,26,0,26
39,57,12,57,60,71,-11
39,57,12,71,0,41,-41
39,57,12,91,89,104,-15
39,57,12,95,34,0,34
39,57,12,99,0,25,-25
39,57,12,103,50,36,14
39,57,12,113,0,40,-40
39,57,12,115,31,0,31
39,57,13,67,0,45,-45
39,57,13,121,0,36,-36
39,57,13,135,0,33,-33
39,57,13,153,32,0,32
39,57,15,3,64,0,64
39,57,17,31,76,95,-19
39,57,17,43,0,31,-31
39,57,17,163,0,39,-39
39,57,18,3,28,0,28
39,57,18,97,40,63,-23
39,57,21,67,0,27,-27
39,57,21,111,32,38,-6
39,57,21,117,0,35,-35
39,57,24,3,0,36,-36
39,57,24,31,45,0,45
39,57,25,17,41,70,-29
39,57,26,81,33,0,33
39,57,26,125,0,32,-32
39,57,26,163,39,29,10
39,57,32,3,74,57,17
39,57,35,1,79,51,28
39,57,37,119,0,32,-32
39,57,39,1,25,27,-2
39,57,39,3,39,0,39
39,57,39,9,32,33,-1
39,57,39,11,39,0,39
39,57,39,17,166,178,-12
39,57,39,21,84,70,14
39,57,39,23,964,844,120
39,57,39,25,43,61,-18
39,57,39,27,173,264,-91
39,57,39,35,101,100,1
39,57,39,37,72,62,10
39,57,39,41,28,67,-39
39,57,39,45,30,24,6
39,57,39,47,101,68,33
39,57,39,49,417,564,-147
39,57,39,61,207,225,-18
39,57,39,71,62,78,-16
39,57,39,89,34,27,7
39,57,39,91,26,0,26
39,57,39,95,35,56,-21
39,57,39,97,0,31,-31
39,57,39,99,28,0,28
39,57,39,107,29,0,29
39,57,39,109,239,276,-37
39,57,39,113,5711,5684,27
39,57,39,135,59,38,21
39,57,39,139,28,0,28
39,57,39,141,35,0,35
39,57,39,145,31,0,31
39,57,39,149,31,22,9
39,57,39,151,25,0,25
39,57,39,159,0,34,-34
39,57,39,165,327,453,-126
39,57,42,3,41,49,-8
39,57,47,93,32,0,32
39,57,48,29,106,116,-10
39,57,48,113,0,31,-31
39,57,48,439,0,49,-49
39,57,49,11,65,0,65
39,57,51,13,0,27,-27
39,57,51,59,64,129,-65
39,57,51,153,48,0,48
39,57,51,510,0,30,-30
39,57,53,33,0,28,-28
39,59,39,13,108,97,11
39,59,39,31,64,32,32
39,59,39,35,32,31,1
39,59,39,49,136,148,-12
39,59,39,67,38,0,38
39,59,39,89,40,48,-8
39,59,39,119,335,322,13
39,59,39,121,181,184,-3
39,59,39,151,37,41,-4
39,59,39,153,42,52,-10
39,59,39,157,79,150,-71
39,59,39,167,0,34,-34
39,61,1,73,54,60,-6
39,61,1,89,42,0,42
39,61,1,101,25,0,25
39,61,4,13,163,249,-86
39,61,4,19,39,94,-55
39,61,5,119,34,42,-8
39,61,5,143,45,55,-10
39,61,6,1,56,84,-28
39,61,6,13,39,31,8
39,61,6,37,292,369,-77
39,61,6,59,64,98,-34
39,61,6,65,46,43,3
39,61,6,67,0,22,-22
39,61,6,71,0,52,-52
39,61,6,73,172,209,-37
39,61,6,75,49,101,-52
39,61,6,81,0,27,-27
39,61,6,85,49,95,-46
39,61,8,5,33,33,0
39,61,8,13,33,45,-12
39,61,8,31,39,96,-57
39,61,8,41,36,57,-21
39,61,8,45,0,29,-29
39,61,8,59,0,31,-31
39,61,8,69,25,0,25
39,61,9,1,85,81,4
39,61,9,3,31,64,-33
39,61,9,9,30,0,30
39,61,11,1,60,142,-82
39,61,12,1,46,0,46
39,61,12,9,0,50,-50
39,61,12,11,83,86,-3
39,61,12,21,43,88,-45
39,61,12,31,120,119,1
39,61,12,33,0,35,-35
39,61,12,57,107,171,-64
39,61,12,69,28,0,28
39,61,12,71,52,163,-111
39,61,12,81,32,75,-43
39,61,12,86,91,105,-14
39,61,12,91,0,27,-27
39,61,12,95,85,98,-13
39,61,12,99,77,105,-28
39,61,12,101,28,50,-22
39,61,12,103,82,111,-29
39,61,12,105,42,48,-6
39,61,12,115,42,90,-48
39,61,12,117,33,46,-13
39,61,12,119,0,42,-42
39,61,12,127,39,58,-19
39,61,13,51,20,60,-40
39,61,13,63,34,77,-43
39,61,13,67,85,134,-49
39,61,13,89,126,202,-76
39,61,13,97,0,23,-23
39,61,13,121,134,272,-138
39,61,13,135,72,86,-14
39,61,13,151,0,32,-32
39,61,15,3,57,35,22
39,61,17,19,32,36,-4
39,61,17,31,563,760,-197
39,61,17,43,71,102,-31
39,61,17,89,31,41,-10
39,61,17,97,59,66,-7
39,61,17,197,30,0,30
39,61,18,3,68,42,26
39,61,18,5,0,21,-21
39,61,18,29,913,1421,-508
39,61,18,31,40,0,40
39,61,18,35,38,0,38
39,61,18,47,187,195,-8
39,61,18,57,93,91,2
39,61,18,63,22,52,-30
39,61,18,81,0,32,-32
39,61,18,89,32,25,7
39,61,18,97,208,312,-104
39,61,18,105,58,60,-2
39,61,18,115,31,47,-16
39,61,18,137,103,156,-53
39,61,18,141,35,42,-7
39,61,18,155,0,49,-49
39,61,18,157,48,35,13
39,61,18,163,30,29,1
39,61,18,177,63,33,30
39,61,19,163,0,24,-24
39,61,20,91,41,41,0
39,61,20,173,0,37,-37
39,61,21,15,778,1214,-436
39,61,21,37,1065,1382,-317
39,61,21,67,207,229,-22
39,61,21,73,27,0,27
39,61,21,81,64,83,-19
39,61,21,111,251,342,-91
39,61,21,113,0,30,-30
39,61,21,117,1886,2543,-657
39,61,21,121,0,32,-32
39,61,21,151,35,48,-13
39,61,21,185,0,30,-30
39,61,21,191,34,43,-9
39,61,21,199,31,40,-9
39,61,22,33,0,35,-35
39,61,22,51,27,0,27
39,61,24,3,30,31,-1
39,61,24,5,0,57,-57
39,61,24,27,0,27,-27
39,61,24,31,78,102,-24
39,61,24,33,35,85,-50
39,61,24,510,53,91,-38
39,61,25,9,0,37,-37
39,61,25,17,107,133,-26
39,61,25,21,47,82,-35
39,61,25,25,48,129,-81
39,61,25,27,41,0,41
39,61,26,65,38,48,-10
39,61,26,81,41,55,-14
39,61,26,99,40,0,40
39,61,26,125,155,121,34
39,61,26,161,117,63,54
39,61,26,163,173,89,84
39,61,27,53,91,106,-15
39,61,27,109,37,0,37
39,61,27,123,0,30,-30
39,61,29,95,0,42,-42
39,61,29,189,72,79,-7
39,61,29,510,45,72,-27
39,61,31,55,32,0,32
39,61,32,3,83,189,-106
39,61,32,31,0,32,-32
39,61,34,3,33,36,-3
39,61,34,13,37,44,-7
39,61,34,17,62,51,11
39,61,34,21,0,33,-33
39,61,34,23,40,42,-2
39,61,34,35,0,26,-26
39,61,35,1,33,28,5
39,61,36,5,115,49,66
39,61,36,29,53,31,22
39,61,36,47,122,134,-12
39,61,36,55,48,0,48
39,61,36,59,29,0,29
39,61,36,61,231,274,-43
39,61,36,81,67,72,-5
39,61,36,103,0,23,-23
39,61,37,21,0,40,-40
39,61,37,51,0,41,-41
39,61,37,63,34,36,-2
39,61,37,67,0,32,-32
39,61,37,81,45,44,1
39,61,37,119,101,246,-145
39,61,37,129,0,37,-37
39,61,37,133,46,46,0
39,61,37,183,61,121,-60
39,61,39,1,59,64,-5
39,61,39,3,73,63,10
39,61,39,9,61,56,5
39,61,39,11,37,0,37
39,61,39,15,324,333,-9
39,61,39,17,7403,9217,-1814
39,61,39,23,112,73,39
39,61,39,25,4318,5612,-1294
39,61,39,27,140,126,14
39,61,39,29,28,0,28
39,61,39,35,455,400,55
39,61,39,37,29,0,29
39,61,39,39,24,0,24
39,61,39,41,83,123,-40
39,61,39,43,33,27,6
39,61,39,45,43,43,0
39,61,39,47,39,0,39
39,61,39,49,993,1227,-234
39,61,39,57,225,207,18
39,61,39,63,47,0,47
39,61,39,71,101,71,30
39,61,39,83,21,0,21
39,61,39,85,48,37,11
39,61,39,89,71,28,43
39,61,39,91,30,0,30
39,61,39,93,70,43,27
39,61,39,95,205,108,97
39,61,39,99,74,41,33
39,61,39,103,43,0,43
39,61,39,109,103,49,54
39,61,39,113,903,783,120
39,61,39,119,0,27,-27
39,61,39,133,32,0,32
39,61,39,135,57,49,8
39,61,39,139,47,32,15
39,61,39,141,22,38,-16
39,61,39,145,46,30,16
39,61,39,149,44,39,5
39,61,39,151,93,74,19
39,61,39,153,152,133,19
39,61,39,155,49,0,49
39,61,39,165,2526,3761,-1235
39,61,39,167,20,0,20
39,61,39,169,30,0,30
39,61,39,173,56,57,-1
39,61,40,109,39,0,39
39,61,41,51,0,59,-59
39,61,41,67,0,32,-32
39,61,42,3,174,174,0
39,61,42,17,39,0,39
39,61,42,45,34,0,34
39,61,42,49,28,0,28
39,61,42,91,47,61,-14
39,61,42,101,73,93,-20
39,61,44,7,34,29,5
39,61,45,13,43,50,-7
39,61,45,19,40,69,-29
39,61,45,45,40,96,-56
39,61,45,51,34,46,-12
39,61,45,79,35,44,-9
39,61,45,91,0,28,-28
39,61,46,99,0,32,-32
39,61,47,37,118,167,-49
39,61,47,65,0,44,-44
39,61,47,93,59,71,-12
39,61,47,125,24,43,-19
39,61,47,157,111,78,33
39,61,47,187,40,0,40
39,61,48,27,0,57,-57
39,61,48,29,54,75,-21
39,61,48,85,33,53,-20
39,61,48,113,123,144,-21
39,61,48,121,27,31,-4
39,61,48,141,0,26,-26
39,61,48,201,77,229,-152
39,61,48,439,66,75,-9
39,61,48,453,37,86,-49
39,61,49,35,40,62,-22
39,61,51,13,35,50,-15
39,61,51,59,66,87,-21
39,61,51,87,0,30,-30
39,61,51,510,27,45,-18
39,61,51,710,35,51,-16
39,61,51,810,54,44,10
39,61,53,33,81,213,-132
39,61,53,53,0,51,-51
39,61,54,11,35,0,35
39,61,54,39,41,0,41
39,61,55,25,37,45,-8
39,61,55,79,53,70,-17
39,63,4,13,0,41,-41
39,63,12,57,0,36,-36
39,63,17,31,0,24,-24
39,63,26,99,55,0,55
39,63,26,125,30,34,-4
39,63,26,163,133,43,90
39,63,39,3,264,252,12
39,63,39,33,28,31,-3
39,63,39,35,43,58,-15
39,63,39,39,38,0,38
39,63,39,41,0,51,-51
39,63,39,43,25,0,25
39,63,39,49,127,235,-108
39,63,39,61,0,47,-47
39,63,39,65,251,208,43
39,63,39,69,55,81,-26
39,63,39,77,28,0,28
39,63,39,91,0,31,-31
39,63,39,95,210,214,-4
39,63,39,101,0,24,-24
39,63,39,113,0,35,-35
39,63,39,123,25,0,25
39,63,39,137,271,161,110
39,63,39,143,79,55,24
39,63,39,147,450,394,56
39,63,39,153,0,31,-31
39,63,39,173,567,562,5
39,63,39,175,214,212,2
39,63,48,201,0,28,-28
39,65,39,3,298,307,-9
39,65,39,11,47,34,13
39,65,39,21,28,28,0
39,65,39,49,65,105,-40
39,65,39,63,208,251,-43
39,65,39,91,248,294,-46
39,65,39,101,108,68,40
39,65,39,137,38,0,38
39,65,39,149,0,36,-36
39,65,39,159,72,83,-11
39,65,39,173,0,32,-32
39,65,39,175,158,108,50
39,67,39,13,84,78,6
39,67,39,19,0,91,-91
39,67,39,59,0,38,-38
39,67,39,81,189,169,20
39,67,39,151,0,49,-49
39,67,39,153,33,27,6
39,67,39,157,184,196,-12
39,69,39,39,219,246,-27
39,69,39,49,0,54,-54
39,69,39,51,324,309,15
39,69,39,63,81,55,26
39,69,39,95,194,212,-18
39,69,39,125,26,52,-26
39,69,39,137,68,80,-12
39,69,39,171,95,98,-3
39,69,39,173,211,266,-55
39,71,39,1,180,172,8
39,71,39,15,213,221,-8
39,71,39,17,64,50,14
39,71,39,23,37,0,37
39,71,39,25,226,214,12
39,71,39,27,556,650,-94
39,71,39,47,288,357,-69
39,71,39,49,103,95,8
39,71,39,57,78,62,16
39,71,39,61,71,101,-30
39,71,39,113,107,90,17
39,71,39,129,42,0,42
39,71,39,131,64,68,-4
39,71,39,141,222,255,-33
39,71,39,145,36,0,36
39,71,39,165,131,102,29
39,73,39,9,277,231,46
39,73,39,45,422,485,-63
39,73,39,49,315,247,68
39,73,39,89,37,38,-1
39,73,39,127,155,107,48
39,73,39,129,90,137,-47
39,73,39,141,94,54,40
39,73,39,163,47,56,-9
39,75,39,5,94,91,3
39,75,39,31,160,171,-11
39,75,39,49,0,39,-39
39,75,39,103,31,0,31
39,75,39,139,0,30,-30
39,75,39,151,62,66,-4
39,75,39,157,140,288,-148
39,75,39,169,416,472,-56
39,77,39,5,121,181,-60
39,77,39,33,77,82,-5
39,77,39,35,131,105,26
39,77,39,43,821,927,-106
39,77,39,49,58,126,-68
39,77,39,63,0,28,-28
39,77,39,93,393,325,68
39,77,39,95,58,56,2
39,77,39,103,33,61,-28
39,77,39,123,42,61,-19
39,77,39,139,416,322,94
39,77,39,143,201,251,-50
39,77,39,147,176,153,23
39,77,39,153,36,29,7
39,77,39,169,0,31,-31
39,77,39,173,26,36,-10
39,79,39,9,70,23,47
39,79,39,49,119,144,-25
39,79,39,53,177,194,-17
39,79,39,87,0,55,-55
39,79,39,105,43,54,-11
39,79,39,129,0,39,-39
39,79,39,131,152,135,17
39,79,39,141,150,128,22
39,79,39,145,143,115,28
39,79,39,163,268,236,32
39,81,4,13,0,30,-30
39,81,39,13,397,242,155
39,81,39,19,49,101,-52
39,81,39,29,144,137,7
39,81,39,35,44,34,10
39,81,39,49,97,187,-90
39,81,39,67,169,189,-20
39,81,39,99,33,29,4
39,81,39,151,28,34,-6
39,81,39,153,29,36,-7
39,81,39,155,0,28,-28
39,81,42,3,153,154,-1
39,81,42,125,43,41,2
39,81,54,9,160,139,21
39,81,54,29,214,268,-54
39,81,54,51,34,0,34
39,81,54,69,90,38,52
39,83,39,5,82,54,28
39,83,39,31,120,89,31
39,83,39,33,0,37,-37
39,83,39,35,36,25,11
39,83,39,41,199,212,-13
39,83,39,45,41,45,-4
39,83,39,49,635,554,81
39,83,39,61,0,21,-21
39,83,39,89,461,382,79
39,83,39,101,30,35,-5
39,83,39,117,216,138,78
39,83,39,119,0,26,-26
39,83,39,139,199,146,53
39,83,39,151,31,0,31
39,83,39,153,0,27,-27
39,83,39,169,0,36,-36
39,85,4,13,49,130,-81
39,85,4,21,0,30,-30
39,85,6,37,40,41,-1
39,85,6,59,33,26,7
39,85,6,73,28,51,-23
39,85,8,41,0,37,-37
39,85,11,1,0,24,-24
39,85,12,11,0,53,-53
39,85,12,21,0,25,-25
39,85,12,57,31,57,-26
39,85,12,71,37,75,-38
39,85,12,99,31,40,-9
39,85,12,103,39,61,-22
39,85,17,31,52,91,-39
39,85,26,125,26,0,26
39,85,32,3,74,113,-39
39,85,34,3,44,0,44
39,85,36,29,0,36,-36
39,85,36,47,0,20,-20
39,85,36,61,0,35,-35
39,85,37,119,0,75,-75
39,85,37,183,0,38,-38
39,85,39,7,1112,982,130
39,85,39,9,28,0,28
39,85,39,17,0,24,-24
39,85,39,29,44,0,44
39,85,39,35,5590,3605,1985
39,85,39,41,0,39,-39
39,85,39,49,195,250,-55
39,85,39,55,984,1014,-30
39,85,39,61,37,48,-11
39,85,39,93,146,148,-2
39,85,39,95,56,57,-1
39,85,39,99,88,50,38
39,85,39,103,102,94,8
39,85,39,113,23,30,-7
39,85,39,133,170,204,-34
39,85,39,151,64,56,8
39,85,39,153,341,438,-97
39,85,39,155,83,78,5
39,85,39,169,0,35,-35
39,85,39,173,0,29,-29
39,85,42,3,46,53,-7
39,85,42,49,72,69,3
39,85,45,19,0,28,-28
39,85,45,51,0,40,-40
39,85,45,83,0,28,-28
39,85,48,201,0,59,-59
39,85,51,810,0,41,-41
39,87,12,57,33,0,33
39,87,21,19,243,305,-62
39,87,21,43,0,32,-32
39,87,21,67,0,28,-28
39,87,21,89,192,183,9
39,87,39,49,120,89,31
39,87,39,53,129,106,23
39,87,39,79,55,0,55
39,87,39,145,176,185,-9
39,87,54,11,765,709,56
39,87,54,39,50,41,9
39,87,54,79,0,36,-36
39,87,54,99,186,176,10
39,89,4,13,53,37,16
39,89,6,73,41,27,14
39,89,12,31,0,28,-28
39,89,12,57,0,35,-35
39,89,12,71,0,54,-54
39,89,12,95,23,0,23
39,89,12,103,32,37,-5
39,89,12,105,0,28,-28
39,89,17,31,35,32,3
39,89,26,111,26,0,26
39,89,37,119,0,32,-32
39,89,39,9,41,59,-18
39,89,39,17,43,0,43
39,89,39,31,163,112,51
39,89,39,35,90,60,30
39,89,39,41,230,283,-53
39,89,39,45,847,796,51
39,89,39,49,4111,3410,701
39,89,39,57,27,34,-7
39,89,39,59,48,40,8
39,89,39,61,28,71,-43
39,89,39,73,38,37,1
39,89,39,83,382,461,-79
39,89,39,93,0,27,-27
39,89,39,95,44,42,2
39,89,39,97,0,38,-38
39,89,39,101,36,0,36
39,89,39,113,38,44,-6
39,89,39,115,32,33,-1
39,89,39,117,42,60,-18
39,89,39,119,628,607,21
39,89,39,127,330,434,-104
39,89,39,129,67,55,12
39,89,39,139,45,28,17
39,89,39,141,0,33,-33
39,89,39,151,45,34,11
39,89,39,153,61,42,19
39,89,39,159,34,58,-24
39,89,39,165,32,0,32
39,89,39,167,26,0,26
39,89,39,173,26,0,26
39,91,39,3,129,123,6
39,91,39,11,67,131,-64
39,91,39,21,312,336,-24
39,91,39,23,109,118,-9
39,91,39,41,49,36,13
39,91,39,49,256,305,-49
39,91,39,57,0,26,-26
39,91,39,61,0,30,-30
39,91,39,63,31,0,31
39,91,39,65,294,248,46
39,91,39,97,32,0,32
39,91,39,101,30,63,-33
39,91,39,109,71,38,33
39,91,39,113,85,101,-16
39,91,39,149,215,217,-2
39,91,39,159,282,243,39
39,93,4,13,89,187,-98
39,93,4,19,34,37,-3
39,93,6,37,48,38,10
39,93,6,59,45,0,45
39,93,6,73,47,86,-39
39,93,11,1,0,23,-23
39,93,12,9,0,34,-34
39,93,12,11,29,40,-11
39,93,12,21,25,37,-12
39,93,12,31,36,32,4
39,93,12,57,59,52,7
39,93,12,69,0,22,-22
39,93,12,71,62,88,-26
39,93,12,81,0,35,-35
39,93,12,95,53,48,5
39,93,12,97,45,0,45
39,93,12,99,27,36,-9
39,93,12,101,0,41,-41
39,93,12,103,42,88,-46
39,93,12,105,53,57,-4
39,93,12,115,0,28,-28
39,93,13,67,0,38,-38
39,93,13,135,0,36,-36
39,93,17,31,55,83,-28
39,93,17,97,0,28,-28
39,93,18,97,35,28,7
39,93,21,111,58,52,6
39,93,24,31,0,30,-30
39,93,25,17,29,0,29
39,93,26,99,30,33,-3
39,93,26,125,60,0,60
39,93,26,161,41,0,41
39,93,26,163,96,72,24
39,93,32,3,52,79,-27
39,93,36,29,49,0,49
39,93,36,47,0,38,-38
39,93,36,61,33,54,-21
39,93,37,51,0,33,-33
39,93,37,119,60,96,-36
39,93,37,133,32,0,32
39,93,37,183,0,54,-54
39,93,39,5,182,229,-47
39,93,39,7,34,24,10
39,93,39,9,25,0,25
39,93,39,17,0,27,-27
39,93,39,35,6481,4211,2270
39,93,39,41,42,60,-18
39,93,39,43,741,691,50
39,93,39,45,26,0,26
39,93,39,49,215,550,-335
39,93,39,55,42,34,8
39,93,39,61,43,70,-27
39,93,39,77,325,393,-68
39,93,39,85,148,146,2
39,93,39,89,27,0,27
39,93,39,95,152,112,40
39,93,39,99,65,39,26
39,93,39,103,674,686,-12
39,93,39,113,30,53,-23
39,93,39,123,53,46,7
39,93,39,133,88,92,-4
39,93,39,139,51,40,11
39,93,39,143,32,0,32
39,93,39,151,86,108,-22
39,93,39,153,266,300,-34
39,93,39,155,26,40,-14
39,93,39,165,0,27,-27
39,93,39,169,78,70,8
39,93,39,173,68,87,-19
39,93,42,3,54,59,-5
39,93,45,45,0,37,-37
39,93,48,113,0,36,-36
39,93,48,201,0,47,-47
39,93,48,439,0,46,-46
39,93,51,59,41,0,41
39,93,51,810,29,0,29
39,93,53,33,0,29,-29
39,95,4,13,68,257,-189
39,95,4,19,0,77,-77
39,95,6,37,68,134,-66
39,95,6,59,0,50,-50
39,95,6,65,0,32,-32
39,95,6,67,36,20,16
39,95,6,71,0,35,-35
39,95,6,73,60,67,-7
39,95,6,75,0,22,-22
39,95,6,85,0,39,-39
39,95,8,31,0,25,-25
39,95,8,41,0,68,-68
39,95,11,1,0,26,-26
39,95,12,9,32,49,-17
39,95,12,11,40,83,-43
39,95,12,21,0,53,-53
39,95,12,31,0,44,-44
39,95,12,57,37,96,-59
39,95,12,69,0,41,-41
39,95,12,71,52,149,-97
39,95,12,81,0,59,-59
39,95,12,86,0,45,-45
39,95,12,95,25,45,-20
39,95,12,99,40,72,-32
39,95,12,101,0,56,-56
39,95,12,103,76,133,-57
39,95,12,105,51,58,-7
39,95,12,115,0,66,-66
39,95,12,127,21,0,21
39,95,13,67,42,46,-4
39,95,13,89,45,0,45
39,95,13,121,33,56,-23
39,95,13,135,0,55,-55
39,95,15,3,33,33,0
39,95,17,31,127,319,-192
39,95,17,43,31,43,-12
39,95,17,97,0,25,-25
39,95,17,197,56,0,56
39,95,18,3,47,108,-61
39,95,18,39,36,0,36
39,95,18,97,53,89,-36
39,95,18,141,0,35,-35
39,95,21,111,0,67,-67
39,95,21,117,0,25,-25
39,95,24,3,28,0,28
39,95,24,31,0,31,-31
39,95,25,17,0,37,-37
39,95,25,25,0,36,-36
39,95,26,49,59,45,14
39,95,26,59,44,31,13
39,95,26,65,30,0,30
39,95,26,75,26,44,-18
39,95,26,77,38,38,0
39,95,26,81,51,79,-28
39,95,26,91,273,253,20
39,95,26,93,0,30,-30
39,95,26,99,110,77,33
39,95,26,115,1803,1855,-52
39,95,26,125,275,177,98
39,95,26,145,0,43,-43
39,95,26,161,230,213,17
39,95,26,163,506,520,-14
39,95,27,53,28,0,28
39,95,32,3,74,193,-119
39,95,36,29,0,44,-44
39,95,36,47,0,27,-27
39,95,36,55,0,40,-40
39,95,36,61,0,42,-42
39,95,36,81,0,27,-27
39,95,37,119,49,128,-79
39,95,37,133,29,53,-24
39,95,37,183,0,88,-88
39,95,39,3,126,87,39
39,95,39,11,27,34,-7
39,95,39,17,53,111,-58
39,95,39,23,44,0,44
39,95,39,25,0,31,-31
39,95,39,33,25,0,25
39,95,39,35,319,565,-246
39,95,39,39,99,82,17
39,95,39,41,30,104,-74
39,95,39,43,107,111,-4
39,95,39,45,0,33,-33
39,95,39,49,504,979,-475
39,95,39,51,902,962,-60
39,95,39,57,56,35,21
39,95,39,61,108,205,-97
39,95,39,63,214,210,4
39,95,39,69,212,194,18
39,95,39,77,56,58,-2
39,95,39,85,57,56,1
39,95,39,89,42,44,-2
39,95,39,93,112,152,-40
39,95,39,99,28,49,-21
39,95,39,103,59,59,0
39,95,39,107,28,0,28
39,95,39,109,0,29,-29
39,95,39,113,124,172,-48
39,95,39,123,413,557,-144
39,95,39,125,32,0,32
39,95,39,133,27,58,-31
39,95,39,137,61,25,36
39,95,39,139,46,40,6
39,95,39,143,330,267,63
39,95,39,147,106,72,34
39,95,39,151,74,71,3
39,95,39,153,108,176,-68
39,95,39,155,44,0,44
39,95,39,165,36,50,-14
39,95,39,169,27,0,27
39,95,39,171,150,89,61
39,95,39,173,3298,3997,-699
39,95,41,51,0,22,-22
39,95,42,3,30,84,-54
39,95,42,101,0,46,-46
39,95,45,13,0,28,-28
39,95,45,19,0,37,-37
39,95,45,45,0,40,-40
39,95,45,51,27,32,-5
39,95,45,79,0,27,-27
39,95,47,37,28,69,-41
39,95,47,157,0,54,-54
39,95,48,29,0,55,-55
39,95,48,113,0,72,-72
39,95,48,201,53,90,-37
39,95,48,439,0,44,-44
39,95,48,453,0,24,-24
39,95,51,59,22,38,-16
39,95,51,810,33,0,33
39,95,53,33,21,60,-39
39,95,55,79,0,34,-34
39,97,39,21,70,97,-27
39,97,39,23,237,246,-9
39,97,39,41,62,69,-7
39,97,39,45,37,32,5
39,97,39,47,101,103,-2
39,97,39,49,1632,1461,171
39,97,39,57,31,0,31
39,97,39,89,38,0,38
39,97,39,91,0,32,-32
39,97,39,113,67,0,67
39,97,39,129,116,112,4
39,97,39,141,48,0,48
39,97,39,159,149,171,-22
39,99,4,13,43,122,-79
39,99,6,37,49,47,2
39,99,6,73,34,45,-11
39,99,11,1,0,21,-21
39,99,12,11,28,28,0
39,99,12,21,0,32,-32
39,99,12,31,0,31,-31
39,99,12,57,37,51,-14
39,99,12,71,39,73,-34
39,99,12,81,0,31,-31
39,99,12,86,0,32,-32
39,99,12,95,43,44,-1
39,99,12,99,26,33,-7
39,99,12,101,0,28,-28
39,99,12,103,40,51,-11
39,99,12,115,0,44,-44
39,99,12,117,28,0,28
39,99,13,63,0,29,-29
39,99,13,67,0,35,-35
39,99,13,89,0,37,-37
39,99,13,121,0,32,-32
39,99,17,31,21,46,-25
39,99,26,163,0,32,-32
39,99,32,3,62,99,-37
39,99,36,5,0,70,-70
39,99,36,47,0,41,-41
39,99,36,61,0,87,-87
39,99,37,51,0,45,-45
39,99,37,119,0,100,-100
39,99,37,133,0,33,-33
39,99,37,183,0,52,-52
39,99,39,7,91,78,13
39,99,39,17,0,24,-24
39,99,39,19,0,48,-48
39,99,39,29,1154,975,179
39,99,39,35,250,430,-180
39,99,39,41,0,70,-70
39,99,39,49,280,695,-415
39,99,39,57,0,28,-28
39,99,39,61,41,74,-33
39,99,39,81,29,33,-4
39,99,39,85,50,88,-38
39,99,39,93,39,65,-26
39,99,39,95,49,28,21
39,99,39,103,31,39,-8
39,99,39,113,64,48,16
39,99,39,133,340,313,27
39,99,39,151,477,497,-20
39,99,39,153,273,366,-93
39,99,39,155,2476,2432,44
39,99,39,157,0,32,-32
39,99,39,173,25,0,25
39,99,42,3,183,231,-48
39,99,42,7,100,74,26
39,99,42,19,55,61,-6
39,99,42,49,0,38,-38
39,99,42,73,192,184,8
39,99,42,85,174,132,42
39,99,42,101,0,26,-26
39,99,42,129,38,45,-7
39,99,45,19,0,33,-33
39,99,45,51,22,45,-23
39,99,48,201,0,34,-34
39,99,48,439,0,27,-27
39,99,51,13,0,20,-20
39,101,17,31,0,26,-26
39,101,39,33,275,273,2
39,101,39,41,369,412,-43
39,101,39,49,385,422,-37
39,101,39,63,24,0,24
39,101,39,65,68,108,-40
39,101,39,83,35,30,5
39,101,39,89,0,36,-36
39,101,39,91,63,30,33
39,101,39,117,381,262,119
39,101,39,139,114,58,56
39,101,39,145,30,0,30
39,101,39,159,217,163,54
39,101,39,175,143,127,16
39,103,4,13,40,139,-99
39,103,4,19,0,21,-21
39,103,6,37,0,42,-42
39,103,6,73,44,28,16
39,103,12,21,0,25,-25
39,103,12,57,0,32,-32
39,103,12,71,25,47,-22
39,103,12,103,0,37,-37
39,103,12,117,0,24,-24
39,103,17,31,0,55,-55
39,103,26,125,27,32,-5
39,103,26,163,51,0,51
39,103,32,3,26,71,-45
39,103,37,119,0,36,-36
39,103,37,133,27,0,27
39,103,37,183,0,33,-33
39,103,39,5,186,212,-26
39,103,39,7,24,32,-8
39,103,39,17,0,32,-32
39,103,39,35,4671,2554,2117
39,103,39,41,41,110,-69
39,103,39,43,0,40,-40
39,103,39,49,216,275,-59
39,103,39,55,61,24,37
39,103,39,61,0,43,-43
39,103,39,75,0,31,-31
39,103,39,77,61,33,28
39,103,39,85,94,102,-8
39,103,39,93,686,674,12
39,103,39,95,59,59,0
39,103,39,99,39,31,8
39,103,39,113,0,32,-32
39,103,39,133,130,138,-8
39,103,39,139,44,36,8
39,103,39,151,190,130,60
39,103,39,153,1721,1336,385
39,103,39,155,42,0,42
39,103,39,157,0,32,-32
39,103,39,165,0,33,-33
39,103,39,169,764,982,-218
39,103,39,173,33,22,11
39,103,42,3,46,34,12
39,103,45,19,0,20,-20
39,103,47,37,0,31,-31
39,103,48,201,0,59,-59
39,105,39,9,224,295,-71
39,105,39,49,50,69,-19
39,105,39,53,126,111,15
39,105,39,79,54,43,11
39,105,39,163,48,0,48
39,105,39,167,46,66,-20
39,105,54,53,91,98,-7
39,105,54,107,0,33,-33
39,107,18,1,46,46,0
39,107,18,3,0,29,-29
39,107,18,75,34,36,-2
39,107,39,3,82,64,18
39,107,39,11,301,403,-102
39,107,39,37,145,116,29
39,107,39,49,53,119,-66
39,107,39,57,0,29,-29
39,107,39,95,0,28,-28
39,107,39,109,47,68,-21
39,107,39,113,84,71,13
39,107,39,149,78,84,-6
39,107,39,161,157,170,-13
39,109,4,13,0,27,-27
39,109,12,71,26,29,-3
39,109,17,31,0,26,-26
39,109,18,177,30,0,30
39,109,21,67,0,25,-25
39,109,26,163,36,0,36
39,109,39,3,31,57,-26
39,109,39,9,0,27,-27
39,109,39,11,65,60,5
39,109,39,17,67,114,-47
39,109,39,21,178,198,-20
39,109,39,23,289,235,54
39,109,39,37,489,441,48
39,109,39,41,0,44,-44
39,109,39,49,139,250,-111
39,109,39,57,276,239,37
39,109,39,61,49,103,-54
39,109,39,91,38,71,-33
39,109,39,95,29,0,29
39,109,39,107,68,47,21
39,109,39,113,2030,1585,445
39,109,39,135,56,54,2
39,109,39,149,609,656,-47
39,109,39,153,0,26,-26
39,109,39,165,75,118,-43
39,109,39,173,28,29,-1
39,111,39,13,137,157,-20
39,111,39,121,35,25,10
39,111,39,167,77,75,2
39,111,54,103,49,52,-3
39,113,1,73,26,0,26
39,113,1,89,0,33,-33
39,113,1,101,34,42,-8
39,113,2,20,42,49,-7
39,113,4,13,100,236,-136
39,113,4,19,61,73,-12
39,113,6,1,0,53,-53
39,113,6,29,44,61,-17
39,113,6,37,129,248,-119
39,113,6,59,43,63,-20
39,113,6,65,34,35,-1
39,113,6,71,44,0,44
39,113,6,73,97,96,1
39,113,6,75,0,26,-26
39,113,6,83,0,44,-44
39,113,6,85,31,0,31
39,113,8,13,0,35,-35
39,113,8,31,0,45,-45
39,113,8,35,0,28,-28
39,113,8,41,99,118,-19
39,113,8,69,0,33,-33
39,113,9,1,31,0,31
39,113,10,3,0,28,-28
39,113,11,1,36,48,-12
39,113,12,5,57,27,30
39,113,12,9,69,94,-25
39,113,12,11,76,67,9
39,113,12,21,41,50,-9
39,113,12,31,37,74,-37
39,113,12,57,74,131,-57
39,113,12,69,0,34,-34
39,113,12,71,55,99,-44
39,113,12,81,41,64,-23
39,113,12,83,0,55,-55
39,113,12,86,0,45,-45
39,113,12,91,79,83,-4
39,113,12,95,88,98,-10
39,113,12,97,32,0,32
39,113,12,99,58,98,-40
39,113,12,101,31,67,-36
39,113,12,103,81,117,-36
39,113,12,105,43,57,-14
39,113,12,113,0,39,-39
39,113,12,115,54,92,-38
39,113,12,117,0,56,-56
39,113,12,127,63,37,26
39,113,13,51,0,28,-28
39,113,13,67,40,82,-42
39,113,13,89,35,65,-30
39,113,13,121,40,122,-82
39,113,13,135,0,73,-73
39,113,13,153,38,30,8
39,113,15,3,104,75,29
39,113,16,1,40,0,40
39,113,17,31,162,341,-179
39,113,17,43,55,73,-18
39,113,17,163,36,66,-30
39,113,17,197,0,36,-36
39,113,18,3,51,90,-39
39,113,18,57,46,60,-14
39,113,18,63,0,38,-38
39,113,18,95,35,0,35
39,113,18,97,146,225,-79
39,113,18,105,0,25,-25
39,113,18,141,38,0,38
39,113,18,157,33,0,33
39,113,18,177,63,76,-13
39,113,19,163,0,35,-35
39,113,21,15,44,65,-21
39,113,21,37,35,48,-13
39,113,21,47,0,32,-32
39,113,21,67,65,62,3
39,113,21,111,69,86,-17
39,113,21,117,75,106,-31
39,113,21,151,0,41,-41
39,113,24,5,0,28,-28
39,113,24,31,49,73,-24
39,113,24,33,29,0,29
39,113,25,17,40,60,-20
39,113,26,49,39,0,39
39,113,26,65,38,0,38
39,113,26,81,41,39,2
39,113,26,99,39,33,6
39,113,26,125,121,115,6
39,113,26,161,32,34,-2
39,113,26,163,122,90,32
39,113,27,53,26,57,-31
39,113,29,189,40,44,-4
39,113,29,510,28,21,7
39,113,32,3,96,226,-130
39,113,34,23,0,27,-27
39,113,35,1,48,93,-45
39,113,36,5,0,29,-29
39,113,36,29,30,0,30
39,113,36,47,0,39,-39
39,113,36,55,26,41,-15
39,113,36,61,0,69,-69
39,113,36,81,28,52,-24
39,113,37,25,0,36,-36
39,113,37,51,51,58,-7
39,113,37,63,0,41,-41
39,113,37,81,0,39,-39
39,113,37,119,53,125,-72
39,113,37,133,45,70,-25
39,113,37,183,0,107,-107
39,113,39,1,0,39,-39
39,113,39,3,85,76,9
39,113,39,9,46,46,0
39,113,39,11,78,50,28
39,113,39,17,1133,1307,-174
39,113,39,21,128,110,18
39,113,39,23,1234,1189,45
39,113,39,25,124,139,-15
39,113,39,27,182,152,30
39,113,39,35,249,320,-71
39,113,39,37,358,313,45
39,113,39,39,25,0,25
39,113,39,41,47,99,-52
39,113,39,45,56,69,-13
39,113,39,47,47,56,-9
39,113,39,49,924,1556,-632
39,113,39,57,5684,5711,-27
39,113,39,61,783,903,-120
39,113,39,63,35,0,35
39,113,39,71,90,107,-17
39,113,39,85,30,23,7
39,113,39,89,44,38,6
39,113,39,91,101,85,16
39,113,39,93,53,30,23
39,113,39,95,172,124,48
39,113,39,97,0,67,-67
39,113,39,99,48,64,-16
39,113,39,103,32,0,32
39,113,39,107,71,84,-13
39,113,39,109,1585,2030,-445
39,113,39,119,27,0,27
39,113,39,129,27,0,27
39,113,39,131,0,31,-31
39,113,39,133,0,45,-45
39,113,39,135,592,748,-156
39,113,39,137,31,0,31
39,113,39,139,44,50,-6
39,113,39,141,37,43,-6
39,113,39,143,23,0,23
39,113,39,149,146,102,44
39,113,39,151,33,66,-33
39,113,39,153,71,104,-33
39,113,39,155,39,0,39
39,113,39,159,33,0,33
39,113,39,165,2023,2719,-696
39,113,39,169,26,0,26
39,113,39,173,69,55,14
39,113,40,109,63,45,18
39,113,41,51,0,28,-28
39,113,42,3,101,96,5
39,113,42,101,0,31,-31
39,113,45,13,0,34,-34
39,113,45,15,0,33,-33
39,113,45,19,30,43,-13
39,113,45,35,0,33,-33
39,113,45,45,0,29,-29
39,113,45,79,0,44,-44
39,113,47,13,0,54,-54
39,113,47,37,54,115,-61
39,113,47,93,55,50,5
39,113,47,125,26,0,26
39,113,47,149,0,66,-66
39,113,47,157,0,59,-59
39,113,48,27,29,47,-18
39,113,48,29,106,186,-80
39,113,48,85,0,51,-51
39,113,48,113,32,61,-29
39,113,48,121,0,42,-42
39,113,48,141,0,38,-38
39,113,48,157,0,28,-28
39,113,48,201,74,111,-37
39,113,48,439,42,81,-39
39,113,48,485,34,0,34
39,113,49,11,42,0,42
39,113,49,35,0,40,-40
39,113,51,13,0,24,-24
39,113,51,41,0,54,-54
39,113,51,59,50,152,-102
39,113,51,87,0,32,-32
39,113,51,107,0,43,-43
39,113,51,153,0,64,-64
39,113,51,510,0,28,-28
39,113,51,650,35,0,35
39,113,51,700,0,28,-28
39,113,51,810,32,68,-36
39,113,53,33,36,94,-58
39,113,53,53,0,44,-44
39,113,55,79,0,49,-49
39,115,39,9,57,34,23
39,115,39,49,67,82,-15
39,115,39,89,33,32,1
39,115,39,119,112,194,-82
39,115,39,127,49,75,-26
39,115,39,167,116,153,-37
39,117,39,33,177,187,-10
39,117,39,41,371,315,56
39,117,39,49,502,335,167
39,117,39,83,138,216,-78
39,117,39,89,60,42,18
39,117,39,101,262,381,-119
39,117,39,139,296,266,30
39,119,4,13,0,27,-27
39,119,39,9,0,28,-28
39,119,39,13,28,34,-6
39,119,39,31,202,173,29
39,119,39,41,0,40,-40
39,119,39,45,94,157,-63
39,119,39,49,335,512,-177
39,119,39,59,322,335,-13
39,119,39,61,27,0,27
39,119,39,83,26,0,26
39,119,39,89,607,628,-21
39,119,39,113,0,27,-27
39,119,39,115,194,112,82
39,119,39,121,30,44,-14
39,119,39,127,400,449,-49
39,119,39,167,53,0,53
39,119,45,51,0,25,-25
39,121,39,13,0,31,-31
39,121,39,35,34,0,34
39,121,39,49,0,28,-28
39,121,39,59,184,181,3
39,121,39,111,25,35,-10
39,121,39,119,44,30,14
39,121,39,167,56,85,-29
39,123,12,71,0,36,-36
39,123,39,35,123,65,58
39,123,39,43,159,257,-98
39,123,39,49,49,80,-31
39,123,39,63,0,25,-25
39,123,39,77,61,42,19
39,123,39,93,46,53,-7
39,123,39,95,557,413,144
39,123,39,143,392,366,26
39,123,39,147,84,0,84
39,123,39,153,29,0,29
39,123,39,173,297,414,-117
39,125,18,3,93,137,-44
39,125,39,39,274,348,-74
39,125,39,49,0,25,-25
39,125,39,69,52,26,26
39,125,39,95,0,32,-32
39,125,39,137,38,50,-12
39,125,39,161,116,156,-40
39,125,39,171,49,55,-6
39,127,39,9,84,57,27
39,127,39,45,507,412,95
39,127,39,49,310,246,64
39,127,39,73,107,155,-48
39,127,39,89,434,330,104
39,127,39,115,75,49,26
39,127,39,119,449,400,49
39,129,39,41,29,32,-3
39,129,39,45,429,453,-24
39,129,39,47,146,184,-38
39,129,39,49,1975,1584,391
39,129,39,71,0,42,-42
39,129,39,73,137,90,47
39,129,39,79,39,0,39
39,129,39,89,55,67,-12
39,129,39,97,112,116,-4
39,129,39,113,0,27,-27
39,129,39,131,44,0,44
39,129,39,141,414,382,32
39,129,39,145,0,41,-41
39,129,39,163,0,28,-28
39,131,39,1,42,50,-8
39,131,39,49,153,120,33
39,131,39,71,68,64,4
39,131,39,79,135,152,-17
39,131,39,113,31,0,31
39,131,39,129,0,44,-44
39,131,39,141,388,322,66
39,131,39,145,259,209,50
39,133,4,13,29,105,-76
39,133,6,37,41,44,-3
39,133,12,71,52,0,52
39,133,13,121,0,34,-34
39,133,17,31,0,67,-67
39,133,26,125,33,0,33
39,133,26,163,35,0,35
39,133,32,3,21,39,-18
39,133,37,119,0,44,-44
39,133,37,133,29,0,29
39,133,37,183,0,39,-39
39,133,39,5,29,0,29
39,133,39,7,84,81,3
39,133,39,29,113,65,48
39,133,39,35,1857,1229,628
39,133,39,43,32,27,5
39,133,39,49,125,243,-118
39,133,39,55,378,371,7
39,133,39,61,0,32,-32
39,133,39,85,204,170,34
39,133,39,93,92,88,4
39,133,39,95,58,27,31
39,133,39,99,313,340,-27
39,133,39,103,138,130,8
39,133,39,113,45,0,45
39,133,39,139,29,0,29
39,133,39,151,583,633,-50
39,133,39,153,3755,3465,290
39,133,39,155,553,522,31
39,133,39,157,76,28,48
39,133,39,169,58,63,-5
39,133,42,3,74,61,13
39,133,42,49,28,0,28
39,133,42,129,26,0,26
39,133,51,810,0,27,-27
39,135,18,161,38,0,38
39,135,18,177,240,234,6
39,135,39,17,548,437,111
39,135,39,37,150,164,-14
39,135,39,49,0,25,-25
39,135,39,57,38,59,-21
39,135,39,61,49,57,-8
39,135,39,109,54,56,-2
39,135,39,113,748,592,156
39,135,39,165,78,77,1
39,137,39,3,372,424,-52
39,137,39,11,0,33,-33
39,137,39,39,70,91,-21
39,137,39,49,41,83,-42
39,137,39,63,161,271,-110
39,137,39,65,0,38,-38
39,137,39,69,80,68,12
39,137,39,95,25,61,-36
39,137,39,113,0,31,-31
39,137,39,125,50,38,12
39,137,39,161,41,92,-51
39,137,39,173,29,43,-14
39,139,4,13,26,60,-34
39,139,6,73,0,27,-27
39,139,12,11,34,0,34
39,139,12,105,0,34,-34
39,139,17,31,31,26,5
39,139,26,163,0,30,-30
39,139,39,5,594,709,-115
39,139,39,33,691,703,-12
39,139,39,35,121,150,-29
39,139,39,41,97,73,24
39,139,39,43,37,69,-32
39,139,39,45,0,25,-25
39,139,39,49,392,768,-376
39,139,39,57,0,28,-28
39,139,39,61,32,47,-15
39,139,39,75,30,0,30
39,139,39,77,322,416,-94
39,139,39,83,146,199,-53
39,139,39,89,28,45,-17
39,139,39,93,40,51,-11
39,139,39,95,40,46,-6
39,139,39,101,58,114,-56
39,139,39,103,36,44,-8
39,139,39,113,50,44,6
39,139,39,117,266,296,-30
39,139,39,133,0,29,-29
39,139,39,147,26,50,-24
39,139,39,151,36,51,-15
39,139,39,153,67,59,8
39,139,39,165,0,35,-35
39,139,39,169,99,65,34
39,139,39,173,0,32,-32
39,141,39,9,43,31,12
39,141,39,23,31,28,3
39,141,39,27,42,37,5
39,141,39,45,103,104,-1
39,141,39,47,207,166,41
39,141,39,49,400,623,-223
39,141,39,53,39,0,39
39,141,39,57,0,35,-35
39,141,39,61,38,22,16
39,141,39,71,255,222,33
39,141,39,73,54,94,-40
39,141,39,79,128,150,-22
39,141,39,89,33,0,33
39,141,39,97,0,48,-48
39,141,39,113,43,37,6
39,141,39,129,382,414,-32
39,141,39,131,322,388,-66
39,141,39,145,123,81,42
39,141,39,163,143,114,29
39,143,39,35,0,52,-52
39,143,39,43,300,316,-16
39,143,39,49,48,108,-60
39,143,39,51,0,32,-32
39,143,39,63,55,79,-24
39,143,39,77,251,201,50
39,143,39,93,0,32,-32
39,143,39,95,267,330,-63
39,143,39,113,0,23,-23
39,143,39,123,366,392,-26
39,143,39,147,520,577,-57
39,143,39,173,247,335,-88
39,145,21,19,0,33,-33
39,145,21,67,0,21,-21
39,145,21,89,200,185,15
39,145,21,135,44,47,-3
39,145,39,1,140,114,26
39,145,39,17,27,31,-4
39,145,39,41,0,32,-32
39,145,39,49,259,224,35
39,145,39,53,30,27,3
39,145,39,57,0,31,-31
39,145,39,61,30,46,-16
39,145,39,71,0,36,-36
39,145,39,79,115,143,-28
39,145,39,87,185,176,9
39,145,39,101,0,30,-30
39,145,39,129,41,0,41
39,145,39,131,209,259,-50
39,145,39,141,81,123,-42
39,145,54,11,29,39,-10
39,147,39,3,26,36,-10
39,147,39,33,116,47,69
39,147,39,35,0,34,-34
39,147,39,41,0,29,-29
39,147,39,43,52,72,-20
39,147,39,49,41,127,-86
39,147,39,63,394,450,-56
39,147,39,77,153,176,-23
39,147,39,95,72,106,-34
39,147,39,123,0,84,-84
39,147,39,139,50,26,24
39,147,39,143,577,520,57
39,147,39,173,221,287,-66
39,147,39,175,191,248,-57
39,149,39,3,43,102,-59
39,149,39,11,385,288,97
39,149,39,21,71,48,23
39,149,39,23,0,33,-33
39,149,39,37,127,130,-3
39,149,39,49,68,154,-86
39,149,39,57,22,31,-9
39,149,39,61,39,44,-5
39,149,39,65,36,0,36
39,149,39,91,217,215,2
39,149,39,107,84,78,6
39,149,39,109,656,609,47
39,149,39,113,102,146,-44
39,151,4,13,88,168,-80
39,151,6,37,64,62,2
39,151,6,59,0,23,-23
39,151,6,65,0,40,-40
39,151,6,71,0,26,-26
39,151,6,73,66,70,-4
39,151,8,31,0,28,-28
39,151,12,9,0,54,-54
39,151,12,11,36,44,-8
39,151,12,21,31,43,-12
39,151,12,31,33,27,6
39,151,12,57,36,48,-12
39,151,12,71,67,75,-8
39,151,12,81,57,53,4
39,151,12,83,0,23,-23
39,151,12,91,0,29,-29
39,151,12,95,31,45,-14
39,151,12,99,32,69,-37
39,151,12,101,34,34,0
39,151,12,103,59,69,-10
39,151,12,105,33,52,-19
39,151,12,115,31,39,-8
39,151,12,117,0,45,-45
39,151,12,127,0,56,-56
39,151,13,121,0,61,-61
39,151,13,217,0,27,-27
39,151,17,31,51,95,-44
39,151,18,97,30,36,-6
39,151,26,125,35,0,35
39,151,26,163,53,37,16
39,151,32,3,69,103,-34
39,151,36,29,0,26,-26
39,151,36,47,0,38,-38
39,151,36,61,0,42,-42
39,151,37,51,0,34,-34
39,151,37,119,26,103,-77
39,151,37,129,0,29,-29
39,151,37,133,0,38,-38
39,151,37,183,0,62,-62
39,151,39,3,25,0,25
39,151,39,5,46,44,2
39,151,39,7,30,0,30
39,151,39,9,30,32,-2
39,151,39,17,0,42,-42
39,151,39,19,933,750,183
39,151,39,29,584,502,82
39,151,39,31,34,0,34
39,151,39,35,490,560,-70
39,151,39,41,58,70,-12
39,151,39,43,36,31,5
39,151,39,45,0,42,-42
39,151,39,49,385,774,-389
39,151,39,57,0,25,-25
39,151,39,59,41,37,4
39,151,39,61,74,93,-19
39,151,39,67,49,0,49
39,151,39,75,66,62,4
39,151,39,81,34,28,6
39,151,39,83,0,31,-31
39,151,39,85,56,64,-8
39,151,39,89,34,45,-11
39,151,39,93,108,86,22
39,151,39,95,71,74,-3
39,151,39,99,497,477,20
39,151,39,103,130,190,-60
39,151,39,113,66,33,33
39,151,39,133,633,583,50
39,151,39,139,51,36,15
39,151,39,153,3614,2943,671
39,151,39,155,95,121,-26
39,151,39,157,1092,917,175
39,151,39,165,0,23,-23
39,151,39,167,0,39,-39
39,151,39,169,598,609,-11
39,151,39,173,50,30,20
39,151,42,3,74,129,-55
39,151,42,49,0,27,-27
39,151,45,13,0,39,-39
39,151,45,15,0,29,-29
39,151,45,19,0,35,-35
39,151,45,35,0,31,-31
39,151,45,45,0,26,-26
39,151,45,51,0,41,-41
39,151,45,79,0,28,-28
39,151,47,37,0,48,-48
39,151,48,27,0,46,-46
39,151,48,29,0,32,-32
39,151,48,113,0,36,-36
39,151,48,201,43,67,-24
39,151,48,439,0,25,-25
39,151,51,810,49,0,49
39,151,54,107,40,0,40
39,153,4,13,162,262,-100
39,153,4,19,28,44,-16
39,153,4,21,0,34,-34
39,153,6,1,0,38,-38
39,153,6,37,139,193,-54
39,153,6,59,53,61,-8
39,153,6,65,31,44,-13
39,153,6,71,30,32,-2
39,153,6,73,112,109,3
39,153,6,75,0,29,-29
39,153,6,85,26,41,-15
39,153,8,13,0,27,-27
39,153,8,31,0,33,-33
39,153,8,35,0,36,-36
39,153,8,41,50,51,-1
39,153,11,1,0,31,-31
39,153,12,9,24,61,-37
39,153,12,11,39,86,-47
39,153,12,21,39,86,-47
39,153,12,31,41,120,-79
39,153,12,33,0,30,-30
39,153,12,57,57,107,-50
39,153,12,71,109,159,-50
39,153,12,81,39,46,-7
39,153,12,83,0,30,-30
39,153,12,85,0,32,-32
39,153,12,86,35,43,-8
39,153,12,95,47,103,-56
39,153,12,97,0,32,-32
39,153,12,99,69,109,-40
39,153,12,101,34,56,-22
39,153,12,103,102,96,6
39,153,12,105,35,40,-5
39,153,12,109,0,27,-27
39,153,12,115,40,85,-45
39,153,12,117,40,41,-1
39,153,12,127,45,62,-17
39,153,13,67,0,71,-71
39,153,13,89,0,65,-65
39,153,13,121,47,125,-78
39,153,13,135,0,45,-45
39,153,13,215,0,33,-33
39,153,13,245,0,28,-28
39,153,15,3,56,35,21
39,153,17,31,138,305,-167
39,153,17,43,50,52,-2
39,153,17,89,0,35,-35
39,153,17,97,0,27,-27
39,153,17,197,45,0,45
39,153,18,3,26,61,-35
39,153,18,97,32,93,-61
39,153,21,67,0,44,-44
39,153,21,111,60,45,15
39,153,22,33,0,28,-28
39,153,24,5,0,38,-38
39,153,24,31,34,64,-30
39,153,25,17,0,88,-88
39,153,25,25,0,42,-42
39,153,26,81,40,41,-1
39,153,26,99,57,0,57
39,153,26,125,87,111,-24
39,153,26,161,0,34,-34
39,153,26,163,153,81,72
39,153,27,53,0,43,-43
39,153,29,510,0,23,-23
39,153,31,55,0,39,-39
39,153,31,109,29,0,29
39,153,32,3,94,200,-106
39,153,35,1,0,28,-28
39,153,36,5,0,29,-29
39,153,36,29,64,48,16
39,153,36,47,0,61,-61
39,153,36,55,36,0,36
39,153,36,61,51,102,-51
39,153,36,81,33,31,2
39,153,37,51,0,44,-44
39,153,37,63,0,30,-30
39,153,37,81,0,34,-34
39,153,37,97,0,27,-27
39,153,37,119,49,276,-227
39,153,37,133,41,67,-26
39,153,37,183,38,119,-81
39,153,39,5,60,54,6
39,153,39,7,108,86,22
39,153,39,9,26,47,-21
39,153,39,13,28,0,28
39,153,39,17,51,85,-34
39,153,39,19,67,87,-20
39,153,39,25,0,31,-31
39,153,39,29,90,99,-9
39,153,39,31,32,0,32
39,153,39,35,5547,3777,1770
39,153,39,41,70,164,-94
39,153,39,43,48,81,-33
39,153,39,45,45,32,13
39,153,39,49,645,1055,-410
39,153,39,55,207,229,-22
39,153,39,59,52,42,10
39,153,39,61,133,152,-19
39,153,39,63,31,0,31
39,153,39,67,27,33,-6
39,153,39,77,29,36,-7
39,153,39,81,36,29,7
39,153,39,83,27,0,27
39,153,39,85,438,341,97
39,153,39,89,42,61,-19
39,153,39,93,300,266,34
39,153,39,95,176,108,68
39,153,39,99,366,273,93
39,153,39,103,1336,1721,-385
39,153,39,109,26,0,26
39,153,39,113,104,71,33
39,153,39,123,0,29,-29
39,153,39,133,3465,3755,-290
39,153,39,139,59,67,-8
39,153,39,151,2943,3614,-671
39,153,39,155,356,255,101
39,153,39,157,157,170,-13
39,153,39,159,0,29,-29
39,153,39,165,42,79,-37
39,153,39,167,37,0,37
39,153,39,169,748,804,-56
39,153,39,173,82,61,21
39,153,42,3,165,218,-53
39,153,42,19,42,44,-2
39,153,42,49,49,32,17
39,153,42,73,22,0,22
39,153,42,85,30,0,30
39,153,42,101,0,40,-40
39,153,42,125,30,37,-7
39,153,42,129,47,0,47
39,153,45,13,29,69,-40
39,153,45,19,32,33,-1
39,153,45,35,0,23,-23
39,153,45,45,0,80,-80
39,153,45,51,0,77,-77
39,153,45,91,0,29,-29
39,153,47,37,31,45,-14
39,153,47,93,0,39,-39
39,153,47,157,41,29,12
39,153,47,187,0,35,-35
39,153,48,27,28,41,-13
39,153,48,29,0,38,-38
39,153,48,85,0,57,-57
39,153,48,113,31,65,-34
39,153,48,121,0,50,-50
39,153,48,157,0,47,-47
39,153,48,201,66,140,-74
39,153,48,439,43,106,-63
39,153,48,453,0,58,-58
39,153,51,13,0,46,-46
39,153,51,59,50,39,11
39,153,51,107,0,24,-24
39,153,51,153,0,32,-32
39,153,51,510,0,29,-29
39,153,51,710,0,28,-28
39,153,51,810,41,40,1
39,153,53,33,0,51,-51
39,153,55,25,35,44,-9
39,153,55,79,0,48,-48
39,155,4,13,48,104,-56
39,155,6,37,24,49,-25
39,155,6,73,27,41,-14
39,155,12,69,0,42,-42
39,155,12,71,36,45,-9
39,155,12,95,0,37,-37
39,155,12,99,0,31,-31
39,155,12,101,35,34,1
39,155,12,103,42,58,-16
39,155,12,105,0,23,-23
39,155,12,115,0,29,-29
39,155,12,127,38,39,-1
39,155,17,31,0,40,-40
39,155,32,3,31,79,-48
39,155,36,61,0,22,-22
39,155,37,51,0,33,-33
39,155,37,119,0,60,-60
39,155,37,183,0,42,-42
39,155,39,7,351,321,30
39,155,39,29,108,102,6
39,155,39,35,228,421,-193
39,155,39,49,142,488,-346
39,155,39,55,262,204,58
39,155,39,61,0,49,-49
39,155,39,81,28,0,28
39,155,39,85,78,83,-5
39,155,39,93,40,26,14
39,155,39,95,0,44,-44
39,155,39,99,2432,2476,-44
39,155,39,103,0,42,-42
39,155,39,113,0,39,-39
39,155,39,133,522,553,-31
39,155,39,151,121,95,26
39,155,39,153,255,356,-101
39,155,42,3,72,165,-93
39,155,42,7,26,0,26
39,155,42,19,33,26,7
39,155,42,49,36,0,36
39,155,42,73,84,59,25
39,155,42,85,591,499,92
39,155,45,13,0,25,-25
39,155,45,45,0,25,-25
39,155,45,51,0,37,-37
39,155,48,201,0,31,-31
39,155,49,35,0,93,-93
39,157,4,13,0,24,-24
39,157,12,115,25,0,25
39,157,37,119,0,24,-24
39,157,39,13,0,25,-25
39,157,39,19,213,176,37
39,157,39,29,0,30,-30
39,157,39,31,287,324,-37
39,157,39,35,45,84,-39
39,157,39,41,0,27,-27
39,157,39,49,114,178,-64
39,157,39,59,150,79,71
39,157,39,67,196,184,12
39,157,39,75,288,140,148
39,157,39,99,32,0,32
39,157,39,103,32,0,32
39,157,39,133,28,76,-48
39,157,39,151,917,1092,-175
39,157,39,153,170,157,13
39,157,39,169,96,96,0
39,157,42,3,0,27,-27
39,159,26,125,55,0,55
39,159,39,21,222,237,-15
39,159,39,23,43,39,4
39,159,39,41,394,329,65
39,159,39,45,32,53,-21
39,159,39,49,1429,1014,415
39,159,39,57,34,0,34
39,159,39,65,83,72,11
39,159,39,89,58,34,24
39,159,39,91,243,282,-39
39,159,39,97,171,149,22
39,159,39,101,163,217,-54
39,159,39,113,0,33,-33
39,159,39,153,29,0,29
39,161,18,1,67,99,-32
39,161,18,3,59,97,-38
39,161,39,3,240,288,-48
39,161,39,11,31,69,-38
39,161,39,39,34,0,34
39,161,39,49,49,62,-13
39,161,39,107,170,157,13
39,161,39,125,156,116,40
39,161,39,137,92,41,51
39,163,39,9,54,71,-17
39,163,39,45,0,30,-30
39,163,39,49,70,95,-25
39,163,39,73,56,47,9
39,163,39,79,236,268,-32
39,163,39,105,0,48,-48
39,163,39,129,28,0,28
39,163,39,141,114,143,-29
39,165,4,13,66,82,-16
39,165,6,37,78,61,17
39,165,6,59,31,48,-17
39,165,6,73,37,36,1
39,165,8,5,0,37,-37
39,165,12,11,0,42,-42
39,165,12,21,0,23,-23
39,165,12,57,46,51,-5
39,165,12,71,0,50,-50
39,165,12,83,0,29,-29
39,165,12,95,0,34,-34
39,165,12,103,36,41,-5
39,165,12,127,0,29,-29
39,165,13,67,0,30,-30
39,165,13,121,0,51,-51
39,165,13,135,52,0,52
39,165,17,31,92,129,-37
39,165,17,43,0,39,-39
39,165,18,3,26,0,26
39,165,18,29,34,39,-5
39,165,18,47,32,0,32
39,165,18,57,71,94,-23
39,165,18,97,60,61,-1
39,165,21,15,108,115,-7
39,165,21,37,84,77,7
39,165,21,67,37,57,-20
39,165,21,111,50,63,-13
39,165,21,117,123,135,-12
39,165,21,151,0,31,-31
39,165,25,21,39,0,39
39,165,26,125,92,0,92
39,165,26,163,55,36,19
39,165,29,189,52,0,52
39,165,32,3,33,30,3
39,165,36,55,38,0,38
39,165,37,119,32,44,-12
39,165,37,183,0,38,-38
39,165,39,1,34,38,-4
39,165,39,3,45,0,45
39,165,39,15,78,91,-13
39,165,39,17,3699,3097,602
39,165,39,23,69,71,-2
39,165,39,25,1093,822,271
39,165,39,27,493,495,-2
39,165,39,35,112,53,59
39,165,39,41,108,72,36
39,165,39,45,0,32,-32
39,165,39,49,376,346,30
39,165,39,57,453,327,126
39,165,39,61,3761,2526,1235
39,165,39,71,102,131,-29
39,165,39,89,0,32,-32
39,165,39,93,27,0,27
39,165,39,95,50,36,14
39,165,39,103,33,0,33
39,165,39,109,118,75,43
39,165,39,113,2719,2023,696
39,165,39,135,77,78,-1
39,165,39,139,35,0,35
39,165,39,151,23,0,23
39,165,39,153,79,42,37
39,165,39,173,30,32,-2
39,165,42,3,53,38,15
39,165,47,37,0,28,-28
39,165,47,157,48,0,48
39,165,48,29,0,31,-31
39,165,48,85,0,62,-62
39,165,48,113,0,24,-24
39,165,48,201,55,74,-19
39,165,48,439,0,35,-35
39,165,53,33,0,42,-42
39,167,39,9,195,151,44
39,167,39,35,0,30,-30
39,167,39,45,0,29,-29
39,167,39,49,126,213,-87
39,167,39,59,34,0,34
39,167,39,61,0,20,-20
39,167,39,89,0,26,-26
39,167,39,105,66,46,20
39,167,39,111,75,77,-2
39,167,39,115,153,116,37
39,167,39,119,0,53,-53
39,167,39,121,85,56,29
39,167,39,151,39,0,39
39,167,39,153,0,37,-37
39,167,54,73,40,46,-6
39,167,54,85,0,24,-24
39,167,54,95,30,0,30
39,167,54,107,714,788,-74
39,169,4,13,0,38,-38
39,169,17,31,0,30,-30
39,169,39,5,372,325,47
39,169,39,31,48,36,12
39,169,39,35,253,224,29
39,169,39,41,35,38,-3
39,169,39,49,138,225,-87
39,169,39,61,0,30,-30
39,169,39,75,472,416,56
39,169,39,77,31,0,31
39,169,39,83,36,0,36
39,169,39,85,35,0,35
39,169,39,93,70,78,-8
39,169,39,95,0,27,-27
39,169,39,103,982,764,218
39,169,39,113,0,26,-26
39,169,39,133,63,58,5
39,169,39,139,65,99,-34
39,169,39,151,609,598,11
39,169,39,153,804,748,56
39,169,39,157,96,96,0
39,169,42,3,0,34,-34
39,171,18,3,39,49,-10
39,171,18,33,81,57,24
39,171,18,151,48,107,-59
39,171,26,59,60,92,-32
39,171,39,39,255,355,-100
39,171,39,49,0,55,-55
39,171,39,51,267,243,24
39,171,39,69,98,95,3
39,171,39,95,89,150,-61
39,171,39,125,55,49,6
39,171,39,173,0,52,-52
39,173,4,13,33,76,-43
39,173,6,37,0,30,-30
39,173,6,73,0,30,-30
39,173,12,11,0,32,-32
39,173,12,71,0,24,-24
39,173,12,103,0,31,-31
39,173,12,105,0,23,-23
39,173,13,121,0,25,-25
39,173,17,31,53,127,-74
39,173,18,3,33,0,33
39,173,18,97,0,31,-31
39,173,24,31,0,39,-39
39,173,26,81,31,0,31
39,173,26,91,54,39,15
39,173,26,115,110,141,-31
39,173,26,125,67,57,10
39,173,26,161,0,67,-67
39,173,26,163,106,80,26
39,173,32,3,0,50,-50
39,173,36,61,0,23,-23
39,173,37,81,0,29,-29
39,173,37,119,0,42,-42
39,173,37,183,0,27,-27
39,173,39,3,76,62,14
39,173,39,17,0,47,-47
39,173,39,35,179,234,-55
39,173,39,39,52,56,-4
39,173,39,41,0,49,-49
39,173,39,43,71,79,-8
39,173,39,49,175,399,-224
39,173,39,51,191,136,55
39,173,39,61,57,56,1
39,173,39,63,562,567,-5
39,173,39,65,32,0,32
39,173,39,69,266,211,55
39,173,39,77,36,26,10
39,173,39,85,29,0,29
39,173,39,89,0,26,-26
39,173,39,93,87,68,19
39,173,39,95,3997,3298,699
39,173,39,99,0,25,-25
39,173,39,103,22,33,-11
39,173,39,109,29,28,1
39,173,39,113,55,69,-14
39,173,39,123,414,297,117
39,173,39,137,43,29,14
39,173,39,139,32,0,32
39,173,39,143,335,247,88
39,173,39,147,287,221,66
39,173,39,151,30,50,-20
39,173,39,153,61,82,-21
39,173,39,165,32,30,2
39,173,39,171,52,0,52
39,173,39,175,0,27,-27
39,173,42,3,0,34,-34
39,173,45,19,0,21,-21
39,173,48,201,0,29,-29
39,175,39,33,190,209,-19
39,175,39,49,25,81,-56
39,175,39,63,212,214,-2
39,175,39,65,108,158,-50
39,175,39,101,127,143,-16
39,175,39,147,248,191,57
39,175,39,173,27,0,27
40,1,5,7,198,243,-45
40,1,5,143,169,98,71
40,1,40,21,194,287,-93
40,1,40,41,95,80,15
40,1,40,101,28,39,-11
40,1,40,135,57,35,22
40,1,40,143,54,109,-55
40,1,40,145,0,35,-35
40,3,40,47,86,86,0
40,3,40,93,27,0,27
40,3,40,151,51,38,13
40,5,40,13,226,194,32
40,5,40,29,86,64,22
40,5,40,109,28,38,-10
40,5,40,121,72,69,3
40,5,40,123,34,36,-2
40,5,40,127,0,50,-50
40,5,48,181,39,36,3
40,7,20,175,67,91,-24
40,7,40,139,36,0,36
40,9,40,15,39,0,39
40,9,40,17,53,72,-19
40,9,40,27,46,38,8
40,9,40,39,188,150,38
40,9,40,51,0,39,-39
40,9,40,55,38,39,-1
40,9,40,65,41,39,2
40,9,40,109,122,118,4
40,9,40,129,104,125,-21
40,9,40,149,183,193,-10
40,9,40,153,37,0,37
40,9,48,483,26,0,26
40,11,40,17,66,95,-29
40,11,40,27,0,36,-36
40,11,40,39,61,72,-11
40,11,40,47,67,69,-2
40,11,40,73,37,27,10
40,11,40,93,87,47,40
40,11,40,109,95,53,42
40,11,40,119,0,26,-26
40,13,40,5,194,226,-32
40,13,40,19,93,60,33
40,13,40,23,121,60,61
40,13,40,27,28,63,-35
40,13,40,69,174,99,75
40,13,40,89,101,60,41
40,13,40,95,180,117,63
40,13,40,109,68,92,-24
40,13,40,121,0,46,-46
40,13,40,127,46,36,10
40,13,40,143,0,85,-85
40,13,48,85,72,107,-35
40,13,48,113,97,80,17
40,13,48,121,50,39,11
40,13,48,147,32,0,32
40,13,48,181,539,377,162
40,13,48,439,58,62,-4
40,15,40,9,0,39,-39
40,15,40,17,158,117,41
40,15,40,27,69,73,-4
40,15,40,31,257,271,-14
40,15,40,39,162,147,15
40,15,40,51,202,255,-53
40,15,40,75,71,0,71
40,15,40,109,192,262,-70
40,17,4,13,34,42,-8
40,17,6,59,24,0,24
40,17,6,73,49,27,22
40,17,20,173,0,45,-45
40,17,40,9,72,53,19
40,17,40,11,95,66,29
40,17,40,15,117,158,-41
40,17,40,19,52,0,52
40,17,40,27,822,761,61
40,17,40,31,93,35,58
40,17,40,39,129,108,21
40,17,40,47,98,62,36
40,17,40,51,280,403,-123
40,17,40,65,39,0,39
40,17,40,73,123,134,-11
40,17,40,81,64,64,0
40,17,40,83,89,110,-21
40,17,40,87,137,135,2
40,17,40,95,0,30,-30
40,17,40,109,5654,3921,1733
40,17,40,119,78,56,22
40,17,40,123,49,0,49
40,17,40,125,83,94,-11
40,17,40,133,0,40,-40
40,17,40,137,64,0,64
40,17,40,143,168,147,21
40,17,40,149,43,0,43
40,17,40,153,45,30,15
40,17,48,85,36,53,-17
40,17,48,113,59,54,5
40,17,48,121,34,45,-11
40,17,48,201,51,83,-32
40,17,48,439,106,97,9
40,17,48,485,27,0,27
40,19,40,13,60,93,-33
40,19,40,17,0,52,-52
40,19,40,27,143,150,-7
40,19,40,31,45,43,2
40,19,40,49,95,73,22
40,19,40,67,101,54,47
40,19,40,69,115,111,4
40,19,40,85,266,202,64
40,19,40,95,152,121,31
40,19,40,99,91,110,-19
40,19,40,109,235,250,-15
40,19,40,119,0,28,-28
40,19,40,121,24,0,24
40,19,40,123,71,68,3
40,19,40,137,107,111,-4
40,19,40,143,39,42,-3
40,19,48,97,50,0,50
40,19,48,113,85,50,35
40,19,48,121,68,62,6
40,19,48,181,0,31,-31
40,19,48,201,31,45,-14
40,19,48,439,78,41,37
40,19,48,485,0,30,-30
40,21,5,7,53,58,-5
40,21,5,131,36,0,36
40,21,5,143,0,47,-47
40,21,40,1,287,194,93
40,21,40,27,34,47,-13
40,21,40,37,22,39,-17
40,21,40,41,94,48,46
40,21,40,97,149,154,-5
40,21,40,101,346,374,-28
40,21,40,109,56,96,-40
40,21,40,111,49,44,5
40,21,40,113,0,30,-30
40,21,40,115,37,0,37
40,21,40,131,60,57,3
40,21,40,135,112,87,25
40,21,40,143,352,486,-134
40,21,40,145,145,196,-51
40,23,40,13,60,121,-61
40,23,40,89,92,106,-14
40,23,40,109,0,37,-37
40,23,40,127,116,129,-13
40,23,48,277,110,130,-20
40,27,2,20,57,75,-18
40,27,4,13,120,159,-39
40,27,4,19,0,62,-62
40,27,5,7,33,30,3
40,27,5,131,27,0,27
40,27,5,143,47,0,47
40,27,6,37,158,98,60
40,27,6,59,60,47,13
40,27,6,65,69,0,69
40,27,6,67,26,34,-8
40,27,6,71,56,51,5
40,27,6,73,126,72,54
40,27,6,111,39,0,39
40,27,8,1,0,39,-39
40,27,8,5,36,37,-1
40,27,8,31,0,27,-27
40,27,8,41,70,69,1
40,27,11,1,0,27,-27
40,27,12,5,87,0,87
40,27,12,11,33,0,33
40,27,12,31,42,40,2
40,27,12,33,0,37,-37
40,27,12,57,0,43,-43
40,27,12,91,30,0,30
40,27,12,95,24,27,-3
40,27,13,121,31,27,4
40,27,15,3,44,47,-3
40,27,17,31,71,56,15
40,27,17,97,36,0,36
40,27,20,45,0,34,-34
40,27,20,91,31,78,-47
40,27,20,173,120,87,33
40,27,22,71,0,33,-33
40,27,25,17,0,41,-41
40,27,29,47,0,32,-32
40,27,29,77,37,0,37
40,27,29,95,40,40,0
40,27,29,97,29,0,29
40,27,29,189,0,28,-28
40,27,32,3,65,68,-3
40,27,35,1,27,0,27
40,27,36,47,0,23,-23
40,27,36,61,34,62,-28
40,27,39,49,24,0,24
40,27,40,9,38,46,-8
40,27,40,11,36,0,36
40,27,40,13,63,28,35
40,27,40,15,73,69,4
40,27,40,17,761,822,-61
40,27,40,19,150,143,7
40,27,40,21,47,34,13
40,27,40,31,383,135,248
40,27,40,37,48,31,17
40,27,40,39,74,75,-1
40,27,40,47,129,89,40
40,27,40,49,256,165,91
40,27,40,51,462,451,11
40,27,40,63,46,39,7
40,27,40,65,77,57,20
40,27,40,69,31,29,2
40,27,40,71,82,51,31
40,27,40,73,47,35,12
40,27,40,79,0,39,-39
40,27,40,81,152,138,14
40,27,40,83,136,150,-14
40,27,40,87,1064,1143,-79
40,27,40,89,31,45,-14
40,27,40,91,55,31,24
40,27,40,95,38,41,-3
40,27,40,97,34,0,34
40,27,40,99,57,68,-11
40,27,40,101,71,43,28
40,27,40,109,11053,8793,2260
40,27,40,111,53,36,17
40,27,40,113,28,29,-1
40,27,40,115,31,0,31
40,27,40,119,233,121,112
40,27,40,121,113,70,43
40,27,40,123,197,137,60
40,27,40,125,576,602,-26
40,27,40,127,0,41,-41
40,27,40,131,37,30,7
40,27,40,133,113,49,64
40,27,40,135,40,0,40
40,27,40,137,120,109,11
40,27,40,143,703,633,70
40,27,40,145,60,61,-1
40,27,40,147,67,39,28
40,27,40,149,28,0,28
40,27,40,151,25,0,25
40,27,40,153,36,33,3
40,27,47,37,33,0,33
40,27,48,27,49,0,49
40,27,48,29,114,145,-31
40,27,48,85,114,196,-82
40,27,48,113,209,256,-47
40,27,48,121,163,98,65
40,27,48,141,0,28,-28
40,27,48,157,0,49,-49
40,27,48,181,0,25,-25
40,27,48,201,138,262,-124
40,27,48,303,46,37,9
40,27,48,329,0,36,-36
40,27,48,339,29,38,-9
40,27,48,355,30,37,-7
40,27,48,375,0,28,-28
40,27,48,381,28,0,28
40,27,48,439,249,311,-62
40,27,48,453,69,107,-38
40,27,48,485,68,36,32
40,27,48,491,33,46,-13
40,27,51,59,0,32,-32
40,27,51,810,49,0,49
40,27,53,33,30,77,-47
40,29,40,5,64,86,-22
40,29,40,121,0,40,-40
40,29,40,123,60,90,-30
40,31,1,89,37,0,37
40,31,2,20,0,101,-101
40,31,2,90,121,139,-18
40,31,4,3,54,69,-15
40,31,4,13,78,114,-36
40,31,4,19,0,26,-26
40,31,5,119,26,0,26
40,31,5,131,49,0,49
40,31,6,37,75,83,-8
40,31,6,65,40,0,40
40,31,6,71,97,116,-19
40,31,6,73,84,90,-6
40,31,6,85,0,35,-35
40,31,8,41,173,253,-80
40,31,12,57,35,59,-24
40,31,12,86,0,34,-34
40,31,12,95,0,47,-47
40,31,13,51,45,0,45
40,31,13,73,0,41,-41
40,31,13,151,0,49,-49
40,31,13,179,74,94,-20
40,31,13,215,0,91,-91
40,31,13,245,53,97,-44
40,31,15,3,166,324,-158
40,31,17,31,44,52,-8
40,31,20,61,67,207,-140
40,31,20,103,55,62,-7
40,31,20,161,53,86,-33
40,31,20,173,39,33,6
40,31,21,47,135,117,18
40,31,21,93,0,78,-78
40,31,22,115,141,69,72
40,31,24,3,41,32,9
40,31,24,25,0,43,-43
40,31,24,31,0,41,-41
40,31,24,33,0,41,-41
40,31,29,169,46,81,-35
40,31,32,3,81,63,18
40,31,36,45,170,152,18
40,31,36,71,35,0,35
40,31,37,51,170,271,-101
40,31,37,93,0,47,-47
40,31,37,133,76,78,-2
40,31,40,15,271,257,14
40,31,40,17,35,93,-58
40,31,40,19,43,45,-2
40,31,40,27,135,383,-248
40,31,40,33,117,100,17
40,31,40,39,26,55,-29
40,31,40,51,68,150,-82
40,31,40,65,100,97,3
40,31,40,75,119,77,42
40,31,40,87,0,37,-37
40,31,40,109,384,668,-284
40,31,40,119,49,48,1
40,31,40,125,0,48,-48
40,31,40,137,286,344,-58
40,31,40,141,129,69,60
40,31,40,143,92,174,-82
40,31,45,79,67,108,-41
40,31,47,125,180,220,-40
40,31,47,157,0,34,-34
40,31,48,27,335,609,-274
40,31,48,29,163,171,-8
40,31,48,85,47,51,-4
40,31,48,99,111,143,-32
40,31,48,113,141,169,-28
40,31,48,121,57,88,-31
40,31,48,141,226,217,9
40,31,48,201,100,177,-77
40,31,48,303,0,30,-30
40,31,48,375,0,38,-38
40,31,48,381,27,0,27
40,31,48,439,132,221,-89
40,31,48,453,0,38,-38
40,31,48,485,153,177,-24
40,31,51,59,48,123,-75
40,31,51,153,0,44,-44
40,31,51,700,48,44,4
40,31,51,810,52,31,21
40,31,53,53,150,688,-538
40,31,53,67,0,200,-200
40,33,40,31,100,117,-17
40,33,40,137,55,62,-7
40,33,48,485,55,83,-28
40,35,40,41,80,62,18
40,35,40,97,142,160,-18
40,35,40,109,0,34,-34
40,35,40,115,169,147,22
40,35,40,131,99,128,-29
40,35,40,143,68,67,1
40,35,40,145,0,37,-37
40,37,4,13,35,0,35
40,37,40,21,39,22,17
40,37,40,27,31,48,-17
40,37,40,81,142,108,34
40,37,40,97,43,46,-3
40,37,40,101,69,56,13
40,37,40,107,0,28,-28
40,37,40,109,177,158,19
40,37,40,111,208,183,25
40,37,40,113,146,158,-12
40,37,40,117,184,141,43
40,37,40,119,282,220,62
40,37,40,121,31,0,31
40,37,40,131,141,135,6
40,37,40,143,3995,3431,564
40,37,40,145,136,153,-17
40,37,40,147,44,51,-7
40,37,48,201,0,32,-32
40,39,40,9,150,188,-38
40,39,40,11,72,61,11
40,39,40,15,147,162,-15
40,39,40,17,108,129,-21
40,39,40,27,75,74,1
40,39,40,31,55,26,29
40,39,40,43,40,0,40
40,39,40,47,0,24,-24
40,39,40,65,24,26,-2
40,39,40,75,30,0,30
40,39,40,109,224,316,-92
40,39,40,119,0,37,-37
40,39,40,143,52,91,-39
40,39,40,149,222,220,2
40,39,40,153,26,0,26
40,41,5,7,520,412,108
40,41,5,143,81,58,23
40,41,20,173,33,0,33
40,41,29,97,81,63,18
40,41,29,119,101,74,27
40,41,29,145,33,56,-23
40,41,40,1,80,95,-15
40,41,40,21,48,94,-46
40,41,40,35,62,80,-18
40,41,40,97,181,239,-58
40,41,40,101,0,30,-30
40,41,40,109,34,35,-1
40,41,40,115,365,319,46
40,41,40,131,64,81,-17
40,41,40,143,161,245,-84
40,41,40,145,41,38,3
40,41,40,147,0,30,-30
40,41,48,439,0,33,-33
40,43,40,39,0,40,-40
40,43,40,109,0,32,-32
40,43,40,153,71,79,-8
40,45,40,153,104,99,5
40,47,4,13,35,81,-46
40,47,4,19,0,35,-35
40,47,5,7,29,0,29
40,47,5,143,37,0,37
40,47,6,95,56,39,17
40,47,8,41,116,0,116
40,47,12,33,83,0,83
40,47,12,91,29,0,29
40,47,12,113,84,30,54
40,47,13,185,60,0,60
40,47,15,3,45,0,45
40,47,20,173,47,77,-30
40,47,32,3,30,0,30
40,47,40,3,86,86,0
40,47,40,11,69,67,2
40,47,40,17,62,98,-36
40,47,40,27,89,129,-40
40,47,40,39,24,0,24
40,47,40,53,90,118,-28
40,47,40,65,42,0,42
40,47,40,71,63,103,-40
40,47,40,73,134,81,53
40,47,40,83,0,54,-54
40,47,40,93,148,111,37
40,47,40,103,44,96,-52
40,47,40,109,260,393,-133
40,47,40,119,103,109,-6
40,47,40,143,133,179,-46
40,47,40,151,72,37,35
40,47,40,153,48,50,-2
40,47,48,29,50,51,-1
40,47,48,113,0,40,-40
40,47,48,201,28,43,-15
40,47,48,355,0,35,-35
40,47,48,439,0,42,-42
40,47,53,53,0,27,-27
40,49,40,19,73,95,-22
40,49,40,27,165,256,-91
40,49,40,51,67,66,1
40,49,40,87,226,150,76
40,49,40,99,160,177,-17
40,49,40,109,161,147,14
40,49,40,123,141,181,-40
40,49,40,125,0,37,-37
40,49,40,137,42,67,-25
40,49,40,143,0,31,-31
40,51,4,13,25,0,25
40,51,40,9,39,0,39
40,51,40,15,255,202,53
40,51,40,17,403,280,123
40,51,40,27,451,462,-11
40,51,40,31,150,68,82
40,51,40,49,66,67,-1
40,51,40,87,215,256,-41
40,51,40,109,804,670,134
40,51,40,121,39,0,39
40,51,40,125,51,35,16
40,51,40,137,173,154,19
40,51,40,143,39,60,-21
40,51,48,201,31,0,31
40,53,40,47,118,90,28
40,53,40,71,43,72,-29
40,55,40,9,39,38,1
40,55,40,65,91,70,21
40,55,40,109,0,38,-38
40,57,40,65,0,50,-50
40,59,40,153,66,60,6
40,61,5,131,30,43,-13
40,61,40,77,37,0,37
40,61,40,79,120,101,19
40,61,40,91,0,43,-43
40,61,40,101,56,66,-10
40,61,40,121,85,100,-15
40,61,40,135,48,56,-8
40,61,40,143,37,0,37
40,63,40,27,39,46,-7
40,63,40,107,54,52,2
40,63,40,109,45,58,-13
40,63,40,111,0,67,-67
40,63,40,121,67,59,8
40,63,40,123,93,132,-39
40,63,40,125,56,47,9
40,63,40,133,157,152,5
40,63,40,143,44,0,44
40,65,6,95,0,47,-47
40,65,8,41,0,43,-43
40,65,10,1,0,59,-59
40,65,20,173,47,46,1
40,65,28,87,27,0,27
40,65,40,9,39,41,-2
40,65,40,17,0,39,-39
40,65,40,27,57,77,-20
40,65,40,31,97,100,-3
40,65,40,39,26,24,2
40,65,40,47,0,42,-42
40,65,40,55,70,91,-21
40,65,40,57,50,0,50
40,65,40,75,77,87,-10
40,65,40,109,112,197,-85
40,65,40,141,51,49,2
40,65,40,143,0,35,-35
40,65,45,35,59,0,59
40,65,48,29,0,172,-172
40,65,48,113,0,38,-38
40,65,48,439,0,61,-61
40,65,48,485,41,32,9
40,65,48,487,0,33,-33
40,65,53,53,59,36,23
40,67,40,19,54,101,-47
40,67,40,137,123,97,26
40,67,48,485,29,35,-6
40,69,40,13,99,174,-75
40,69,40,19,111,115,-4
40,69,40,27,29,31,-2
40,69,40,95,88,58,30
40,69,40,99,26,47,-21
40,69,40,109,0,30,-30
40,69,40,123,45,75,-30
40,71,20,35,165,130,35
40,71,20,173,85,89,-4
40,71,20,191,22,0,22
40,71,40,27,51,82,-31
40,71,40,47,103,63,40
40,71,40,53,72,43,29
40,71,40,103,95,119,-24
40,71,40,109,179,270,-91
40,71,40,113,254,270,-16
40,71,40,117,0,29,-29
40,71,40,119,153,184,-31
40,71,40,131,0,44,-44
40,71,40,143,104,161,-57
40,71,40,147,74,117,-43
40,71,48,201,57,47,10
40,73,40,11,27,37,-10
40,73,40,17,134,123,11
40,73,40,27,35,47,-12
40,73,40,47,81,134,-53
40,73,40,83,70,47,23
40,73,40,109,139,221,-82
40,73,40,119,0,32,-32
40,75,40,15,0,71,-71
40,75,40,31,77,119,-42
40,75,40,39,0,30,-30
40,75,40,65,87,77,10
40,75,40,109,29,60,-31
40,75,40,141,38,0,38
40,75,40,149,66,53,13
40,77,40,61,0,37,-37
40,77,40,79,138,110,28
40,77,40,109,24,37,-13
40,77,40,121,156,194,-38
40,77,40,127,43,35,8
40,77,40,143,0,25,-25
40,79,5,7,0,39,-39
40,79,5,33,103,135,-32
40,79,5,127,45,51,-6
40,79,5,131,734,716,18
40,79,5,143,0,49,-49
40,79,40,27,39,0,39
40,79,40,61,101,120,-19
40,79,40,77,110,138,-28
40,79,40,89,37,46,-9
40,79,40,109,69,38,31
40,79,40,121,63,87,-24
40,79,40,135,116,196,-80
40,79,40,143,78,108,-30
40,81,40,17,64,64,0
40,81,40,27,138,152,-14
40,81,40,37,108,142,-34
40,81,40,83,0,42,-42
40,81,40,107,74,58,16
40,81,40,109,597,638,-41
40,81,40,119,221,255,-34
40,81,40,125,388,436,-48
40,81,40,133,41,33,8
40,81,40,143,80,112,-32
40,83,40,17,110,89,21
40,83,40,27,150,136,14
40,83,40,47,54,0,54
40,83,40,73,47,70,-23
40,83,40,81,42,0,42
40,83,40,103,44,0,44
40,83,40,109,2115,1442,673
40,83,40,119,109,128,-19
40,83,40,125,40,0,40
40,83,40,143,71,71,0
40,83,48,113,30,0,30
40,83,48,439,0,28,-28
40,85,40,19,202,266,-64
40,85,40,95,0,33,-33
40,85,48,97,125,85,40
40,85,48,367,0,28,-28
40,87,40,17,135,137,-2
40,87,40,27,1143,1064,79
40,87,40,31,37,0,37
40,87,40,49,150,226,-76
40,87,40,51,256,215,41
40,87,40,99,30,0,30
40,87,40,109,674,538,136
40,87,40,123,35,56,-21
40,87,40,125,44,46,-2
40,87,40,137,23,0,23
40,87,40,143,43,45,-2
40,87,48,439,29,32,-3
40,89,5,113,0,50,-50
40,89,5,133,55,82,-27
40,89,40,13,60,101,-41
40,89,40,23,106,92,14
40,89,40,27,45,31,14
40,89,40,79,46,37,9
40,89,40,109,60,77,-17
40,89,40,127,55,41,14
40,89,40,143,42,29,13
40,89,48,37,48,60,-12
40,89,48,113,27,0,27
40,89,48,277,27,0,27
40,89,48,439,27,29,-2
40,91,40,27,31,55,-24
40,91,40,61,43,0,43
40,91,40,101,244,282,-38
40,91,40,109,111,81,30
40,91,40,111,106,66,40
40,91,40,121,108,127,-19
40,91,40,125,0,40,-40
40,91,40,135,37,0,37
40,91,40,143,119,113,6
40,91,40,145,41,38,3
40,93,40,3,0,27,-27
40,93,40,11,47,87,-40
40,93,40,47,111,148,-37
40,93,40,109,25,0,25
40,95,40,13,117,180,-63
40,95,40,17,30,0,30
40,95,40,19,121,152,-31
40,95,40,27,41,38,3
40,95,40,69,58,88,-30
40,95,40,85,33,0,33
40,95,40,109,94,53,41
40,95,48,113,0,41,-41
40,95,48,181,25,46,-21
40,97,5,7,61,30,31
40,97,5,143,37,0,37
40,97,40,21,154,149,5
40,97,40,27,0,34,-34
40,97,40,35,160,142,18
40,97,40,37,46,43,3
40,97,40,41,239,181,58
40,97,40,101,41,57,-16
40,97,40,109,0,63,-63
40,97,40,115,60,52,8
40,97,40,119,0,36,-36
40,97,40,131,388,467,-79
40,97,40,143,513,538,-25
40,97,40,145,112,156,-44
40,97,40,147,33,0,33
40,99,40,19,110,91,19
40,99,40,27,68,57,11
40,99,40,49,177,160,17
40,99,40,69,47,26,21
40,99,40,87,0,30,-30
40,99,40,109,61,58,3
40,99,40,123,109,105,4
40,101,5,7,31,0,31
40,101,5,131,43,34,9
40,101,5,143,30,0,30
40,101,6,65,35,0,35
40,101,40,1,39,28,11
40,101,40,21,374,346,28
40,101,40,27,43,71,-28
40,101,40,37,56,69,-13
40,101,40,41,30,0,30
40,101,40,61,66,56,10
40,101,40,91,282,244,38
40,101,40,97,57,41,16
40,101,40,109,138,199,-61
40,101,40,111,131,78,53
40,101,40,113,0,42,-42
40,101,40,119,0,40,-40
40,101,40,121,84,97,-13
40,101,40,125,28,24,4
40,101,40,131,51,64,-13
40,101,40,135,152,160,-8
40,101,40,143,554,894,-340
40,101,40,145,490,507,-17
40,101,48,113,51,39,12
40,101,48,439,0,41,-41
40,103,40,47,96,44,52
40,103,40,71,119,95,24
40,103,40,83,0,44,-44
40,103,40,109,49,56,-7
40,103,40,117,31,29,2
40,103,40,119,325,334,-9
40,103,40,143,26,41,-15
40,105,20,125,179,99,80
40,105,40,131,67,40,27
40,105,40,143,96,102,-6
40,105,40,147,170,220,-50
40,107,40,37,28,0,28
40,107,40,63,52,54,-2
40,107,40,81,58,74,-16
40,107,40,109,86,71,15
40,107,40,111,139,122,17
40,107,40,125,51,76,-25
40,107,40,133,41,39,2
40,107,40,143,58,51,7
40,109,1,97,0,37,-37
40,109,1,101,0,44,-44
40,109,2,20,84,128,-44
40,109,2,90,51,27,24
40,109,4,13,406,324,82
40,109,4,19,97,69,28
40,109,5,7,99,112,-13
40,109,5,33,36,0,36
40,109,5,45,0,38,-38
40,109,5,119,108,97,11
40,109,5,131,113,63,50
40,109,5,143,105,64,41
40,109,6,1,37,48,-11
40,109,6,13,0,38,-38
40,109,6,19,34,0,34
40,109,6,29,116,48,68
40,109,6,37,588,316,272
40,109,6,53,54,0,54
40,109,6,59,171,99,72
40,109,6,65,100,57,43
40,109,6,67,78,83,-5
40,109,6,71,162,113,49
40,109,6,73,315,253,62
40,109,6,75,32,0,32
40,109,6,83,36,37,-1
40,109,6,85,46,32,14
40,109,6,95,37,50,-13
40,109,6,99,37,0,37
40,109,6,111,37,54,-17
40,109,8,1,53,42,11
40,109,8,5,94,78,16
40,109,8,13,29,40,-11
40,109,8,14,0,40,-40
40,109,8,31,74,112,-38
40,109,8,35,63,79,-16
40,109,8,41,134,145,-11
40,109,8,59,45,32,13
40,109,8,69,31,37,-6
40,109,9,3,32,0,32
40,109,11,1,30,53,-23
40,109,12,5,144,32,112
40,109,12,9,47,0,47
40,109,12,11,64,70,-6
40,109,12,31,89,97,-8
40,109,12,33,87,42,45
40,109,12,57,80,72,8
40,109,12,86,96,30,66
40,109,12,91,67,41,26
40,109,12,95,49,55,-6
40,109,12,99,31,26,5
40,109,12,101,44,47,-3
40,109,12,103,42,26,16
40,109,12,105,35,40,-5
40,109,12,113,48,37,11
40,109,12,117,45,0,45
40,109,12,127,30,0,30
40,109,13,63,0,27,-27
40,109,13,67,36,75,-39
40,109,13,89,28,39,-11
40,109,13,121,41,42,-1
40,109,13,135,84,36,48
40,109,13,153,57,40,17
40,109,15,3,99,76,23
40,109,16,1,0,41,-41
40,109,17,31,131,163,-32
40,109,17,43,47,36,11
40,109,17,163,0,53,-53
40,109,18,57,27,0,27
40,109,18,97,41,34,7
40,109,19,153,0,31,-31
40,109,20,15,26,0,26
40,109,20,45,57,43,14
40,109,20,91,215,129,86
40,109,20,161,33,35,-2
40,109,20,169,28,0,28
40,109,20,173,336,352,-16
40,109,20,175,74,34,40
40,109,20,177,49,40,9
40,109,21,67,27,0,27
40,109,21,111,41,47,-6
40,109,22,15,0,39,-39
40,109,22,17,29,0,29
40,109,22,33,30,44,-14
40,109,22,51,42,28,14
40,109,22,55,32,45,-13
40,109,22,71,0,67,-67
40,109,22,103,0,43,-43
40,109,24,31,35,31,4
40,109,24,33,54,49,5
40,109,25,17,39,73,-34
40,109,26,49,32,0,32
40,109,26,125,47,0,47
40,109,26,163,73,32,41
40,109,27,37,31,32,-1
40,109,27,53,47,32,15
40,109,27,123,0,27,-27
40,109,28,47,83,37,46
40,109,29,19,36,32,4
40,109,29,43,31,0,31
40,109,29,47,45,61,-16
40,109,29,77,68,32,36
40,109,29,95,134,149,-15
40,109,29,97,41,53,-12
40,109,29,101,33,0,33
40,109,29,165,0,46,-46
40,109,29,183,40,0,40
40,109,29,189,100,78,22
40,109,29,213,0,34,-34
40,109,29,510,28,0,28
40,109,31,55,74,64,10
40,109,31,109,34,0,34
40,109,31,153,0,49,-49
40,109,32,3,241,282,-41
40,109,32,31,41,47,-6
40,109,35,1,132,80,52
40,109,35,13,0,26,-26
40,109,35,25,0,43,-43
40,109,35,45,44,0,44
40,109,36,5,165,45,120
40,109,36,47,70,47,23
40,109,36,61,150,256,-106
40,109,36,81,46,43,3
40,109,37,51,39,49,-10
40,109,37,119,46,37,9
40,109,37,133,44,0,44
40,109,37,183,0,38,-38
40,109,39,17,35,0,35
40,109,39,35,58,29,29
40,109,39,49,41,51,-10
40,109,39,61,0,39,-39
40,109,39,113,45,63,-18
40,109,40,5,38,28,10
40,109,40,9,118,122,-4
40,109,40,11,53,95,-42
40,109,40,13,92,68,24
40,109,40,15,262,192,70
40,109,40,17,3921,5654,-1733
40,109,40,19,250,235,15
40,109,40,21,96,56,40
40,109,40,23,37,0,37
40,109,40,27,8793,11053,-2260
40,109,40,31,668,384,284
40,109,40,35,34,0,34
40,109,40,37,158,177,-19
40,109,40,39,316,224,92
40,109,40,41,35,34,1
40,109,40,43,32,0,32
40,109,40,47,393,260,133
40,109,40,49,147,161,-14
40,109,40,51,670,804,-134
40,109,40,55,38,0,38
40,109,40,63,58,45,13
40,109,40,65,197,112,85
40,109,40,69,30,0,30
40,109,40,71,270,179,91
40,109,40,73,221,139,82
40,109,40,75,60,29,31
40,109,40,77,37,24,13
40,109,40,79,38,69,-31
40,109,40,81,638,597,41
40,109,40,83,1442,2115,-673
40,109,40,87,538,674,-136
40,109,40,89,77,60,17
40,109,40,91,81,111,-30
40,109,40,93,0,25,-25
40,109,40,95,53,94,-41
40,109,40,97,63,0,63
40,109,40,99,58,61,-3
40,109,40,101,199,138,61
40,109,40,103,56,49,7
40,109,40,107,71,86,-15
40,109,40,111,79,79,0
40,109,40,113,51,68,-17
40,109,40,115,41,44,-3
40,109,40,117,45,25,20
40,109,40,119,713,441,272
40,109,40,121,178,154,24
40,109,40,123,237,215,22
40,109,40,125,1337,1231,106
40,109,40,131,121,124,-3
40,109,40,133,173,159,14
40,109,40,135,39,33,6
40,109,40,137,254,179,75
40,109,40,139,81,94,-13
40,109,40,141,45,0,45
40,109,40,143,1658,1531,127
40,109,40,145,80,123,-43
40,109,40,147,103,100,3
40,109,40,149,58,52,6
40,109,40,151,54,26,28
40,109,40,153,136,112,24
40,109,41,51,46,52,-6
40,109,41,67,0,32,-32
40,109,42,101,49,39,10
40,109,47,37,77,81,-4
40,109,47,93,32,33,-1
40,109,47,125,46,0,46
40,109,47,149,0,44,-44
40,109,47,157,131,61,70
40,109,48,27,111,108,3
40,109,48,29,308,353,-45
40,109,48,37,0,30,-30
40,109,48,39,0,28,-28
40,109,48,41,0,31,-31
40,109,48,61,0,44,-44
40,109,48,85,319,480,-161
40,109,48,113,703,963,-260
40,109,48,121,268,362,-94
40,109,48,135,47,0,47
40,109,48,139,0,58,-58
40,109,48,141,185,194,-9
40,109,48,157,103,96,7
40,109,48,167,36,54,-18
40,109,48,179,34,0,34
40,109,48,181,49,38,11
40,109,48,183,44,48,-4
40,109,48,187,0,34,-34
40,109,48,201,554,639,-85
40,109,48,215,38,41,-3
40,109,48,245,0,41,-41
40,109,48,251,44,0,44
40,109,48,303,98,69,29
40,109,48,309,54,50,4
40,109,48,329,68,59,9
40,109,48,339,143,126,17
40,109,48,355,76,56,20
40,109,48,367,0,34,-34
40,109,48,375,58,56,2
40,109,48,381,74,47,27
40,109,48,397,34,28,6
40,109,48,423,47,50,-3
40,109,48,439,579,785,-206
40,109,48,441,41,37,4
40,109,48,453,165,217,-52
40,109,48,485,151,110,41
40,109,48,491,69,83,-14
40,109,49,11,0,28,-28
40,109,49,35,54,42,12
40,109,49,49,53,31,22
40,109,51,59,104,117,-13
40,109,51,153,42,0,42
40,109,51,199,44,0,44
40,109,51,510,0,27,-27
40,109,51,650,0,53,-53
40,109,51,700,34,0,34
40,109,51,710,65,44,21
40,109,51,810,61,54,7
40,109,53,29,52,34,18
40,109,53,33,105,128,-23
40,109,53,53,104,123,-19
40,109,53,61,41,43,-2
40,109,53,63,28,0,28
40,109,53,67,0,37,-37
40,109,55,79,48,0,48
40,109,55,133,34,0,34
40,111,6,37,33,0,33
40,111,40,21,44,49,-5
40,111,40,27,36,53,-17
40,111,40,37,183,208,-25
40,111,40,63,67,0,67
40,111,40,91,66,106,-40
40,111,40,101,78,131,-53
40,111,40,107,122,139,-17
40,111,40,109,79,79,0
40,111,40,113,0,28,-28
40,111,40,119,28,39,-11
40,111,40,121,30,55,-25
40,111,40,123,26,0,26
40,111,40,125,26,0,26
40,111,40,131,39,0,39
40,111,40,143,830,1054,-224
40,111,40,145,71,37,34
40,113,20,125,0,36,-36
40,113,40,21,30,0,30
40,113,40,27,29,28,1
40,113,40,37,158,146,12
40,113,40,71,270,254,16
40,113,40,101,42,0,42
40,113,40,109,68,51,17
40,113,40,111,28,0,28
40,113,40,117,103,106,-3
40,113,40,119,72,53,19
40,113,40,131,115,135,-20
40,113,40,143,2247,2220,27
40,113,40,145,50,57,-7
40,113,40,147,385,326,59
40,113,48,113,0,41,-41
40,115,5,7,59,35,24
40,115,20,21,147,183,-36
40,115,20,37,0,53,-53
40,115,29,97,153,239,-86
40,115,29,119,46,65,-19
40,115,29,145,156,164,-8
40,115,40,21,0,37,-37
40,115,40,27,0,31,-31
40,115,40,35,147,169,-22
40,115,40,41,319,365,-46
40,115,40,97,52,60,-8
40,115,40,109,44,41,3
40,115,40,131,0,38,-38
40,115,40,143,97,190,-93
40,117,40,37,141,184,-43
40,117,40,71,29,0,29
40,117,40,103,29,31,-2
40,117,40,109,25,45,-20
40,117,40,113,106,103,3
40,117,40,119,115,137,-22
40,117,40,131,0,27,-27
40,117,40,143,395,510,-115
40,119,4,13,35,36,-1
40,119,5,143,0,25,-25
40,119,6,37,0,37,-37
40,119,17,31,0,39,-39
40,119,20,35,0,26,-26
40,119,20,91,0,47,-47
40,119,20,173,35,32,3
40,119,40,11,26,0,26
40,119,40,17,56,78,-22
40,119,40,19,28,0,28
40,119,40,27,121,233,-112
40,119,40,31,48,49,-1
40,119,40,37,220,282,-62
40,119,40,39,37,0,37
40,119,40,47,109,103,6
40,119,40,71,184,153,31
40,119,40,73,32,0,32
40,119,40,81,255,221,34
40,119,40,83,128,109,19
40,119,40,97,36,0,36
40,119,40,101,40,0,40
40,119,40,103,334,325,9
40,119,40,109,441,713,-272
40,119,40,111,39,28,11
40,119,40,113,53,72,-19
40,119,40,117,137,115,22
40,119,40,121,34,0,34
40,119,40,125,47,81,-34
40,119,40,131,63,78,-15
40,119,40,137,41,0,41
40,119,40,143,511,775,-264
40,119,40,145,54,30,24
40,119,40,147,62,43,19
40,119,40,153,42,25,17
40,119,48,29,0,24,-24
40,119,48,85,0,66,-66
40,119,48,113,47,97,-50
40,119,48,121,0,61,-61
40,119,48,201,43,95,-52
40,119,48,439,42,77,-35
40,119,48,453,0,53,-53
40,119,48,485,36,0,36
40,119,53,33,0,25,-25
40,121,5,131,0,29,-29
40,121,40,5,69,72,-3
40,121,40,13,46,0,46
40,121,40,19,0,24,-24
40,121,40,27,70,113,-43
40,121,40,29,40,0,40
40,121,40,37,0,31,-31
40,121,40,51,0,39,-39
40,121,40,61,100,85,15
40,121,40,63,59,67,-8
40,121,40,77,194,156,38
40,121,40,79,87,63,24
40,121,40,91,127,108,19
40,121,40,101,97,84,13
40,121,40,109,154,178,-24
40,121,40,111,55,30,25
40,121,40,119,0,34,-34
40,121,40,123,53,71,-18
40,121,40,125,42,0,42
40,121,40,127,44,0,44
40,121,40,143,127,160,-33
40,121,40,145,0,46,-46
40,121,48,85,30,0,30
40,121,48,113,47,0,47
40,121,48,439,37,48,-11
40,123,40,5,36,34,2
40,123,40,17,0,49,-49
40,123,40,19,68,71,-3
40,123,40,27,137,197,-60
40,123,40,29,90,60,30
40,123,40,49,181,141,40
40,123,40,63,132,93,39
40,123,40,69,75,45,30
40,123,40,87,56,35,21
40,123,40,99,105,109,-4
40,123,40,109,215,237,-22
40,123,40,111,0,26,-26
40,123,40,121,71,53,18
40,123,40,125,100,158,-58
40,123,40,133,159,145,14
40,123,40,137,29,39,-10
40,123,40,143,67,82,-15
40,123,48,439,35,0,35
40,125,4,13,0,26,-26
40,125,40,17,94,83,11
40,125,40,27,602,576,26
40,125,40,31,48,0,48
40,125,40,49,37,0,37
40,125,40,51,35,51,-16
40,125,40,63,47,56,-9
40,125,40,81,436,388,48
40,125,40,83,0,40,-40
40,125,40,87,46,44,2
40,125,40,91,40,0,40
40,125,40,101,24,28,-4
40,125,40,107,76,51,25
40,125,40,109,1231,1337,-106
40,125,40,111,0,26,-26
40,125,40,119,81,47,34
40,125,40,121,0,42,-42
40,125,40,123,158,100,58
40,125,40,133,461,388,73
40,125,40,143,72,145,-73
40,125,48,113,39,30,9
40,125,48,121,0,39,-39
40,125,48,439,40,55,-15
40,127,40,5,50,0,50
40,127,40,13,36,46,-10
40,127,40,23,129,116,13
40,127,40,27,41,0,41
40,127,40,77,35,43,-8
40,127,40,89,41,55,-14
40,127,40,121,0,44,-44
40,127,40,143,0,26,-26
40,129,40,9,125,104,21
40,131,4,13,35,0,35
40,131,5,7,53,36,17
40,131,6,73,38,0,38
40,131,29,97,0,34,-34
40,131,40,21,57,60,-3
40,131,40,27,30,37,-7
40,131,40,35,128,99,29
40,131,40,37,135,141,-6
40,131,40,41,81,64,17
40,131,40,71,44,0,44
40,131,40,97,467,388,79
40,131,40,101,64,51,13
40,131,40,105,40,67,-27
40,131,40,109,124,121,3
40,131,40,111,0,39,-39
40,131,40,113,135,115,20
40,131,40,115,38,0,38
40,131,40,117,27,0,27
40,131,40,119,78,63,15
40,131,40,143,3166,3006,160
40,131,40,145,383,335,48
40,131,40,147,136,77,59
40,131,48,113,45,26,19
40,131,48,201,0,33,-33
40,131,48,439,41,30,11
40,133,40,17,40,0,40
40,133,40,27,49,113,-64
40,133,40,63,152,157,-5
40,133,40,81,33,41,-8
40,133,40,107,39,41,-2
40,133,40,109,159,173,-14
40,133,40,123,145,159,-14
40,133,40,125,388,461,-73
40,133,40,143,37,52,-15
40,135,5,7,0,52,-52
40,135,5,33,209,228,-19
40,135,5,131,560,627,-67
40,135,5,143,0,40,-40
40,135,40,1,35,57,-22
40,135,40,21,87,112,-25
40,135,40,27,0,40,-40
40,135,40,61,56,48,8
40,135,40,79,196,116,80
40,135,40,91,0,37,-37
40,135,40,101,160,152,8
40,135,40,109,33,39,-6
40,135,40,143,89,106,-17
40,137,40,17,0,64,-64
40,137,40,19,111,107,4
40,137,40,27,109,120,-11
40,137,40,31,344,286,58
40,137,40,33,62,55,7
40,137,40,49,67,42,25
40,137,40,51,154,173,-19
40,137,40,67,97,123,-26
40,137,40,87,0,23,-23
40,137,40,109,179,254,-75
40,137,40,119,0,41,-41
40,137,40,123,39,29,10
40,137,40,143,44,66,-22
40,137,48,113,44,31,13
40,137,48,201,31,38,-7
40,137,48,439,48,57,-9
40,137,48,485,0,37,-37
40,139,20,129,0,45,-45
40,139,20,175,237,222,15
40,139,40,7,0,36,-36
40,139,40,109,94,81,13
40,139,40,143,0,27,-27
40,139,48,141,0,43,-43
40,139,48,195,0,33,-33
40,139,48,341,196,47,149
40,139,48,375,28,0,28
40,141,40,31,69,129,-60
40,141,40,65,49,51,-2
40,141,40,75,0,38,-38
40,141,40,109,0,45,-45
40,141,48,485,0,68,-68
40,143,1,3,0,36,-36
40,143,1,73,24,43,-19
40,143,1,97,49,0,49
40,143,2,20,53,49,4
40,143,4,13,349,384,-35
40,143,4,15,0,33,-33
40,143,4,19,73,78,-5
40,143,4,21,0,33,-33
40,143,4,25,46,0,46
40,143,5,7,361,305,56
40,143,5,33,60,0,60
40,143,5,45,74,41,33
40,143,5,51,37,24,13
40,143,5,71,30,0,30
40,143,5,115,0,49,-49
40,143,5,119,169,443,-274
40,143,5,125,0,53,-53
40,143,5,131,212,137,75
40,143,5,143,238,207,31
40,143,5,149,46,82,-36
40,143,6,1,45,27,18
40,143,6,13,50,35,15
40,143,6,19,108,48,60
40,143,6,29,66,48,18
40,143,6,37,458,344,114
40,143,6,53,0,27,-27
40,143,6,59,149,119,30
40,143,6,65,153,74,79
40,143,6,67,122,55,67
40,143,6,71,151,117,34
40,143,6,73,241,180,61
40,143,6,75,29,0,29
40,143,6,77,36,0,36
40,143,6,85,50,66,-16
40,143,6,99,34,0,34
40,143,6,111,56,0,56
40,143,8,1,48,66,-18
40,143,8,5,79,100,-21
40,143,8,13,0,22,-22
40,143,8,31,74,117,-43
40,143,8,35,57,68,-11
40,143,8,41,107,96,11
40,143,8,59,48,63,-15
40,143,8,69,45,33,12
40,143,9,9,33,0,33
40,143,12,1,0,21,-21
40,143,12,5,44,0,44
40,143,12,9,0,24,-24
40,143,12,11,76,46,30
40,143,12,21,28,0,28
40,143,12,31,78,63,15
40,143,12,33,27,0,27
40,143,12,57,92,60,32
40,143,12,71,37,50,-13
40,143,12,86,59,44,15
40,143,12,91,40,38,2
40,143,12,95,86,66,20
40,143,12,99,39,22,17
40,143,12,103,46,25,21
40,143,12,105,28,0,28
40,143,12,115,31,0,31
40,143,12,127,30,27,3
40,143,13,67,57,70,-13
40,143,13,89,0,34,-34
40,143,13,121,46,70,-24
40,143,13,135,24,44,-20
40,143,15,3,78,36,42
40,143,17,31,184,190,-6
40,143,17,43,59,39,20
40,143,17,163,40,0,40
40,143,17,197,0,35,-35
40,143,18,3,26,0,26
40,143,18,89,31,0,31
40,143,18,97,28,65,-37
40,143,18,141,23,0,23
40,143,19,153,39,41,-2
40,143,20,21,24,0,24
40,143,20,35,51,0,51
40,143,20,37,51,0,51
40,143,20,45,46,34,12
40,143,20,91,182,216,-34
40,143,20,99,34,0,34
40,143,20,125,129,61,68
40,143,20,155,26,0,26
40,143,20,161,38,0,38
40,143,20,173,313,285,28
40,143,20,177,59,58,1
40,143,20,209,25,41,-16
40,143,21,111,34,44,-10
40,143,22,33,28,48,-20
40,143,22,71,0,32,-32
40,143,22,73,56,0,56
40,143,24,3,0,23,-23
40,143,24,31,30,0,30
40,143,25,17,0,38,-38
40,143,25,27,43,0,43
40,143,26,49,30,0,30
40,143,26,81,30,0,30
40,143,26,99,66,0,66
40,143,26,125,69,0,69
40,143,26,161,32,0,32
40,143,26,163,56,0,56
40,143,27,53,48,41,7
40,143,27,123,69,0,69
40,143,29,19,56,41,15
40,143,29,43,43,59,-16
40,143,29,47,50,51,-1
40,143,29,77,232,110,122
40,143,29,95,133,182,-49
40,143,29,97,182,92,90
40,143,29,145,95,44,51
40,143,29,183,74,63,11
40,143,29,189,149,112,37
40,143,29,209,33,0,33
40,143,29,213,48,28,20
40,143,29,510,0,22,-22
40,143,31,55,91,87,4
40,143,31,109,52,42,10
40,143,32,3,232,167,65
40,143,35,1,71,100,-29
40,143,35,13,35,0,35
40,143,35,45,34,0,34
40,143,36,47,0,37,-37
40,143,36,61,41,59,-18
40,143,36,81,43,27,16
40,143,36,103,31,0,31
40,143,36,119,30,0,30
40,143,37,51,41,0,41
40,143,37,119,71,44,27
40,143,37,183,30,57,-27
40,143,39,35,29,0,29
40,143,39,49,81,66,15
40,143,40,1,109,54,55
40,143,40,13,85,0,85
40,143,40,17,147,168,-21
40,143,40,19,42,39,3
40,143,40,21,486,352,134
40,143,40,27,633,703,-70
40,143,40,31,174,92,82
40,143,40,35,67,68,-1
40,143,40,37,3431,3995,-564
40,143,40,39,91,52,39
40,143,40,41,245,161,84
40,143,40,47,179,133,46
40,143,40,49,31,0,31
40,143,40,51,60,39,21
40,143,40,61,0,37,-37
40,143,40,63,0,44,-44
40,143,40,65,35,0,35
40,143,40,71,161,104,57
40,143,40,77,25,0,25
40,143,40,79,108,78,30
40,143,40,81,112,80,32
40,143,40,83,71,71,0
40,143,40,87,45,43,2
40,143,40,89,29,42,-13
40,143,40,91,113,119,-6
40,143,40,97,538,513,25
40,143,40,101,894,554,340
40,143,40,103,41,26,15
40,143,40,105,102,96,6
40,143,40,107,51,58,-7
40,143,40,109,1531,1658,-127
40,143,40,111,1054,830,224
40,143,40,113,2220,2247,-27
40,143,40,115,190,97,93
40,143,40,117,510,395,115
40,143,40,119,775,511,264
40,143,40,121,160,127,33
40,143,40,123,82,67,15
40,143,40,125,145,72,73
40,143,40,127,26,0,26
40,143,40,131,3006,3166,-160
40,143,40,133,52,37,15
40,143,40,135,106,89,17
40,143,40,137,66,44,22
40,143,40,139,27,0,27
40,143,40,145,3509,4741,-1232
40,143,40,147,655,595,60
40,143,40,153,35,0,35
40,143,41,51,52,55,-3
40,143,41,67,30,45,-15
40,143,42,3,51,0,51
40,143,42,101,32,24,8
40,143,45,19,35,0,35
40,143,47,37,60,81,-21
40,143,47,157,118,64,54
40,143,47,187,0,32,-32
40,143,48,27,109,83,26
40,143,48,29,132,152,-20
40,143,48,39,47,54,-7
40,143,48,41,28,0,28
40,143,48,61,34,32,2
40,143,48,85,266,360,-94
40,143,48,113,525,725,-200
40,143,48,121,189,277,-88
40,143,48,135,31,0,31
40,143,48,139,0,41,-41
40,143,48,141,76,99,-23
40,143,48,157,121,250,-129
40,143,48,167,0,38,-38
40,143,48,181,61,0,61
40,143,48,183,35,37,-2
40,143,48,201,593,894,-301
40,143,48,215,66,0,66
40,143,48,251,30,0,30
40,143,48,303,76,0,76
40,143,48,309,0,35,-35
40,143,48,329,47,38,9
40,143,48,339,74,135,-61
40,143,48,355,0,43,-43
40,143,48,375,42,33,9
40,143,48,381,46,0,46
40,143,48,423,50,67,-17
40,143,48,439,478,757,-279
40,143,48,441,48,40,8
40,143,48,451,32,0,32
40,143,48,453,177,204,-27
40,143,48,485,53,44,9
40,143,48,491,58,99,-41
40,143,49,35,69,61,8
40,143,49,49,0,33,-33
40,143,51,13,0,25,-25
40,143,51,41,0,32,-32
40,143,51,59,57,79,-22
40,143,51,710,36,0,36
40,143,51,810,71,30,41
40,143,53,11,0,32,-32
40,143,53,33,75,162,-87
40,143,53,53,44,65,-21
40,143,53,61,45,42,3
40,143,55,25,28,0,28
40,143,55,73,34,0,34
40,143,55,79,0,60,-60
40,145,4,13,44,0,44
40,145,5,7,39,0,39
40,145,5,143,44,0,44
40,145,40,1,35,0,35
40,145,40,21,196,145,51
40,145,40,27,61,60,1
40,145,40,35,37,0,37
40,145,40,37,153,136,17
40,145,40,41,38,41,-3
40,145,40,91,38,41,-3
40,145,40,97,156,112,44
40,145,40,101,507,490,17
40,145,40,109,123,80,43
40,145,40,111,37,71,-34
40,145,40,113,57,50,7
40,145,40,119,30,54,-24
40,145,40,121,46,0,46
40,145,40,131,335,383,-48
40,145,40,143,4741,3509,1232
40,145,40,147,37,72,-35
40,145,48,113,32,28,4
40,145,48,201,30,46,-16
40,145,48,439,29,67,-38
40,147,2,20,49,0,49
40,147,4,13,45,0,45
40,147,5,7,38,0,38
40,147,5,143,29,0,29
40,147,20,19,0,28,-28
40,147,20,125,173,133,40
40,147,20,173,0,63,-63
40,147,40,27,39,67,-28
40,147,40,37,51,44,7
40,147,40,41,30,0,30
40,147,40,71,117,74,43
40,147,40,97,0,33,-33
40,147,40,105,220,170,50
40,147,40,109,100,103,-3
40,147,40,113,326,385,-59
40,147,40,119,43,62,-19
40,147,40,131,77,136,-59
40,147,40,143,595,655,-60
40,147,40,145,72,37,35
40,147,48,113,34,33,1
40,147,48,157,89,66,23
40,147,48,201,309,136,173
40,147,48,439,41,33,8
40,149,40,9,193,183,10
40,149,40,17,0,43,-43
40,149,40,27,0,28,-28
40,149,40,39,220,222,-2
40,149,40,75,53,66,-13
40,149,40,109,52,58,-6
40,151,20,7,43,0,43
40,151,40,3,38,51,-13
40,151,40,27,0,25,-25
40,151,40,47,37,72,-35
40,151,40,109,26,54,-28
40,151,40,153,44,42,2
40,153,40,9,0,37,-37
40,153,40,17,30,45,-15
40,153,40,27,33,36,-3
40,153,40,39,0,26,-26
40,153,40,43,79,71,8
40,153,40,45,99,104,-5
40,153,40,47,50,48,2
40,153,40,59,60,66,-6
40,153,40,109,112,136,-24
40,153,40,119,25,42,-17
40,153,40,143,0,35,-35
40,153,40,151,42,44,-2
41,1,16,1,57,60,-3
41,1,16,27,0,32,-32
41,1,41,5,32,0,32
41,1,41,17,58,44,14
41,1,41,23,32,0,32
41,1,41,39,37,27,10
41,1,41,45,62,71,-9
41,1,41,47,30,28,2
41,1,41,51,52,35,17
41,1,41,59,73,52,21
41,1,41,61,86,135,-49
41,1,41,67,57,26,31
41,3,4,13,90,82,8
41,3,4,19,48,0,48
41,3,6,1,56,35,21
41,3,6,13,27,0,27
41,3,6,23,38,0,38
41,3,6,37,116,59,57
41,3,6,59,58,43,15
41,3,6,67,0,26,-26
41,3,6,71,58,22,36
41,3,6,73,78,70,8
41,3,6,81,27,0,27
41,3,6,85,38,58,-20
41,3,6,113,0,25,-25
41,3,8,69,0,30,-30
41,3,15,3,47,25,22
41,3,16,1,0,38,-38
41,3,17,31,29,0,29
41,3,30,63,29,0,29
41,3,32,3,25,40,-15
41,3,32,31,0,29,-29
41,3,41,5,195,269,-74
41,3,41,7,50,28,22
41,3,41,9,42,28,14
41,3,41,11,58,35,23
41,3,41,13,0,24,-24
41,3,41,17,195,235,-40
41,3,41,19,94,49,45
41,3,41,29,123,98,25
41,3,41,31,0,25,-25
41,3,41,33,54,37,17
41,3,41,35,39,55,-16
41,3,41,39,575,620,-45
41,3,41,41,166,159,7
41,3,41,43,1200,1503,-303
41,3,41,47,410,433,-23
41,3,41,51,359,710,-351
41,3,41,53,173,253,-80
41,3,41,57,31,0,31
41,3,41,59,33,0,33
41,3,41,61,37,0,37
41,3,41,67,340,543,-203
41,3,41,71,79,77,2
41,3,48,453,0,30,-30
41,3,49,35,0,38,-38
41,3,53,11,85,118,-33
41,3,53,33,124,212,-88
41,3,53,53,34,45,-11
41,3,53,61,36,60,-24
41,3,53,63,36,33,3
41,3,53,67,0,29,-29
41,5,2,20,67,38,29
41,5,2,170,31,0,31
41,5,4,13,377,383,-6
41,5,4,19,94,53,41
41,5,4,21,0,30,-30
41,5,4,25,30,0,30
41,5,4,27,0,24,-24
41,5,6,1,133,55,78
41,5,6,13,119,65,54
41,5,6,19,83,0,83
41,5,6,23,26,0,26
41,5,6,29,64,0,64
41,5,6,37,527,235,292
41,5,6,53,39,30,9
41,5,6,59,304,124,180
41,5,6,61,35,56,-21
41,5,6,65,157,86,71
41,5,6,67,162,56,106
41,5,6,71,117,84,33
41,5,6,73,325,247,78
41,5,6,75,66,62,4
41,5,6,77,51,0,51
41,5,6,79,34,0,34
41,5,6,81,59,0,59
41,5,6,83,54,27,27
41,5,6,85,199,103,96
41,5,6,89,31,0,31
41,5,6,97,86,27,59
41,5,6,99,67,0,67
41,5,6,111,101,33,68
41,5,8,5,49,25,24
41,5,8,13,44,0,44
41,5,8,31,30,29,1
41,5,8,41,52,48,4
41,5,8,59,0,31,-31
41,5,8,69,0,36,-36
41,5,11,1,0,22,-22
41,5,12,9,33,0,33
41,5,12,31,32,0,32
41,5,12,95,58,0,58
41,5,13,89,28,0,28
41,5,15,1,42,36,6
41,5,15,3,105,78,27
41,5,15,9,25,27,-2
41,5,16,1,128,87,41
41,5,16,27,39,51,-12
41,5,16,55,0,45,-45
41,5,16,57,29,0,29
41,5,16,83,32,0,32
41,5,17,31,52,36,16
41,5,25,17,0,34,-34
41,5,26,163,38,0,38
41,5,27,53,33,30,3
41,5,27,123,30,0,30
41,5,30,29,36,0,36
41,5,30,31,41,0,41
41,5,30,63,30,29,1
41,5,32,3,237,172,65
41,5,32,31,81,73,8
41,5,35,1,26,0,26
41,5,36,47,30,30,0
41,5,36,61,35,33,2
41,5,41,1,0,32,-32
41,5,41,3,269,195,74
41,5,41,7,98,124,-26
41,5,41,9,192,153,39
41,5,41,11,85,56,29
41,5,41,13,52,68,-16
41,5,41,15,36,32,4
41,5,41,17,345,539,-194
41,5,41,19,116,79,37
41,5,41,27,40,34,6
41,5,41,29,245,157,88
41,5,41,31,52,64,-12
41,5,41,33,55,85,-30
41,5,41,35,57,52,5
41,5,41,39,576,414,162
41,5,41,41,170,165,5
41,5,41,43,197,178,19
41,5,41,47,1777,1839,-62
41,5,41,49,40,0,40
41,5,41,51,11962,10273,1689
41,5,41,53,182,166,16
41,5,41,57,92,132,-40
41,5,41,59,102,107,-5
41,5,41,61,0,64,-64
41,5,41,65,83,80,3
41,5,41,67,4794,4698,96
41,5,41,71,455,536,-81
41,5,42,3,27,0,27
41,5,47,37,0,30,-30
41,5,48,29,43,0,43
41,5,48,113,51,0,51
41,5,48,121,0,30,-30
41,5,48,201,30,58,-28
41,5,48,439,60,42,18
41,5,48,453,47,68,-21
41,5,48,491,0,28,-28
41,5,49,35,102,108,-6
41,5,49,49,69,77,-8
41,5,51,59,38,0,38
41,5,53,5,29,54,-25
41,5,53,7,0,26,-26
41,5,53,11,1208,1505,-297
41,5,53,15,92,104,-12
41,5,53,27,0,33,-33
41,5,53,29,36,0,36
41,5,53,33,480,447,33
41,5,53,35,40,26,14
41,5,53,39,0,49,-49
41,5,53,41,0,41,-41
41,5,53,45,29,0,29
41,5,53,49,0,28,-28
41,5,53,53,190,182,8
41,5,53,59,23,34,-11
41,5,53,61,135,143,-8
41,5,53,63,112,129,-17
41,5,53,67,102,62,40
41,5,53,71,41,26,15
41,5,53,73,61,58,3
41,5,53,77,69,33,36
41,5,55,25,0,33,-33
41,7,6,37,31,38,-7
41,7,6,73,50,32,18
41,7,32,3,26,39,-13
41,7,41,3,28,50,-22
41,7,41,5,124,98,26
41,7,41,9,100,89,11
41,7,41,17,55,89,-34
41,7,41,29,38,32,6
41,7,41,39,57,74,-17
41,7,41,41,39,41,-2
41,7,41,47,56,71,-15
41,7,41,51,254,299,-45
41,7,41,53,0,33,-33
41,7,41,57,71,39,32
41,7,41,67,241,274,-33
41,7,41,71,0,33,-33
41,7,53,11,88,68,20
41,7,53,15,62,91,-29
41,7,53,33,78,69,9
41,7,53,49,88,71,17
41,7,53,53,39,32,7
41,7,53,63,32,38,-6
41,7,53,67,0,40,-40
41,7,53,73,0,29,-29
41,9,4,13,0,25,-25
41,9,6,73,27,0,27
41,9,41,3,28,42,-14
41,9,41,5,153,192,-39
41,9,41,7,89,100,-11
41,9,41,17,54,74,-20
41,9,41,19,31,0,31
41,9,41,29,0,40,-40
41,9,41,39,64,50,14
41,9,41,43,0,45,-45
41,9,41,47,53,31,22
41,9,41,51,691,589,102
41,9,41,53,0,52,-52
41,9,41,57,24,35,-11
41,9,41,67,1109,637,472
41,9,41,71,53,36,17
41,9,53,11,150,177,-27
41,9,53,15,258,305,-47
41,9,53,33,61,43,18
41,9,53,53,28,0,28
41,9,53,61,0,35,-35
41,11,4,13,36,39,-3
41,11,6,23,30,0,30
41,11,6,29,47,0,47
41,11,6,37,61,36,25
41,11,6,59,49,0,49
41,11,6,65,43,0,43
41,11,6,67,51,0,51
41,11,6,71,59,0,59
41,11,6,73,60,0,60
41,11,6,89,35,0,35
41,11,32,3,86,29,57
41,11,32,31,44,0,44
41,11,41,3,35,58,-23
41,11,41,5,56,85,-29
41,11,41,15,169,85,84
41,11,41,17,89,161,-72
41,11,41,19,331,333,-2
41,11,41,29,138,174,-36
41,11,41,33,55,54,1
41,11,41,35,59,58,1
41,11,41,39,293,470,-177
41,11,41,41,50,31,19
41,11,41,43,29,82,-53
41,11,41,47,69,88,-19
41,11,41,51,81,122,-41
41,11,41,53,22,68,-46
41,11,41,67,77,75,2
41,11,41,71,0,30,-30
41,11,49,35,29,0,29
41,11,53,11,36,65,-29
41,11,53,33,55,54,1
41,11,53,35,34,0,34
41,11,53,53,0,42,-42
41,11,53,63,0,28,-28
41,13,41,3,24,0,24
41,13,41,5,68,52,16
41,13,41,17,523,626,-103
41,13,41,31,80,87,-7
41,13,41,39,48,47,1
41,13,41,43,0,39,-39
41,13,41,47,68,39,29
41,13,41,51,79,34,45
41,13,41,59,0,34,-34
41,13,41,67,47,0,47
41,15,4,13,0,28,-28
41,15,6,15,132,150,-18
41,15,6,37,44,21,23
41,15,6,67,39,0,39
41,15,6,71,26,0,26
41,15,6,73,27,0,27
41,15,6,89,37,0,37
41,15,32,3,28,0,28
41,15,41,5,32,36,-4
41,15,41,11,85,169,-84
41,15,41,17,28,61,-33
41,15,41,19,45,43,2
41,15,41,29,114,122,-8
41,15,41,33,73,62,11
41,15,41,39,50,128,-78
41,15,41,43,0,29,-29
41,15,41,51,20,52,-32
41,15,41,67,24,33,-9
41,17,2,20,75,41,34
41,17,2,122,27,0,27
41,17,4,5,36,0,36
41,17,4,13,256,202,54
41,17,4,15,45,0,45
41,17,4,19,63,43,20
41,17,4,21,37,0,37
41,17,4,25,31,0,31
41,17,4,27,31,0,31
41,17,6,1,84,30,54
41,17,6,7,28,0,28
41,17,6,13,117,39,78
41,17,6,17,26,0,26
41,17,6,19,48,0,48
41,17,6,23,33,0,33
41,17,6,29,38,0,38
41,17,6,37,440,109,331
41,17,6,53,57,0,57
41,17,6,57,32,0,32
41,17,6,59,263,81,182
41,17,6,61,34,52,-18
41,17,6,65,165,73,92
41,17,6,67,106,65,41
41,17,6,71,111,35,76
41,17,6,73,276,103,173
41,17,6,75,39,23,16
41,17,6,77,43,0,43
41,17,6,79,83,0,83
41,17,6,81,66,0,66
41,17,6,83,57,25,32
41,17,6,85,115,46,69
41,17,6,87,44,0,44
41,17,6,89,82,35,47
41,17,6,95,53,37,16
41,17,6,97,76,0,76
41,17,6,99,56,0,56
41,17,6,111,80,29,51
41,17,8,13,28,0,28
41,17,8,31,25,27,-2
41,17,8,41,49,31,18
41,17,8,69,25,0,25
41,17,15,1,0,37,-37
41,17,15,3,59,30,29
41,17,15,9,48,39,9
41,17,16,1,78,138,-60
41,17,16,13,30,0,30
41,17,16,17,0,34,-34
41,17,16,27,57,46,11
41,17,16,55,38,48,-10
41,17,17,31,37,0,37
41,17,30,29,0,31,-31
41,17,30,31,28,38,-10
41,17,30,63,30,0,30
41,17,32,3,126,77,49
41,17,32,31,96,56,40
41,17,35,1,30,0,30
41,17,41,1,44,58,-14
41,17,41,3,235,195,40
41,17,41,5,539,345,194
41,17,41,7,89,55,34
41,17,41,9,74,54,20
41,17,41,11,161,89,72
41,17,41,13,626,523,103
41,17,41,15,61,28,33
41,17,41,19,156,116,40
41,17,41,23,53,74,-21
41,17,41,25,61,76,-15
41,17,41,27,27,32,-5
41,17,41,29,258,245,13
41,17,41,31,713,459,254
41,17,41,33,69,88,-19
41,17,41,35,262,167,95
41,17,41,37,63,64,-1
41,17,41,39,876,638,238
41,17,41,41,78,121,-43
41,17,41,43,283,214,69
41,17,41,45,0,43,-43
41,17,41,47,436,437,-1
41,17,41,51,764,733,31
41,17,41,53,130,146,-16
41,17,41,57,72,42,30
41,17,41,59,63,87,-24
41,17,41,61,59,71,-12
41,17,41,63,0,29,-29
41,17,41,65,50,81,-31
41,17,41,67,628,514,114
41,17,41,71,78,146,-68
41,17,49,35,63,60,3
41,17,53,5,35,53,-18
41,17,53,11,216,143,73
41,17,53,15,26,36,-10
41,17,53,33,260,212,48
41,17,53,35,65,28,37
41,17,53,39,31,21,10
41,17,53,53,126,103,23
41,17,53,61,79,79,0
41,17,53,63,52,79,-27
41,17,53,67,46,47,-1
41,17,53,71,0,30,-30
41,17,53,73,0,48,-48
41,17,53,77,49,0,49
41,19,2,20,36,0,36
41,19,4,13,56,76,-20
41,19,4,15,34,0,34
41,19,4,19,26,0,26
41,19,6,1,48,0,48
41,19,6,13,30,0,30
41,19,6,23,41,0,41
41,19,6,29,42,0,42
41,19,6,37,111,51,60
41,19,6,45,36,0,36
41,19,6,59,44,0,44
41,19,6,65,71,54,17
41,19,6,67,60,44,16
41,19,6,71,71,35,36
41,19,6,73,111,42,69
41,19,6,79,34,0,34
41,19,6,85,34,0,34
41,19,6,89,38,30,8
41,19,6,93,27,0,27
41,19,6,97,45,0,45
41,19,6,99,54,29,25
41,19,6,111,35,0,35
41,19,15,3,0,37,-37
41,19,16,1,0,28,-28
41,19,16,27,0,34,-34
41,19,32,3,58,58,0
41,19,32,31,71,36,35
41,19,41,3,49,94,-45
41,19,41,5,79,116,-37
41,19,41,9,0,31,-31
41,19,41,11,333,331,2
41,19,41,15,43,45,-2
41,19,41,17,116,156,-40
41,19,41,29,244,332,-88
41,19,41,31,23,0,23
41,19,41,33,208,211,-3
41,19,41,35,116,113,3
41,19,41,39,650,941,-291
41,19,41,41,44,49,-5
41,19,41,43,86,122,-36
41,19,41,47,97,153,-56
41,19,41,51,136,235,-99
41,19,41,53,40,80,-40
41,19,41,57,24,0,24
41,19,41,61,29,26,3
41,19,41,67,170,198,-28
41,19,41,71,35,56,-21
41,19,53,11,58,69,-11
41,19,53,33,60,62,-2
41,19,53,53,46,54,-8
41,19,53,61,38,0,38
41,19,53,63,35,40,-5
41,21,41,49,0,31,-31
41,23,41,1,0,32,-32
41,23,41,17,74,53,21
41,23,41,39,35,0,35
41,23,41,51,38,0,38
41,25,41,17,76,61,15
41,25,41,45,0,34,-34
41,27,6,37,43,0,43
41,27,41,5,34,40,-6
41,27,41,17,32,27,5
41,27,41,39,23,0,23
41,27,41,51,232,223,9
41,27,41,65,149,265,-116
41,27,41,67,77,75,2
41,27,53,11,40,48,-8
41,27,53,33,23,0,23
41,27,53,39,87,135,-48
41,27,53,59,29,44,-15
41,29,2,20,66,65,1
41,29,4,13,202,195,7
41,29,4,15,0,31,-31
41,29,4,19,60,35,25
41,29,4,25,53,0,53
41,29,6,1,127,62,65
41,29,6,7,26,41,-15
41,29,6,13,124,66,58
41,29,6,15,79,66,13
41,29,6,17,0,36,-36
41,29,6,19,35,0,35
41,29,6,23,93,84,9
41,29,6,29,59,0,59
41,29,6,37,395,155,240
41,29,6,41,23,22,1
41,29,6,47,35,0,35
41,29,6,53,93,45,48
41,29,6,55,34,0,34
41,29,6,59,188,98,90
41,29,6,61,40,49,-9
41,29,6,65,154,68,86
41,29,6,67,220,117,103
41,29,6,71,128,66,62
41,29,6,73,228,171,57
41,29,6,75,59,38,21
41,29,6,77,29,37,-8
41,29,6,79,54,32,22
41,29,6,81,85,27,58
41,29,6,83,68,45,23
41,29,6,85,187,73,114
41,29,6,87,73,0,73
41,29,6,89,132,86,46
41,29,6,93,196,135,61
41,29,6,95,39,0,39
41,29,6,97,108,87,21
41,29,6,99,46,0,46
41,29,6,103,34,38,-4
41,29,6,111,91,35,56
41,29,6,113,0,34,-34
41,29,8,13,0,26,-26
41,29,8,31,0,28,-28
41,29,8,41,39,35,4
41,29,8,69,34,0,34
41,29,15,1,49,39,10
41,29,15,3,55,40,15
41,29,15,7,31,0,31
41,29,15,9,29,37,-8
41,29,16,1,40,77,-37
41,29,17,31,42,33,9
41,29,32,3,150,134,16
41,29,32,31,60,66,-6
41,29,35,1,0,27,-27
41,29,41,3,98,123,-25
41,29,41,5,157,245,-88
41,29,41,7,32,38,-6
41,29,41,9,40,0,40
41,29,41,11,174,138,36
41,29,41,15,122,114,8
41,29,41,17,245,258,-13
41,29,41,19,332,244,88
41,29,41,31,34,36,-2
41,29,41,33,1078,1095,-17
41,29,41,35,401,266,135
41,29,41,39,346,486,-140
41,29,41,41,41,57,-16
41,29,41,43,86,100,-14
41,29,41,47,232,232,0
41,29,41,51,355,596,-241
41,29,41,53,54,43,11
41,29,41,59,37,0,37
41,29,41,67,258,419,-161
41,29,41,71,56,57,-1
41,29,48,113,36,0,36
41,29,48,201,0,33,-33
41,29,49,35,70,56,14
41,29,49,49,44,35,9
41,29,53,5,0,32,-32
41,29,53,11,108,182,-74
41,29,53,33,141,194,-53
41,29,53,35,0,30,-30
41,29,53,53,65,94,-29
41,29,53,57,0,30,-30
41,29,53,61,66,83,-17
41,29,53,63,25,50,-25
41,29,53,67,38,53,-15
41,29,53,73,0,27,-27
41,31,6,37,43,34,9
41,31,41,3,25,0,25
41,31,41,5,64,52,12
41,31,41,13,87,80,7
41,31,41,17,459,713,-254
41,31,41,19,0,23,-23
41,31,41,29,36,34,2
41,31,41,39,39,63,-24
41,31,41,43,29,0,29
41,31,41,47,77,74,3
41,31,41,51,102,67,35
41,31,41,59,0,35,-35
41,31,41,67,48,0,48
41,33,4,13,70,44,26
41,33,6,1,58,0,58
41,33,6,7,31,0,31
41,33,6,13,53,0,53
41,33,6,15,47,43,4
41,33,6,19,32,0,32
41,33,6,23,72,0,72
41,33,6,29,45,0,45
41,33,6,37,183,44,139
41,33,6,45,28,0,28
41,33,6,59,89,27,62
41,33,6,61,33,0,33
41,33,6,65,97,0,97
41,33,6,67,81,27,54
41,33,6,71,65,33,32
41,33,6,73,120,67,53
41,33,6,77,38,0,38
41,33,6,79,26,0,26
41,33,6,81,35,0,35
41,33,6,85,70,0,70
41,33,6,87,35,0,35
41,33,6,89,63,0,63
41,33,6,93,27,0,27
41,33,6,95,32,0,32
41,33,6,97,59,0,59
41,33,6,99,0,28,-28
41,33,6,111,42,0,42
41,33,8,41,0,24,-24
41,33,32,3,85,58,27
41,33,32,31,59,33,26
41,33,41,3,37,54,-17
41,33,41,5,85,55,30
41,33,41,11,54,55,-1
41,33,41,15,62,73,-11
41,33,41,17,88,69,19
41,33,41,19,211,208,3
41,33,41,29,1095,1078,17
41,33,41,35,64,45,19
41,33,41,39,145,215,-70
41,33,41,43,32,54,-22
41,33,41,47,59,64,-5
41,33,41,51,67,134,-67
41,33,41,67,108,160,-52
41,33,41,71,0,29,-29
41,33,53,11,0,39,-39
41,33,53,33,47,65,-18
41,33,53,53,45,0,45
41,33,53,61,34,0,34
41,35,4,13,50,41,9
41,35,6,1,34,0,34
41,35,6,7,33,22,11
41,35,6,13,47,0,47
41,35,6,19,31,0,31
41,35,6,23,0,36,-36
41,35,6,37,90,45,45
41,35,6,49,34,52,-18
41,35,6,59,40,39,1
41,35,6,65,45,28,17
41,35,6,67,40,67,-27
41,35,6,71,71,0,71
41,35,6,73,80,43,37
41,35,6,85,38,0,38
41,35,6,89,59,53,6
41,35,6,93,108,83,25
41,35,6,99,36,0,36
41,35,15,3,30,0,30
41,35,16,1,0,31,-31
41,35,16,27,49,0,49
41,35,32,3,55,36,19
41,35,32,31,78,81,-3
41,35,41,3,55,39,16
41,35,41,5,52,57,-5
41,35,41,11,58,59,-1
41,35,41,17,167,262,-95
41,35,41,19,113,116,-3
41,35,41,29,266,401,-135
41,35,41,33,45,64,-19
41,35,41,37,73,52,21
41,35,41,39,193,203,-10
41,35,41,41,0,37,-37
41,35,41,43,47,92,-45
41,35,41,47,80,147,-67
41,35,41,51,95,155,-60
41,35,41,53,0,32,-32
41,35,41,59,39,29,10
41,35,41,67,89,155,-66
41,35,41,71,0,36,-36
41,35,53,11,39,101,-62
41,35,53,33,0,46,-46
41,35,53,53,0,33,-33
41,35,53,63,0,53,-53
41,35,53,77,0,41,-41
41,37,41,17,64,63,1
41,37,41,35,52,73,-21
41,37,41,39,34,25,9
41,39,2,20,88,72,16
41,39,2,90,33,40,-7
41,39,2,110,35,0,35
41,39,2,122,47,27,20
41,39,4,5,29,29,0
41,39,4,13,317,258,59
41,39,4,15,54,32,22
41,39,4,19,69,118,-49
41,39,4,21,0,46,-46
41,39,4,25,56,0,56
41,39,4,27,0,41,-41
41,39,6,1,162,121,41
41,39,6,7,58,26,32
41,39,6,13,92,44,48
41,39,6,15,36,0,36
41,39,6,17,56,0,56
41,39,6,19,59,35,24
41,39,6,23,120,31,89
41,39,6,29,95,35,60
41,39,6,37,588,278,310
41,39,6,41,44,27,17
41,39,6,45,24,0,24
41,39,6,53,65,45,20
41,39,6,55,40,0,40
41,39,6,57,32,0,32
41,39,6,59,268,129,139
41,39,6,61,40,0,40
41,39,6,65,209,78,131
41,39,6,67,193,94,99
41,39,6,71,147,106,41
41,39,6,73,336,226,110
41,39,6,75,62,112,-50
41,39,6,77,76,33,43
41,39,6,79,42,41,1
41,39,6,81,42,79,-37
41,39,6,83,75,0,75
41,39,6,85,166,139,27
41,39,6,87,89,39,50
41,39,6,89,66,60,6
41,39,6,93,0,26,-26
41,39,6,95,45,0,45
41,39,6,97,106,56,50
41,39,6,99,60,31,29
41,39,6,111,93,0,93
41,39,6,113,50,0,50
41,39,8,5,42,52,-10
41,39,8,13,52,36,16
41,39,8,31,50,49,1
41,39,8,41,72,48,24
41,39,8,59,30,38,-8
41,39,8,69,37,27,10
41,39,8,77,25,0,25
41,39,8,123,26,0,26
41,39,11,1,29,0,29
41,39,12,99,31,0,31
41,39,12,115,24,0,24
41,39,13,89,24,0,24
41,39,15,1,54,38,16
41,39,15,3,135,101,34
41,39,15,7,28,0,28
41,39,15,9,38,46,-8
41,39,16,1,134,137,-3
41,39,16,27,68,30,38
41,39,16,55,35,0,35
41,39,16,83,29,0,29
41,39,17,31,71,79,-8
41,39,22,71,0,27,-27
41,39,25,17,53,0,53
41,39,27,53,69,34,35
41,39,30,29,40,34,6
41,39,30,31,34,29,5
41,39,30,63,58,35,23
41,39,32,3,244,229,15
41,39,32,31,125,102,23
41,39,32,510,26,0,26
41,39,35,1,61,41,20
41,39,35,49,31,27,4
41,39,36,47,24,34,-10
41,39,36,61,53,41,12
41,39,39,35,35,0,35
41,39,39,49,39,0,39
41,39,41,1,27,37,-10
41,39,41,3,620,575,45
41,39,41,5,414,576,-162
41,39,41,7,74,57,17
41,39,41,9,50,64,-14
41,39,41,11,470,293,177
41,39,41,13,47,48,-1
41,39,41,15,128,50,78
41,39,41,17,638,876,-238
41,39,41,19,941,650,291
41,39,41,23,0,35,-35
41,39,41,27,0,23,-23
41,39,41,29,486,346,140
41,39,41,31,63,39,24
41,39,41,33,215,145,70
41,39,41,35,203,193,10
41,39,41,37,25,34,-9
41,39,41,41,225,201,24
41,39,41,43,865,1175,-310
41,39,41,45,38,32,6
41,39,41,47,607,591,16
41,39,41,51,951,1810,-859
41,39,41,53,148,163,-15
41,39,41,57,47,66,-19
41,39,41,59,54,70,-16
41,39,41,61,62,35,27
41,39,41,65,36,42,-6
41,39,41,67,695,1117,-422
41,39,41,71,163,154,9
41,39,42,3,34,0,34
41,39,42,101,0,34,-34
41,39,47,157,34,0,34
41,39,48,29,51,26,25
41,39,48,113,0,37,-37
41,39,48,121,31,0,31
41,39,48,201,52,43,9
41,39,48,439,42,32,10
41,39,48,453,57,69,-12
41,39,49,11,0,28,-28
41,39,49,35,101,107,-6
41,39,49,49,83,68,15
41,39,51,59,41,29,12
41,39,53,5,36,62,-26
41,39,53,9,0,35,-35
41,39,53,11,238,293,-55
41,39,53,15,61,69,-8
41,39,53,33,334,598,-264
41,39,53,35,48,47,1
41,39,53,53,196,201,-5
41,39,53,57,0,33,-33
41,39,53,61,164,120,44
41,39,53,63,104,148,-44
41,39,53,67,72,116,-44
41,39,53,73,57,67,-10
41,39,53,77,38,28,10
41,39,55,25,42,40,2
41,41,4,13,65,37,28
41,41,4,15,0,31,-31
41,41,6,37,66,40,26
41,41,6,59,23,0,23
41,41,6,65,0,29,-29
41,41,6,73,32,38,-6
41,41,16,1,42,0,42
41,41,32,3,48,52,-4
41,41,32,31,52,28,24
41,41,41,3,159,166,-7
41,41,41,5,165,170,-5
41,41,41,7,41,39,2
41,41,41,11,31,50,-19
41,41,41,17,121,78,43
41,41,41,19,49,44,5
41,41,41,29,57,41,16
41,41,41,35,37,0,37
41,41,41,39,201,225,-24
41,41,41,43,140,204,-64
41,41,41,47,185,251,-66
41,41,41,51,265,236,29
41,41,41,53,83,87,-4
41,41,41,57,62,63,-1
41,41,41,67,180,181,-1
41,41,41,71,74,88,-14
41,41,49,35,24,0,24
41,41,53,11,75,64,11
41,41,53,33,40,45,-5
41,41,53,53,0,33,-33
41,41,53,61,0,28,-28
41,41,53,63,25,0,25
41,43,4,13,125,65,60
41,43,6,13,31,0,31
41,43,6,37,100,0,100
41,43,6,59,70,0,70
41,43,6,65,74,0,74
41,43,6,67,42,44,-2
41,43,6,71,100,0,100
41,43,6,73,87,48,39
41,43,6,111,35,0,35
41,43,16,1,25,0,25
41,43,32,3,79,49,30
41,43,32,31,0,24,-24
41,43,41,3,1503,1200,303
41,43,41,5,178,197,-19
41,43,41,9,45,0,45
41,43,41,11,82,29,53
41,43,41,13,39,0,39
41,43,41,15,29,0,29
41,43,41,17,214,283,-69
41,43,41,19,122,86,36
41,43,41,29,100,86,14
41,43,41,31,0,29,-29
41,43,41,33,54,32,22
41,43,41,35,92,47,45
41,43,41,39,1175,865,310
41,43,41,41,204,140,64
41,43,41,47,1449,1236,213
41,43,41,51,217,272,-55
41,43,41,53,246,204,42
41,43,41,57,35,0,35
41,43,41,59,0,48,-48
41,43,41,65,37,0,37
41,43,41,67,228,302,-74
41,43,41,71,76,103,-27
41,43,53,11,69,83,-14
41,43,53,33,93,65,28
41,43,53,53,78,84,-6
41,43,53,61,53,41,12
41,43,53,63,41,35,6
41,43,53,67,0,24,-24
41,43,53,73,29,0,29
41,45,16,1,123,237,-114
41,45,16,27,187,299,-112
41,45,16,45,53,0,53
41,45,16,75,330,432,-102
41,45,16,87,71,100,-29
41,45,41,1,71,62,9
41,45,41,17,43,0,43
41,45,41,25,34,0,34
41,45,41,39,32,38,-6
41,45,41,47,31,0,31
41,45,41,51,0,32,-32
41,45,41,61,0,34,-34
41,47,2,20,75,55,20
41,47,4,13,302,292,10
41,47,4,19,27,46,-19
41,47,4,21,0,42,-42
41,47,6,1,73,37,36
41,47,6,7,34,0,34
41,47,6,13,52,44,8
41,47,6,19,92,33,59
41,47,6,23,62,0,62
41,47,6,29,44,35,9
41,47,6,37,496,160,336
41,47,6,47,40,0,40
41,47,6,53,48,0,48
41,47,6,59,134,109,25
41,47,6,61,34,0,34
41,47,6,65,178,72,106
41,47,6,67,165,81,84
41,47,6,71,126,57,69
41,47,6,73,218,123,95
41,47,6,77,60,0,60
41,47,6,79,34,0,34
41,47,6,85,149,58,91
41,47,6,89,43,23,20
41,47,6,99,48,0,48
41,47,6,107,0,53,-53
41,47,6,111,56,0,56
41,47,8,5,0,29,-29
41,47,8,31,0,38,-38
41,47,8,41,43,0,43
41,47,15,1,35,41,-6
41,47,15,3,108,80,28
41,47,15,9,26,0,26
41,47,16,1,69,95,-26
41,47,16,27,46,76,-30
41,47,16,55,33,28,5
41,47,30,63,28,0,28
41,47,32,3,190,136,54
41,47,32,31,61,59,2
41,47,35,1,0,45,-45
41,47,36,61,0,40,-40
41,47,39,49,32,0,32
41,47,41,1,28,30,-2
41,47,41,3,433,410,23
41,47,41,5,1839,1777,62
41,47,41,7,71,56,15
41,47,41,9,31,53,-22
41,47,41,11,88,69,19
41,47,41,13,39,68,-29
41,47,41,17,437,436,1
41,47,41,19,153,97,56
41,47,41,29,232,232,0
41,47,41,31,74,77,-3
41,47,41,33,64,59,5
41,47,41,35,147,80,67
41,47,41,39,591,607,-16
41,47,41,41,251,185,66
41,47,41,43,1236,1449,-213
41,47,41,45,0,31,-31
41,47,41,51,1050,1380,-330
41,47,41,53,2692,3026,-334
41,47,41,57,69,62,7
41,47,41,59,102,105,-3
41,47,41,61,37,33,4
41,47,41,65,40,0,40
41,47,41,67,1403,1380,23
41,47,41,71,654,572,82
41,47,48,29,0,26,-26
41,47,48,201,40,35,5
41,47,48,375,0,53,-53
41,47,49,35,92,94,-2
41,47,49,49,56,47,9
41,47,53,5,80,93,-13
41,47,53,9,28,0,28
41,47,53,11,317,383,-66
41,47,53,15,42,71,-29
41,47,53,33,233,317,-84
41,47,53,35,33,60,-27
41,47,53,53,133,200,-67
41,47,53,57,0,33,-33
41,47,53,61,89,130,-41
41,47,53,63,118,76,42
41,47,53,67,71,116,-45
41,47,53,71,0,38,-38
41,47,53,73,37,0,37
41,47,53,77,44,65,-21
41,49,41,5,0,40,-40
41,49,41,21,31,0,31
41,49,41,59,460,508,-48
41,49,41,61,28,0,28
41,49,53,5,0,67,-67
41,51,2,20,227,153,74
41,51,2,90,44,0,44
41,51,2,110,50,31,19
41,51,2,122,31,35,-4
41,51,2,130,23,30,-7
41,51,4,3,0,27,-27
41,51,4,5,104,33,71
41,51,4,13,720,580,140
41,51,4,15,28,45,-17
41,51,4,19,254,191,63
41,51,4,21,44,53,-9
41,51,4,25,93,30,63
41,51,4,27,0,28,-28
41,51,5,119,24,0,24
41,51,6,1,460,298,162
41,51,6,7,73,43,30
41,51,6,13,193,125,68
41,51,6,17,56,44,12
41,51,6,19,131,70,61
41,51,6,23,156,61,95
41,51,6,29,107,53,54
41,51,6,37,1544,753,791
41,51,6,41,92,73,19
41,51,6,43,23,0,23
41,51,6,45,35,28,7
41,51,6,47,0,32,-32
41,51,6,53,120,53,67
41,51,6,55,59,0,59
41,51,6,57,44,0,44
41,51,6,59,491,237,254
41,51,6,61,54,50,4
41,51,6,65,230,146,84
41,51,6,67,364,238,126
41,51,6,71,221,122,99
41,51,6,73,818,484,334
41,51,6,75,770,363,407
41,51,6,77,102,57,45
41,51,6,79,127,45,82
41,51,6,81,164,98,66
41,51,6,83,134,61,73
41,51,6,85,414,220,194
41,51,6,87,138,77,61
41,51,6,89,68,53,15
41,51,6,93,38,0,38
41,51,6,95,42,44,-2
41,51,6,97,142,92,50
41,51,6,99,62,36,26
41,51,6,107,54,0,54
41,51,6,111,149,86,63
41,51,6,113,41,43,-2
41,51,8,1,27,47,-20
41,51,8,5,96,58,38
41,51,8,13,138,104,34
41,51,8,31,247,143,104
41,51,8,37,20,0,20
41,51,8,41,92,77,15
41,51,8,45,22,0,22
41,51,8,59,74,63,11
41,51,8,67,21,0,21
41,51,8,69,82,71,11
41,51,8,77,23,0,23
41,51,9,1,36,23,13
41,51,9,3,46,23,23
41,51,9,9,50,39,11
41,51,10,3,29,0,29
41,51,11,1,169,140,29
41,51,12,1,28,0,28
41,51,12,9,30,0,30
41,51,12,11,76,64,12
41,51,12,31,67,31,36
41,51,12,33,25,0,25
41,51,12,57,81,35,46
41,51,12,71,30,0,30
41,51,12,73,27,0,27
41,51,12,86,110,79,31
41,51,12,95,102,47,55
41,51,12,99,43,28,15
41,51,12,103,73,23,50
41,51,12,105,45,29,16
41,51,12,115,37,0,37
41,51,12,117,27,0,27
41,51,13,67,52,29,23
41,51,13,89,73,39,34
41,51,13,121,96,69,27
41,51,13,135,28,0,28
41,51,15,1,100,86,14
41,51,15,3,288,180,108
41,51,15,7,29,25,4
41,51,15,9,96,79,17
41,51,16,1,277,263,14
41,51,16,5,28,0,28
41,51,16,13,45,0,45
41,51,16,17,0,35,-35
41,51,16,27,54,75,-21
41,51,16,55,65,71,-6
41,51,16,57,57,0,57
41,51,16,69,26,0,26
41,51,17,19,30,0,30
41,51,17,31,533,300,233
41,51,17,43,88,33,55
41,51,17,89,26,0,26
41,51,17,97,38,0,38
41,51,17,201,30,0,30
41,51,18,3,29,0,29
41,51,18,97,79,45,34
41,51,18,105,20,21,-1
41,51,18,141,22,0,22
41,51,19,103,45,0,45
41,51,19,153,67,35,32
41,51,20,45,44,0,44
41,51,20,91,54,37,17
41,51,20,173,49,0,49
41,51,21,67,31,0,31
41,51,21,111,53,0,53
41,51,22,33,29,0,29
41,51,22,71,36,41,-5
41,51,23,5,55,36,19
41,51,24,3,28,30,-2
41,51,24,5,50,0,50
41,51,24,31,119,74,45
41,51,24,33,48,0,48
41,51,24,510,85,54,31
41,51,25,1,23,21,2
41,51,25,3,24,0,24
41,51,25,9,57,39,18
41,51,25,15,49,0,49
41,51,25,17,231,133,98
41,51,25,21,65,42,23
41,51,25,23,26,0,26
41,51,25,25,160,92,68
41,51,25,27,40,0,40
41,51,26,49,25,0,25
41,51,26,65,53,0,53
41,51,26,77,39,0,39
41,51,26,81,93,29,64
41,51,26,99,22,0,22
41,51,26,103,20,0,20
41,51,26,125,107,48,59
41,51,26,139,23,0,23
41,51,26,161,79,42,37
41,51,26,163,115,0,115
41,51,27,37,28,0,28
41,51,27,53,259,146,113
41,51,27,123,61,42,19
41,51,27,137,27,0,27
41,51,29,19,45,0,45
41,51,29,77,39,68,-29
41,51,29,95,80,42,38
41,51,29,189,91,59,32
41,51,29,510,32,28,4
41,51,30,29,57,60,-3
41,51,30,31,125,52,73
41,51,30,49,34,30,4
41,51,30,63,146,85,61
41,51,30,111,36,57,-21
41,51,31,55,63,39,24
41,51,31,109,54,29,25
41,51,32,3,367,376,-9
41,51,32,31,144,99,45
41,51,33,15,0,22,-22
41,51,34,17,46,0,46
41,51,34,21,26,0,26
41,51,34,27,32,0,32
41,51,35,1,147,116,31
41,51,35,13,36,0,36
41,51,35,43,30,0,30
41,51,35,49,72,33,39
41,51,36,1,41,0,41
41,51,36,5,28,0,28
41,51,36,29,67,0,67
41,51,36,47,356,240,116
41,51,36,55,53,30,23
41,51,36,59,27,0,27
41,51,36,61,382,241,141
41,51,36,67,27,0,27
41,51,36,81,107,63,44
41,51,36,103,47,0,47
41,51,36,109,34,0,34
41,51,36,119,40,23,17
41,51,37,21,55,31,24
41,51,37,63,42,32,10
41,51,37,67,24,0,24
41,51,37,119,68,49,19
41,51,37,133,24,0,24
41,51,37,135,42,24,18
41,51,37,183,68,50,18
41,51,39,35,91,63,28
41,51,39,49,129,50,79
41,51,39,61,59,0,59
41,51,39,95,22,0,22
41,51,39,113,28,0,28
41,51,40,109,52,46,6
41,51,40,143,55,52,3
41,51,41,1,35,52,-17
41,51,41,3,710,359,351
41,51,41,5,10273,11962,-1689
41,51,41,7,299,254,45
41,51,41,9,589,691,-102
41,51,41,11,122,81,41
41,51,41,13,34,79,-45
41,51,41,15,52,20,32
41,51,41,17,733,764,-31
41,51,41,19,235,136,99
41,51,41,23,0,38,-38
41,51,41,27,223,232,-9
41,51,41,29,596,355,241
41,51,41,31,67,102,-35
41,51,41,33,134,67,67
41,51,41,35,155,95,60
41,51,41,39,1810,951,859
41,51,41,41,236,265,-29
41,51,41,43,272,217,55
41,51,41,45,32,0,32
41,51,41,47,1380,1050,330
41,51,41,53,253,291,-38
41,51,41,57,202,192,10
41,51,41,59,188,190,-2
41,51,41,61,63,70,-7
41,51,41,65,151,172,-21
41,51,41,67,9747,9828,-81
41,51,41,71,410,440,-30
41,51,42,3,74,59,15
41,51,42,27,21,0,21
41,51,42,29,23,0,23
41,51,42,45,40,0,40
41,51,42,71,26,25,1
41,51,42,91,32,0,32
41,51,42,101,101,91,10
41,51,42,133,27,0,27
41,51,44,7,60,0,60
41,51,45,19,44,0,44
41,51,46,99,24,0,24
41,51,47,37,51,46,5
41,51,47,157,75,38,37
41,51,48,27,0,30,-30
41,51,48,29,115,64,51
41,51,48,85,43,76,-33
41,51,48,113,159,92,67
41,51,48,121,46,0,46
41,51,48,141,34,39,-5
41,51,48,201,195,147,48
41,51,48,339,0,40,-40
41,51,48,439,94,81,13
41,51,48,453,178,172,6
41,51,48,491,32,40,-8
41,51,49,11,53,25,28
41,51,49,35,304,175,129
41,51,49,49,83,67,16
41,51,49,57,0,64,-64
41,51,50,7,89,0,89
41,51,51,13,67,41,26
41,51,51,59,72,86,-14
41,51,51,107,27,0,27
41,51,51,510,40,0,40
41,51,51,540,29,0,29
41,51,51,760,33,0,33
41,51,51,810,26,0,26
41,51,53,5,129,109,20
41,51,53,7,28,0,28
41,51,53,9,50,0,50
41,51,53,11,3642,4976,-1334
41,51,53,15,245,293,-48
41,51,53,21,25,47,-22
41,51,53,25,0,29,-29
41,51,53,27,46,35,11
41,51,53,29,67,36,31
41,51,53,31,39,37,2
41,51,53,33,1736,1544,192
41,51,53,35,121,106,15
41,51,53,37,0,37,-37
41,51,53,39,61,102,-41
41,51,53,41,68,63,5
41,51,53,45,26,23,3
41,51,53,47,26,0,26
41,51,53,49,43,87,-44
41,51,53,53,366,418,-52
41,51,53,57,52,57,-5
41,51,53,59,45,66,-21
41,51,53,61,250,263,-13
41,51,53,63,316,217,99
41,51,53,67,313,179,134
41,51,53,71,56,93,-37
41,51,53,73,199,118,81
41,51,53,75,34,26,8
41,51,53,77,136,113,23
41,51,55,25,137,97,40
41,51,55,79,107,51,56
41,51,55,133,32,0,32
41,51,56,25,30,0,30
41,51,56,39,28,0,28
41,53,4,13,34,79,-45
41,53,4,19,0,30,-30
41,53,6,37,79,34,45
41,53,6,59,34,0,34
41,53,6,65,54,0,54
41,53,6,67,27,0,27
41,53,6,71,49,0,49
41,53,6,73,47,32,15
41,53,16,1,43,38,5
41,53,32,3,73,39,34
41,53,32,31,32,0,32
41,53,41,3,253,173,80
41,53,41,5,166,182,-16
41,53,41,7,33,0,33
41,53,41,9,52,0,52
41,53,41,11,68,22,46
41,53,41,17,146,130,16
41,53,41,19,80,40,40
41,53,41,29,43,54,-11
41,53,41,35,32,0,32
41,53,41,39,163,148,15
41,53,41,41,87,83,4
41,53,41,43,204,246,-42
41,53,41,47,3026,2692,334
41,53,41,51,291,253,38
41,53,41,57,40,33,7
41,53,41,59,42,38,4
41,53,41,67,269,291,-22
41,53,41,71,563,471,92
41,53,53,11,72,54,18
41,53,53,33,89,65,24
41,53,53,53,58,52,6
41,53,53,67,36,0,36
41,55,41,65,34,0,34
41,57,4,13,29,0,29
41,57,6,73,0,27,-27
41,57,41,3,0,31,-31
41,57,41,5,132,92,40
41,57,41,7,39,71,-32
41,57,41,9,35,24,11
41,57,41,17,42,72,-30
41,57,41,19,0,24,-24
41,57,41,39,66,47,19
41,57,41,41,63,62,1
41,57,41,43,0,35,-35
41,57,41,47,62,69,-7
41,57,41,51,192,202,-10
41,57,41,53,33,40,-7
41,57,41,59,0,39,-39
41,57,41,67,250,200,50
41,57,41,71,50,73,-23
41,57,53,11,47,56,-9
41,57,53,33,39,26,13
41,59,4,13,67,61,6
41,59,6,37,48,36,12
41,59,6,65,30,0,30
41,59,6,71,36,0,36
41,59,6,73,28,0,28
41,59,16,1,48,61,-13
41,59,16,27,0,47,-47
41,59,16,55,26,0,26
41,59,16,57,0,33,-33
41,59,32,3,32,0,32
41,59,41,1,52,73,-21
41,59,41,3,0,33,-33
41,59,41,5,107,102,5
41,59,41,13,34,0,34
41,59,41,17,87,63,24
41,59,41,29,0,37,-37
41,59,41,31,35,0,35
41,59,41,35,29,39,-10
41,59,41,39,70,54,16
41,59,41,43,48,0,48
41,59,41,47,105,102,3
41,59,41,49,508,460,48
41,59,41,51,190,188,2
41,59,41,53,38,42,-4
41,59,41,57,39,0,39
41,59,41,61,211,227,-16
41,59,41,63,30,28,2
41,59,41,65,54,36,18
41,59,41,67,141,139,2
41,59,41,71,42,38,4
41,59,49,35,36,32,4
41,59,53,5,214,388,-174
41,59,53,11,54,75,-21
41,59,53,21,68,110,-42
41,59,53,25,43,37,6
41,59,53,33,54,95,-41
41,59,53,53,39,49,-10
41,59,53,61,31,27,4
41,59,53,63,44,82,-38
41,59,53,65,0,38,-38
41,59,53,71,410,541,-131
41,59,53,77,60,64,-4
41,61,16,1,35,58,-23
41,61,16,27,41,0,41
41,61,41,1,135,86,49
41,61,41,3,0,37,-37
41,61,41,5,64,0,64
41,61,41,17,71,59,12
41,61,41,19,26,29,-3
41,61,41,39,35,62,-27
41,61,41,45,34,0,34
41,61,41,47,33,37,-4
41,61,41,49,0,28,-28
41,61,41,51,70,63,7
41,61,41,59,227,211,16
41,61,41,63,61,49,12
41,61,41,67,56,80,-24
41,61,41,71,30,0,30
41,61,53,5,0,38,-38
41,61,53,11,0,27,-27
41,61,53,33,0,33,-33
41,61,53,61,0,32,-32
41,61,53,63,0,52,-52
41,61,53,71,0,27,-27
41,63,41,17,29,0,29
41,63,41,59,28,30,-2
41,63,41,61,49,61,-12
41,65,41,5,80,83,-3
41,65,41,17,81,50,31
41,65,41,27,265,149,116
41,65,41,39,42,36,6
41,65,41,43,0,37,-37
41,65,41,47,0,40,-40
41,65,41,51,172,151,21
41,65,41,55,0,34,-34
41,65,41,59,36,54,-18
41,65,41,67,61,77,-16
41,65,53,11,45,99,-54
41,65,53,33,0,37,-37
41,65,53,39,144,172,-28
41,65,53,53,0,28,-28
41,67,2,20,166,75,91
41,67,2,170,36,32,4
41,67,4,5,0,30,-30
41,67,4,13,932,930,2
41,67,4,15,45,0,45
41,67,4,19,126,138,-12
41,67,4,21,29,141,-112
41,67,4,25,59,46,13
41,67,6,1,223,182,41
41,67,6,7,79,0,79
41,67,6,13,166,127,39
41,67,6,15,0,32,-32
41,67,6,17,40,0,40
41,67,6,19,105,56,49
41,67,6,23,49,0,49
41,67,6,29,98,57,41
41,67,6,37,1194,556,638
41,67,6,41,35,47,-12
41,67,6,47,42,0,42
41,67,6,53,69,49,20
41,67,6,55,42,0,42
41,67,6,59,522,304,218
41,67,6,61,72,93,-21
41,67,6,65,223,158,65
41,67,6,67,280,208,72
41,67,6,71,168,83,85
41,67,6,73,571,428,143
41,67,6,75,158,123,35
41,67,6,77,104,40,64
41,67,6,79,59,0,59
41,67,6,81,142,50,92
41,67,6,83,76,41,35
41,67,6,85,505,408,97
41,67,6,87,79,31,48
41,67,6,89,71,0,71
41,67,6,95,84,55,29
41,67,6,97,105,37,68
41,67,6,99,79,56,23
41,67,6,111,140,60,80
41,67,6,113,34,26,8
41,67,8,1,39,55,-16
41,67,8,5,100,91,9
41,67,8,13,46,31,15
41,67,8,31,123,90,33
41,67,8,35,60,59,1
41,67,8,41,307,113,194
41,67,8,59,53,31,22
41,67,8,69,48,62,-14
41,67,8,123,0,36,-36
41,67,9,3,25,28,-3
41,67,11,1,23,27,-4
41,67,12,1,37,0,37
41,67,12,11,57,0,57
41,67,12,57,39,45,-6
41,67,12,71,0,29,-29
41,67,12,86,33,53,-20
41,67,12,95,60,35,25
41,67,12,99,50,49,1
41,67,12,103,50,43,7
41,67,13,67,41,43,-2
41,67,13,89,28,0,28
41,67,13,121,67,45,22
41,67,15,1,85,65,20
41,67,15,3,368,224,144
41,67,15,7,0,29,-29
41,67,15,9,73,39,34
41,67,16,1,226,182,44
41,67,16,27,71,65,6
41,67,16,55,59,84,-25
41,67,16,57,45,0,45
41,67,16,65,38,29,9
41,67,17,19,35,0,35
41,67,17,31,191,124,67
41,67,17,43,43,39,4
41,67,17,97,41,0,41
41,67,18,157,40,0,40
41,67,19,153,38,0,38
41,67,20,91,74,0,74
41,67,20,173,25,0,25
41,67,24,5,35,0,35
41,67,24,27,44,0,44
41,67,24,31,45,35,10
41,67,25,17,106,66,40
41,67,25,25,26,35,-9
41,67,25,27,51,0,51
41,67,26,65,30,0,30
41,67,26,81,48,0,48
41,67,26,125,55,35,20
41,67,26,161,60,0,60
41,67,26,163,54,0,54
41,67,27,53,134,92,42
41,67,27,123,32,0,32
41,67,29,77,32,0,32
41,67,29,95,32,0,32
41,67,29,189,55,37,18
41,67,30,13,27,0,27
41,67,30,29,21,0,21
41,67,30,31,37,50,-13
41,67,30,49,0,31,-31
41,67,30,63,64,37,27
41,67,30,111,52,0,52
41,67,31,55,50,0,50
41,67,32,3,427,328,99
41,67,32,31,166,107,59
41,67,34,3,38,0,38
41,67,34,17,34,0,34
41,67,34,23,39,0,39
41,67,35,1,74,63,11
41,67,35,43,42,0,42
41,67,36,29,42,0,42
41,67,36,47,51,35,16
41,67,36,55,30,0,30
41,67,36,61,35,81,-46
41,67,36,81,48,26,22
41,67,37,63,0,38,-38
41,67,37,119,40,39,1
41,67,37,183,47,53,-6
41,67,39,35,38,0,38
41,67,39,49,96,62,34
41,67,39,61,32,0,32
41,67,40,109,32,0,32
41,67,40,143,45,30,15
41,67,41,1,26,57,-31
41,67,41,3,543,340,203
41,67,41,5,4698,4794,-96
41,67,41,7,274,241,33
41,67,41,9,637,1109,-472
41,67,41,11,75,77,-2
41,67,41,13,0,47,-47
41,67,41,15,33,24,9
41,67,41,17,514,628,-114
41,67,41,19,198,170,28
41,67,41,27,75,77,-2
41,67,41,29,419,258,161
41,67,41,31,0,48,-48
41,67,41,33,160,108,52
41,67,41,35,155,89,66
41,67,41,39,1117,695,422
41,67,41,41,181,180,1
41,67,41,43,302,228,74
41,67,41,47,1380,1403,-23
41,67,41,51,9828,9747,81
41,67,41,53,291,269,22
41,67,41,57,200,250,-50
41,67,41,59,139,141,-2
41,67,41,61,80,56,24
41,67,41,65,77,61,16
41,67,41,71,1309,1964,-655
41,67,42,3,66,39,27
41,67,42,101,26,0,26
41,67,45,79,31,0,31
41,67,47,37,32,0,32
41,67,48,27,0,39,-39
41,67,48,29,92,87,5
41,67,48,85,63,119,-56
41,67,48,113,113,109,4
41,67,48,121,57,44,13
41,67,48,141,33,37,-4
41,67,48,157,0,37,-37
41,67,48,201,102,163,-61
41,67,48,439,73,98,-25
41,67,48,453,108,224,-116
41,67,48,491,0,88,-88
41,67,49,5,29,0,29
41,67,49,11,41,65,-24
41,67,49,35,246,202,44
41,67,49,49,159,167,-8
41,67,49,53,0,29,-29
41,67,49,57,22,27,-5
41,67,51,13,22,26,-4
41,67,51,59,40,55,-15
41,67,51,153,0,24,-24
41,67,53,5,63,88,-25
41,67,53,9,0,32,-32
41,67,53,11,1351,1982,-631
41,67,53,15,128,159,-31
41,67,53,21,30,57,-27
41,67,53,25,0,30,-30
41,67,53,27,33,29,4
41,67,53,29,27,0,27
41,67,53,33,850,1101,-251
41,67,53,35,93,80,13
41,67,53,39,0,46,-46
41,67,53,41,0,63,-63
41,67,53,53,316,335,-19
41,67,53,57,27,0,27
41,67,53,61,259,361,-102
41,67,53,63,240,267,-27
41,67,53,67,104,162,-58
41,67,53,71,41,23,18
41,67,53,73,86,82,4
41,67,53,75,40,0,40
41,67,53,77,107,75,32
41,67,55,25,72,40,32
41,67,55,79,31,0,31
41,71,2,20,0,26,-26
41,71,4,13,80,92,-12
41,71,4,19,35,0,35
41,71,6,37,174,45,129
41,71,6,59,42,0,42
41,71,6,65,32,50,-18
41,71,6,67,44,28,16
41,71,6,71,35,0,35
41,71,6,73,50,40,10
41,71,6,111,46,0,46
41,71,16,1,44,35,9
41,71,16,27,0,38,-38
41,71,32,3,58,40,18
41,71,41,3,77,79,-2
41,71,41,5,536,455,81
41,71,41,7,33,0,33
41,71,41,9,36,53,-17
41,71,41,11,30,0,30
41,71,41,17,146,78,68
41,71,41,19,56,35,21
41,71,41,29,57,56,1
41,71,41,33,29,0,29
41,71,41,35,36,0,36
41,71,41,39,154,163,-9
41,71,41,41,88,74,14
41,71,41,43,103,76,27
41,71,41,47,572,654,-82
41,71,41,51,440,410,30
41,71,41,53,471,563,-92
41,71,41,57,73,50,23
41,71,41,59,38,42,-4
41,71,41,61,0,30,-30
41,71,41,67,1964,1309,655
41,71,53,11,125,93,32
41,71,53,33,69,66,3
41,71,53,53,72,54,18
41,71,53,61,56,0,56
41,71,53,63,34,38,-4
41,71,53,67,25,0,25
42,1,6,37,0,31,-31
42,1,24,3,92,49,43
42,1,24,5,184,100,84
42,1,24,13,651,213,438
42,1,24,21,459,178,281
42,1,24,27,38,0,38
42,1,24,31,120,54,66
42,1,24,33,36,22,14
42,1,24,43,54,39,15
42,1,24,510,40,20,20
42,1,42,3,31,37,-6
42,1,42,11,27,0,27
42,1,42,27,0,40,-40
42,1,42,29,36,44,-8
42,1,42,41,216,374,-158
42,1,42,43,97,125,-28
42,1,42,55,280,406,-126
42,1,42,71,66,71,-5
42,1,42,75,35,0,35
42,1,42,91,0,42,-42
42,1,42,101,34,40,-6
42,1,42,133,2035,2066,-31
42,1,45,51,0,31,-31
42,1,51,59,37,0,37
42,3,1,73,45,78,-33
42,3,2,20,25,47,-22
42,3,4,13,357,539,-182
42,3,4,19,71,96,-25
42,3,6,1,59,159,-100
42,3,6,13,50,51,-1
42,3,6,37,389,509,-120
42,3,6,53,0,32,-32
42,3,6,59,108,156,-48
42,3,6,65,71,69,2
42,3,6,67,54,54,0
42,3,6,71,76,66,10
42,3,6,73,274,278,-4
42,3,6,75,68,155,-87
42,3,6,81,29,81,-52
42,3,6,83,0,42,-42
42,3,6,85,107,319,-212
42,3,6,97,0,20,-20
42,3,6,111,31,0,31
42,3,8,5,38,65,-27
42,3,8,13,28,53,-25
42,3,8,31,72,84,-12
42,3,8,35,50,29,21
42,3,8,41,70,90,-20
42,3,8,59,0,46,-46
42,3,9,1,88,106,-18
42,3,9,3,95,78,17
42,3,9,9,94,102,-8
42,3,9,11,46,0,46
42,3,10,1,38,29,9
42,3,10,3,92,85,7
42,3,10,5,0,33,-33
42,3,11,1,223,339,-116
42,3,12,1,46,62,-16
42,3,12,9,81,104,-23
42,3,12,11,271,213,58
42,3,12,15,0,37,-37
42,3,12,19,0,44,-44
42,3,12,21,31,110,-79
42,3,12,31,91,181,-90
42,3,12,33,49,30,19
42,3,12,35,0,47,-47
42,3,12,57,185,181,4
42,3,12,61,25,0,25
42,3,12,69,36,33,3
42,3,12,71,160,158,2
42,3,12,73,36,0,36
42,3,12,81,76,94,-18
42,3,12,83,40,73,-33
42,3,12,85,0,35,-35
42,3,12,86,78,138,-60
42,3,12,87,30,31,-1
42,3,12,91,26,24,2
42,3,12,95,139,215,-76
42,3,12,97,0,74,-74
42,3,12,99,185,241,-56
42,3,12,101,74,74,0
42,3,12,103,196,240,-44
42,3,12,105,58,64,-6
42,3,12,109,24,58,-34
42,3,12,111,31,29,2
42,3,12,115,80,95,-15
42,3,12,117,69,72,-3
42,3,12,119,0,57,-57
42,3,12,127,83,105,-22
42,3,13,51,0,50,-50
42,3,13,63,55,45,10
42,3,13,67,72,106,-34
42,3,13,89,157,171,-14
42,3,13,121,167,276,-109
42,3,13,135,73,137,-64
42,3,13,215,0,44,-44
42,3,13,245,0,27,-27
42,3,15,3,90,98,-8
42,3,16,1,28,0,28
42,3,17,19,69,0,69
42,3,17,31,486,625,-139
42,3,17,43,90,91,-1
42,3,17,97,71,54,17
42,3,17,197,37,0,37
42,3,18,3,22,33,-11
42,3,18,57,0,40,-40
42,3,18,89,37,0,37
42,3,18,97,70,94,-24
42,3,18,105,0,26,-26
42,3,18,127,0,25,-25
42,3,18,141,45,0,45
42,3,18,157,27,0,27
42,3,19,153,31,0,31
42,3,19,163,0,35,-35
42,3,20,91,43,63,-20
42,3,20,173,25,29,-4
42,3,21,67,31,26,5
42,3,21,111,72,82,-10
42,3,22,33,27,0,27
42,3,22,51,0,27,-27
42,3,22,71,28,53,-25
42,3,23,5,0,33,-33
42,3,24,1,35,0,35
42,3,24,3,128,126,2
42,3,24,5,161,200,-39
42,3,24,17,53,39,14
42,3,24,21,70,85,-15
42,3,24,23,32,0,32
42,3,24,25,45,61,-16
42,3,24,27,89,105,-16
42,3,24,31,304,358,-54
42,3,24,33,173,109,64
42,3,24,37,0,58,-58
42,3,24,43,56,30,26
42,3,24,45,37,0,37
42,3,24,47,0,23,-23
42,3,24,510,139,206,-67
42,3,25,5,0,23,-23
42,3,25,9,0,28,-28
42,3,25,17,216,285,-69
42,3,25,21,70,93,-23
42,3,25,23,39,27,12
42,3,25,25,112,148,-36
42,3,25,27,60,57,3
42,3,26,65,46,0,46
42,3,26,77,35,41,-6
42,3,26,81,40,48,-8
42,3,26,99,42,31,11
42,3,26,125,172,142,30
42,3,26,161,100,99,1
42,3,26,163,179,105,74
42,3,27,53,99,144,-45
42,3,27,123,33,57,-24
42,3,29,95,39,32,7
42,3,29,189,95,94,1
42,3,29,510,48,30,18
42,3,31,55,23,34,-11
42,3,32,3,226,358,-132
42,3,32,31,42,0,42
42,3,33,11,38,27,11
42,3,34,1,26,22,4
42,3,34,3,57,83,-26
42,3,34,5,65,54,11
42,3,34,7,82,84,-2
42,3,34,13,49,48,1
42,3,34,15,30,25,5
42,3,34,17,113,129,-16
42,3,34,19,25,0,25
42,3,34,21,54,64,-10
42,3,34,23,159,185,-26
42,3,34,25,58,29,29
42,3,34,27,82,89,-7
42,3,34,29,32,0,32
42,3,34,31,29,0,29
42,3,34,35,47,36,11
42,3,34,39,53,37,16
42,3,35,1,58,60,-2
42,3,36,1,46,0,46
42,3,36,5,68,35,33
42,3,36,7,31,0,31
42,3,36,13,57,31,26
42,3,36,29,222,169,53
42,3,36,45,34,0,34
42,3,36,47,188,274,-86
42,3,36,55,169,122,47
42,3,36,59,61,42,19
42,3,36,61,301,654,-353
42,3,36,63,0,26,-26
42,3,36,67,76,60,16
42,3,36,71,28,0,28
42,3,36,81,144,207,-63
42,3,36,87,24,0,24
42,3,36,89,28,0,28
42,3,36,91,37,32,5
42,3,36,93,0,29,-29
42,3,36,103,84,65,19
42,3,36,109,40,38,2
42,3,36,111,35,0,35
42,3,36,119,51,96,-45
42,3,37,19,0,54,-54
42,3,37,21,31,29,2
42,3,37,25,0,46,-46
42,3,37,51,75,102,-27
42,3,37,63,71,109,-38
42,3,37,67,41,62,-21
42,3,37,71,0,68,-68
42,3,37,81,52,104,-52
42,3,37,119,192,503,-311
42,3,37,129,49,62,-13
42,3,37,133,104,85,19
42,3,37,135,42,80,-38
42,3,37,147,0,42,-42
42,3,37,183,139,345,-206
42,3,39,7,42,35,7
42,3,39,13,53,37,16
42,3,39,17,64,46,18
42,3,39,25,0,30,-30
42,3,39,29,116,78,38
42,3,39,35,471,440,31
42,3,39,41,39,45,-6
42,3,39,45,31,34,-3
42,3,39,49,465,464,1
42,3,39,57,49,41,8
42,3,39,61,174,174,0
42,3,39,81,154,153,1
42,3,39,85,53,46,7
42,3,39,93,59,54,5
42,3,39,95,84,30,54
42,3,39,99,231,183,48
42,3,39,103,34,46,-12
42,3,39,113,96,101,-5
42,3,39,133,61,74,-13
42,3,39,151,129,74,55
42,3,39,153,218,165,53
42,3,39,155,165,72,93
42,3,39,157,27,0,27
42,3,39,165,38,53,-15
42,3,39,169,34,0,34
42,3,39,173,34,0,34
42,3,40,143,0,51,-51
42,3,41,5,0,27,-27
42,3,41,39,0,34,-34
42,3,41,51,59,74,-15
42,3,41,67,39,66,-27
42,3,42,1,37,31,6
42,3,42,5,600,470,130
42,3,42,7,2023,2364,-341
42,3,42,9,57,62,-5
42,3,42,11,152,88,64
42,3,42,13,235,157,78
42,3,42,17,163,153,10
42,3,42,19,2513,3433,-920
42,3,42,21,478,199,279
42,3,42,27,303,187,116
42,3,42,29,194,158,36
42,3,42,31,125,137,-12
42,3,42,33,128,78,50
42,3,42,35,0,27,-27
42,3,42,37,23,0,23
42,3,42,39,259,271,-12
42,3,42,41,199,160,39
42,3,42,43,250,222,28
42,3,42,45,180,182,-2
42,3,42,47,71,36,35
42,3,42,49,648,454,194
42,3,42,51,541,364,177
42,3,42,53,29,28,1
42,3,42,55,106,61,45
42,3,42,59,119,93,26
42,3,42,61,24,39,-15
42,3,42,63,446,236,210
42,3,42,65,104,116,-12
42,3,42,69,84,49,35
42,3,42,71,180,131,49
42,3,42,73,382,332,50
42,3,42,75,55,51,4
42,3,42,77,116,94,22
42,3,42,79,82,50,32
42,3,42,81,82,66,16
42,3,42,83,91,32,59
42,3,42,85,393,362,31
42,3,42,89,40,31,9
42,3,42,91,340,330,10
42,3,42,95,72,61,11
42,3,42,97,34,25,9
42,3,42,101,506,613,-107
42,3,42,105,46,34,12
42,3,42,107,46,0,46
42,3,42,111,221,138,83
42,3,42,119,22,28,-6
42,3,42,121,184,154,30
42,3,42,123,81,48,33
42,3,42,125,2955,4276,-1321
42,3,42,129,4753,5662,-909
42,3,42,133,235,142,93
42,3,44,7,52,32,20
42,3,45,7,0,34,-34
42,3,45,13,43,92,-49
42,3,45,15,0,26,-26
42,3,45,19,75,133,-58
42,3,45,45,32,59,-27
42,3,45,51,72,106,-34
42,3,45,63,0,41,-41
42,3,45,79,68,67,1
42,3,45,91,0,75,-75
42,3,47,37,93,100,-7
42,3,47,65,0,33,-33
42,3,47,93,25,58,-33
42,3,47,149,0,25,-25
42,3,47,157,77,52,25
42,3,48,27,45,69,-24
42,3,48,29,59,76,-17
42,3,48,85,42,90,-48
42,3,48,113,115,138,-23
42,3,48,121,57,60,-3
42,3,48,141,41,0,41
42,3,48,157,0,80,-80
42,3,48,201,183,297,-114
42,3,48,339,0,42,-42
42,3,48,355,30,0,30
42,3,48,439,121,71,50
42,3,48,453,90,111,-21
42,3,49,35,88,78,10
42,3,49,49,42,0,42
42,3,50,7,44,25,19
42,3,51,3,46,72,-26
42,3,51,13,118,236,-118
42,3,51,41,40,66,-26
42,3,51,59,337,397,-60
42,3,51,87,68,90,-22
42,3,51,107,91,72,19
42,3,51,121,39,0,39
42,3,51,153,167,97,70
42,3,51,510,109,113,-4
42,3,51,540,0,33,-33
42,3,51,550,44,60,-16
42,3,51,650,0,28,-28
42,3,51,700,0,44,-44
42,3,51,710,51,72,-21
42,3,51,740,29,0,29
42,3,51,760,36,56,-20
42,3,51,810,78,112,-34
42,3,53,33,160,268,-108
42,3,53,35,0,29,-29
42,3,53,53,69,52,17
42,3,53,61,0,42,-42
42,3,54,3,0,35,-35
42,3,54,9,55,82,-27
42,3,54,29,141,160,-19
42,3,54,33,30,0,30
42,3,54,39,78,41,37
42,3,54,49,48,34,14
42,3,54,51,50,0,50
42,3,54,61,207,112,95
42,3,54,69,90,42,48
42,3,55,25,35,73,-38
42,3,55,79,67,49,18
42,5,42,3,470,600,-130
42,5,42,19,417,400,17
42,5,42,31,184,203,-19
42,5,42,49,0,32,-32
42,5,42,63,264,261,3
42,5,42,65,35,65,-30
42,5,42,85,31,0,31
42,5,42,121,0,29,-29
42,5,42,125,0,29,-29
42,5,42,129,793,620,173
42,7,4,13,67,89,-22
42,7,6,37,34,32,2
42,7,12,9,0,33,-33
42,7,12,11,0,34,-34
42,7,12,31,0,28,-28
42,7,12,57,0,31,-31
42,7,12,71,0,27,-27
42,7,12,103,28,37,-9
42,7,12,127,0,28,-28
42,7,17,31,0,22,-22
42,7,32,3,0,37,-37
42,7,37,71,0,25,-25
42,7,37,119,0,66,-66
42,7,37,183,0,30,-30
42,7,39,29,174,284,-110
42,7,39,35,26,25,1
42,7,39,49,53,45,8
42,7,39,99,74,100,-26
42,7,39,155,0,26,-26
42,7,42,3,2364,2023,341
42,7,42,19,748,713,35
42,7,42,21,0,25,-25
42,7,42,39,43,41,2
42,7,42,43,0,32,-32
42,7,42,49,108,43,65
42,7,42,51,40,50,-10
42,7,42,53,0,25,-25
42,7,42,73,439,435,4
42,7,42,85,63,48,15
42,7,42,101,0,22,-22
42,7,42,121,33,29,4
42,7,42,125,156,186,-30
42,7,42,129,121,121,0
42,7,42,133,24,0,24
42,7,48,201,0,34,-34
42,7,51,59,36,40,-4
42,7,54,29,67,106,-39
42,9,24,1,111,122,-11
42,9,24,43,51,0,51
42,9,42,3,62,57,5
42,9,42,13,444,277,167
42,9,42,21,80,105,-25
42,9,42,27,0,32,-32
42,9,42,41,47,25,22
42,9,42,55,52,77,-25
42,9,42,57,88,81,7
42,9,42,61,125,98,27
42,9,42,71,35,30,5
42,9,42,111,74,88,-14
42,9,53,53,40,0,40
42,11,4,13,52,106,-54
42,11,4,19,0,30,-30
42,11,6,37,52,64,-12
42,11,6,59,34,33,1
42,11,6,73,41,70,-29
42,11,9,1,34,35,-1
42,11,9,3,41,0,41
42,11,9,9,42,0,42
42,11,10,1,0,46,-46
42,11,10,3,104,77,27
42,11,10,5,50,77,-27
42,11,11,1,30,24,6
42,11,12,9,29,32,-3
42,11,12,11,68,59,9
42,11,12,31,36,43,-7
42,11,12,57,38,89,-51
42,11,12,71,36,63,-27
42,11,12,83,0,32,-32
42,11,12,86,51,68,-17
42,11,12,95,94,118,-24
42,11,12,97,58,33,25
42,11,12,99,35,74,-39
42,11,12,101,0,33,-33
42,11,12,103,75,65,10
42,11,12,105,38,77,-39
42,11,12,117,0,37,-37
42,11,12,119,0,39,-39
42,11,12,127,0,38,-38
42,11,17,31,0,45,-45
42,11,24,3,0,48,-48
42,11,24,5,76,45,31
42,11,24,31,57,70,-13
42,11,24,33,39,35,4
42,11,24,510,28,42,-14
42,11,25,9,33,47,-14
42,11,25,17,0,46,-46
42,11,25,25,35,25,10
42,11,32,3,46,50,-4
42,11,34,1,32,0,32
42,11,34,3,45,40,5
42,11,34,5,58,29,29
42,11,34,7,78,42,36
42,11,34,11,33,0,33
42,11,34,13,121,40,81
42,11,34,15,58,47,11
42,11,34,17,104,64,40
42,11,34,21,46,0,46
42,11,34,23,114,48,66
42,11,34,25,47,0,47
42,11,34,27,46,0,46
42,11,34,29,65,35,30
42,11,34,31,79,42,37
42,11,34,39,83,0,83
42,11,36,5,532,264,268
42,11,36,47,416,281,135
42,11,36,55,49,25,24
42,11,36,59,79,44,35
42,11,36,61,207,234,-27
42,11,36,81,307,193,114
42,11,36,85,39,0,39
42,11,36,87,26,0,26
42,11,36,103,83,68,15
42,11,36,119,83,26,57
42,11,37,81,0,28,-28
42,11,37,97,0,35,-35
42,11,37,119,28,55,-27
42,11,37,133,28,30,-2
42,11,37,183,0,77,-77
42,11,39,49,0,41,-41
42,11,42,1,0,27,-27
42,11,42,3,88,152,-64
42,11,42,13,29,0,29
42,11,42,17,489,298,191
42,11,42,25,59,41,18
42,11,42,27,50,95,-45
42,11,42,29,1314,1120,194
42,11,42,37,35,0,35
42,11,42,41,76,129,-53
42,11,42,43,159,251,-92
42,11,42,45,255,162,93
42,11,42,49,54,0,54
42,11,42,55,31,60,-29
42,11,42,69,35,48,-13
42,11,42,71,1006,1287,-281
42,11,42,75,617,892,-275
42,11,42,77,1315,1070,245
42,11,42,79,150,161,-11
42,11,42,81,38,42,-4
42,11,42,87,28,0,28
42,11,42,89,62,61,1
42,11,42,91,2750,2157,593
42,11,42,95,379,252,127
42,11,42,97,0,53,-53
42,11,42,101,659,634,25
42,11,42,107,532,836,-304
42,11,42,117,0,34,-34
42,11,42,129,28,42,-14
42,11,42,133,197,226,-29
42,11,44,7,46,39,7
42,11,45,51,0,71,-71
42,11,48,201,34,66,-32
42,11,51,13,0,28,-28
42,11,51,59,50,61,-11
42,11,51,87,0,26,-26
42,11,51,810,0,35,-35
42,13,4,13,0,34,-34
42,13,12,101,0,33,-33
42,13,24,31,0,22,-22
42,13,34,13,53,0,53
42,13,36,61,0,24,-24
42,13,37,183,0,33,-33
42,13,42,3,157,235,-78
42,13,42,9,277,444,-167
42,13,42,11,0,29,-29
42,13,42,19,30,36,-6
42,13,42,21,495,497,-2
42,13,42,27,230,284,-54
42,13,42,29,37,28,9
42,13,42,33,141,159,-18
42,13,42,35,34,0,34
42,13,42,41,95,59,36
42,13,42,43,60,49,11
42,13,42,49,0,37,-37
42,13,42,55,0,38,-38
42,13,42,61,236,204,32
42,13,42,63,46,49,-3
42,13,42,71,31,75,-44
42,13,42,81,41,0,41
42,13,42,87,38,33,5
42,13,42,91,0,24,-24
42,13,42,101,0,40,-40
42,13,42,111,34,0,34
42,13,42,129,44,50,-6
42,13,42,133,57,58,-1
42,13,51,59,0,32,-32
42,15,36,7,57,69,-12
42,15,36,15,196,256,-60
42,15,36,101,34,52,-18
42,15,36,107,374,352,22
42,15,36,109,27,28,-1
42,15,42,17,39,0,39
42,15,42,27,26,0,26
42,15,42,41,0,39,-39
42,15,42,43,26,26,0
42,15,42,69,48,33,15
42,15,42,71,0,40,-40
42,15,42,79,47,56,-9
42,15,42,81,46,104,-58
42,15,42,91,24,51,-27
42,15,42,101,68,34,34
42,15,42,113,62,61,1
42,15,42,115,69,61,8
42,15,42,117,137,138,-1
42,15,42,131,157,102,55
42,17,4,13,122,232,-110
42,17,4,19,0,57,-57
42,17,4,25,0,30,-30
42,17,6,1,0,72,-72
42,17,6,37,131,176,-45
42,17,6,59,74,48,26
42,17,6,65,0,31,-31
42,17,6,71,0,38,-38
42,17,6,73,108,141,-33
42,17,6,75,0,55,-55
42,17,6,81,0,45,-45
42,17,6,85,0,84,-84
42,17,6,111,39,44,-5
42,17,8,5,0,38,-38
42,17,8,13,0,44,-44
42,17,8,31,0,42,-42
42,17,8,35,0,50,-50
42,17,8,41,29,0,29
42,17,8,59,0,37,-37
42,17,9,1,81,61,20
42,17,9,3,37,63,-26
42,17,9,7,28,0,28
42,17,9,9,92,44,48
42,17,10,1,0,55,-55
42,17,10,3,226,333,-107
42,17,10,5,32,100,-68
42,17,11,1,63,99,-36
42,17,12,9,40,75,-35
42,17,12,11,174,136,38
42,17,12,15,0,29,-29
42,17,12,21,31,71,-40
42,17,12,31,107,92,15
42,17,12,33,32,0,32
42,17,12,35,0,61,-61
42,17,12,53,0,39,-39
42,17,12,57,104,91,13
42,17,12,61,0,25,-25
42,17,12,71,51,117,-66
42,17,12,81,38,43,-5
42,17,12,83,0,44,-44
42,17,12,86,46,57,-11
42,17,12,87,0,28,-28
42,17,12,95,80,107,-27
42,17,12,97,0,24,-24
42,17,12,99,105,142,-37
42,17,12,101,36,51,-15
42,17,12,103,45,114,-69
42,17,12,105,36,81,-45
42,17,12,109,0,67,-67
42,17,12,111,0,44,-44
42,17,12,115,32,66,-34
42,17,12,117,27,60,-33
42,17,12,119,0,24,-24
42,17,12,127,43,53,-10
42,17,13,67,35,65,-30
42,17,13,89,24,42,-18
42,17,13,121,45,52,-7
42,17,13,135,0,57,-57
42,17,15,3,67,40,27
42,17,17,31,125,120,5
42,17,17,43,0,55,-55
42,17,17,97,0,45,-45
42,17,23,5,47,26,21
42,17,24,3,41,79,-38
42,17,24,5,70,102,-32
42,17,24,15,0,37,-37
42,17,24,25,47,0,47
42,17,24,27,80,39,41
42,17,24,31,93,142,-49
42,17,24,33,46,57,-11
42,17,24,510,53,55,-2
42,17,25,9,0,45,-45
42,17,25,17,75,159,-84
42,17,25,21,0,39,-39
42,17,25,23,0,31,-31
42,17,25,25,24,81,-57
42,17,25,27,0,45,-45
42,17,26,125,49,0,49
42,17,26,163,45,0,45
42,17,27,53,45,61,-16
42,17,32,3,66,88,-22
42,17,34,1,114,157,-43
42,17,34,3,132,112,20
42,17,34,5,820,866,-46
42,17,34,7,395,435,-40
42,17,34,9,84,164,-80
42,17,34,11,32,32,0
42,17,34,13,172,64,108
42,17,34,15,246,205,41
42,17,34,17,117,144,-27
42,17,34,19,423,279,144
42,17,34,21,2229,1307,922
42,17,34,23,549,315,234
42,17,34,25,178,149,29
42,17,34,27,195,78,117
42,17,34,29,258,185,73
42,17,34,31,56,40,16
42,17,34,35,332,141,191
42,17,34,39,140,60,80
42,17,34,41,74,45,29
42,17,36,1,0,27,-27
42,17,36,5,72,35,37
42,17,36,7,27,0,27
42,17,36,27,28,0,28
42,17,36,29,46,0,46
42,17,36,47,214,230,-16
42,17,36,55,66,29,37
42,17,36,59,104,50,54
42,17,36,61,249,301,-52
42,17,36,67,28,49,-21
42,17,36,71,50,32,18
42,17,36,81,184,160,24
42,17,36,85,43,35,8
42,17,36,103,153,77,76
42,17,36,119,86,44,42
42,17,37,19,0,36,-36
42,17,37,51,0,26,-26
42,17,37,63,24,0,24
42,17,37,119,33,146,-113
42,17,37,129,0,27,-27
42,17,37,133,82,42,40
42,17,37,183,43,111,-68
42,17,39,35,46,35,11
42,17,39,49,54,58,-4
42,17,39,61,0,39,-39
42,17,42,3,153,163,-10
42,17,42,11,298,489,-191
42,17,42,15,0,39,-39
42,17,42,21,28,32,-4
42,17,42,25,67,135,-68
42,17,42,27,72,79,-7
42,17,42,29,554,757,-203
42,17,42,37,32,87,-55
42,17,42,41,84,106,-22
42,17,42,43,92,93,-1
42,17,42,45,634,631,3
42,17,42,49,37,0,37
42,17,42,55,0,30,-30
42,17,42,69,46,47,-1
42,17,42,71,170,362,-192
42,17,42,75,38,69,-31
42,17,42,77,786,873,-87
42,17,42,79,134,161,-27
42,17,42,81,0,51,-51
42,17,42,89,106,131,-25
42,17,42,91,6922,6688,234
42,17,42,95,444,547,-103
42,17,42,101,7929,5962,1967
42,17,42,103,33,57,-24
42,17,42,107,64,106,-42
42,17,42,115,0,31,-31
42,17,42,117,0,53,-53
42,17,42,127,0,61,-61
42,17,42,129,34,40,-6
42,17,42,133,98,82,16
42,17,44,7,40,30,10
42,17,45,13,0,73,-73
42,17,45,15,0,33,-33
42,17,45,19,0,30,-30
42,17,45,45,0,34,-34
42,17,45,51,27,100,-73
42,17,45,91,0,37,-37
42,17,47,187,0,34,-34
42,17,48,27,0,26,-26
42,17,48,29,36,62,-26
42,17,48,85,0,44,-44
42,17,48,113,0,85,-85
42,17,48,201,97,108,-11
42,17,48,439,75,62,13
42,17,48,453,0,35,-35
42,17,50,7,28,0,28
42,17,51,13,0,88,-88
42,17,51,59,108,142,-34
42,17,51,107,46,0,46
42,17,51,510,0,56,-56
42,17,51,710,0,34,-34
42,17,51,810,59,75,-16
42,17,53,33,36,67,-31
42,17,53,61,0,33,-33
42,19,4,13,55,32,23
42,19,4,19,0,41,-41
42,19,6,37,0,27,-27
42,19,6,73,0,28,-28
42,19,8,41,0,33,-33
42,19,12,9,0,29,-29
42,19,12,11,28,32,-4
42,19,12,71,37,33,4
42,19,12,95,0,23,-23
42,19,12,103,22,28,-6
42,19,12,127,0,34,-34
42,19,17,31,0,44,-44
42,19,24,31,0,23,-23
42,19,32,3,28,41,-13
42,19,36,61,0,41,-41
42,19,37,119,29,52,-23
42,19,37,183,0,68,-68
42,19,39,35,47,32,15
42,19,39,49,40,45,-5
42,19,39,99,61,55,6
42,19,39,153,44,42,2
42,19,39,155,26,33,-7
42,19,42,3,3433,2513,920
42,19,42,5,400,417,-17
42,19,42,7,713,748,-35
42,19,42,13,36,30,6
42,19,42,21,28,0,28
42,19,42,27,38,41,-3
42,19,42,29,29,0,29
42,19,42,31,188,176,12
42,19,42,39,90,78,12
42,19,42,43,0,58,-58
42,19,42,49,142,139,3
42,19,42,51,27,25,2
42,19,42,63,45,27,18
42,19,42,65,42,0,42
42,19,42,71,0,28,-28
42,19,42,73,383,405,-22
42,19,42,77,0,34,-34
42,19,42,85,359,422,-63
42,19,42,91,33,27,6
42,19,42,101,32,30,2
42,19,42,111,0,42,-42
42,19,42,121,202,118,84
42,19,42,125,132,117,15
42,19,42,129,368,251,117
42,19,45,19,0,32,-32
42,19,51,59,26,48,-22
42,19,54,61,0,33,-33
42,21,4,13,0,35,-35
42,21,6,73,35,27,8
42,21,12,103,24,0,24
42,21,24,21,32,0,32
42,21,37,119,0,23,-23
42,21,42,3,199,478,-279
42,21,42,7,25,0,25
42,21,42,9,105,80,25
42,21,42,13,497,495,2
42,21,42,17,32,28,4
42,21,42,19,0,28,-28
42,21,42,27,62,71,-9
42,21,42,29,0,20,-20
42,21,42,33,156,149,7
42,21,42,41,45,58,-13
42,21,42,43,32,77,-45
42,21,42,49,0,36,-36
42,21,42,55,24,44,-20
42,21,42,61,32,25,7
42,21,42,63,330,390,-60
42,21,42,65,0,25,-25
42,21,42,71,77,61,16
42,21,42,91,31,39,-8
42,21,42,101,44,34,10
42,21,42,111,775,615,160
42,21,42,125,41,44,-3
42,21,42,129,214,241,-27
42,21,42,133,50,31,19
42,21,51,59,0,67,-67
42,21,51,510,0,21,-21
42,21,51,810,0,27,-27
42,23,42,47,60,27,33
42,23,42,83,0,39,-39
42,25,34,13,39,0,39
42,25,34,17,38,0,38
42,25,34,23,49,0,49
42,25,34,25,31,0,31
42,25,34,27,28,0,28
42,25,34,41,30,0,30
42,25,36,47,78,0,78
42,25,36,81,51,0,51
42,25,36,103,33,0,33
42,25,42,11,41,59,-18
42,25,42,17,135,67,68
42,25,42,43,0,31,-31
42,25,42,45,38,0,38
42,25,42,69,28,25,3
42,25,42,77,654,596,58
42,25,42,79,319,394,-75
42,25,42,89,470,307,163
42,25,42,91,184,81,103
42,25,42,95,512,339,173
42,25,42,101,115,90,25
42,25,42,107,402,523,-121
42,27,4,13,52,66,-14
42,27,4,19,30,0,30
42,27,6,1,0,20,-20
42,27,6,37,41,96,-55
42,27,6,59,28,0,28
42,27,6,73,36,44,-8
42,27,6,85,0,54,-54
42,27,8,13,0,32,-32
42,27,10,3,0,41,-41
42,27,11,1,26,40,-14
42,27,12,103,0,31,-31
42,27,13,121,0,24,-24
42,27,17,31,74,82,-8
42,27,24,5,0,24,-24
42,27,24,21,0,30,-30
42,27,24,27,26,0,26
42,27,24,31,60,88,-28
42,27,24,33,0,34,-34
42,27,24,510,0,50,-50
42,27,25,17,39,76,-37
42,27,25,25,31,28,3
42,27,26,161,37,0,37
42,27,32,3,0,37,-37
42,27,34,3,25,0,25
42,27,34,17,0,28,-28
42,27,34,23,33,0,33
42,27,34,27,27,23,4
42,27,36,29,22,42,-20
42,27,36,47,28,44,-16
42,27,36,55,32,0,32
42,27,36,61,31,83,-52
42,27,36,81,52,32,20
42,27,37,119,0,52,-52
42,27,37,183,0,52,-52
42,27,39,35,0,43,-43
42,27,39,49,0,49,-49
42,27,41,51,0,21,-21
42,27,42,1,40,0,40
42,27,42,3,187,303,-116
42,27,42,9,32,0,32
42,27,42,11,95,50,45
42,27,42,13,284,230,54
42,27,42,15,0,26,-26
42,27,42,17,79,72,7
42,27,42,19,41,38,3
42,27,42,21,71,62,9
42,27,42,29,124,72,52
42,27,42,33,535,521,14
42,27,42,35,307,306,1
42,27,42,39,0,24,-24
42,27,42,41,111,85,26
42,27,42,43,86,129,-43
42,27,42,45,52,44,8
42,27,42,47,42,0,42
42,27,42,49,76,38,38
42,27,42,51,21,0,21
42,27,42,55,38,0,38
42,27,42,61,177,127,50
42,27,42,63,44,37,7
42,27,42,65,0,29,-29
42,27,42,69,36,27,9
42,27,42,71,120,102,18
42,27,42,75,37,28,9
42,27,42,77,100,42,58
42,27,42,79,52,34,18
42,27,42,81,126,93,33
42,27,42,87,115,152,-37
42,27,42,89,23,0,23
42,27,42,91,144,166,-22
42,27,42,95,41,42,-1
42,27,42,97,35,35,0
42,27,42,99,29,0,29
42,27,42,101,96,176,-80
42,27,42,105,27,0,27
42,27,42,107,39,24,15
42,27,42,109,29,0,29
42,27,42,111,22,0,22
42,27,42,117,0,23,-23
42,27,42,119,68,47,21
42,27,42,125,32,0,32
42,27,42,129,70,48,22
42,27,42,133,100,89,11
42,27,47,37,0,25,-25
42,27,48,113,0,23,-23
42,27,48,201,0,39,-39
42,27,48,453,23,40,-17
42,27,51,13,0,52,-52
42,27,51,59,68,120,-52
42,27,51,87,0,36,-36
42,27,51,510,0,27,-27
42,27,53,33,43,31,12
42,27,55,25,0,33,-33
42,29,4,13,120,208,-88
42,29,4,19,32,42,-10
42,29,6,1,66,45,21
42,29,6,13,0,49,-49
42,29,6,37,147,165,-18
42,29,6,59,48,107,-59
42,29,6,65,58,0,58
42,29,6,71,30,0,30
42,29,6,73,132,136,-4
42,29,6,75,39,46,-7
42,29,6,81,0,29,-29
42,29,6,85,57,78,-21
42,29,6,111,53,31,22
42,29,8,13,0,39,-39
42,29,8,31,34,41,-7
42,29,8,69,0,29,-29
42,29,9,1,113,72,41
42,29,9,3,80,64,16
42,29,9,9,44,0,44
42,29,10,1,57,82,-25
42,29,10,3,2178,1786,392
42,29,10,5,105,180,-75
42,29,11,1,56,134,-78
42,29,12,9,0,47,-47
42,29,12,11,90,67,23
42,29,12,21,34,45,-11
42,29,12,31,0,36,-36
42,29,12,57,84,70,14
42,29,12,69,0,40,-40
42,29,12,71,29,66,-37
42,29,12,86,52,74,-22
42,29,12,95,60,67,-7
42,29,12,99,111,135,-24
42,29,12,101,0,40,-40
42,29,12,103,52,92,-40
42,29,12,105,0,22,-22
42,29,12,109,0,36,-36
42,29,12,115,0,51,-51
42,29,12,117,28,52,-24
42,29,13,51,0,29,-29
42,29,13,67,70,69,1
42,29,13,89,42,0,42
42,29,13,117,0,36,-36
42,29,13,121,24,56,-32
42,29,15,3,33,0,33
42,29,17,31,132,103,29
42,29,17,43,50,36,14
42,29,17,89,44,0,44
42,29,17,97,35,41,-6
42,29,17,197,56,0,56
42,29,18,97,46,0,46
42,29,20,91,0,42,-42
42,29,21,111,32,0,32
42,29,24,3,65,69,-4
42,29,24,5,83,106,-23
42,29,24,15,310,283,27
42,29,24,21,40,22,18
42,29,24,25,87,74,13
42,29,24,27,75,53,22
42,29,24,31,175,162,13
42,29,24,33,63,61,2
42,29,24,510,62,124,-62
42,29,25,1,0,31,-31
42,29,25,17,128,108,20
42,29,25,21,49,38,11
42,29,25,25,47,72,-25
42,29,25,27,93,39,54
42,29,26,125,65,0,65
42,29,26,161,48,0,48
42,29,26,163,44,0,44
42,29,27,53,39,37,2
42,29,29,189,32,0,32
42,29,32,3,66,56,10
42,29,33,11,25,36,-11
42,29,34,1,83,63,20
42,29,34,3,111,38,73
42,29,34,5,227,133,94
42,29,34,7,194,117,77
42,29,34,9,79,87,-8
42,29,34,11,41,0,41
42,29,34,13,51,42,9
42,29,34,15,195,120,75
42,29,34,17,61,81,-20
42,29,34,19,62,46,16
42,29,34,21,118,64,54
42,29,34,23,217,102,115
42,29,34,25,80,46,34
42,29,34,27,134,52,82
42,29,34,29,106,67,39
42,29,34,33,47,30,17
42,29,34,35,81,50,31
42,29,34,39,57,44,13
42,29,34,41,32,0,32
42,29,36,5,0,23,-23
42,29,36,29,41,0,41
42,29,36,47,85,107,-22
42,29,36,55,62,34,28
42,29,36,59,56,38,18
42,29,36,61,125,248,-123
42,29,36,67,45,45,0
42,29,36,71,56,0,56
42,29,36,81,64,64,0
42,29,36,91,46,0,46
42,29,36,103,99,55,44
42,29,36,109,0,29,-29
42,29,36,119,74,32,42
42,29,37,51,0,27,-27
42,29,37,63,36,32,4
42,29,37,81,0,34,-34
42,29,37,119,64,112,-48
42,29,37,129,0,34,-34
42,29,37,133,37,30,7
42,29,37,183,66,180,-114
42,29,39,35,71,0,71
42,29,39,49,79,56,23
42,29,41,51,0,23,-23
42,29,42,1,44,36,8
42,29,42,3,158,194,-36
42,29,42,11,1120,1314,-194
42,29,42,13,28,37,-9
42,29,42,17,757,554,203
42,29,42,19,0,29,-29
42,29,42,21,20,0,20
42,29,42,27,72,124,-52
42,29,42,37,37,33,4
42,29,42,41,147,112,35
42,29,42,43,163,130,33
42,29,42,45,4675,3002,1673
42,29,42,49,41,0,41
42,29,42,55,51,0,51
42,29,42,69,71,32,39
42,29,42,71,1278,2129,-851
42,29,42,75,66,125,-59
42,29,42,77,237,193,44
42,29,42,79,128,72,56
42,29,42,81,26,36,-10
42,29,42,89,89,49,40
42,29,42,91,5331,4517,814
42,29,42,95,128,106,22
42,29,42,101,1887,1601,286
42,29,42,107,35,52,-17
42,29,42,117,0,37,-37
42,29,42,125,25,0,25
42,29,42,129,33,43,-10
42,29,42,133,184,165,19
42,29,44,7,27,0,27
42,29,45,13,0,43,-43
42,29,45,19,0,38,-38
42,29,45,45,41,0,41
42,29,45,51,0,49,-49
42,29,45,79,0,29,-29
42,29,45,91,0,40,-40
42,29,47,37,0,35,-35
42,29,47,157,37,0,37
42,29,48,29,38,35,3
42,29,48,85,53,53,0
42,29,48,113,45,73,-28
42,29,48,201,64,92,-28
42,29,48,439,42,0,42
42,29,48,453,0,57,-57
42,29,49,35,0,37,-37
42,29,51,13,70,93,-23
42,29,51,41,54,36,18
42,29,51,59,164,122,42
42,29,51,87,35,48,-13
42,29,51,107,93,65,28
42,29,51,153,39,31,8
42,29,51,510,28,22,6
42,29,51,810,67,28,39
42,29,53,33,86,89,-3
42,31,42,3,137,125,12
42,31,42,5,203,184,19
42,31,42,19,176,188,-12
42,31,42,33,38,34,4
42,31,42,39,0,27,-27
42,31,42,49,66,43,23
42,31,42,53,67,64,3
42,31,42,65,195,185,10
42,31,42,85,47,52,-5
42,31,42,121,226,175,51
42,31,42,129,41,27,14
42,33,42,3,78,128,-50
42,33,42,13,159,141,18
42,33,42,21,149,156,-7
42,33,42,27,521,535,-14
42,33,42,31,34,38,-4
42,33,42,43,0,34,-34
42,33,42,47,134,99,35
42,33,42,49,27,32,-5
42,33,42,61,0,30,-30
42,33,42,63,67,106,-39
42,33,42,65,604,585,19
42,33,42,71,58,30,28
42,33,42,83,31,0,31
42,33,42,91,37,0,37
42,33,42,129,0,37,-37
42,33,42,133,0,49,-49
42,35,42,3,27,0,27
42,35,42,13,0,34,-34
42,35,42,27,306,307,-1
42,35,42,43,0,33,-33
42,35,42,71,0,27,-27
42,35,42,81,571,553,18
42,35,42,97,0,42,-42
42,35,42,101,0,25,-25
42,35,42,133,26,27,-1
42,37,42,3,0,23,-23
42,37,42,11,0,35,-35
42,37,42,17,87,32,55
42,37,42,29,33,37,-4
42,37,42,41,36,0,36
42,37,42,43,25,32,-7
42,37,42,45,25,0,25
42,37,42,69,61,50,11
42,37,42,71,31,35,-4
42,37,42,77,38,43,-5
42,37,42,79,675,616,59
42,37,42,81,127,80,47
42,37,42,89,36,0,36
42,37,42,91,28,30,-2
42,37,42,93,353,353,0
42,37,42,95,0,30,-30
42,37,42,97,293,379,-86
42,37,42,101,55,52,3
42,37,42,107,98,71,27
42,37,42,109,37,0,37
42,37,42,119,46,48,-2
42,37,42,133,22,0,22
42,39,4,13,0,27,-27
42,39,12,71,0,30,-30
42,39,36,13,31,39,-8
42,39,39,7,58,93,-35
42,39,39,35,34,38,-4
42,39,42,3,271,259,12
42,39,42,7,41,43,-2
42,39,42,19,78,90,-12
42,39,42,27,24,0,24
42,39,42,31,27,0,27
42,39,42,49,868,946,-78
42,39,42,85,360,353,7
42,39,42,121,282,285,-3
42,39,42,123,87,86,1
42,39,42,125,0,45,-45
42,39,42,129,25,25,0
42,41,4,13,60,54,6
42,41,6,37,57,57,0
42,41,6,73,62,67,-5
42,41,8,41,39,45,-6
42,41,9,9,37,0,37
42,41,10,3,41,44,-3
42,41,10,5,0,28,-28
42,41,11,1,27,49,-22
42,41,12,9,0,29,-29
42,41,12,11,52,0,52
42,41,12,31,28,0,28
42,41,12,57,0,64,-64
42,41,12,86,45,0,45
42,41,12,91,0,41,-41
42,41,12,95,38,35,3
42,41,12,99,0,34,-34
42,41,12,103,51,36,15
42,41,12,117,0,39,-39
42,41,13,121,26,0,26
42,41,15,3,82,76,6
42,41,17,31,32,53,-21
42,41,24,3,43,74,-31
42,41,24,5,87,74,13
42,41,24,21,40,35,5
42,41,24,25,46,0,46
42,41,24,27,24,0,24
42,41,24,31,44,80,-36
42,41,24,33,0,31,-31
42,41,24,43,48,50,-2
42,41,24,510,35,40,-5
42,41,25,17,0,25,-25
42,41,25,25,0,21,-21
42,41,32,3,42,31,11
42,41,34,5,51,0,51
42,41,34,23,53,0,53
42,41,34,25,25,29,-4
42,41,34,27,0,37,-37
42,41,36,29,27,0,27
42,41,36,45,58,0,58
42,41,36,47,38,34,4
42,41,36,55,33,0,33
42,41,36,61,30,75,-45
42,41,36,67,39,0,39
42,41,36,71,36,0,36
42,41,36,81,0,36,-36
42,41,36,103,73,0,73
42,41,37,51,82,73,9
42,41,37,81,0,30,-30
42,41,37,119,38,26,12
42,41,37,183,0,48,-48
42,41,39,49,59,36,23
42,41,42,1,374,216,158
42,41,42,3,160,199,-39
42,41,42,9,25,47,-22
42,41,42,11,129,76,53
42,41,42,13,59,95,-36
42,41,42,15,39,0,39
42,41,42,17,106,84,22
42,41,42,21,58,45,13
42,41,42,27,85,111,-26
42,41,42,29,112,147,-35
42,41,42,37,0,36,-36
42,41,42,43,3489,2904,585
42,41,42,45,65,65,0
42,41,42,49,40,27,13
42,41,42,55,851,776,75
42,41,42,61,79,73,6
42,41,42,63,26,0,26
42,41,42,67,60,61,-1
42,41,42,69,50,34,16
42,41,42,71,427,368,59
42,41,42,75,226,228,-2
42,41,42,77,92,79,13
42,41,42,79,95,57,38
42,41,42,81,88,52,36
42,41,42,87,72,44,28
42,41,42,89,54,0,54
42,41,42,91,179,115,64
42,41,42,93,25,0,25
42,41,42,95,52,51,1
42,41,42,97,82,54,28
42,41,42,99,1005,977,28
42,41,42,101,156,180,-24
42,41,42,107,106,48,58
42,41,42,109,33,30,3
42,41,42,111,26,27,-1
42,41,42,117,36,0,36
42,41,42,119,39,0,39
42,41,42,125,29,25,4
42,41,42,129,43,33,10
42,41,42,133,2303,1955,348
42,41,45,79,0,34,-34
42,41,48,27,0,76,-76
42,41,48,29,35,34,1
42,41,49,35,32,0,32
42,41,51,13,39,54,-15
42,41,51,41,0,39,-39
42,41,51,59,149,164,-15
42,41,51,153,0,89,-89
42,41,51,810,51,55,-4
42,41,53,53,0,36,-36
42,43,4,13,82,80,2
42,43,6,37,52,61,-9
42,43,6,59,0,24,-24
42,43,6,73,40,58,-18
42,43,9,1,40,0,40
42,43,9,3,48,0,48
42,43,9,9,38,0,38
42,43,10,1,0,29,-29
42,43,10,3,46,54,-8
42,43,10,5,0,57,-57
42,43,11,1,32,54,-22
42,43,12,11,40,47,-7
42,43,12,31,28,30,-2
42,43,12,57,28,48,-20
42,43,12,71,35,0,35
42,43,12,86,43,46,-3
42,43,12,95,75,53,22
42,43,12,99,33,39,-6
42,43,12,101,0,31,-31
42,43,12,103,38,55,-17
42,43,12,105,34,0,34
42,43,13,89,0,35,-35
42,43,13,121,0,39,-39
42,43,17,31,80,63,17
42,43,24,3,46,45,1
42,43,24,5,95,79,16
42,43,24,21,0,36,-36
42,43,24,25,38,0,38
42,43,24,27,45,24,21
42,43,24,31,62,67,-5
42,43,24,33,68,35,33
42,43,24,43,0,29,-29
42,43,24,510,80,80,0
42,43,25,17,33,33,0
42,43,25,25,29,0,29
42,43,26,125,35,0,35
42,43,32,3,44,39,5
42,43,34,5,30,31,-1
42,43,34,7,49,44,5
42,43,34,13,61,0,61
42,43,34,17,48,37,11
42,43,34,23,71,46,25
42,43,34,25,29,0,29
42,43,34,39,44,0,44
42,43,36,5,158,56,102
42,43,36,29,26,0,26
42,43,36,47,166,113,53
42,43,36,55,38,0,38
42,43,36,59,0,26,-26
42,43,36,61,69,110,-41
42,43,36,81,116,67,49
42,43,36,103,46,0,46
42,43,36,119,31,0,31
42,43,37,81,51,34,17
42,43,37,119,41,59,-18
42,43,37,129,0,23,-23
42,43,37,133,51,37,14
42,43,37,183,29,64,-35
42,43,39,35,0,43,-43
42,43,39,49,53,52,1
42,43,42,1,125,97,28
42,43,42,3,222,250,-28
42,43,42,7,32,0,32
42,43,42,11,251,159,92
42,43,42,13,49,60,-11
42,43,42,15,26,26,0
42,43,42,17,93,92,1
42,43,42,19,58,0,58
42,43,42,21,77,32,45
42,43,42,25,31,0,31
42,43,42,27,129,86,43
42,43,42,29,130,163,-33
42,43,42,33,34,0,34
42,43,42,35,33,0,33
42,43,42,37,32,25,7
42,43,42,41,2904,3489,-585
42,43,42,45,122,85,37
42,43,42,49,57,35,22
42,43,42,55,77,130,-53
42,43,42,61,30,27,3
42,43,42,63,42,0,42
42,43,42,67,77,60,17
42,43,42,69,84,33,51
42,43,42,71,1209,1170,39
42,43,42,75,1224,1577,-353
42,43,42,77,138,113,25
42,43,42,79,172,56,116
42,43,42,81,180,94,86
42,43,42,87,70,50,20
42,43,42,89,49,44,5
42,43,42,91,209,177,32
42,43,42,93,25,0,25
42,43,42,95,61,49,12
42,43,42,97,218,255,-37
42,43,42,99,594,650,-56
42,43,42,101,324,367,-43
42,43,42,107,392,399,-7
42,43,42,109,72,92,-20
42,43,42,119,32,38,-6
42,43,42,125,22,0,22
42,43,42,129,56,41,15
42,43,42,133,1237,1020,217
42,43,45,19,0,27,-27
42,43,48,29,27,50,-23
42,43,48,113,37,46,-9
42,43,48,201,37,91,-54
42,43,51,13,0,27,-27
42,43,51,59,69,77,-8
42,43,51,107,0,26,-26
42,43,51,153,22,36,-14
42,43,51,510,27,27,0
42,43,51,810,50,51,-1
42,43,53,33,0,41,-41
42,43,53,53,0,47,-47
42,45,4,13,83,166,-83
42,45,6,1,31,29,2
42,45,6,37,130,218,-88
42,45,6,59,38,64,-26
42,45,6,71,0,27,-27
42,45,6,73,118,116,2
42,45,6,75,28,32,-4
42,45,6,81,0,35,-35
42,45,6,85,0,47,-47
42,45,8,5,0,31,-31
42,45,9,1,54,51,3
42,45,9,3,55,0,55
42,45,9,9,42,42,0
42,45,10,1,78,203,-125
42,45,10,3,1856,2601,-745
42,45,10,5,80,278,-198
42,45,11,1,52,113,-61
42,45,12,11,68,99,-31
42,45,12,15,30,0,30
42,45,12,21,0,30,-30
42,45,12,31,49,46,3
42,45,12,57,45,58,-13
42,45,12,71,42,57,-15
42,45,12,83,0,33,-33
42,45,12,86,70,59,11
42,45,12,95,44,74,-30
42,45,12,99,79,108,-29
42,45,12,101,0,29,-29
42,45,12,103,44,113,-69
42,45,12,105,0,37,-37
42,45,12,111,0,48,-48
42,45,12,115,0,28,-28
42,45,12,117,0,46,-46
42,45,12,127,26,34,-8
42,45,13,67,37,35,2
42,45,13,89,61,57,4
42,45,13,121,60,70,-10
42,45,13,135,26,96,-70
42,45,15,3,49,47,2
42,45,17,31,94,120,-26
42,45,17,43,44,0,44
42,45,24,3,68,68,0
42,45,24,5,104,131,-27
42,45,24,15,88,121,-33
42,45,24,21,27,0,27
42,45,24,25,52,57,-5
42,45,24,27,26,58,-32
42,45,24,31,111,146,-35
42,45,24,33,73,72,1
42,45,24,45,0,31,-31
42,45,24,510,89,74,15
42,45,25,9,25,49,-24
42,45,25,17,97,148,-51
42,45,25,21,46,34,12
42,45,25,23,0,35,-35
42,45,25,25,65,69,-4
42,45,26,125,21,0,21
42,45,27,53,0,32,-32
42,45,32,3,39,67,-28
42,45,34,1,130,131,-1
42,45,34,3,55,84,-29
42,45,34,5,232,195,37
42,45,34,7,431,412,19
42,45,34,9,114,235,-121
42,45,34,11,67,44,23
42,45,34,13,67,71,-4
42,45,34,15,264,502,-238
42,45,34,17,51,106,-55
42,45,34,21,56,90,-34
42,45,34,23,59,103,-44
42,45,34,25,46,65,-19
42,45,34,27,45,51,-6
42,45,34,29,65,55,10
42,45,34,33,62,83,-21
42,45,34,35,39,70,-31
42,45,34,39,33,40,-7
42,45,36,1,25,0,25
42,45,36,5,96,46,50
42,45,36,47,221,144,77
42,45,36,55,25,0,25
42,45,36,59,64,0,64
42,45,36,61,175,283,-108
42,45,36,67,32,29,3
42,45,36,81,176,118,58
42,45,36,103,51,55,-4
42,45,36,119,54,48,6
42,45,37,51,0,51,-51
42,45,37,63,0,23,-23
42,45,37,119,54,103,-49
42,45,37,133,38,29,9
42,45,37,183,27,131,-104
42,45,39,35,32,34,-2
42,45,39,49,49,47,2
42,45,39,61,0,34,-34
42,45,41,51,0,40,-40
42,45,42,3,182,180,2
42,45,42,11,162,255,-93
42,45,42,17,631,634,-3
42,45,42,25,0,38,-38
42,45,42,27,44,52,-8
42,45,42,29,3002,4675,-1673
42,45,42,37,0,25,-25
42,45,42,41,65,65,0
42,45,42,43,85,122,-37
42,45,42,63,27,0,27
42,45,42,69,63,34,29
42,45,42,71,222,399,-177
42,45,42,75,23,37,-14
42,45,42,77,127,144,-17
42,45,42,79,112,57,55
42,45,42,81,52,34,18
42,45,42,89,70,45,25
42,45,42,91,2906,2982,-76
42,45,42,95,58,54,4
42,45,42,97,0,40,-40
42,45,42,101,11156,7492,3664
42,45,42,107,54,36,18
42,45,42,129,0,32,-32
42,45,42,133,89,87,2
42,45,44,7,35,0,35
42,45,45,51,26,50,-24
42,45,48,85,0,37,-37
42,45,48,113,48,48,0
42,45,48,201,48,98,-50
42,45,48,439,0,51,-51
42,45,49,35,0,30,-30
42,45,51,13,30,73,-43
42,45,51,41,0,40,-40
42,45,51,59,80,134,-54
42,45,51,87,44,0,44
42,45,51,107,0,42,-42
42,45,51,153,0,26,-26
42,45,51,510,0,33,-33
42,45,51,810,45,45,0
42,45,53,33,36,106,-70
42,47,42,3,36,71,-35
42,47,42,23,27,60,-33
42,47,42,27,0,42,-42
42,47,42,33,99,134,-35
42,47,42,49,0,36,-36
42,47,42,65,131,126,5
42,47,42,83,63,71,-8
42,49,4,13,63,167,-104
42,49,4,19,32,45,-13
42,49,6,37,51,58,-7
42,49,6,59,0,25,-25
42,49,6,73,35,49,-14
42,49,9,3,33,0,33
42,49,12,11,0,24,-24
42,49,12,31,0,38,-38
42,49,12,57,0,43,-43
42,49,12,71,38,46,-8
42,49,12,81,0,32,-32
42,49,12,95,36,61,-25
42,49,12,97,0,30,-30
42,49,12,99,23,47,-24
42,49,12,103,61,64,-3
42,49,12,105,0,58,-58
42,49,12,115,0,33,-33
42,49,12,127,0,25,-25
42,49,15,3,37,27,10
42,49,17,31,48,90,-42
42,49,24,5,0,39,-39
42,49,24,31,0,28,-28
42,49,25,17,0,62,-62
42,49,26,125,47,29,18
42,49,26,163,70,31,39
42,49,32,3,33,69,-36
42,49,34,5,22,0,22
42,49,34,7,35,0,35
42,49,34,23,0,30,-30
42,49,36,13,340,223,117
42,49,36,29,129,137,-8
42,49,36,55,41,78,-37
42,49,36,61,0,46,-46
42,49,36,63,43,45,-2
42,49,37,51,0,38,-38
42,49,37,81,0,26,-26
42,49,37,119,52,116,-64
42,49,37,129,0,27,-27
42,49,37,133,35,41,-6
42,49,37,183,34,101,-67
42,49,39,7,163,216,-53
42,49,39,35,155,170,-15
42,49,39,49,31,114,-83
42,49,39,61,0,28,-28
42,49,39,85,69,72,-3
42,49,39,99,38,0,38
42,49,39,133,0,28,-28
42,49,39,151,27,0,27
42,49,39,153,32,49,-17
42,49,39,155,0,36,-36
42,49,42,3,454,648,-194
42,49,42,5,32,0,32
42,49,42,7,43,108,-65
42,49,42,11,0,54,-54
42,49,42,13,37,0,37
42,49,42,17,0,37,-37
42,49,42,19,139,142,-3
42,49,42,21,36,0,36
42,49,42,27,38,76,-38
42,49,42,29,0,41,-41
42,49,42,31,43,66,-23
42,49,42,33,32,27,5
42,49,42,39,946,868,78
42,49,42,41,27,40,-13
42,49,42,43,35,57,-22
42,49,42,47,36,0,36
42,49,42,63,38,26,12
42,49,42,65,38,0,38
42,49,42,73,45,39,6
42,49,42,77,30,24,6
42,49,42,81,35,0,35
42,49,42,83,62,56,6
42,49,42,85,138,114,24
42,49,42,91,25,55,-30
42,49,42,101,69,47,22
42,49,42,121,151,85,66
42,49,42,123,307,273,34
42,49,42,125,51,36,15
42,49,42,129,77,119,-42
42,49,42,133,41,54,-13
42,49,45,13,0,26,-26
42,49,45,19,0,28,-28
42,49,45,45,0,29,-29
42,49,45,51,0,40,-40
42,49,45,83,0,38,-38
42,49,47,37,0,22,-22
42,49,48,27,31,0,31
42,49,48,201,0,37,-37
42,49,48,439,0,42,-42
42,49,51,13,0,32,-32
42,49,51,59,28,63,-35
42,49,51,510,0,21,-21
42,49,51,710,0,26,-26
42,49,51,810,41,43,-2
42,49,53,33,0,33,-33
42,51,24,3,27,0,27
42,51,36,39,0,49,-49
42,51,39,35,36,0,36
42,51,42,3,364,541,-177
42,51,42,7,50,40,10
42,51,42,19,25,27,-2
42,51,42,27,0,21,-21
42,51,42,59,220,202,18
42,51,42,63,27,28,-1
42,51,42,91,30,0,30
42,51,42,111,127,102,25
42,51,42,125,531,562,-31
42,51,42,129,1116,1276,-160
42,51,45,51,26,0,26
42,51,54,61,117,135,-18
42,51,54,77,31,44,-13
42,53,42,3,28,29,-1
42,53,42,7,25,0,25
42,53,42,31,64,67,-3
42,53,42,121,31,58,-27
42,53,42,123,0,36,-36
42,55,4,13,0,39,-39
42,55,11,1,29,0,29
42,55,12,127,0,24,-24
42,55,24,1,37,0,37
42,55,24,3,79,29,50
42,55,24,5,62,32,30
42,55,24,13,68,30,38
42,55,24,21,517,222,295
42,55,24,25,37,0,37
42,55,24,27,33,0,33
42,55,24,31,122,59,63
42,55,24,33,68,0,68
42,55,24,43,1545,835,710
42,55,24,510,45,25,20
42,55,37,133,32,27,5
42,55,42,1,406,280,126
42,55,42,3,61,106,-45
42,55,42,9,77,52,25
42,55,42,11,60,31,29
42,55,42,13,38,0,38
42,55,42,17,30,0,30
42,55,42,21,44,24,20
42,55,42,27,0,38,-38
42,55,42,29,0,51,-51
42,55,42,41,776,851,-75
42,55,42,43,130,77,53
42,55,42,57,206,166,40
42,55,42,61,75,181,-106
42,55,42,71,56,115,-59
42,55,42,75,43,0,43
42,55,42,81,31,0,31
42,55,42,87,36,0,36
42,55,42,91,61,56,5
42,55,42,99,0,46,-46
42,55,42,101,58,62,-4
42,55,42,111,29,0,29
42,55,42,133,165,136,29
42,55,45,51,0,29,-29
42,55,51,59,44,36,8
42,55,54,3,139,130,9
42,57,24,43,133,115,18
42,57,42,9,81,88,-7
42,57,42,55,166,206,-40
42,57,42,61,52,55,-3
42,57,54,65,0,41,-41
42,59,42,3,93,119,-26
42,59,42,51,202,220,-18
42,59,42,125,405,435,-30
42,59,42,129,73,0,73
42,59,54,61,154,126,28
42,61,42,3,39,24,15
42,61,42,9,98,125,-27
42,61,42,13,204,236,-32
42,61,42,21,25,32,-7
42,61,42,27,127,177,-50
42,61,42,33,30,0,30
42,61,42,41,73,79,-6
42,61,42,43,27,30,-3
42,61,42,55,181,75,106
42,61,42,57,55,52,3
42,61,42,71,43,38,5
42,61,42,87,173,271,-98
42,63,42,3,236,446,-210
42,63,42,5,261,264,-3
42,63,42,13,49,46,3
42,63,42,19,27,45,-18
42,63,42,21,390,330,60
42,63,42,27,37,44,-7
42,63,42,33,106,67,39
42,63,42,41,0,26,-26
42,63,42,43,0,42,-42
42,63,42,45,0,27,-27
42,63,42,49,26,38,-12
42,63,42,51,28,27,1
42,63,42,65,175,298,-123
42,63,42,71,53,58,-5
42,63,42,91,0,24,-24
42,63,42,101,29,35,-6
42,63,42,111,41,23,18
42,63,42,125,0,45,-45
42,63,42,129,565,638,-73
42,63,42,133,0,23,-23
42,63,51,59,0,27,-27
42,65,42,3,116,104,12
42,65,42,5,65,35,30
42,65,42,19,0,42,-42
42,65,42,21,25,0,25
42,65,42,27,29,0,29
42,65,42,31,185,195,-10
42,65,42,33,585,604,-19
42,65,42,47,126,131,-5
42,65,42,49,0,38,-38
42,65,42,63,298,175,123
42,65,42,71,0,22,-22
42,65,42,129,34,45,-11
42,67,42,41,61,60,1
42,67,42,43,60,77,-17
42,67,42,71,46,53,-7
42,67,42,87,183,171,12
42,67,42,99,131,120,11
42,67,42,109,125,109,16
42,67,42,133,29,32,-3
42,69,4,13,30,67,-37
42,69,6,37,29,41,-12
42,69,6,73,34,28,6
42,69,9,3,37,35,2
42,69,9,9,0,29,-29
42,69,10,3,29,0,29
42,69,12,11,28,47,-19
42,69,12,31,0,41,-41
42,69,12,57,33,49,-16
42,69,12,71,0,33,-33
42,69,12,86,0,31,-31
42,69,12,99,46,39,7
42,69,12,103,0,43,-43
42,69,12,105,0,34,-34
42,69,17,31,0,37,-37
42,69,24,31,0,32,-32
42,69,25,17,0,28,-28
42,69,25,25,0,21,-21
42,69,32,3,26,30,-4
42,69,34,3,30,0,30
42,69,34,5,0,40,-40
42,69,34,13,127,46,81
42,69,34,17,68,38,30
42,69,34,23,79,55,24
42,69,34,27,59,50,9
42,69,34,29,35,0,35
42,69,34,31,42,0,42
42,69,34,37,34,0,34
42,69,36,5,114,56,58
42,69,36,7,73,90,-17
42,69,36,47,141,78,63
42,69,36,59,43,0,43
42,69,36,61,72,93,-21
42,69,36,67,25,31,-6
42,69,36,71,38,0,38
42,69,36,81,99,37,62
42,69,36,85,32,0,32
42,69,36,103,60,32,28
42,69,36,119,32,0,32
42,69,37,119,28,39,-11
42,69,37,133,28,0,28
42,69,37,183,0,49,-49
42,69,42,3,49,84,-35
42,69,42,11,48,35,13
42,69,42,15,33,48,-15
42,69,42,17,47,46,1
42,69,42,25,25,28,-3
42,69,42,27,27,36,-9
42,69,42,29,32,71,-39
42,69,42,37,50,61,-11
42,69,42,41,34,50,-16
42,69,42,43,33,84,-51
42,69,42,45,34,63,-29
42,69,42,71,43,53,-10
42,69,42,77,115,83,32
42,69,42,79,1249,1247,2
42,69,42,81,44,34,10
42,69,42,89,388,182,206
42,69,42,91,99,141,-42
42,69,42,95,73,50,23
42,69,42,101,170,226,-56
42,69,42,103,159,78,81
42,69,42,107,43,32,11
42,69,42,115,435,438,-3
42,69,42,127,761,647,114
42,69,42,131,445,461,-16
42,69,42,133,37,46,-9
42,69,51,13,0,28,-28
42,69,51,59,23,21,2
42,71,4,13,107,128,-21
42,71,4,19,43,38,5
42,71,6,37,73,83,-10
42,71,6,59,0,39,-39
42,71,6,73,59,68,-9
42,71,8,31,0,28,-28
42,71,8,41,0,43,-43
42,71,9,1,48,0,48
42,71,9,3,49,34,15
42,71,9,9,48,31,17
42,71,10,1,30,60,-30
42,71,10,3,228,194,34
42,71,10,5,48,155,-107
42,71,11,1,33,45,-12
42,71,12,9,38,28,10
42,71,12,11,47,83,-36
42,71,12,31,37,43,-6
42,71,12,33,0,21,-21
42,71,12,57,76,116,-40
42,71,12,71,39,51,-12
42,71,12,81,29,0,29
42,71,12,83,35,30,5
42,71,12,86,70,89,-19
42,71,12,95,65,66,-1
42,71,12,97,41,59,-18
42,71,12,99,49,65,-16
42,71,12,101,0,30,-30
42,71,12,103,53,41,12
42,71,12,105,37,53,-16
42,71,12,115,29,29,0
42,71,12,117,0,36,-36
42,71,12,127,38,31,7
42,71,13,67,33,43,-10
42,71,15,3,0,27,-27
42,71,17,31,62,55,7
42,71,24,3,96,39,57
42,71,24,5,125,133,-8
42,71,24,13,26,30,-4
42,71,24,15,130,130,0
42,71,24,21,44,28,16
42,71,24,25,99,33,66
42,71,24,27,0,27,-27
42,71,24,31,41,86,-45
42,71,24,33,32,31,1
42,71,24,510,95,75,20
42,71,25,9,0,33,-33
42,71,25,17,0,41,-41
42,71,25,25,0,37,-37
42,71,25,27,42,34,8
42,71,29,213,0,32,-32
42,71,32,3,53,59,-6
42,71,34,1,45,36,9
42,71,34,3,53,0,53
42,71,34,5,78,34,44
42,71,34,7,106,45,61
42,71,34,9,27,0,27
42,71,34,11,37,0,37
42,71,34,13,51,0,51
42,71,34,15,57,31,26
42,71,34,17,58,43,15
42,71,34,21,67,31,36
42,71,34,23,114,27,87
42,71,34,25,51,0,51
42,71,34,27,38,0,38
42,71,34,29,76,33,43
42,71,34,31,74,0,74
42,71,34,35,46,0,46
42,71,34,39,42,0,42
42,71,36,5,170,95,75
42,71,36,29,59,0,59
42,71,36,47,167,154,13
42,71,36,55,61,31,30
42,71,36,59,65,24,41
42,71,36,61,98,151,-53
42,71,36,67,34,0,34
42,71,36,71,49,0,49
42,71,36,81,168,101,67
42,71,36,85,41,33,8
42,71,36,103,108,59,49
42,71,36,119,36,0,36
42,71,37,51,0,50,-50
42,71,37,119,50,57,-7
42,71,37,133,55,56,-1
42,71,37,183,30,48,-18
42,71,39,35,34,0,34
42,71,39,49,30,51,-21
42,71,41,51,25,26,-1
42,71,42,1,71,66,5
42,71,42,3,131,180,-49
42,71,42,9,30,35,-5
42,71,42,11,1287,1006,281
42,71,42,13,75,31,44
42,71,42,15,40,0,40
42,71,42,17,362,170,192
42,71,42,19,28,0,28
42,71,42,21,61,77,-16
42,71,42,27,102,120,-18
42,71,42,29,2129,1278,851
42,71,42,33,30,58,-28
42,71,42,35,27,0,27
42,71,42,37,35,31,4
42,71,42,41,368,427,-59
42,71,42,43,1170,1209,-39
42,71,42,45,399,222,177
42,71,42,55,115,56,59
42,71,42,61,38,43,-5
42,71,42,63,58,53,5
42,71,42,65,22,0,22
42,71,42,67,53,46,7
42,71,42,69,53,43,10
42,71,42,75,843,1147,-304
42,71,42,77,156,148,8
42,71,42,79,93,93,0
42,71,42,81,105,47,58
42,71,42,87,43,53,-10
42,71,42,89,81,43,38
42,71,42,91,530,427,103
42,71,42,95,139,60,79
42,71,42,97,69,92,-23
42,71,42,99,75,87,-12
42,71,42,101,521,543,-22
42,71,42,105,0,45,-45
42,71,42,107,135,148,-13
42,71,42,109,56,40,16
42,71,42,111,31,0,31
42,71,42,117,48,30,18
42,71,42,119,31,41,-10
42,71,42,125,0,33,-33
42,71,42,127,26,0,26
42,71,42,129,61,56,5
42,71,42,133,1523,1496,27
42,71,44,7,31,41,-10
42,71,45,51,0,62,-62
42,71,47,37,41,0,41
42,71,48,113,32,39,-7
42,71,48,201,37,64,-27
42,71,51,13,0,43,-43
42,71,51,59,130,63,67
42,71,51,107,0,38,-38
42,71,51,153,32,0,32
42,71,51,510,0,27,-27
42,71,51,660,0,29,-29
42,71,51,810,38,29,9
42,71,53,33,48,38,10
42,71,53,53,0,34,-34
42,73,4,13,0,22,-22
42,73,12,71,0,27,-27
42,73,39,29,49,35,14
42,73,39,49,0,32,-32
42,73,39,99,184,192,-8
42,73,39,153,0,22,-22
42,73,39,155,59,84,-25
42,73,42,3,332,382,-50
42,73,42,7,435,439,-4
42,73,42,19,405,383,22
42,73,42,49,39,45,-6
42,73,42,85,356,467,-111
42,73,42,121,35,0,35
42,73,42,129,51,25,26
42,75,4,13,0,27,-27
42,75,6,37,0,27,-27
42,75,10,3,0,20,-20
42,75,10,5,0,33,-33
42,75,24,5,0,27,-27
42,75,24,510,0,32,-32
42,75,34,5,34,0,34
42,75,34,23,33,0,33
42,75,34,31,27,0,27
42,75,36,5,86,117,-31
42,75,36,47,61,84,-23
42,75,36,61,45,64,-19
42,75,36,81,36,66,-30
42,75,37,183,0,26,-26
42,75,42,1,0,35,-35
42,75,42,3,51,55,-4
42,75,42,11,892,617,275
42,75,42,17,69,38,31
42,75,42,27,28,37,-9
42,75,42,29,125,66,59
42,75,42,41,228,226,2
42,75,42,43,1577,1224,353
42,75,42,45,37,23,14
42,75,42,55,0,43,-43
42,75,42,71,1147,843,304
42,75,42,77,72,69,3
42,75,42,79,44,0,44
42,75,42,81,36,0,36
42,75,42,91,91,68,23
42,75,42,95,30,0,30
42,75,42,97,46,38,8
42,75,42,99,36,51,-15
42,75,42,101,91,83,8
42,75,42,107,224,226,-2
42,75,42,129,0,31,-31
42,75,42,133,144,158,-14
42,77,4,13,81,132,-51
42,77,4,19,0,27,-27
42,77,6,37,62,101,-39
42,77,6,59,0,55,-55
42,77,6,65,0,44,-44
42,77,6,73,53,79,-26
42,77,6,85,28,51,-23
42,77,8,13,0,39,-39
42,77,8,41,0,39,-39
42,77,9,1,40,39,1
42,77,9,3,36,47,-11
42,77,9,9,51,51,0
42,77,10,1,0,25,-25
42,77,10,3,54,58,-4
42,77,10,5,25,51,-26
42,77,11,1,0,41,-41
42,77,12,9,41,54,-13
42,77,12,11,91,100,-9
42,77,12,31,26,32,-6
42,77,12,57,103,160,-57
42,77,12,69,0,53,-53
42,77,12,71,30,52,-22
42,77,12,86,65,80,-15
42,77,12,95,82,118,-36
42,77,12,97,0,65,-65
42,77,12,99,90,98,-8
42,77,12,101,0,51,-51
42,77,12,103,33,61,-28
42,77,12,105,25,73,-48
42,77,12,117,0,70,-70
42,77,12,127,40,38,2
42,77,13,121,0,49,-49
42,77,13,135,0,36,-36
42,77,17,31,57,75,-18
42,77,17,43,0,30,-30
42,77,24,3,32,0,32
42,77,24,5,60,62,-2
42,77,24,31,52,88,-36
42,77,24,510,31,62,-31
42,77,25,9,70,35,35
42,77,25,13,43,0,43
42,77,25,17,36,39,-3
42,77,25,25,0,35,-35
42,77,25,27,29,0,29
42,77,32,3,26,52,-26
42,77,34,3,141,68,73
42,77,34,5,73,38,35
42,77,34,7,74,41,33
42,77,34,9,22,0,22
42,77,34,13,440,89,351
42,77,34,17,320,147,173
42,77,34,19,60,40,20
42,77,34,21,57,35,22
42,77,34,23,309,137,172
42,77,34,25,42,49,-7
42,77,34,27,132,67,65
42,77,34,29,49,69,-20
42,77,34,31,239,96,143
42,77,34,35,174,57,117
42,77,34,37,36,0,36
42,77,34,39,230,95,135
42,77,34,41,166,115,51
42,77,36,5,941,495,446
42,77,36,7,0,32,-32
42,77,36,29,32,45,-13
42,77,36,47,828,336,492
42,77,36,55,0,30,-30
42,77,36,59,162,97,65
42,77,36,61,445,450,-5
42,77,36,71,38,0,38
42,77,36,81,458,278,180
42,77,36,85,112,0,112
42,77,36,87,46,0,46
42,77,36,103,206,91,115
42,77,36,119,108,44,64
42,77,37,63,0,26,-26
42,77,37,67,0,25,-25
42,77,37,119,0,68,-68
42,77,37,133,34,28,6
42,77,37,183,0,103,-103
42,77,39,35,41,45,-4
42,77,39,49,35,50,-15
42,77,42,3,94,116,-22
42,77,42,11,1070,1315,-245
42,77,42,17,873,786,87
42,77,42,19,34,0,34
42,77,42,25,596,654,-58
42,77,42,27,42,100,-58
42,77,42,29,193,237,-44
42,77,42,37,43,38,5
42,77,42,41,79,92,-13
42,77,42,43,113,138,-25
42,77,42,45,144,127,17
42,77,42,49,24,30,-6
42,77,42,69,83,115,-32
42,77,42,71,148,156,-8
42,77,42,75,69,72,-3
42,77,42,79,281,273,8
42,77,42,81,31,26,5
42,77,42,89,424,255,169
42,77,42,91,832,777,55
42,77,42,95,6224,6085,139
42,77,42,97,24,48,-24
42,77,42,101,465,535,-70
42,77,42,103,40,38,2
42,77,42,107,218,376,-158
42,77,42,133,91,127,-36
42,77,44,7,74,34,40
42,77,45,45,0,57,-57
42,77,45,51,0,72,-72
42,77,48,27,29,49,-20
42,77,48,29,0,33,-33
42,77,48,85,0,38,-38
42,77,48,113,0,49,-49
42,77,48,201,40,83,-43
42,77,48,439,26,38,-12
42,77,48,453,0,46,-46
42,77,51,13,0,46,-46
42,77,51,59,55,74,-19
42,77,51,107,0,32,-32
42,77,51,810,27,43,-16
42,77,53,33,0,44,-44
42,79,4,13,45,94,-49
42,79,6,37,33,38,-5
42,79,6,73,61,40,21
42,79,9,1,0,26,-26
42,79,9,3,0,48,-48
42,79,9,9,27,0,27
42,79,9,11,24,0,24
42,79,10,3,40,51,-11
42,79,11,1,0,29,-29
42,79,12,9,0,57,-57
42,79,12,11,26,51,-25
42,79,12,57,33,48,-15
42,79,12,71,0,31,-31
42,79,12,83,0,37,-37
42,79,12,86,31,32,-1
42,79,12,95,40,51,-11
42,79,12,99,34,40,-6
42,79,12,103,0,34,-34
42,79,12,105,39,0,39
42,79,13,121,0,28,-28
42,79,17,31,0,28,-28
42,79,24,3,0,52,-52
42,79,24,5,29,42,-13
42,79,24,31,0,24,-24
42,79,24,33,0,25,-25
42,79,24,510,0,29,-29
42,79,25,9,37,43,-6
42,79,25,25,0,24,-24
42,79,32,3,51,67,-16
42,79,34,1,42,0,42
42,79,34,3,91,43,48
42,79,34,5,43,0,43
42,79,34,7,40,27,13
42,79,34,13,151,68,83
42,79,34,17,129,57,72
42,79,34,23,104,39,65
42,79,34,25,66,37,29
42,79,34,27,38,35,3
42,79,34,29,61,30,31
42,79,34,31,413,80,333
42,79,34,35,41,31,10
42,79,34,37,23,0,23
42,79,34,39,58,33,25
42,79,34,41,48,0,48
42,79,36,5,443,136,307
42,79,36,7,31,23,8
42,79,36,29,26,0,26
42,79,36,47,466,148,318
42,79,36,55,0,34,-34
42,79,36,59,94,30,64
42,79,36,61,239,166,73
42,79,36,67,36,36,0
42,79,36,71,38,0,38
42,79,36,81,275,145,130
42,79,36,85,73,0,73
42,79,36,103,116,55,61
42,79,36,107,0,23,-23
42,79,36,119,64,39,25
42,79,37,51,23,0,23
42,79,37,119,0,47,-47
42,79,37,133,0,29,-29
42,79,37,183,0,37,-37
42,79,39,35,0,23,-23
42,79,39,49,0,33,-33
42,79,42,3,50,82,-32
42,79,42,11,161,150,11
42,79,42,15,56,47,9
42,79,42,17,161,134,27
42,79,42,25,394,319,75
42,79,42,27,34,52,-18
42,79,42,29,72,128,-56
42,79,42,37,616,675,-59
42,79,42,41,57,95,-38
42,79,42,43,56,172,-116
42,79,42,45,57,112,-55
42,79,42,69,1247,1249,-2
42,79,42,71,93,93,0
42,79,42,75,0,44,-44
42,79,42,77,273,281,-8
42,79,42,81,94,43,51
42,79,42,89,447,245,202
42,79,42,91,130,200,-70
42,79,42,93,56,44,12
42,79,42,95,139,129,10
42,79,42,97,108,73,35
42,79,42,101,281,301,-20
42,79,42,103,48,40,8
42,79,42,107,627,724,-97
42,79,42,115,94,71,23
42,79,42,119,0,30,-30
42,79,42,127,98,76,22
42,79,42,131,342,334,8
42,79,42,133,90,109,-19
42,79,44,7,31,0,31
42,79,45,51,0,52,-52
42,79,48,27,36,31,5
42,79,51,13,0,23,-23
42,79,51,59,0,55,-55
42,79,51,810,0,31,-31
42,81,4,13,30,0,30
42,81,24,31,0,28,-28
42,81,34,29,26,0,26
42,81,37,119,0,28,-28
42,81,42,3,66,82,-16
42,81,42,11,42,38,4
42,81,42,13,0,41,-41
42,81,42,15,104,46,58
42,81,42,17,51,0,51
42,81,42,27,93,126,-33
42,81,42,29,36,26,10
42,81,42,35,553,571,-18
42,81,42,37,80,127,-47
42,81,42,41,52,88,-36
42,81,42,43,94,180,-86
42,81,42,45,34,52,-18
42,81,42,49,0,35,-35
42,81,42,55,0,31,-31
42,81,42,69,34,44,-10
42,81,42,71,47,105,-58
42,81,42,75,0,36,-36
42,81,42,77,26,31,-5
42,81,42,79,43,94,-51
42,81,42,87,31,0,31
42,81,42,89,0,26,-26
42,81,42,91,53,67,-14
42,81,42,93,60,72,-12
42,81,42,95,0,30,-30
42,81,42,97,326,345,-19
42,81,42,101,92,124,-32
42,81,42,107,39,42,-3
42,81,42,109,44,33,11
42,81,42,113,107,40,67
42,81,42,117,146,132,14
42,81,42,119,136,180,-44
42,81,42,133,64,89,-25
42,83,36,3,44,39,5
42,83,36,9,222,154,68
42,83,36,13,34,33,1
42,83,36,29,0,53,-53
42,83,42,3,32,91,-59
42,83,42,23,39,0,39
42,83,42,33,0,31,-31
42,83,42,47,71,63,8
42,83,42,49,56,62,-6
42,83,42,105,136,136,0
42,83,42,123,62,43,19
42,85,4,13,0,29,-29
42,85,6,73,30,0,30
42,85,12,71,29,0,29
42,85,12,103,0,20,-20
42,85,37,119,0,39,-39
42,85,39,7,39,0,39
42,85,39,29,0,36,-36
42,85,39,35,32,54,-22
42,85,39,49,0,27,-27
42,85,39,99,132,174,-42
42,85,39,153,0,30,-30
42,85,39,155,499,591,-92
42,85,42,3,362,393,-31
42,85,42,5,0,31,-31
42,85,42,7,48,63,-15
42,85,42,19,422,359,63
42,85,42,31,52,47,5
42,85,42,39,353,360,-7
42,85,42,49,114,138,-24
42,85,42,73,467,356,111
42,85,42,101,0,29,-29
42,85,42,121,202,150,52
42,85,42,125,43,0,43
42,85,42,129,48,44,4
42,87,42,11,0,28,-28
42,87,42,13,33,38,-5
42,87,42,27,152,115,37
42,87,42,41,44,72,-28
42,87,42,43,50,70,-20
42,87,42,55,0,36,-36
42,87,42,61,271,173,98
42,87,42,67,171,183,-12
42,87,42,71,53,43,10
42,87,42,81,0,31,-31
42,87,42,99,45,31,14
42,87,42,109,110,63,47
42,87,42,133,30,28,2
42,89,4,13,37,42,-5
42,89,6,37,23,29,-6
42,89,6,73,33,36,-3
42,89,9,3,0,26,-26
42,89,10,3,29,36,-7
42,89,12,11,48,63,-15
42,89,12,31,0,33,-33
42,89,12,57,0,43,-43
42,89,12,69,0,33,-33
42,89,12,71,0,26,-26
42,89,12,86,0,40,-40
42,89,12,95,41,58,-17
42,89,12,99,0,48,-48
42,89,12,101,0,46,-46
42,89,12,103,34,41,-7
42,89,12,105,0,37,-37
42,89,12,127,0,45,-45
42,89,13,121,0,26,-26
42,89,24,31,0,24,-24
42,89,25,25,0,20,-20
42,89,32,3,0,38,-38
42,89,34,3,358,186,172
42,89,34,5,34,61,-27
42,89,34,7,0,31,-31
42,89,34,13,480,133,347
42,89,34,17,322,113,209
42,89,34,19,45,0,45
42,89,34,21,50,0,50
42,89,34,23,232,107,125
42,89,34,25,63,63,0
42,89,34,27,288,217,71
42,89,34,29,107,116,-9
42,89,34,31,352,106,246
42,89,34,35,121,54,67
42,89,34,37,159,93,66
42,89,34,39,213,90,123
42,89,34,41,214,162,52
42,89,36,5,731,301,430
42,89,36,47,903,334,569
42,89,36,59,223,88,135
42,89,36,61,313,156,157
42,89,36,67,0,25,-25
42,89,36,71,57,46,11
42,89,36,81,895,294,601
42,89,36,85,183,149,34
42,89,36,87,73,0,73
42,89,36,103,203,72,131
42,89,36,119,97,70,27
42,89,37,119,0,42,-42
42,89,37,183,0,45,-45
42,89,42,3,31,40,-9
42,89,42,11,61,62,-1
42,89,42,17,131,106,25
42,89,42,25,307,470,-163
42,89,42,27,0,23,-23
42,89,42,29,49,89,-40
42,89,42,37,0,36,-36
42,89,42,41,0,54,-54
42,89,42,43,44,49,-5
42,89,42,45,45,70,-25
42,89,42,69,182,388,-206
42,89,42,71,43,81,-38
42,89,42,77,255,424,-169
42,89,42,79,245,447,-202
42,89,42,81,26,0,26
42,89,42,91,123,160,-37
42,89,42,95,824,1043,-219
42,89,42,97,0,29,-29
42,89,42,101,155,199,-44
42,89,42,103,430,316,114
42,89,42,107,41,64,-23
42,89,42,127,71,138,-67
42,89,42,133,0,45,-45
42,89,45,51,0,37,-37
42,89,48,201,0,45,-45
42,91,4,13,200,243,-43
42,91,4,19,45,50,-5
42,91,6,1,45,105,-60
42,91,6,13,0,60,-60
42,91,6,37,263,363,-100
42,91,6,59,114,136,-22
42,91,6,65,37,43,-6
42,91,6,67,0,27,-27
42,91,6,73,234,248,-14
42,91,6,75,73,117,-44
42,91,6,81,55,92,-37
42,91,6,85,68,140,-72
42,91,6,111,27,35,-8
42,91,8,13,46,0,46
42,91,8,31,43,53,-10
42,91,8,35,0,38,-38
42,91,8,41,28,28,0
42,91,8,69,0,34,-34
42,91,9,1,107,102,5
42,91,9,3,167,90,77
42,91,9,7,32,0,32
42,91,9,9,98,59,39
42,91,9,11,30,0,30
42,91,10,1,33,82,-49
42,91,10,3,416,540,-124
42,91,10,5,78,147,-69
42,91,11,1,111,163,-52
42,91,12,1,44,0,44
42,91,12,9,43,42,1
42,91,12,11,220,187,33
42,91,12,15,0,36,-36
42,91,12,19,0,37,-37
42,91,12,21,0,105,-105
42,91,12,31,79,90,-11
42,91,12,33,28,27,1
42,91,12,57,92,142,-50
42,91,12,61,0,31,-31
42,91,12,69,0,27,-27
42,91,12,71,68,99,-31
42,91,12,73,29,0,29
42,91,12,81,0,56,-56
42,91,12,83,0,34,-34
42,91,12,85,26,0,26
42,91,12,86,100,146,-46
42,91,12,95,88,94,-6
42,91,12,97,0,48,-48
42,91,12,99,158,359,-201
42,91,12,101,0,68,-68
42,91,12,103,94,87,7
42,91,12,105,31,54,-23
42,91,12,109,0,57,-57
42,91,12,111,31,50,-19
42,91,12,115,45,64,-19
42,91,12,117,36,38,-2
42,91,12,127,36,58,-22
42,91,13,51,0,31,-31
42,91,13,67,59,95,-36
42,91,13,89,58,65,-7
42,91,13,121,114,125,-11
42,91,13,135,66,84,-18
42,91,15,3,62,64,-2
42,91,17,31,309,245,64
42,91,17,43,46,43,3
42,91,17,97,0,81,-81
42,91,18,97,24,33,-9
42,91,19,163,0,54,-54
42,91,20,91,0,29,-29
42,91,21,111,33,38,-5
42,91,22,71,27,39,-12
42,91,23,5,34,0,34
42,91,24,3,77,140,-63
42,91,24,5,161,164,-3
42,91,24,15,44,47,-3
42,91,24,17,0,27,-27
42,91,24,21,32,35,-3
42,91,24,25,47,52,-5
42,91,24,27,66,73,-7
42,91,24,31,218,250,-32
42,91,24,33,86,68,18
42,91,24,37,35,0,35
42,91,24,47,0,32,-32
42,91,24,510,102,104,-2
42,91,25,9,35,50,-15
42,91,25,13,0,32,-32
42,91,25,17,191,278,-87
42,91,25,21,71,60,11
42,91,25,25,104,136,-32
42,91,25,27,53,49,4
42,91,26,81,36,0,36
42,91,26,125,89,64,25
42,91,26,161,91,37,54
42,91,26,163,64,0,64
42,91,27,53,89,47,42
42,91,29,189,35,49,-14
42,91,32,3,85,139,-54
42,91,32,31,0,23,-23
42,91,34,1,151,179,-28
42,91,34,3,164,126,38
42,91,34,5,425,312,113
42,91,34,7,515,498,17
42,91,34,9,153,206,-53
42,91,34,11,45,0,45
42,91,34,13,102,81,21
42,91,34,15,239,192,47
42,91,34,17,148,209,-61
42,91,34,19,61,38,23
42,91,34,21,216,186,30
42,91,34,23,339,282,57
42,91,34,25,143,99,44
42,91,34,27,134,126,8
42,91,34,29,152,136,16
42,91,34,31,56,46,10
42,91,34,35,174,140,34
42,91,34,39,90,58,32
42,91,34,41,31,0,31
42,91,35,1,0,32,-32
42,91,36,1,29,33,-4
42,91,36,5,78,72,6
42,91,36,7,24,25,-1
42,91,36,19,23,0,23
42,91,36,27,56,0,56
42,91,36,29,45,33,12
42,91,36,47,187,258,-71
42,91,36,55,103,86,17
42,91,36,59,105,63,42
42,91,36,61,288,581,-293
42,91,36,67,69,63,6
42,91,36,71,34,0,34
42,91,36,81,191,209,-18
42,91,36,85,40,0,40
42,91,36,87,29,0,29
42,91,36,91,41,0,41
42,91,36,103,80,88,-8
42,91,36,109,0,23,-23
42,91,36,111,32,0,32
42,91,36,119,72,92,-20
42,91,37,19,0,34,-34
42,91,37,49,0,29,-29
42,91,37,51,40,39,1
42,91,37,63,61,85,-24
42,91,37,81,47,69,-22
42,91,37,119,89,185,-96
42,91,37,133,54,54,0
42,91,37,135,0,24,-24
42,91,37,183,70,206,-136
42,91,39,35,64,52,12
42,91,39,49,72,62,10
42,91,39,61,61,47,14
42,91,41,51,0,32,-32
42,91,42,1,42,0,42
42,91,42,3,330,340,-10
42,91,42,11,2157,2750,-593
42,91,42,13,24,0,24
42,91,42,15,51,24,27
42,91,42,17,6688,6922,-234
42,91,42,19,27,33,-6
42,91,42,21,39,31,8
42,91,42,25,81,184,-103
42,91,42,27,166,144,22
42,91,42,29,4517,5331,-814
42,91,42,33,0,37,-37
42,91,42,37,30,28,2
42,91,42,41,115,179,-64
42,91,42,43,177,209,-32
42,91,42,45,2982,2906,76
42,91,42,49,55,25,30
42,91,42,51,0,30,-30
42,91,42,55,56,61,-5
42,91,42,63,24,0,24
42,91,42,69,141,99,42
42,91,42,71,427,530,-103
42,91,42,75,68,91,-23
42,91,42,77,777,832,-55
42,91,42,79,200,130,70
42,91,42,81,67,53,14
42,91,42,89,160,123,37
42,91,42,95,365,264,101
42,91,42,97,29,35,-6
42,91,42,101,12585,8419,4166
42,91,42,107,127,121,6
42,91,42,111,0,41,-41
42,91,42,117,28,42,-14
42,91,42,119,27,0,27
42,91,42,127,26,30,-4
42,91,42,129,37,51,-14
42,91,42,133,167,193,-26
42,91,44,7,35,57,-22
42,91,45,13,0,47,-47
42,91,45,19,27,52,-25
42,91,45,45,0,50,-50
42,91,45,51,0,40,-40
42,91,45,79,0,33,-33
42,91,45,91,0,32,-32
42,91,47,37,31,51,-20
42,91,47,157,45,28,17
42,91,48,27,0,32,-32
42,91,48,29,59,58,1
42,91,48,85,39,91,-52
42,91,48,113,67,97,-30
42,91,48,121,0,67,-67
42,91,48,141,0,35,-35
42,91,48,157,0,40,-40
42,91,48,201,116,121,-5
42,91,48,339,0,32,-32
42,91,48,439,85,76,9
42,91,48,453,26,42,-16
42,91,49,35,41,36,5
42,91,49,49,0,34,-34
42,91,51,13,89,142,-53
42,91,51,41,48,42,6
42,91,51,59,185,212,-27
42,91,51,87,32,58,-26
42,91,51,107,44,71,-27
42,91,51,153,56,50,6
42,91,51,510,48,58,-10
42,91,51,710,41,28,13
42,91,51,760,30,34,-4
42,91,51,810,68,81,-13
42,91,53,33,96,122,-26
42,91,53,61,0,25,-25
42,91,55,25,30,45,-15
42,91,55,79,36,32,4
42,93,42,37,353,353,0
42,93,42,41,0,25,-25
42,93,42,43,0,25,-25
42,93,42,79,44,56,-12
42,93,42,81,72,60,12
42,93,42,97,323,281,42
42,93,42,109,33,43,-10
42,93,42,119,63,47,16
42,95,4,13,53,132,-79
42,95,6,37,70,67,3
42,95,6,73,0,48,-48
42,95,8,5,0,27,-27
42,95,9,9,39,0,39
42,95,10,3,29,48,-19
42,95,11,1,0,36,-36
42,95,12,9,0,31,-31
42,95,12,11,81,58,23
42,95,12,31,0,27,-27
42,95,12,57,48,56,-8
42,95,12,71,0,40,-40
42,95,12,83,0,35,-35
42,95,12,86,0,27,-27
42,95,12,95,42,66,-24
42,95,12,97,0,43,-43
42,95,12,99,50,69,-19
42,95,12,101,0,39,-39
42,95,12,103,24,32,-8
42,95,12,105,0,31,-31
42,95,12,115,0,37,-37
42,95,12,127,0,42,-42
42,95,13,67,0,35,-35
42,95,13,89,0,38,-38
42,95,13,117,0,46,-46
42,95,13,135,0,48,-48
42,95,17,31,34,54,-20
42,95,24,3,0,34,-34
42,95,24,5,0,24,-24
42,95,24,31,30,32,-2
42,95,24,510,0,21,-21
42,95,25,17,37,48,-11
42,95,25,25,0,24,-24
42,95,32,3,22,40,-18
42,95,34,3,146,92,54
42,95,34,5,31,56,-25
42,95,34,7,49,45,4
42,95,34,13,469,101,368
42,95,34,17,237,111,126
42,95,34,19,378,161,217
42,95,34,21,65,49,16
42,95,34,23,532,136,396
42,95,34,25,116,58,58
42,95,34,27,250,133,117
42,95,34,29,91,66,25
42,95,34,31,141,56,85
42,95,34,35,470,150,320
42,95,34,37,98,34,64
42,95,34,39,379,115,264
42,95,34,41,1380,768,612
42,95,36,5,185,128,57
42,95,36,47,380,143,237
42,95,36,59,67,0,67
42,95,36,61,162,184,-22
42,95,36,71,32,0,32
42,95,36,81,238,144,94
42,95,36,85,82,0,82
42,95,36,103,122,42,80
42,95,36,119,61,32,29
42,95,37,119,0,30,-30
42,95,37,183,0,73,-73
42,95,42,3,61,72,-11
42,95,42,11,252,379,-127
42,95,42,17,547,444,103
42,95,42,25,339,512,-173
42,95,42,27,42,41,1
42,95,42,29,106,128,-22
42,95,42,37,30,0,30
42,95,42,41,51,52,-1
42,95,42,43,49,61,-12
42,95,42,45,54,58,-4
42,95,42,69,50,73,-23
42,95,42,71,60,139,-79
42,95,42,75,0,30,-30
42,95,42,77,6085,6224,-139
42,95,42,79,129,139,-10
42,95,42,81,30,0,30
42,95,42,89,1043,824,219
42,95,42,91,264,365,-101
42,95,42,97,0,31,-31
42,95,42,101,219,294,-75
42,95,42,103,83,58,25
42,95,42,107,124,144,-20
42,95,42,127,34,0,34
42,95,42,133,53,62,-9
42,95,45,13,0,37,-37
42,95,45,51,0,41,-41
42,95,48,113,0,27,-27
42,95,48,201,0,88,-88
42,95,51,13,0,38,-38
42,95,51,59,30,47,-17
42,95,51,810,31,35,-4
42,95,53,33,0,36,-36
42,97,36,61,0,27,-27
42,97,42,3,25,34,-9
42,97,42,11,53,0,53
42,97,42,27,35,35,0
42,97,42,35,42,0,42
42,97,42,37,379,293,86
42,97,42,41,54,82,-28
42,97,42,43,255,218,37
42,97,42,45,40,0,40
42,97,42,71,92,69,23
42,97,42,75,38,46,-8
42,97,42,77,48,24,24
42,97,42,79,73,108,-35
42,97,42,81,345,326,19
42,97,42,89,29,0,29
42,97,42,91,35,29,6
42,97,42,93,281,323,-42
42,97,42,95,31,0,31
42,97,42,99,31,0,31
42,97,42,101,84,61,23
42,97,42,107,295,218,77
42,97,42,109,513,541,-28
42,97,42,119,736,712,24
42,97,42,133,61,61,0
42,99,42,27,0,29,-29
42,99,42,41,977,1005,-28
42,99,42,43,650,594,56
42,99,42,55,46,0,46
42,99,42,67,120,131,-11
42,99,42,71,87,75,12
42,99,42,75,51,36,15
42,99,42,87,31,45,-14
42,99,42,97,0,31,-31
42,99,42,109,50,58,-8
42,99,42,133,172,164,8
42,101,1,73,57,49,8
42,101,4,13,207,275,-68
42,101,4,19,54,73,-19
42,101,6,1,117,158,-41
42,101,6,13,36,89,-53
42,101,6,19,32,29,3
42,101,6,37,564,702,-138
42,101,6,53,20,0,20
42,101,6,59,109,174,-65
42,101,6,65,73,81,-8
42,101,6,67,46,67,-21
42,101,6,71,58,67,-9
42,101,6,73,218,268,-50
42,101,6,75,243,324,-81
42,101,6,81,58,102,-44
42,101,6,83,38,39,-1
42,101,6,85,142,228,-86
42,101,6,95,0,33,-33
42,101,6,111,0,33,-33
42,101,8,1,0,27,-27
42,101,8,5,60,44,16
42,101,8,13,31,39,-8
42,101,8,31,98,105,-7
42,101,8,41,28,48,-20
42,101,9,1,204,130,74
42,101,9,3,194,155,39
42,101,9,5,26,30,-4
42,101,9,7,28,0,28
42,101,9,9,244,182,62
42,101,9,11,55,37,18
42,101,10,1,178,413,-235
42,101,10,3,1315,2012,-697
42,101,10,5,84,146,-62
42,101,11,1,547,488,59
42,101,12,1,32,0,32
42,101,12,9,43,60,-17
42,101,12,11,311,406,-95
42,101,12,19,0,36,-36
42,101,12,21,29,0,29
42,101,12,31,176,175,1
42,101,12,33,32,41,-9
42,101,12,35,0,40,-40
42,101,12,57,190,254,-64
42,101,12,69,30,66,-36
42,101,12,71,101,101,0
42,101,12,73,0,28,-28
42,101,12,81,26,41,-15
42,101,12,83,47,60,-13
42,101,12,86,355,326,29
42,101,12,95,295,292,3
42,101,12,97,93,238,-145
42,101,12,99,232,301,-69
42,101,12,101,35,48,-13
42,101,12,103,113,142,-29
42,101,12,105,72,162,-90
42,101,12,111,0,71,-71
42,101,12,115,57,75,-18
42,101,12,117,43,58,-15
42,101,12,127,54,85,-31
42,101,13,51,61,32,29
42,101,13,57,0,40,-40
42,101,13,63,59,97,-38
42,101,13,67,116,134,-18
42,101,13,89,192,231,-39
42,101,13,97,0,50,-50
42,101,13,113,0,32,-32
42,101,13,121,181,299,-118
42,101,13,135,69,133,-64
42,101,13,151,0,49,-49
42,101,13,179,44,0,44
42,101,13,245,0,54,-54
42,101,15,3,103,92,11
42,101,17,19,31,0,31
42,101,17,31,527,527,0
42,101,17,43,44,42,2
42,101,17,97,37,27,10
42,101,18,3,23,0,23
42,101,18,97,70,54,16
42,101,18,105,26,25,1
42,101,19,103,40,0,40
42,101,20,91,37,0,37
42,101,21,67,35,0,35
42,101,21,111,43,57,-14
42,101,22,33,25,0,25
42,101,22,51,0,57,-57
42,101,22,71,23,64,-41
42,101,23,5,39,48,-9
42,101,24,3,226,102,124
42,101,24,5,305,255,50
42,101,24,13,28,0,28
42,101,24,15,46,68,-22
42,101,24,17,0,34,-34
42,101,24,21,59,42,17
42,101,24,25,57,59,-2
42,101,24,27,67,68,-1
42,101,24,31,394,407,-13
42,101,24,33,238,283,-45
42,101,24,45,24,0,24
42,101,24,510,343,410,-67
42,101,25,1,23,26,-3
42,101,25,5,29,0,29
42,101,25,9,87,101,-14
42,101,25,13,73,56,17
42,101,25,15,27,0,27
42,101,25,17,417,361,56
42,101,25,21,162,126,36
42,101,25,23,40,48,-8
42,101,25,25,388,374,14
42,101,25,27,82,86,-4
42,101,26,65,44,22,22
42,101,26,77,34,0,34
42,101,26,81,51,0,51
42,101,26,99,29,33,-4
42,101,26,125,97,57,40
42,101,26,161,107,71,36
42,101,26,163,104,45,59
42,101,27,37,27,0,27
42,101,27,53,127,134,-7
42,101,27,123,47,0,47
42,101,29,19,26,0,26
42,101,29,95,37,37,0
42,101,29,189,75,57,18
42,101,29,510,67,67,0
42,101,31,55,26,0,26
42,101,32,3,143,190,-47
42,101,33,9,0,26,-26
42,101,33,11,51,36,15
42,101,33,13,32,0,32
42,101,33,15,30,0,30
42,101,34,1,522,534,-12
42,101,34,3,199,173,26
42,101,34,5,1570,1619,-49
42,101,34,7,2539,3328,-789
42,101,34,9,268,503,-235
42,101,34,11,167,194,-27
42,101,34,13,414,251,163
42,101,34,15,995,1471,-476
42,101,34,17,374,414,-40
42,101,34,19,78,76,2
42,101,34,21,574,515,59
42,101,34,23,401,354,47
42,101,34,25,282,160,122
42,101,34,27,152,95,57
42,101,34,29,289,199,90
42,101,34,31,172,111,61
42,101,34,33,87,133,-46
42,101,34,35,160,130,30
42,101,34,37,61,27,34
42,101,34,39,218,171,47
42,101,34,41,24,0,24
42,101,35,1,40,0,40
42,101,36,1,59,25,34
42,101,36,5,789,733,56
42,101,36,7,64,29,35
42,101,36,27,53,29,24
42,101,36,29,112,61,51
42,101,36,45,0,31,-31
42,101,36,47,1481,1165,316
42,101,36,55,134,97,37
42,101,36,59,279,186,93
42,101,36,61,1755,2393,-638
42,101,36,67,134,71,63
42,101,36,71,52,47,5
42,101,36,81,846,575,271
42,101,36,85,102,75,27
42,101,36,87,64,58,6
42,101,36,91,28,26,2
42,101,36,93,29,0,29
42,101,36,103,195,145,50
42,101,36,109,51,50,1
42,101,36,111,53,0,53
42,101,36,119,225,176,49
42,101,37,21,27,40,-13
42,101,37,25,0,37,-37
42,101,37,35,0,26,-26
42,101,37,51,93,110,-17
42,101,37,63,112,113,-1
42,101,37,67,51,66,-15
42,101,37,71,0,38,-38
42,101,37,81,42,82,-40
42,101,37,109,23,72,-49
42,101,37,119,289,385,-96
42,101,37,129,38,42,-4
42,101,37,133,62,66,-4
42,101,37,135,41,24,17
42,101,37,147,0,23,-23
42,101,37,179,0,69,-69
42,101,37,183,133,206,-73
42,101,37,191,0,41,-41
42,101,39,35,131,112,19
42,101,39,49,147,147,0
42,101,39,61,93,73,20
42,101,39,95,46,0,46
42,101,39,99,26,0,26
42,101,39,113,31,0,31
42,101,39,153,40,0,40
42,101,40,109,39,49,-10
42,101,40,143,24,32,-8
42,101,41,39,34,0,34
42,101,41,51,91,101,-10
42,101,41,67,0,26,-26
42,101,42,1,40,34,6
42,101,42,3,613,506,107
42,101,42,7,22,0,22
42,101,42,11,634,659,-25
42,101,42,13,40,0,40
42,101,42,15,34,68,-34
42,101,42,17,5962,7929,-1967
42,101,42,19,30,32,-2
42,101,42,21,34,44,-10
42,101,42,25,90,115,-25
42,101,42,27,176,96,80
42,101,42,29,1601,1887,-286
42,101,42,35,25,0,25
42,101,42,37,52,55,-3
42,101,42,41,180,156,24
42,101,42,43,367,324,43
42,101,42,45,7492,11156,-3664
42,101,42,49,47,69,-22
42,101,42,55,62,58,4
42,101,42,63,35,29,6
42,101,42,69,226,170,56
42,101,42,71,543,521,22
42,101,42,75,83,91,-8
42,101,42,77,535,465,70
42,101,42,79,301,281,20
42,101,42,81,124,92,32
42,101,42,85,29,0,29
42,101,42,89,199,155,44
42,101,42,91,8419,12585,-4166
42,101,42,95,294,219,75
42,101,42,97,61,84,-23
42,101,42,103,54,0,54
42,101,42,107,105,86,19
42,101,42,117,0,49,-49
42,101,42,119,28,0,28
42,101,42,127,30,31,-1
42,101,42,129,77,56,21
42,101,42,133,243,201,42
42,101,44,7,237,150,87
42,101,45,13,30,30,0
42,101,45,19,67,73,-6
42,101,45,41,0,47,-47
42,101,45,45,49,38,11
42,101,45,51,27,58,-31
42,101,45,63,0,34,-34
42,101,45,79,50,73,-23
42,101,45,83,0,42,-42
42,101,47,37,57,86,-29
42,101,47,65,0,27,-27
42,101,47,157,60,46,14
42,101,48,27,41,65,-24
42,101,48,29,56,79,-23
42,101,48,85,39,39,0
42,101,48,113,126,159,-33
42,101,48,121,0,34,-34
42,101,48,141,0,34,-34
42,101,48,157,0,53,-53
42,101,48,201,214,314,-100
42,101,48,439,65,79,-14
42,101,48,453,79,122,-43
42,101,49,35,54,36,18
42,101,50,7,26,0,26
42,101,51,3,43,0,43
42,101,51,13,160,137,23
42,101,51,41,31,61,-30
42,101,51,59,236,267,-31
42,101,51,87,47,55,-8
42,101,51,107,44,45,-1
42,101,51,121,24,0,24
42,101,51,153,68,72,-4
42,101,51,179,0,27,-27
42,101,51,510,59,101,-42
42,101,51,540,22,0,22
42,101,51,550,35,34,1
42,101,51,650,32,28,4
42,101,51,700,36,61,-25
42,101,51,710,160,107,53
42,101,51,740,30,0,30
42,101,51,760,75,64,11
42,101,51,810,127,167,-40
42,101,53,33,226,322,-96
42,101,53,53,49,50,-1
42,101,53,61,0,31,-31
42,101,54,61,0,23,-23
42,101,55,25,79,45,34
42,101,55,79,62,60,2
42,103,12,11,0,28,-28
42,103,12,99,0,31,-31
42,103,34,3,130,70,60
42,103,34,13,118,39,79
42,103,34,17,96,48,48
42,103,34,23,58,0,58
42,103,34,25,45,0,45
42,103,34,27,112,110,2
42,103,34,29,48,53,-5
42,103,34,31,117,43,74
42,103,34,35,40,0,40
42,103,34,37,405,182,223
42,103,34,39,62,29,33
42,103,34,41,36,33,3
42,103,36,5,232,47,185
42,103,36,27,57,0,57
42,103,36,47,323,88,235
42,103,36,59,114,44,70
42,103,36,61,137,62,75
42,103,36,71,654,269,385
42,103,36,81,315,87,228
42,103,36,85,137,66,71
42,103,36,87,52,26,26
42,103,36,103,153,36,117
42,103,36,105,100,52,48
42,103,36,111,48,0,48
42,103,36,119,70,0,70
42,103,42,17,57,33,24
42,103,42,69,78,159,-81
42,103,42,77,38,40,-2
42,103,42,79,40,48,-8
42,103,42,89,316,430,-114
42,103,42,95,58,83,-25
42,103,42,101,0,54,-54
42,103,42,127,250,361,-111
42,105,36,3,50,104,-54
42,105,36,9,27,54,-27
42,105,36,29,0,31,-31
42,105,42,3,34,46,-12
42,105,42,27,0,27,-27
42,105,42,71,45,0,45
42,105,42,83,136,136,0
42,105,42,117,140,156,-16
42,107,34,23,32,0,32
42,107,36,81,43,0,43
42,107,42,3,0,46,-46
42,107,42,11,836,532,304
42,107,42,17,106,64,42
42,107,42,25,523,402,121
42,107,42,27,24,39,-15
42,107,42,29,52,35,17
42,107,42,37,71,98,-27
42,107,42,41,48,106,-58
42,107,42,43,399,392,7
42,107,42,45,36,54,-18
42,107,42,69,32,43,-11
42,107,42,71,148,135,13
42,107,42,75,226,224,2
42,107,42,77,376,218,158
42,107,42,79,724,627,97
42,107,42,81,42,39,3
42,107,42,89,64,41,23
42,107,42,91,121,127,-6
42,107,42,95,144,124,20
42,107,42,97,218,295,-77
42,107,42,101,86,105,-19
42,107,42,133,67,47,20
42,107,51,59,0,24,-24
42,109,42,27,0,29,-29
42,109,42,37,0,37,-37
42,109,42,41,30,33,-3
42,109,42,43,92,72,20
42,109,42,67,109,125,-16
42,109,42,71,40,56,-16
42,109,42,81,33,44,-11
42,109,42,87,63,110,-47
42,109,42,93,43,33,10
42,109,42,97,541,513,28
42,109,42,99,58,50,8
42,109,42,119,301,281,20
42,109,42,133,40,35,5
42,111,24,1,70,85,-15
42,111,24,23,65,50,15
42,111,42,3,138,221,-83
42,111,42,9,88,74,14
42,111,42,13,0,34,-34
42,111,42,19,42,0,42
42,111,42,21,615,775,-160
42,111,42,27,0,22,-22
42,111,42,41,27,26,1
42,111,42,51,102,127,-25
42,111,42,55,0,29,-29
42,111,42,63,23,41,-18
42,111,42,71,0,31,-31
42,111,42,91,41,0,41
42,111,42,125,50,25,25
42,111,42,129,240,203,37
42,111,42,133,32,0,32
42,113,42,15,61,62,-1
42,113,42,81,40,107,-67
42,115,36,7,313,380,-67
42,115,36,107,41,36,5
42,115,42,15,61,69,-8
42,115,42,17,31,0,31
42,115,42,69,438,435,3
42,115,42,79,71,94,-23
42,115,42,127,99,114,-15
42,115,42,131,213,206,7
42,117,36,15,91,99,-8
42,117,36,101,150,176,-26
42,117,42,11,34,0,34
42,117,42,15,138,137,1
42,117,42,17,53,0,53
42,117,42,27,23,0,23
42,117,42,29,37,0,37
42,117,42,41,0,36,-36
42,117,42,71,30,48,-18
42,117,42,81,132,146,-14
42,117,42,91,42,28,14
42,117,42,101,49,0,49
42,117,42,105,156,140,16
42,117,42,133,24,0,24
42,119,42,3,28,22,6
42,119,42,27,47,68,-21
42,119,42,37,48,46,2
42,119,42,41,0,39,-39
42,119,42,43,38,32,6
42,119,42,71,41,31,10
42,119,42,79,30,0,30
42,119,42,81,180,136,44
42,119,42,91,0,27,-27
42,119,42,93,47,63,-16
42,119,42,97,712,736,-24
42,119,42,101,0,28,-28
42,119,42,109,281,301,-20
42,121,42,3,154,184,-30
42,121,42,5,29,0,29
42,121,42,7,29,33,-4
42,121,42,19,118,202,-84
42,121,42,31,175,226,-51
42,121,42,39,285,282,3
42,121,42,49,85,151,-66
42,121,42,53,58,31,27
42,121,42,73,0,35,-35
42,121,42,85,150,202,-52
42,121,42,123,44,43,1
42,121,42,129,27,46,-19
42,123,36,13,219,156,63
42,123,42,3,48,81,-33
42,123,42,39,86,87,-1
42,123,42,49,273,307,-34
42,123,42,53,36,0,36
42,123,42,83,43,62,-19
42,123,42,121,43,44,-1
42,125,4,13,59,75,-16
42,125,6,37,46,47,-1
42,125,11,1,0,32,-32
42,125,12,11,39,0,39
42,125,12,57,0,29,-29
42,125,12,71,29,0,29
42,125,12,99,0,24,-24
42,125,12,103,27,24,3
42,125,17,31,0,22,-22
42,125,24,5,31,0,31
42,125,24,31,0,49,-49
42,125,32,3,30,33,-3
42,125,37,133,37,0,37
42,125,37,183,0,35,-35
42,125,39,13,57,23,34
42,125,39,35,37,32,5
42,125,39,49,57,41,16
42,125,39,81,41,43,-2
42,125,39,153,37,30,7
42,125,42,3,4276,2955,1321
42,125,42,5,29,0,29
42,125,42,7,186,156,30
42,125,42,19,117,132,-15
42,125,42,21,44,41,3
42,125,42,27,0,32,-32
42,125,42,29,0,25,-25
42,125,42,39,45,0,45
42,125,42,41,25,29,-4
42,125,42,43,0,22,-22
42,125,42,49,36,51,-15
42,125,42,51,562,531,31
42,125,42,59,435,405,30
42,125,42,63,45,0,45
42,125,42,71,33,0,33
42,125,42,85,0,43,-43
42,125,42,111,25,50,-25
42,125,42,129,732,686,46
42,125,42,133,61,0,61
42,125,45,51,0,47,-47
42,125,48,201,0,35,-35
42,125,51,13,0,24,-24
42,125,54,9,47,96,-49
42,125,54,29,78,81,-3
42,125,54,51,35,0,35
42,125,54,61,55,68,-13
42,125,54,69,90,61,29
42,127,34,3,71,0,71
42,127,34,23,45,0,45
42,127,34,27,38,0,38
42,127,34,29,48,27,21
42,127,34,31,31,0,31
42,127,34,37,47,0,47
42,127,34,39,29,0,29
42,127,36,7,0,27,-27
42,127,36,25,38,38,0
42,127,36,47,75,45,30
42,127,36,59,99,0,99
42,127,36,61,26,22,4
42,127,36,71,59,0,59
42,127,36,81,93,0,93
42,127,36,85,31,30,1
42,127,36,103,106,40,66
42,127,36,105,117,46,71
42,127,42,17,61,0,61
42,127,42,69,647,761,-114
42,127,42,71,0,26,-26
42,127,42,79,76,98,-22
42,127,42,89,138,71,67
42,127,42,91,30,26,4
42,127,42,95,0,34,-34
42,127,42,101,31,30,1
42,127,42,103,361,250,111
42,127,42,115,114,99,15
42,129,4,13,73,101,-28
42,129,6,37,26,63,-37
42,129,6,73,54,59,-5
42,129,10,3,28,0,28
42,129,11,1,0,29,-29
42,129,12,9,0,32,-32
42,129,12,11,39,24,15
42,129,12,57,51,0,51
42,129,12,71,54,30,24
42,129,12,83,0,31,-31
42,129,12,86,0,24,-24
42,129,12,95,40,37,3
42,129,12,99,31,51,-20
42,129,12,101,48,0,48
42,129,12,103,71,39,32
42,129,12,127,39,32,7
42,129,15,3,29,0,29
42,129,17,31,46,43,3
42,129,17,43,32,0,32
42,129,24,3,36,33,3
42,129,24,5,0,49,-49
42,129,24,21,37,0,37
42,129,24,27,0,20,-20
42,129,24,31,66,56,10
42,129,24,510,0,41,-41
42,129,25,17,0,25,-25
42,129,32,3,47,59,-12
42,129,36,47,0,30,-30
42,129,36,61,26,48,-22
42,129,36,81,26,23,3
42,129,37,51,0,25,-25
42,129,37,119,0,35,-35
42,129,37,133,47,35,12
42,129,37,183,0,56,-56
42,129,39,35,52,52,0
42,129,39,49,51,78,-27
42,129,39,99,45,38,7
42,129,39,133,0,26,-26
42,129,39,153,0,47,-47
42,129,42,3,5662,4753,909
42,129,42,5,620,793,-173
42,129,42,7,121,121,0
42,129,42,11,42,28,14
42,129,42,13,50,44,6
42,129,42,17,40,34,6
42,129,42,19,251,368,-117
42,129,42,21,241,214,27
42,129,42,27,48,70,-22
42,129,42,29,43,33,10
42,129,42,31,27,41,-14
42,129,42,33,37,0,37
42,129,42,39,25,25,0
42,129,42,41,33,43,-10
42,129,42,43,41,56,-15
42,129,42,45,32,0,32
42,129,42,49,119,77,42
42,129,42,51,1276,1116,160
42,129,42,59,0,73,-73
42,129,42,63,638,565,73
42,129,42,65,45,34,11
42,129,42,71,56,61,-5
42,129,42,73,25,51,-26
42,129,42,75,31,0,31
42,129,42,85,44,48,-4
42,129,42,91,51,37,14
42,129,42,101,56,77,-21
42,129,42,111,203,240,-37
42,129,42,121,46,27,19
42,129,42,125,686,732,-46
42,129,42,133,57,34,23
42,129,45,19,0,21,-21
42,129,45,51,0,66,-66
42,129,45,91,0,35,-35
42,129,48,113,0,25,-25
42,129,48,201,29,33,-4
42,129,51,13,0,41,-41
42,129,51,59,35,84,-49
42,129,51,107,0,25,-25
42,129,51,153,33,31,2
42,129,53,33,0,29,-29
42,129,54,61,36,36,0
42,131,42,15,102,157,-55
42,131,42,69,461,445,16
42,131,42,79,334,342,-8
42,131,42,115,206,213,-7
42,133,4,13,65,110,-45
42,133,4,19,37,31,6
42,133,6,37,46,84,-38
42,133,6,65,35,0,35
42,133,6,73,97,99,-2
42,133,8,41,40,0,40
42,133,9,1,36,0,36
42,133,10,1,32,49,-17
42,133,10,3,77,58,19
42,133,10,5,71,139,-68
42,133,11,1,39,47,-8
42,133,12,9,35,69,-34
42,133,12,11,49,43,6
42,133,12,33,0,28,-28
42,133,12,35,0,25,-25
42,133,12,57,49,48,1
42,133,12,71,50,28,22
42,133,12,81,32,0,32
42,133,12,86,33,29,4
42,133,12,95,55,73,-18
42,133,12,97,0,76,-76
42,133,12,99,60,36,24
42,133,12,101,0,32,-32
42,133,12,103,42,68,-26
42,133,12,105,30,31,-1
42,133,12,115,0,63,-63
42,133,12,127,31,37,-6
42,133,13,121,29,0,29
42,133,15,3,36,48,-12
42,133,17,31,36,30,6
42,133,24,3,602,169,433
42,133,24,5,2981,801,2180
42,133,24,13,960,353,607
42,133,24,15,105,70,35
42,133,24,17,49,0,49
42,133,24,21,129,84,45
42,133,24,25,1077,463,614
42,133,24,27,294,131,163
42,133,24,31,144,73,71
42,133,24,33,212,88,124
42,133,24,43,60,0,60
42,133,24,45,37,33,4
42,133,24,47,28,32,-4
42,133,24,510,1036,311,725
42,133,25,17,0,31,-31
42,133,25,25,0,28,-28
42,133,32,3,46,44,2
42,133,34,5,33,31,2
42,133,34,7,0,37,-37
42,133,34,13,30,0,30
42,133,34,17,79,0,79
42,133,34,23,32,33,-1
42,133,34,25,0,32,-32
42,133,34,27,0,25,-25
42,133,34,29,42,0,42
42,133,34,31,32,0,32
42,133,36,5,91,72,19
42,133,36,29,41,0,41
42,133,36,45,0,26,-26
42,133,36,47,82,75,7
42,133,36,55,34,43,-9
42,133,36,59,44,0,44
42,133,36,61,53,91,-38
42,133,36,67,31,0,31
42,133,36,81,48,45,3
42,133,36,103,66,35,31
42,133,37,21,0,27,-27
42,133,37,51,0,40,-40
42,133,37,81,0,41,-41
42,133,37,119,47,58,-11
42,133,37,133,70,64,6
42,133,37,183,47,82,-35
42,133,41,51,0,27,-27
42,133,42,1,2066,2035,31
42,133,42,3,142,235,-93
42,133,42,7,0,24,-24
42,133,42,11,226,197,29
42,133,42,13,58,57,1
42,133,42,17,82,98,-16
42,133,42,21,31,50,-19
42,133,42,27,89,100,-11
42,133,42,29,165,184,-19
42,133,42,33,49,0,49
42,133,42,35,27,26,1
42,133,42,37,0,22,-22
42,133,42,41,1955,2303,-348
42,133,42,43,1020,1237,-217
42,133,42,45,87,89,-2
42,133,42,49,54,41,13
42,133,42,55,136,165,-29
42,133,42,63,23,0,23
42,133,42,67,32,29,3
42,133,42,69,46,37,9
42,133,42,71,1496,1523,-27
42,133,42,75,158,144,14
42,133,42,77,127,91,36
42,133,42,79,109,90,19
42,133,42,81,89,64,25
42,133,42,87,28,30,-2
42,133,42,89,45,0,45
42,133,42,91,193,167,26
42,133,42,95,62,53,9
42,133,42,97,61,61,0
42,133,42,99,164,172,-8
42,133,42,101,201,243,-42
42,133,42,107,47,67,-20
42,133,42,109,35,40,-5
42,133,42,111,0,32,-32
42,133,42,117,0,24,-24
42,133,42,125,0,61,-61
42,133,42,129,34,57,-23
42,133,45,15,0,30,-30
42,133,45,19,0,28,-28
42,133,45,45,0,39,-39
42,133,45,51,34,55,-21
42,133,45,91,0,38,-38
42,133,47,37,0,21,-21
42,133,48,27,0,38,-38
42,133,48,29,0,34,-34
42,133,48,113,0,27,-27
42,133,48,201,0,46,-46
42,133,48,439,0,44,-44
42,133,51,13,0,44,-44
42,133,51,41,38,0,38
42,133,51,59,87,82,5
42,133,51,107,41,38,3
42,133,51,153,40,0,40
42,133,51,510,0,25,-25
42,133,51,700,52,0,52
42,133,51,810,0,66,-66
42,133,53,33,0,30,-30
42,133,53,53,0,34,-34
44,1,9,3,31,0,31
44,1,11,1,0,20,-20
44,1,25,5,316,437,-121
44,1,25,17,59,58,1
44,1,25,21,0,41,-41
44,1,25,23,27,0,27
44,1,25,25,0,75,-75
44,1,25,27,31,0,31
44,1,36,61,0,30,-30
44,1,44,3,166,168,-2
44,1,44,5,390,319,71
44,1,44,7,916,956,-40
44,3,4,13,36,67,-31
44,3,6,37,37,42,-5
44,3,6,73,38,40,-2
44,3,9,1,44,0,44
44,3,9,3,87,73,14
44,3,9,7,23,0,23
44,3,9,9,69,59,10
44,3,9,11,84,137,-53
44,3,9,15,88,274,-186
44,3,11,1,0,30,-30
44,3,12,9,0,31,-31
44,3,12,11,33,40,-7
44,3,12,21,0,27,-27
44,3,12,31,0,23,-23
44,3,12,57,28,31,-3
44,3,12,71,0,47,-47
44,3,12,81,0,37,-37
44,3,12,83,0,29,-29
44,3,12,95,0,30,-30
44,3,12,99,30,71,-41
44,3,12,103,25,52,-27
44,3,12,105,0,41,-41
44,3,12,111,0,28,-28
44,3,12,115,0,64,-64
44,3,17,31,35,0,35
44,3,23,5,26,29,-3
44,3,24,31,0,23,-23
44,3,25,1,0,27,-27
44,3,25,5,333,416,-83
44,3,25,9,29,54,-25
44,3,25,13,29,23,6
44,3,25,17,134,159,-25
44,3,25,21,72,151,-79
44,3,25,23,52,52,0
44,3,25,25,75,107,-32
44,3,25,27,113,128,-15
44,3,32,3,0,46,-46
44,3,33,11,27,52,-25
44,3,33,15,0,26,-26
44,3,34,17,0,29,-29
44,3,36,47,0,48,-48
44,3,36,59,28,0,28
44,3,36,61,32,54,-22
44,3,37,119,0,41,-41
44,3,37,183,0,48,-48
44,3,44,5,264,194,70
44,3,44,7,6189,4891,1298
44,3,44,9,1651,1535,116
44,3,48,201,0,25,-25
44,5,4,13,0,25,-25
44,5,6,31,41,0,41
44,5,6,37,31,71,-40
44,5,6,53,173,0,173
44,5,6,59,27,0,27
44,5,6,73,292,222,70
44,5,8,41,0,86,-86
44,5,9,1,28,47,-19
44,5,9,3,36,46,-10
44,5,9,9,39,36,3
44,5,9,11,63,76,-13
44,5,11,1,31,20,11
44,5,12,11,28,33,-5
44,5,12,21,25,0,25
44,5,12,31,87,108,-21
44,5,12,57,0,67,-67
44,5,12,71,0,38,-38
44,5,12,86,0,23,-23
44,5,12,95,31,0,31
44,5,12,99,40,29,11
44,5,12,103,28,39,-11
44,5,15,3,150,162,-12
44,5,17,31,30,27,3
44,5,23,5,46,35,11
44,5,24,3,0,115,-115
44,5,25,1,34,28,6
44,5,25,5,658,847,-189
44,5,25,9,36,0,36
44,5,25,13,25,27,-2
44,5,25,17,101,118,-17
44,5,25,21,75,70,5
44,5,25,23,51,63,-12
44,5,25,25,78,104,-26
44,5,25,27,68,67,1
44,5,31,153,0,54,-54
44,5,32,3,0,21,-21
44,5,33,11,31,0,31
44,5,36,47,0,46,-46
44,5,36,61,36,63,-27
44,5,36,81,0,27,-27
44,5,36,103,24,0,24
44,5,37,133,91,50,41
44,5,44,1,319,390,-71
44,5,44,7,546,490,56
44,5,44,9,274,442,-168
44,5,51,13,30,50,-20
44,5,51,59,75,166,-91
44,5,51,153,43,68,-25
44,5,51,510,0,37,-37
44,5,51,550,63,97,-34
44,5,51,710,94,63,31
44,5,51,810,172,199,-27
44,5,53,33,0,30,-30
44,5,53,35,50,0,50
44,5,53,61,54,40,14
44,7,4,13,89,164,-75
44,7,4,19,32,38,-6
44,7,6,1,0,63,-63
44,7,6,37,207,235,-28
44,7,6,59,53,88,-35
44,7,6,65,0,44,-44
44,7,6,67,28,43,-15
44,7,6,71,28,50,-22
44,7,6,73,61,132,-71
44,7,6,75,37,73,-36
44,7,6,85,41,48,-7
44,7,8,13,0,23,-23
44,7,8,31,0,39,-39
44,7,9,1,136,143,-7
44,7,9,3,226,280,-54
44,7,9,5,40,23,17
44,7,9,7,28,52,-24
44,7,9,9,171,161,10
44,7,9,11,245,203,42
44,7,9,13,31,0,31
44,7,9,15,249,614,-365
44,7,10,3,21,28,-7
44,7,11,1,59,116,-57
44,7,12,9,37,72,-35
44,7,12,11,163,247,-84
44,7,12,15,53,67,-14
44,7,12,21,33,77,-44
44,7,12,31,46,71,-25
44,7,12,35,0,45,-45
44,7,12,53,0,35,-35
44,7,12,57,150,205,-55
44,7,12,61,0,35,-35
44,7,12,69,0,53,-53
44,7,12,71,74,164,-90
44,7,12,81,0,70,-70
44,7,12,83,35,72,-37
44,7,12,86,176,184,-8
44,7,12,95,162,210,-48
44,7,12,97,89,139,-50
44,7,12,99,119,210,-91
44,7,12,101,27,125,-98
44,7,12,103,82,127,-45
44,7,12,105,56,109,-53
44,7,12,111,27,61,-34
44,7,12,115,42,89,-47
44,7,12,117,48,61,-13
44,7,12,119,0,56,-56
44,7,12,127,75,99,-24
44,7,13,51,0,34,-34
44,7,13,67,31,105,-74
44,7,13,89,57,102,-45
44,7,13,121,37,72,-35
44,7,13,135,35,126,-91
44,7,13,139,0,29,-29
44,7,15,3,0,51,-51
44,7,17,31,138,169,-31
44,7,18,97,0,27,-27
44,7,21,111,36,0,36
44,7,22,51,0,29,-29
44,7,23,5,60,69,-9
44,7,23,19,0,35,-35
44,7,23,31,43,52,-9
44,7,24,3,0,27,-27
44,7,24,5,31,41,-10
44,7,24,31,39,79,-40
44,7,24,33,36,49,-13
44,7,24,510,27,50,-23
44,7,25,1,98,201,-103
44,7,25,3,28,0,28
44,7,25,5,2668,3147,-479
44,7,25,9,231,280,-49
44,7,25,11,27,0,27
44,7,25,13,129,126,3
44,7,25,15,63,105,-42
44,7,25,17,717,1075,-358
44,7,25,21,843,976,-133
44,7,25,23,325,363,-38
44,7,25,25,747,884,-137
44,7,25,27,986,1297,-311
44,7,26,125,41,0,41
44,7,26,161,35,28,7
44,7,27,53,47,46,1
44,7,27,123,24,0,24
44,7,29,95,24,0,24
44,7,32,3,84,128,-44
44,7,33,1,0,29,-29
44,7,33,3,33,0,33
44,7,33,5,30,0,30
44,7,33,9,35,58,-23
44,7,33,11,115,149,-34
44,7,33,13,51,36,15
44,7,33,15,94,106,-12
44,7,33,17,21,0,21
44,7,34,1,0,23,-23
44,7,34,3,72,78,-6
44,7,34,5,31,35,-4
44,7,34,13,39,87,-48
44,7,34,17,86,115,-29
44,7,34,21,50,49,1
44,7,34,23,41,62,-21
44,7,34,25,0,37,-37
44,7,34,27,28,50,-22
44,7,34,29,0,31,-31
44,7,34,31,59,73,-14
44,7,34,35,0,38,-38
44,7,34,39,55,0,55
44,7,35,1,0,35,-35
44,7,36,1,30,33,-3
44,7,36,5,389,416,-27
44,7,36,27,22,27,-5
44,7,36,29,40,28,12
44,7,36,47,256,319,-63
44,7,36,55,42,88,-46
44,7,36,59,92,51,41
44,7,36,61,399,504,-105
44,7,36,67,60,32,28
44,7,36,81,198,208,-10
44,7,36,91,27,22,5
44,7,36,103,89,89,0
44,7,36,119,76,117,-41
44,7,37,25,0,38,-38
44,7,37,51,0,50,-50
44,7,37,119,80,240,-160
44,7,37,133,34,0,34
44,7,37,183,50,253,-203
44,7,39,35,47,49,-2
44,7,39,49,35,56,-21
44,7,39,61,29,34,-5
44,7,41,51,0,60,-60
44,7,42,3,32,52,-20
44,7,42,11,39,46,-7
44,7,42,17,30,40,-10
44,7,42,29,0,27,-27
44,7,42,45,0,35,-35
44,7,42,71,41,31,10
44,7,42,77,34,74,-40
44,7,42,79,0,31,-31
44,7,42,91,57,35,22
44,7,42,101,150,237,-87
44,7,44,1,956,916,40
44,7,44,3,4891,6189,-1298
44,7,44,9,1175,1488,-313
44,7,45,13,0,27,-27
44,7,45,19,0,20,-20
44,7,45,45,0,118,-118
44,7,45,51,0,31,-31
44,7,45,83,0,73,-73
44,7,48,29,0,28,-28
44,7,48,85,0,45,-45
44,7,48,113,31,106,-75
44,7,48,121,33,35,-2
44,7,48,201,72,114,-42
44,7,48,439,36,89,-53
44,7,48,453,37,53,-16
44,7,50,7,52,38,14
44,7,50,27,0,27,-27
44,7,51,13,28,35,-7
44,7,51,59,49,79,-30
44,7,51,153,38,55,-17
44,7,51,510,0,40,-40
44,7,51,810,58,47,11
44,7,53,33,63,108,-45
44,7,53,53,32,0,32
44,7,55,25,0,34,-34
44,9,4,13,32,0,32
44,9,6,37,0,43,-43
44,9,6,73,27,71,-44
44,9,9,1,77,52,25
44,9,9,3,154,53,101
44,9,9,7,47,41,6
44,9,9,9,37,58,-21
44,9,9,11,619,703,-84
44,9,9,15,67,73,-6
44,9,12,9,0,33,-33
44,9,12,11,31,42,-11
44,9,12,21,25,41,-16
44,9,12,57,0,39,-39
44,9,12,71,27,63,-36
44,9,12,99,0,64,-64
44,9,12,103,0,26,-26
44,9,12,115,0,70,-70
44,9,23,5,21,0,21
44,9,25,5,109,84,25
44,9,25,9,0,22,-22
44,9,25,13,36,0,36
44,9,25,17,77,117,-40
44,9,25,21,48,49,-1
44,9,25,23,0,24,-24
44,9,25,25,49,92,-43
44,9,25,27,51,65,-14
44,9,26,161,36,0,36
44,9,33,11,0,38,-38
44,9,36,47,0,38,-38
44,9,36,61,29,62,-33
44,9,36,81,0,32,-32
44,9,36,119,57,0,57
44,9,37,183,0,52,-52
44,9,44,3,1535,1651,-116
44,9,44,5,442,274,168
44,9,44,7,1488,1175,313
44,9,45,51,0,28,-28
44,9,53,33,0,23,-23
45,1,45,7,285,343,-58
45,1,45,19,0,31,-31
45,1,45,45,82,106,-24
45,1,45,47,480,468,12
45,1,45,59,45,45,0
45,1,45,63,29,0,29
45,1,45,65,38,33,5
45,1,45,79,0,29,-29
45,3,6,37,38,0,38
45,3,6,73,0,39,-39
45,3,12,9,39,0,39
45,3,12,11,42,0,42
45,3,12,21,27,0,27
45,3,12,31,42,43,-1
45,3,12,57,62,0,62
45,3,12,71,37,0,37
45,3,12,95,0,44,-44
45,3,12,99,73,0,73
45,3,12,127,34,0,34
45,3,13,33,50,35,15
45,3,13,51,51,24,27
45,3,13,67,27,37,-10
45,3,13,73,490,563,-73
45,3,13,89,52,42,10
45,3,13,121,37,70,-33
45,3,13,135,53,40,13
45,3,13,189,60,0,60
45,3,13,245,1591,1241,350
45,3,32,3,31,44,-13
45,3,36,81,36,0,36
45,3,37,119,77,95,-18
45,3,37,133,27,0,27
45,3,37,183,34,34,0
45,3,45,5,43,47,-4
45,3,45,7,35,51,-16
45,3,45,9,37,0,37
45,3,45,11,285,217,68
45,3,45,13,80,65,15
45,3,45,15,44,67,-23
45,3,45,19,149,143,6
45,3,45,29,0,42,-42
45,3,45,35,40,40,0
45,3,45,37,659,772,-113
45,3,45,41,35,38,-3
45,3,45,45,150,90,60
45,3,45,47,60,51,9
45,3,45,51,42,43,-1
45,3,45,63,429,560,-131
45,3,45,65,43,31,12
45,3,45,75,84,110,-26
45,3,45,77,0,34,-34
45,3,45,79,252,395,-143
45,3,45,81,125,102,23
45,3,45,83,35,60,-25
45,3,45,85,33,0,33
45,3,45,91,54,59,-5
45,3,47,93,45,64,-19
45,3,48,201,0,50,-50
45,3,51,59,29,0,29
45,5,45,3,47,43,4
45,5,45,11,93,114,-21
45,5,45,49,70,69,1
45,5,45,63,0,31,-31
45,5,45,79,0,62,-62
45,7,4,13,46,0,46
45,7,6,37,35,0,35
45,7,6,71,36,0,36
45,7,6,73,29,39,-10
45,7,12,9,36,0,36
45,7,12,11,134,0,134
45,7,12,15,28,0,28
45,7,12,31,52,28,24
45,7,12,57,48,0,48
45,7,12,71,62,0,62
45,7,12,86,47,0,47
45,7,12,95,79,0,79
45,7,12,97,44,0,44
45,7,12,99,132,0,132
45,7,12,101,31,0,31
45,7,12,103,38,0,38
45,7,12,111,42,0,42
45,7,12,115,42,0,42
45,7,12,127,44,0,44
45,7,13,67,48,56,-8
45,7,13,89,37,47,-10
45,7,13,105,40,33,7
45,7,13,119,39,0,39
45,7,13,121,52,58,-6
45,7,13,135,96,55,41
45,7,13,147,129,73,56
45,7,13,245,32,0,32
45,7,13,257,46,0,46
45,7,26,125,31,0,31
45,7,36,103,55,0,55
45,7,37,21,75,34,41
45,7,37,81,26,0,26
45,7,37,89,37,0,37
45,7,37,119,91,70,21
45,7,37,133,0,30,-30
45,7,37,183,25,50,-25
45,7,42,3,34,0,34
45,7,45,1,343,285,58
45,7,45,3,51,35,16
45,7,45,13,0,38,-38
45,7,45,15,51,48,3
45,7,45,19,130,128,2
45,7,45,21,0,28,-28
45,7,45,35,48,45,3
45,7,45,41,34,0,34
45,7,45,45,2382,2391,-9
45,7,45,47,234,141,93
45,7,45,51,89,42,47
45,7,45,59,127,178,-51
45,7,45,63,102,80,22
45,7,45,73,589,434,155
45,7,45,77,1479,1277,202
45,7,45,79,135,136,-1
45,7,45,83,248,317,-69
45,7,45,85,29,0,29
45,7,45,91,54,65,-11
45,7,47,37,0,24,-24
45,9,45,3,0,37,-37
45,9,45,11,99,123,-24
45,9,45,19,0,30,-30
45,9,45,29,37,0,37
45,9,45,63,37,58,-21
45,9,45,75,187,270,-83
45,9,45,79,59,105,-46
45,11,13,245,0,34,-34
45,11,45,3,217,285,-68
45,11,45,5,114,93,21
45,11,45,9,123,99,24
45,11,45,13,0,32,-32
45,11,45,63,63,70,-7
45,11,45,75,83,105,-22
45,11,45,79,34,67,-33
45,13,1,73,0,36,-36
45,13,4,13,72,77,-5
45,13,4,19,46,0,46
45,13,4,27,38,41,-3
45,13,6,31,40,42,-2
45,13,6,37,89,73,16
45,13,6,59,107,43,64
45,13,6,65,50,33,17
45,13,6,71,178,94,84
45,13,6,73,441,447,-6
45,13,9,1,94,0,94
45,13,9,3,42,0,42
45,13,10,3,42,0,42
45,13,12,9,53,35,18
45,13,12,11,87,62,25
45,13,12,19,38,39,-1
45,13,12,21,0,33,-33
45,13,12,31,150,186,-36
45,13,12,33,147,120,27
45,13,12,57,77,87,-10
45,13,12,71,28,51,-23
45,13,12,73,0,27,-27
45,13,12,83,29,0,29
45,13,12,85,29,0,29
45,13,12,86,143,212,-69
45,13,12,95,77,67,10
45,13,12,97,0,41,-41
45,13,12,99,131,83,48
45,13,12,101,34,33,1
45,13,12,103,38,41,-3
45,13,12,105,28,0,28
45,13,12,109,0,30,-30
45,13,12,111,49,0,49
45,13,12,113,0,46,-46
45,13,12,115,43,0,43
45,13,12,117,29,32,-3
45,13,12,127,75,0,75
45,13,13,29,23,0,23
45,13,13,31,46,41,5
45,13,13,51,307,429,-122
45,13,13,59,31,29,2
45,13,13,67,149,100,49
45,13,13,73,49,0,49
45,13,13,89,54,49,5
45,13,13,103,66,96,-30
45,13,13,121,120,132,-12
45,13,13,127,41,28,13
45,13,13,135,129,72,57
45,13,13,153,0,37,-37
45,13,13,179,0,37,-37
45,13,13,245,52,40,12
45,13,15,3,146,157,-11
45,13,17,31,76,55,21
45,13,17,43,34,0,34
45,13,17,97,40,0,40
45,13,21,67,0,39,-39
45,13,23,5,40,0,40
45,13,24,3,72,0,72
45,13,24,5,44,0,44
45,13,24,31,94,38,56
45,13,24,33,42,0,42
45,13,24,37,58,34,24
45,13,25,1,32,0,32
45,13,25,9,44,27,17
45,13,25,17,33,0,33
45,13,25,21,46,0,46
45,13,25,23,45,0,45
45,13,25,25,23,0,23
45,13,26,99,31,0,31
45,13,26,125,94,0,94
45,13,26,161,31,0,31
45,13,26,163,33,0,33
45,13,27,53,30,0,30
45,13,28,47,0,48,-48
45,13,29,189,0,35,-35
45,13,32,3,36,35,1
45,13,33,11,24,0,24
45,13,34,3,63,0,63
45,13,34,5,34,0,34
45,13,34,23,38,0,38
45,13,34,25,64,0,64
45,13,34,27,50,0,50
45,13,34,29,102,0,102
45,13,34,35,35,0,35
45,13,36,5,66,0,66
45,13,36,29,33,34,-1
45,13,36,47,59,52,7
45,13,36,55,52,0,52
45,13,36,59,92,0,92
45,13,36,61,71,37,34
45,13,36,71,38,0,38
45,13,36,81,55,31,24
45,13,36,87,31,0,31
45,13,36,103,142,37,105
45,13,36,119,50,0,50
45,13,37,21,30,47,-17
45,13,37,49,177,113,64
45,13,37,51,38,53,-15
45,13,37,67,28,32,-4
45,13,37,81,50,49,1
45,13,37,89,0,30,-30
45,13,37,119,173,192,-19
45,13,37,129,33,0,33
45,13,37,133,682,524,158
45,13,37,183,109,89,20
45,13,39,35,71,32,39
45,13,39,49,76,39,37
45,13,39,61,50,43,7
45,13,39,95,28,0,28
45,13,39,113,34,0,34
45,13,39,151,39,0,39
45,13,39,153,69,29,40
45,13,39,155,25,0,25
45,13,42,3,92,43,49
45,13,42,17,73,0,73
45,13,42,29,43,0,43
45,13,42,49,26,0,26
45,13,42,91,47,0,47
45,13,42,95,37,0,37
45,13,42,101,30,30,0
45,13,44,7,27,0,27
45,13,45,3,65,80,-15
45,13,45,7,38,0,38
45,13,45,11,32,0,32
45,13,45,15,92,100,-8
45,13,45,19,340,378,-38
45,13,45,29,119,114,5
45,13,45,35,77,93,-16
45,13,45,41,26,47,-21
45,13,45,45,114,207,-93
45,13,45,47,34,0,34
45,13,45,49,145,162,-17
45,13,45,51,65,55,10
45,13,45,53,550,842,-292
45,13,45,63,137,141,-4
45,13,45,75,29,46,-17
45,13,45,77,29,32,-3
45,13,45,79,249,244,5
45,13,45,83,51,71,-20
45,13,45,85,31,24,7
45,13,45,91,77,87,-10
45,13,47,37,40,35,5
45,13,47,65,0,34,-34
45,13,47,93,0,38,-38
45,13,47,157,31,0,31
45,13,48,29,42,53,-11
45,13,48,113,29,36,-7
45,13,48,201,35,75,-40
45,13,48,355,0,34,-34
45,13,48,439,45,90,-45
45,13,51,13,25,0,25
45,13,51,59,125,45,80
45,13,51,107,41,0,41
45,13,51,153,89,140,-51
45,13,51,179,32,0,32
45,13,51,550,54,0,54
45,13,51,710,49,49,0
45,13,51,810,191,116,75
45,15,2,20,0,43,-43
45,15,4,13,49,66,-17
45,15,4,19,24,0,24
45,15,6,13,24,0,24
45,15,6,37,29,64,-35
45,15,6,59,28,0,28
45,15,6,65,42,25,17
45,15,6,73,171,261,-90
45,15,6,111,33,0,33
45,15,8,41,28,0,28
45,15,9,1,34,0,34
45,15,9,11,65,201,-136
45,15,12,9,44,37,7
45,15,12,11,89,36,53
45,15,12,19,0,36,-36
45,15,12,31,130,135,-5
45,15,12,33,0,51,-51
45,15,12,57,67,62,5
45,15,12,83,39,0,39
45,15,12,86,74,0,74
45,15,12,91,36,0,36
45,15,12,95,65,53,12
45,15,12,99,35,0,35
45,15,12,103,36,55,-19
45,15,12,117,29,0,29
45,15,13,39,83,179,-96
45,15,13,51,46,69,-23
45,15,13,67,51,39,12
45,15,13,89,40,47,-7
45,15,13,121,49,55,-6
45,15,13,135,51,38,13
45,15,13,245,62,0,62
45,15,15,3,73,194,-121
45,15,17,31,43,28,15
45,15,24,3,54,33,21
45,15,24,31,36,29,7
45,15,24,33,38,0,38
45,15,24,510,26,0,26
45,15,25,17,41,0,41
45,15,25,27,36,0,36
45,15,26,49,29,0,29
45,15,26,81,24,0,24
45,15,26,99,34,0,34
45,15,26,125,45,0,45
45,15,26,163,46,0,46
45,15,32,3,33,28,5
45,15,34,5,47,0,47
45,15,34,13,30,0,30
45,15,34,17,28,0,28
45,15,34,25,35,0,35
45,15,34,29,35,0,35
45,15,36,5,65,0,65
45,15,36,47,71,34,37
45,15,36,59,39,0,39
45,15,36,61,46,0,46
45,15,36,81,53,0,53
45,15,36,91,0,492,-492
45,15,36,103,67,0,67
45,15,37,21,0,39,-39
45,15,37,51,60,42,18
45,15,37,81,33,0,33
45,15,37,119,131,139,-8
45,15,37,133,84,55,29
45,15,37,183,80,69,11
45,15,39,49,74,0,74
45,15,39,113,33,0,33
45,15,39,151,29,0,29
45,15,42,3,26,0,26
45,15,42,17,33,0,33
45,15,42,133,30,0,30
45,15,45,3,67,44,23
45,15,45,7,48,51,-3
45,15,45,13,100,92,8
45,15,45,19,7337,4655,2682
45,15,45,27,45,37,8
45,15,45,29,171,182,-11
45,15,45,31,44,0,44
45,15,45,35,3113,2920,193
45,15,45,41,102,58,44
45,15,45,43,94,45,49
45,15,45,45,145,127,18
45,15,45,47,22,0,22
45,15,45,51,164,120,44
45,15,45,63,164,139,25
45,15,45,75,279,233,46
45,15,45,77,32,0,32
45,15,45,79,265,232,33
45,15,45,83,103,67,36
45,15,45,85,59,35,24
45,15,45,89,66,0,66
45,15,45,91,52,104,-52
45,15,47,37,0,32,-32
45,15,47,157,0,27,-27
45,15,48,29,33,0,33
45,15,48,113,38,28,10
45,15,48,201,78,64,14
45,15,48,439,32,27,5
45,15,51,59,66,0,66
45,15,51,153,44,0,44
45,15,51,550,48,75,-27
45,15,51,650,44,111,-67
45,15,51,700,97,102,-5
45,15,51,710,91,173,-82
45,15,51,740,36,51,-15
45,15,51,800,38,42,-4
45,15,51,810,190,222,-32
45,15,53,33,35,37,-2
45,15,53,35,105,285,-180
45,15,53,53,34,0,34
45,15,53,61,0,67,-67
45,17,45,19,42,0,42
45,17,45,63,205,255,-50
45,17,45,75,384,398,-14
45,17,45,79,122,198,-76
45,19,1,73,79,31,48
45,19,1,89,0,22,-22
45,19,1,101,27,28,-1
45,19,1,117,0,34,-34
45,19,2,20,35,69,-34
45,19,4,13,110,90,20
45,19,4,19,31,0,31
45,19,6,1,0,24,-24
45,19,6,37,143,127,16
45,19,6,59,58,30,28
45,19,6,65,36,31,5
45,19,6,71,47,0,47
45,19,6,73,175,210,-35
45,19,6,75,22,20,2
45,19,8,31,48,38,10
45,19,8,41,63,51,12
45,19,9,1,54,28,26
45,19,9,3,40,0,40
45,19,9,9,77,29,48
45,19,9,11,58,64,-6
45,19,10,1,0,43,-43
45,19,10,3,43,0,43
45,19,11,1,90,129,-39
45,19,12,1,51,0,51
45,19,12,9,56,37,19
45,19,12,11,141,82,59
45,19,12,19,0,54,-54
45,19,12,21,43,0,43
45,19,12,31,152,191,-39
45,19,12,33,32,50,-18
45,19,12,35,31,0,31
45,19,12,57,125,90,35
45,19,12,69,24,0,24
45,19,12,71,48,35,13
45,19,12,73,53,33,20
45,19,12,86,115,123,-8
45,19,12,87,32,26,6
45,19,12,89,33,0,33
45,19,12,91,50,0,50
45,19,12,95,129,65,64
45,19,12,99,96,96,0
45,19,12,101,30,0,30
45,19,12,103,75,56,19
45,19,12,105,0,30,-30
45,19,12,109,38,37,1
45,19,12,115,30,42,-12
45,19,12,117,41,0,41
45,19,12,127,40,36,4
45,19,13,21,30,0,30
45,19,13,31,32,0,32
45,19,13,39,53,55,-2
45,19,13,51,152,168,-16
45,19,13,57,28,0,28
45,19,13,59,56,39,17
45,19,13,63,31,36,-5
45,19,13,67,144,155,-11
45,19,13,73,49,24,25
45,19,13,89,214,136,78
45,19,13,113,33,30,3
45,19,13,117,31,0,31
45,19,13,121,248,243,5
45,19,13,127,38,0,38
45,19,13,135,111,80,31
45,19,13,151,32,0,32
45,19,13,153,0,32,-32
45,19,13,215,27,0,27
45,19,13,245,108,76,32
45,19,15,3,87,128,-41
45,19,17,31,125,112,13
45,19,17,43,41,0,41
45,19,17,97,40,0,40
45,19,17,163,35,0,35
45,19,18,3,31,0,31
45,19,18,97,58,50,8
45,19,21,67,62,27,35
45,19,21,111,49,56,-7
45,19,22,71,33,32,1
45,19,23,31,0,28,-28
45,19,24,3,127,54,73
45,19,24,5,87,47,40
45,19,24,27,32,28,4
45,19,24,31,119,75,44
45,19,24,33,72,60,12
45,19,24,510,32,35,-3
45,19,25,9,38,0,38
45,19,25,17,90,46,44
45,19,25,21,33,0,33
45,19,25,23,24,0,24
45,19,25,25,56,49,7
45,19,25,27,40,30,10
45,19,26,49,32,0,32
45,19,26,81,38,0,38
45,19,26,99,0,26,-26
45,19,26,125,90,37,53
45,19,26,161,40,0,40
45,19,26,163,56,28,28
45,19,27,53,0,26,-26
45,19,28,47,25,39,-14
45,19,29,189,54,49,5
45,19,31,55,0,33,-33
45,19,32,3,47,52,-5
45,19,33,11,46,0,46
45,19,34,3,32,0,32
45,19,34,5,37,0,37
45,19,34,13,45,0,45
45,19,34,17,44,30,14
45,19,34,23,27,0,27
45,19,34,25,80,0,80
45,19,34,27,75,0,75
45,19,34,29,38,0,38
45,19,34,35,27,0,27
45,19,34,39,33,0,33
45,19,36,5,86,40,46
45,19,36,29,53,29,24
45,19,36,47,118,71,47
45,19,36,55,37,41,-4
45,19,36,59,69,0,69
45,19,36,61,152,107,45
45,19,36,67,47,0,47
45,19,36,71,39,0,39
45,19,36,81,70,25,45
45,19,36,91,0,34,-34
45,19,36,103,74,43,31
45,19,36,119,64,0,64
45,19,37,19,25,44,-19
45,19,37,21,120,140,-20
45,19,37,25,44,34,10
45,19,37,35,55,0,55
45,19,37,49,27,0,27
45,19,37,51,119,78,41
45,19,37,55,34,0,34
45,19,37,63,88,69,19
45,19,37,67,67,48,19
45,19,37,71,42,35,7
45,19,37,81,147,74,73
45,19,37,89,25,60,-35
45,19,37,97,63,39,24
45,19,37,119,545,520,25
45,19,37,129,125,70,55
45,19,37,133,60,32,28
45,19,37,135,39,52,-13
45,19,37,147,49,0,49
45,19,37,159,32,39,-7
45,19,37,179,35,60,-25
45,19,37,183,202,204,-2
45,19,37,189,30,0,30
45,19,39,35,68,57,11
45,19,39,49,102,76,26
45,19,39,61,69,40,29
45,19,39,85,28,0,28
45,19,39,95,37,0,37
45,19,39,99,33,0,33
45,19,39,103,20,0,20
45,19,39,113,43,30,13
45,19,39,151,35,0,35
45,19,39,153,33,32,1
45,19,39,173,21,0,21
45,19,40,143,0,35,-35
45,19,41,51,0,44,-44
45,19,42,3,133,75,58
45,19,42,17,30,0,30
45,19,42,19,32,0,32
45,19,42,29,38,0,38
45,19,42,43,27,0,27
45,19,42,49,28,0,28
45,19,42,91,52,27,25
45,19,42,101,73,67,6
45,19,42,129,21,0,21
45,19,42,133,28,0,28
45,19,44,7,20,0,20
45,19,45,1,31,0,31
45,19,45,3,143,149,-6
45,19,45,7,128,130,-2
45,19,45,9,30,0,30
45,19,45,13,378,340,38
45,19,45,15,4655,7337,-2682
45,19,45,17,0,42,-42
45,19,45,25,40,0,40
45,19,45,27,37,46,-9
45,19,45,29,297,373,-76
45,19,45,31,57,62,-5
45,19,45,35,3298,5097,-1799
45,19,45,39,0,27,-27
45,19,45,41,272,138,134
45,19,45,43,163,146,17
45,19,45,45,520,532,-12
45,19,45,47,85,44,41
45,19,45,49,0,38,-38
45,19,45,51,344,266,78
45,19,45,53,30,0,30
45,19,45,55,59,65,-6
45,19,45,57,44,33,11
45,19,45,59,37,0,37
45,19,45,63,326,367,-41
45,19,45,67,40,0,40
45,19,45,71,0,34,-34
45,19,45,73,71,35,36
45,19,45,75,195,193,2
45,19,45,77,121,72,49
45,19,45,79,886,606,280
45,19,45,83,310,160,150
45,19,45,85,137,88,49
45,19,45,89,0,29,-29
45,19,45,91,243,205,38
45,19,47,37,68,108,-40
45,19,47,65,43,27,16
45,19,47,93,68,69,-1
45,19,47,157,96,72,24
45,19,47,179,32,30,2
45,19,48,29,48,57,-9
45,19,48,85,45,0,45
45,19,48,113,57,68,-11
45,19,48,121,0,24,-24
45,19,48,201,77,96,-19
45,19,48,339,0,32,-32
45,19,48,439,33,37,-4
45,19,48,453,33,52,-19
45,19,48,465,24,0,24
45,19,50,7,28,0,28
45,19,51,3,29,34,-5
45,19,51,13,93,49,44
45,19,51,41,39,35,4
45,19,51,59,197,103,94
45,19,51,87,36,44,-8
45,19,51,107,60,0,60
45,19,51,121,30,0,30
45,19,51,153,53,54,-1
45,19,51,179,0,37,-37
45,19,51,199,30,29,1
45,19,51,510,34,21,13
45,19,51,550,63,63,0
45,19,51,650,28,56,-28
45,19,51,700,46,69,-23
45,19,51,710,91,112,-21
45,19,51,740,0,35,-35
45,19,51,760,33,44,-11
45,19,51,810,123,94,29
45,19,53,33,73,71,2
45,19,53,35,50,104,-54
45,19,53,53,35,38,-3
45,19,53,61,36,29,7
45,19,54,39,29,0,29
45,19,55,25,29,22,7
45,19,55,79,47,0,47
45,21,37,45,214,201,13
45,21,37,71,79,68,11
45,21,37,119,60,50,10
45,21,37,161,65,40,25
45,21,45,7,28,0,28
45,21,45,45,84,78,6
45,21,45,51,31,39,-8
45,21,45,59,38,28,10
45,21,45,79,0,37,-37
45,21,45,83,975,960,15
45,21,45,87,55,71,-16
45,21,45,91,172,108,64
45,23,37,71,41,0,41
45,23,37,119,122,100,22
45,23,45,39,73,74,-1
45,23,45,51,29,0,29
45,23,45,57,280,224,56
45,23,45,79,37,65,-28
45,23,45,87,37,40,-3
45,23,45,91,830,836,-6
45,25,37,7,106,84,22
45,25,37,119,92,106,-14
45,25,37,153,0,44,-44
45,25,37,179,330,236,94
45,25,45,19,0,40,-40
45,25,45,31,157,265,-108
45,25,45,41,63,64,-1
45,25,45,51,47,58,-11
45,25,45,55,55,54,1
45,25,45,57,147,141,6
45,25,45,63,0,25,-25
45,25,45,69,235,197,38
45,25,45,79,45,48,-3
45,25,45,83,0,35,-35
45,25,45,91,63,47,16
45,27,45,15,37,45,-8
45,27,45,19,46,37,9
45,27,45,31,33,0,33
45,27,45,35,47,0,47
45,27,45,41,121,155,-34
45,27,45,51,33,30,3
45,27,45,61,39,0,39
45,27,45,63,0,56,-56
45,27,45,75,84,66,18
45,27,45,79,103,134,-31
45,27,45,85,434,500,-66
45,27,45,89,81,66,15
45,29,12,31,27,29,-2
45,29,45,3,42,0,42
45,29,45,9,0,37,-37
45,29,45,13,114,119,-5
45,29,45,15,182,171,11
45,29,45,19,373,297,76
45,29,45,35,414,370,44
45,29,45,49,57,58,-1
45,29,45,63,55,45,10
45,29,45,75,46,73,-27
45,29,45,79,49,90,-41
45,31,37,51,0,38,-38
45,31,37,119,73,73,0
45,31,37,183,0,26,-26
45,31,45,15,0,44,-44
45,31,45,19,62,57,5
45,31,45,25,265,157,108
45,31,45,27,0,33,-33
45,31,45,33,55,35,20
45,31,45,41,1548,1629,-81
45,31,45,43,0,36,-36
45,31,45,45,40,52,-12
45,31,45,51,75,144,-69
45,31,45,55,38,31,7
45,31,45,61,153,167,-14
45,31,45,63,63,55,8
45,31,45,67,49,0,49
45,31,45,69,82,33,49
45,31,45,79,117,159,-42
45,31,45,85,68,65,3
45,31,45,91,0,34,-34
45,33,37,51,35,41,-6
45,33,37,81,0,42,-42
45,33,37,119,31,34,-3
45,33,37,155,88,92,-4
45,33,45,31,35,55,-20
45,33,45,41,136,186,-50
45,33,45,51,96,133,-37
45,33,45,63,0,25,-25
45,33,45,67,283,265,18
45,33,45,69,97,103,-6
45,33,45,79,41,49,-8
45,35,6,37,53,30,23
45,35,6,59,25,0,25
45,35,6,73,70,28,42
45,35,8,41,39,37,2
45,35,9,1,33,0,33
45,35,9,9,45,0,45
45,35,9,11,39,0,39
45,35,12,11,75,0,75
45,35,12,31,61,44,17
45,35,12,57,59,60,-1
45,35,12,86,71,43,28
45,35,12,91,0,40,-40
45,35,12,95,50,32,18
45,35,12,99,45,0,45
45,35,12,103,39,0,39
45,35,13,39,36,45,-9
45,35,13,51,76,52,24
45,35,13,67,0,32,-32
45,35,13,89,44,35,9
45,35,13,121,0,38,-38
45,35,13,135,49,60,-11
45,35,15,3,63,38,25
45,35,17,31,0,32,-32
45,35,24,3,63,0,63
45,35,24,5,0,26,-26
45,35,24,33,43,39,4
45,35,26,125,52,0,52
45,35,26,163,36,0,36
45,35,32,3,40,0,40
45,35,34,25,55,0,55
45,35,36,5,38,0,38
45,35,36,29,37,0,37
45,35,36,47,44,0,44
45,35,36,55,36,0,36
45,35,36,59,56,0,56
45,35,36,81,46,0,46
45,35,36,103,71,0,71
45,35,37,21,38,0,38
45,35,37,51,56,44,12
45,35,37,81,38,41,-3
45,35,37,119,130,122,8
45,35,37,133,74,30,44
45,35,37,183,71,54,17
45,35,39,35,38,0,38
45,35,39,49,28,0,28
45,35,39,113,33,0,33
45,35,39,151,31,0,31
45,35,39,153,23,0,23
45,35,40,65,0,59,-59
45,35,45,3,40,40,0
45,35,45,7,45,48,-3
45,35,45,13,93,77,16
45,35,45,15,2920,3113,-193
45,35,45,19,5097,3298,1799
45,35,45,27,0,47,-47
45,35,45,29,370,414,-44
45,35,45,41,87,47,40
45,35,45,43,40,0,40
45,35,45,45,74,123,-49
45,35,45,47,41,0,41
45,35,45,51,110,116,-6
45,35,45,55,0,44,-44
45,35,45,63,161,194,-33
45,35,45,75,314,269,45
45,35,45,77,0,28,-28
45,35,45,79,199,186,13
45,35,45,83,39,79,-40
45,35,45,85,99,41,58
45,35,45,91,64,75,-11
45,35,48,29,31,0,31
45,35,51,59,64,46,18
45,35,51,153,40,0,40
45,35,51,550,49,0,49
45,35,51,700,48,0,48
45,35,51,710,0,29,-29
45,35,51,810,140,51,89
45,35,53,35,56,47,9
45,37,13,73,101,36,65
45,37,13,245,139,90,49
45,37,45,3,772,659,113
45,37,45,47,41,71,-30
45,37,45,63,0,70,-70
45,37,45,79,0,47,-47
45,37,45,81,73,64,9
45,39,37,119,35,0,35
45,39,45,19,27,0,27
45,39,45,23,74,73,1
45,39,45,55,95,83,12
45,39,45,63,162,87,75
45,39,45,71,0,43,-43
45,39,45,79,522,569,-47
45,39,45,91,49,48,1
45,41,11,1,25,0,25
45,41,12,11,54,0,54
45,41,12,31,81,35,46
45,41,12,57,0,26,-26
45,41,13,89,0,41,-41
45,41,13,121,0,28,-28
45,41,13,135,0,48,-48
45,41,24,33,29,0,29
45,41,36,5,32,0,32
45,41,36,47,40,23,17
45,41,36,81,42,0,42
45,41,36,103,31,0,31
45,41,37,21,0,24,-24
45,41,37,51,43,48,-5
45,41,37,67,0,25,-25
45,41,37,81,0,37,-37
45,41,37,119,137,194,-57
45,41,37,183,60,82,-22
45,41,42,101,47,0,47
45,41,45,3,38,35,3
45,41,45,7,0,34,-34
45,41,45,13,47,26,21
45,41,45,15,58,102,-44
45,41,45,19,138,272,-134
45,41,45,25,64,63,1
45,41,45,27,155,121,34
45,41,45,31,1629,1548,81
45,41,45,33,186,136,50
45,41,45,35,47,87,-40
45,41,45,43,116,170,-54
45,41,45,45,52,155,-103
45,41,45,51,289,402,-113
45,41,45,55,49,60,-11
45,41,45,61,122,121,1
45,41,45,63,96,173,-77
45,41,45,67,296,210,86
45,41,45,69,108,43,65
45,41,45,75,38,44,-6
45,41,45,77,0,33,-33
45,41,45,79,243,432,-189
45,41,45,83,45,44,1
45,41,45,85,169,156,13
45,41,45,89,530,376,154
45,41,45,91,58,73,-15
45,43,13,89,41,0,41
45,43,24,3,33,0,33
45,43,34,25,33,0,33
45,43,34,29,39,0,39
45,43,37,81,25,0,25
45,43,37,119,76,63,13
45,43,37,183,0,38,-38
45,43,45,15,45,94,-49
45,43,45,19,146,163,-17
45,43,45,31,36,0,36
45,43,45,35,0,40,-40
45,43,45,41,170,116,54
45,43,45,45,61,142,-81
45,43,45,51,1069,999,70
45,43,45,63,56,39,17
45,43,45,75,0,22,-22
45,43,45,79,134,146,-12
45,43,45,83,32,36,-4
45,43,45,85,0,27,-27
45,43,45,89,150,114,36
45,43,51,59,26,0,26
45,45,1,73,70,63,7
45,45,1,81,38,0,38
45,45,1,89,26,43,-17
45,45,1,117,51,0,51
45,45,1,125,27,0,27
45,45,4,13,131,122,9
45,45,4,19,31,0,31
45,45,6,1,0,27,-27
45,45,6,37,188,102,86
45,45,6,59,103,53,50
45,45,6,65,51,0,51
45,45,6,71,36,27,9
45,45,6,73,105,81,24
45,45,6,85,30,0,30
45,45,8,41,0,57,-57
45,45,9,1,37,0,37
45,45,9,3,118,47,71
45,45,9,9,28,0,28
45,45,10,3,34,0,34
45,45,11,1,26,32,-6
45,45,12,1,39,0,39
45,45,12,5,35,0,35
45,45,12,9,78,34,44
45,45,12,11,469,58,411
45,45,12,15,62,0,62
45,45,12,19,52,0,52
45,45,12,21,43,39,4
45,45,12,31,162,100,62
45,45,12,33,40,47,-7
45,45,12,35,29,0,29
45,45,12,57,263,47,216
45,45,12,61,26,0,26
45,45,12,69,56,0,56
45,45,12,71,98,52,46
45,45,12,73,0,28,-28
45,45,12,81,66,35,31
45,45,12,83,50,0,50
45,45,12,85,60,0,60
45,45,12,86,403,107,296
45,45,12,91,30,0,30
45,45,12,95,232,94,138
45,45,12,97,49,0,49
45,45,12,99,399,77,322
45,45,12,101,80,0,80
45,45,12,103,159,54,105
45,45,12,105,85,0,85
45,45,12,111,103,0,103
45,45,12,115,74,0,74
45,45,12,117,133,0,133
45,45,12,127,129,28,101
45,45,13,51,74,76,-2
45,45,13,57,78,0,78
45,45,13,59,28,24,4
45,45,13,63,0,29,-29
45,45,13,67,173,163,10
45,45,13,73,53,34,19
45,45,13,77,0,37,-37
45,45,13,89,135,103,32
45,45,13,97,40,0,40
45,45,13,117,41,0,41
45,45,13,121,224,197,27
45,45,13,135,282,194,88
45,45,13,139,33,28,5
45,45,13,147,20,0,20
45,45,13,151,0,36,-36
45,45,13,179,30,0,30
45,45,13,245,47,74,-27
45,45,15,3,34,28,6
45,45,17,31,139,104,35
45,45,17,43,73,0,73
45,45,17,97,36,0,36
45,45,17,111,31,0,31
45,45,17,143,52,0,52
45,45,18,3,39,0,39
45,45,18,97,44,0,44
45,45,18,141,35,0,35
45,45,21,67,46,0,46
45,45,21,111,74,41,33
45,45,24,3,39,0,39
45,45,24,5,39,0,39
45,45,24,27,27,0,27
45,45,24,31,61,27,34
45,45,24,33,49,0,49
45,45,24,510,32,0,32
45,45,25,9,44,0,44
45,45,25,13,34,0,34
45,45,25,17,35,32,3
45,45,25,21,37,0,37
45,45,25,25,38,0,38
45,45,25,27,35,0,35
45,45,26,49,47,0,47
45,45,26,81,53,0,53
45,45,26,93,28,0,28
45,45,26,99,73,0,73
45,45,26,121,26,0,26
45,45,26,125,199,63,136
45,45,26,161,54,0,54
45,45,26,163,149,65,84
45,45,27,53,45,40,5
45,45,29,183,34,0,34
45,45,32,3,82,38,44
45,45,33,11,56,45,11
45,45,33,13,36,0,36
45,45,34,3,55,0,55
45,45,34,7,31,0,31
45,45,34,13,45,0,45
45,45,34,17,36,0,36
45,45,34,21,43,0,43
45,45,34,23,80,29,51
45,45,34,27,102,0,102
45,45,34,29,44,0,44
45,45,34,31,76,0,76
45,45,34,35,39,0,39
45,45,34,39,63,0,63
45,45,35,1,39,0,39
45,45,36,1,32,0,32
45,45,36,5,36,0,36
45,45,36,27,32,0,32
45,45,36,29,62,41,21
45,45,36,47,83,28,55
45,45,36,55,89,33,56
45,45,36,59,74,0,74
45,45,36,61,44,53,-9
45,45,36,67,49,0,49
45,45,36,71,56,0,56
45,45,36,81,92,48,44
45,45,36,91,55,0,55
45,45,36,93,48,0,48
45,45,36,103,161,32,129
45,45,36,119,38,0,38
45,45,37,19,33,0,33
45,45,37,21,339,183,156
45,45,37,25,37,23,14
45,45,37,35,52,29,23
45,45,37,45,71,38,33
45,45,37,51,71,54,17
45,45,37,63,37,41,-4
45,45,37,67,83,72,11
45,45,37,71,70,44,26
45,45,37,81,116,79,37
45,45,37,87,38,40,-2
45,45,37,89,198,115,83
45,45,37,97,42,47,-5
45,45,37,119,501,576,-75
45,45,37,129,53,40,13
45,45,37,133,59,79,-20
45,45,37,149,48,64,-16
45,45,37,159,0,34,-34
45,45,37,161,25,33,-8
45,45,37,175,74,34,40
45,45,37,179,62,41,21
45,45,37,183,197,189,8
45,45,37,189,24,0,24
45,45,39,17,47,0,47
45,45,39,35,60,30,30
45,45,39,49,97,60,37
45,45,39,61,96,40,56
45,45,39,93,37,0,37
45,45,39,95,40,0,40
45,45,39,113,29,0,29
45,45,39,151,26,0,26
45,45,39,153,80,0,80
45,45,39,155,25,0,25
45,45,42,3,59,32,27
45,45,42,17,34,0,34
45,45,42,29,0,41,-41
45,45,42,49,29,0,29
45,45,42,77,57,0,57
45,45,42,91,50,0,50
45,45,42,101,38,49,-11
45,45,42,133,39,0,39
45,45,44,7,118,0,118
45,45,45,1,106,82,24
45,45,45,3,90,150,-60
45,45,45,7,2391,2382,9
45,45,45,13,207,114,93
45,45,45,15,127,145,-18
45,45,45,19,532,520,12
45,45,45,21,78,84,-6
45,45,45,31,52,40,12
45,45,45,35,123,74,49
45,45,45,41,155,52,103
45,45,45,43,142,61,81
45,45,45,47,398,197,201
45,45,45,51,254,164,90
45,45,45,55,45,34,11
45,45,45,57,73,47,26
45,45,45,59,1428,1352,76
45,45,45,63,360,352,8
45,45,45,71,60,35,25
45,45,45,73,280,258,22
45,45,45,75,86,37,49
45,45,45,77,2250,2340,-90
45,45,45,79,628,590,38
45,45,45,83,3507,3863,-356
45,45,45,85,107,45,62
45,45,45,87,89,0,89
45,45,45,91,237,289,-52
45,45,47,37,55,76,-21
45,45,47,65,53,23,30
45,45,47,93,103,55,48
45,45,47,157,40,45,-5
45,45,47,163,25,0,25
45,45,47,179,0,41,-41
45,45,48,27,47,0,47
45,45,48,29,0,41,-41
45,45,48,85,0,39,-39
45,45,48,113,73,81,-8
45,45,48,121,32,28,4
45,45,48,157,0,41,-41
45,45,48,201,102,117,-15
45,45,48,439,81,42,39
45,45,48,453,38,50,-12
45,45,51,13,0,20,-20
45,45,51,41,49,45,4
45,45,51,59,109,52,57
45,45,51,87,29,0,29
45,45,51,153,35,0,35
45,45,51,550,32,0,32
45,45,51,700,34,0,34
45,45,51,710,39,0,39
45,45,51,810,85,52,33
45,45,53,5,55,0,55
45,45,53,33,41,51,-10
45,45,53,53,0,44,-44
45,45,53,61,47,26,21
45,45,54,39,35,0,35
45,45,55,79,0,26,-26
45,47,13,135,32,0,32
45,47,13,245,0,53,-53
45,47,36,119,0,121,-121
45,47,37,119,33,37,-4
45,47,45,1,468,480,-12
45,47,45,3,51,60,-9
45,47,45,7,141,234,-93
45,47,45,13,0,34,-34
45,47,45,15,0,22,-22
45,47,45,19,44,85,-41
45,47,45,35,0,41,-41
45,47,45,37,71,41,30
45,47,45,45,197,398,-201
45,47,45,51,0,38,-38
45,47,45,59,378,309,69
45,47,45,63,96,129,-33
45,47,45,65,161,147,14
45,47,45,71,75,67,8
45,47,45,73,0,26,-26
45,47,45,77,37,76,-39
45,47,45,79,112,126,-14
45,47,45,81,107,96,11
45,47,45,83,82,111,-29
45,47,45,91,27,49,-22
45,49,13,51,59,34,25
45,49,45,5,69,70,-1
45,49,45,13,162,145,17
45,49,45,19,38,0,38
45,49,45,29,58,57,1
45,49,45,53,120,171,-51
45,49,45,63,38,54,-16
45,49,45,75,0,40,-40
45,49,45,79,29,49,-20
45,51,4,13,60,98,-38
45,51,4,19,0,32,-32
45,51,6,37,95,47,48
45,51,6,59,29,0,29
45,51,6,65,27,0,27
45,51,6,73,65,31,34
45,51,9,1,100,27,73
45,51,9,3,96,33,63
45,51,9,5,44,0,44
45,51,9,7,27,0,27
45,51,9,9,134,0,134
45,51,9,11,36,0,36
45,51,10,3,42,28,14
45,51,10,5,0,26,-26
45,51,11,1,26,0,26
45,51,12,9,43,57,-14
45,51,12,11,117,77,40
45,51,12,17,0,29,-29
45,51,12,21,0,25,-25
45,51,12,31,62,71,-9
45,51,12,33,27,0,27
45,51,12,57,50,36,14
45,51,12,71,48,53,-5
45,51,12,81,31,32,-1
45,51,12,86,88,73,15
45,51,12,87,33,0,33
45,51,12,95,115,87,28
45,51,12,97,24,0,24
45,51,12,99,69,65,4
45,51,12,101,45,0,45
45,51,12,103,69,51,18
45,51,12,105,57,39,18
45,51,12,115,28,38,-10
45,51,12,117,43,0,43
45,51,12,127,49,48,1
45,51,13,51,54,79,-25
45,51,13,57,27,0,27
45,51,13,67,69,43,26
45,51,13,89,47,50,-3
45,51,13,121,66,71,-5
45,51,13,135,39,45,-6
45,51,15,3,56,0,56
45,51,17,31,41,33,8
45,51,18,97,32,35,-3
45,51,21,111,0,26,-26
45,51,24,3,147,38,109
45,51,24,5,122,29,93
45,51,24,9,47,0,47
45,51,24,13,60,0,60
45,51,24,17,85,0,85
45,51,24,21,52,26,26
45,51,24,25,52,32,20
45,51,24,27,56,0,56
45,51,24,31,118,29,89
45,51,24,33,87,0,87
45,51,24,37,41,0,41
45,51,24,43,85,0,85
45,51,24,510,33,0,33
45,51,25,1,33,0,33
45,51,25,5,41,0,41
45,51,25,9,36,0,36
45,51,25,13,53,0,53
45,51,25,17,70,31,39
45,51,25,23,78,0,78
45,51,25,27,79,27,52
45,51,26,99,37,0,37
45,51,26,125,68,0,68
45,51,26,163,54,0,54
45,51,32,3,107,75,32
45,51,33,5,31,0,31
45,51,33,11,64,0,64
45,51,33,15,31,0,31
45,51,34,1,76,25,51
45,51,34,3,94,22,72
45,51,34,5,98,0,98
45,51,34,7,95,0,95
45,51,34,9,41,0,41
45,51,34,13,53,0,53
45,51,34,15,29,0,29
45,51,34,19,37,0,37
45,51,34,21,72,0,72
45,51,34,23,138,0,138
45,51,34,25,141,0,141
45,51,34,27,66,0,66
45,51,34,29,193,40,153
45,51,34,31,57,0,57
45,51,34,35,34,0,34
45,51,34,37,29,0,29
45,51,34,39,30,0,30
45,51,36,1,48,0,48
45,51,36,5,52,0,52
45,51,36,7,55,0,55
45,51,36,9,0,25,-25
45,51,36,15,35,0,35
45,51,36,27,77,0,77
45,51,36,29,89,42,47
45,51,36,45,0,28,-28
45,51,36,47,55,36,19
45,51,36,55,41,39,2
45,51,36,59,165,28,137
45,51,36,61,48,26,22
45,51,36,63,28,0,28
45,51,36,65,33,0,33
45,51,36,67,78,0,78
45,51,36,71,145,0,145
45,51,36,79,36,0,36
45,51,36,81,109,32,77
45,51,36,87,44,0,44
45,51,36,91,53,0,53
45,51,36,93,29,0,29
45,51,36,103,278,63,215
45,51,36,105,49,0,49
45,51,36,111,42,0,42
45,51,36,119,110,0,110
45,51,37,1,32,32,0
45,51,37,19,459,395,64
45,51,37,21,90,75,15
45,51,37,25,65,51,14
45,51,37,27,0,45,-45
45,51,37,31,25,0,25
45,51,37,35,72,26,46
45,51,37,45,0,45,-45
45,51,37,47,358,359,-1
45,51,37,51,110,74,36
45,51,37,57,100,43,57
45,51,37,63,52,47,5
45,51,37,67,111,84,27
45,51,37,71,95,68,27
45,51,37,81,184,102,82
45,51,37,85,32,0,32
45,51,37,97,60,30,30
45,51,37,101,32,58,-26
45,51,37,119,376,319,57
45,51,37,125,46,34,12
45,51,37,129,153,159,-6
45,51,37,133,49,102,-53
45,51,37,147,36,0,36
45,51,37,151,58,49,9
45,51,37,153,43,0,43
45,51,37,155,53,53,0
45,51,37,159,64,39,25
45,51,37,165,57,27,30
45,51,37,167,31,0,31
45,51,37,179,123,61,62
45,51,37,183,251,243,8
45,51,37,191,29,0,29
45,51,39,17,35,0,35
45,51,39,35,96,38,58
45,51,39,49,75,45,30
45,51,39,61,46,34,12
45,51,39,85,40,0,40
45,51,39,95,32,27,5
45,51,39,99,45,22,23
45,51,39,119,25,0,25
45,51,39,151,41,0,41
45,51,39,153,77,0,77
45,51,39,155,37,0,37
45,51,42,1,31,0,31
45,51,42,3,106,72,34
45,51,42,11,71,0,71
45,51,42,17,100,27,73
45,51,42,29,49,0,49
45,51,42,45,50,26,24
45,51,42,49,40,0,40
45,51,42,51,0,26,-26
45,51,42,55,29,0,29
45,51,42,71,62,0,62
45,51,42,77,72,0,72
45,51,42,79,52,0,52
45,51,42,89,37,0,37
45,51,42,91,40,0,40
45,51,42,95,41,0,41
45,51,42,101,58,27,31
45,51,42,125,47,0,47
45,51,42,129,66,0,66
45,51,42,133,55,34,21
45,51,44,7,31,0,31
45,51,44,9,28,0,28
45,51,45,3,43,42,1
45,51,45,7,42,89,-47
45,51,45,13,55,65,-10
45,51,45,15,120,164,-44
45,51,45,19,266,344,-78
45,51,45,21,39,31,8
45,51,45,23,0,29,-29
45,51,45,25,58,47,11
45,51,45,27,30,33,-3
45,51,45,31,144,75,69
45,51,45,33,133,96,37
45,51,45,35,116,110,6
45,51,45,41,402,289,113
45,51,45,43,999,1069,-70
45,51,45,45,164,254,-90
45,51,45,47,38,0,38
45,51,45,55,49,49,0
45,51,45,57,60,50,10
45,51,45,59,32,0,32
45,51,45,63,246,265,-19
45,51,45,67,407,391,16
45,51,45,69,55,33,22
45,51,45,73,32,35,-3
45,51,45,75,45,41,4
45,51,45,77,48,49,-1
45,51,45,79,374,357,17
45,51,45,83,106,157,-51
45,51,45,85,128,64,64
45,51,45,89,159,78,81
45,51,45,91,218,219,-1
45,51,47,37,57,40,17
45,51,47,93,37,46,-9
45,51,47,155,32,42,-10
45,51,47,163,0,31,-31
45,51,47,165,34,0,34
45,51,47,179,29,0,29
45,51,48,29,0,56,-56
45,51,48,85,0,30,-30
45,51,48,113,0,52,-52
45,51,48,201,29,42,-13
45,51,51,41,50,0,50
45,51,51,59,196,80,116
45,51,51,61,29,0,29
45,51,51,87,51,33,18
45,51,51,107,40,0,40
45,51,51,143,30,0,30
45,51,51,153,157,55,102
45,51,51,161,32,0,32
45,51,51,177,48,0,48
45,51,51,179,36,0,36
45,51,51,700,36,0,36
45,51,51,770,35,0,35
45,51,51,810,44,47,-3
45,51,54,3,38,0,38
45,51,54,11,42,0,42
45,51,54,39,86,36,50
45,51,54,49,24,0,24
45,51,54,55,29,0,29
45,51,54,61,28,0,28
45,51,54,107,23,0,23
45,53,13,51,185,148,37
45,53,13,103,44,83,-39
45,53,45,13,842,550,292
45,53,45,19,0,30,-30
45,53,45,49,171,120,51
45,53,45,79,0,52,-52
45,55,37,119,48,85,-37
45,55,45,19,65,59,6
45,55,45,25,54,55,-1
45,55,45,31,31,38,-7
45,55,45,35,44,0,44
45,55,45,39,83,95,-12
45,55,45,41,60,49,11
45,55,45,45,34,45,-11
45,55,45,51,49,49,0
45,55,45,57,162,193,-31
45,55,45,61,126,148,-22
45,55,45,63,263,290,-27
45,55,45,75,0,29,-29
45,55,45,79,1107,981,126
45,55,45,83,0,49,-49
45,55,45,85,198,167,31
45,55,45,91,86,50,36
45,57,6,73,35,0,35
45,57,36,103,50,0,50
45,57,37,71,26,34,-8
45,57,37,119,1288,246,1042
45,57,37,179,380,149,231
45,57,45,19,33,44,-11
45,57,45,23,224,280,-56
45,57,45,25,141,147,-6
45,57,45,45,47,73,-26
45,57,45,51,50,60,-10
45,57,45,55,193,162,31
45,57,45,63,31,41,-10
45,57,45,79,125,161,-36
45,57,45,83,0,36,-36
45,57,45,91,1203,676,527
45,59,37,119,0,32,-32
45,59,45,1,45,45,0
45,59,45,7,178,127,51
45,59,45,19,0,37,-37
45,59,45,21,28,38,-10
45,59,45,45,1352,1428,-76
45,59,45,47,309,378,-69
45,59,45,51,0,32,-32
45,59,45,63,83,62,21
45,59,45,71,130,94,36
45,59,45,73,33,0,33
45,59,45,77,71,52,19
45,59,45,79,34,106,-72
45,59,45,83,346,428,-82
45,59,45,87,0,41,-41
45,59,45,91,34,0,34
45,61,45,27,0,39,-39
45,61,45,31,167,153,14
45,61,45,41,121,122,-1
45,61,45,55,148,126,22
45,61,45,63,0,31,-31
45,61,45,79,78,136,-58
45,61,45,85,330,400,-70
45,61,45,91,0,33,-33
45,63,1,51,37,0,37
45,63,1,73,39,41,-2
45,63,1,101,38,0,38
45,63,4,13,40,63,-23
45,63,4,19,35,0,35
45,63,6,37,83,37,46
45,63,6,73,41,0,41
45,63,9,3,32,0,32
45,63,9,9,32,0,32
45,63,11,1,0,25,-25
45,63,12,9,58,0,58
45,63,12,11,141,0,141
45,63,12,31,79,55,24
45,63,12,57,53,36,17
45,63,12,69,37,0,37
45,63,12,71,36,0,36
45,63,12,73,34,0,34
45,63,12,86,101,0,101
45,63,12,95,63,47,16
45,63,12,99,57,0,57
45,63,12,101,46,0,46
45,63,12,103,89,0,89
45,63,12,105,44,38,6
45,63,12,111,36,0,36
45,63,12,117,33,0,33
45,63,12,127,34,0,34
45,63,13,51,35,34,1
45,63,13,67,70,30,40
45,63,13,73,79,38,41
45,63,13,89,44,53,-9
45,63,13,121,74,70,4
45,63,13,135,93,70,23
45,63,13,179,46,0,46
45,63,13,245,143,70,73
45,63,17,31,39,39,0
45,63,18,97,41,0,41
45,63,24,3,56,0,56
45,63,24,5,35,0,35
45,63,24,31,35,0,35
45,63,24,33,49,0,49
45,63,25,17,33,0,33
45,63,26,125,38,0,38
45,63,26,163,41,0,41
45,63,32,3,0,30,-30
45,63,34,23,35,0,35
45,63,36,5,30,0,30
45,63,36,45,58,0,58
45,63,36,47,50,26,24
45,63,36,59,31,0,31
45,63,36,61,30,0,30
45,63,36,103,52,34,18
45,63,37,21,56,52,4
45,63,37,25,35,0,35
45,63,37,51,75,66,9
45,63,37,57,27,0,27
45,63,37,63,0,35,-35
45,63,37,67,0,29,-29
45,63,37,81,66,31,35
45,63,37,97,34,0,34
45,63,37,119,152,327,-175
45,63,37,133,44,57,-13
45,63,37,179,39,0,39
45,63,37,183,80,81,-1
45,63,39,49,38,0,38
45,63,42,3,41,0,41
45,63,42,101,34,0,34
45,63,45,1,0,29,-29
45,63,45,3,560,429,131
45,63,45,5,31,0,31
45,63,45,7,80,102,-22
45,63,45,9,58,37,21
45,63,45,11,70,63,7
45,63,45,13,141,137,4
45,63,45,15,139,164,-25
45,63,45,17,255,205,50
45,63,45,19,367,326,41
45,63,45,25,25,0,25
45,63,45,27,56,0,56
45,63,45,29,45,55,-10
45,63,45,31,55,63,-8
45,63,45,33,25,0,25
45,63,45,35,194,161,33
45,63,45,37,70,0,70
45,63,45,39,87,162,-75
45,63,45,41,173,96,77
45,63,45,43,39,56,-17
45,63,45,45,352,360,-8
45,63,45,47,129,96,33
45,63,45,49,54,38,16
45,63,45,51,265,246,19
45,63,45,55,290,263,27
45,63,45,57,41,31,10
45,63,45,59,62,83,-21
45,63,45,61,31,0,31
45,63,45,71,314,315,-1
45,63,45,73,0,33,-33
45,63,45,75,543,269,274
45,63,45,77,83,79,4
45,63,45,79,7605,6668,937
45,63,45,81,438,290,148
45,63,45,83,143,146,-3
45,63,45,85,224,166,58
45,63,45,89,35,39,-4
45,63,45,91,164,186,-22
45,63,47,37,34,0,34
45,63,47,93,0,52,-52
45,63,47,125,46,0,46
45,63,47,157,50,0,50
45,63,48,27,39,38,1
45,63,48,201,0,47,-47
45,63,51,41,0,37,-37
45,63,51,59,40,32,8
45,63,51,710,40,0,40
45,63,51,810,56,0,56
45,65,13,73,49,50,-1
45,65,13,245,39,0,39
45,65,45,1,33,38,-5
45,65,45,3,31,43,-12
45,65,45,47,147,161,-14
45,67,37,47,45,0,45
45,67,37,119,0,36,-36
45,67,45,19,0,40,-40
45,67,45,31,0,49,-49
45,67,45,33,265,283,-18
45,67,45,41,210,296,-86
45,67,45,51,391,407,-16
45,67,45,79,74,86,-12
45,69,37,81,0,37,-37
45,69,37,119,0,28,-28
45,69,37,153,60,76,-16
45,69,37,155,34,37,-3
45,69,37,165,157,157,0
45,69,45,25,197,235,-38
45,69,45,31,33,82,-49
45,69,45,33,103,97,6
45,69,45,41,43,108,-65
45,69,45,51,33,55,-22
45,69,45,79,45,46,-1
45,71,45,19,34,0,34
45,71,45,39,43,0,43
45,71,45,45,35,60,-25
45,71,45,47,67,75,-8
45,71,45,59,94,130,-36
45,71,45,63,315,314,1
45,71,45,79,284,293,-9
45,71,45,81,103,37,66
45,71,45,83,64,72,-8
45,71,45,85,0,27,-27
45,71,45,87,49,67,-18
45,73,12,9,31,0,31
45,73,12,99,36,0,36
45,73,12,103,34,0,34
45,73,13,67,54,0,54
45,73,13,89,25,0,25
45,73,13,121,46,0,46
45,73,13,135,73,0,73
45,73,13,147,46,0,46
45,73,13,241,35,0,35
45,73,13,257,67,49,18
45,73,37,21,0,24,-24
45,73,37,99,37,0,37
45,73,37,119,46,43,3
45,73,45,7,434,589,-155
45,73,45,19,35,71,-36
45,73,45,45,258,280,-22
45,73,45,47,26,0,26
45,73,45,51,35,32,3
45,73,45,59,0,33,-33
45,73,45,63,33,0,33
45,73,45,77,516,724,-208
45,73,45,79,36,86,-50
45,73,45,83,66,75,-9
45,73,45,91,37,41,-4
45,75,12,31,0,34,-34
45,75,13,89,0,37,-37
45,75,13,121,0,40,-40
45,75,13,245,25,33,-8
45,75,36,5,43,0,43
45,75,36,47,37,0,37
45,75,37,81,0,22,-22
45,75,37,119,65,107,-42
45,75,45,3,110,84,26
45,75,45,9,270,187,83
45,75,45,11,105,83,22
45,75,45,13,46,29,17
45,75,45,15,233,279,-46
45,75,45,17,398,384,14
45,75,45,19,193,195,-2
45,75,45,27,66,84,-18
45,75,45,29,73,46,27
45,75,45,35,269,314,-45
45,75,45,41,44,38,6
45,75,45,43,22,0,22
45,75,45,45,37,86,-49
45,75,45,49,40,0,40
45,75,45,51,41,45,-4
45,75,45,55,29,0,29
45,75,45,63,269,543,-274
45,75,45,79,338,630,-292
45,75,45,83,25,32,-7
45,75,45,85,31,57,-26
45,75,45,89,31,0,31
45,75,45,91,38,63,-25
45,77,6,85,0,24,-24
45,77,12,9,36,0,36
45,77,12,11,55,0,55
45,77,12,31,57,0,57
45,77,12,57,33,0,33
45,77,12,86,45,0,45
45,77,12,95,31,0,31
45,77,12,111,51,0,51
45,77,13,121,36,54,-18
45,77,13,135,36,34,2
45,77,17,31,0,25,-25
45,77,24,31,0,29,-29
45,77,37,21,52,0,52
45,77,37,81,24,0,24
45,77,37,89,38,32,6
45,77,37,119,35,103,-68
45,77,37,175,43,0,43
45,77,37,183,26,51,-25
45,77,45,3,34,0,34
45,77,45,7,1277,1479,-202
45,77,45,13,32,29,3
45,77,45,15,0,32,-32
45,77,45,19,72,121,-49
45,77,45,35,28,0,28
45,77,45,41,33,0,33
45,77,45,45,2340,2250,90
45,77,45,47,76,37,39
45,77,45,51,49,48,1
45,77,45,59,52,71,-19
45,77,45,63,79,83,-4
45,77,45,73,724,516,208
45,77,45,79,82,91,-9
45,77,45,83,218,226,-8
45,77,45,91,66,77,-11
45,77,47,93,0,34,-34
45,77,51,59,0,21,-21
45,79,1,1,47,0,47
45,79,1,51,83,0,83
45,79,1,73,52,83,-31
45,79,1,81,44,0,44
45,79,1,89,44,39,5
45,79,1,101,129,0,129
45,79,2,20,33,56,-23
45,79,2,90,73,37,36
45,79,4,3,55,0,55
45,79,4,13,94,125,-31
45,79,5,119,0,29,-29
45,79,6,1,0,53,-53
45,79,6,37,96,96,0
45,79,6,53,36,0,36
45,79,6,59,0,33,-33
45,79,6,65,33,0,33
45,79,6,71,96,78,18
45,79,6,73,64,56,8
45,79,6,85,30,0,30
45,79,8,5,0,38,-38
45,79,8,41,213,127,86
45,79,9,1,71,22,49
45,79,9,3,57,0,57
45,79,9,9,35,34,1
45,79,9,11,34,0,34
45,79,10,3,58,0,58
45,79,11,1,64,107,-43
45,79,12,1,51,0,51
45,79,12,9,46,37,9
45,79,12,11,183,108,75
45,79,12,31,148,162,-14
45,79,12,33,0,30,-30
45,79,12,57,112,114,-2
45,79,12,71,57,0,57
45,79,12,73,48,51,-3
45,79,12,81,28,0,28
45,79,12,86,196,72,124
45,79,12,91,49,0,49
45,79,12,95,117,83,34
45,79,12,97,31,0,31
45,79,12,99,134,57,77
45,79,12,101,0,39,-39
45,79,12,103,47,69,-22
45,79,12,105,27,0,27
45,79,12,117,46,42,4
45,79,12,127,36,39,-3
45,79,13,21,42,27,15
45,79,13,31,0,37,-37
45,79,13,51,130,75,55
45,79,13,59,42,23,19
45,79,13,63,58,45,13
45,79,13,67,105,144,-39
45,79,13,73,87,45,42
45,79,13,89,156,206,-50
45,79,13,121,133,284,-151
45,79,13,135,124,128,-4
45,79,13,151,0,59,-59
45,79,13,153,36,0,36
45,79,13,179,148,48,100
45,79,13,215,140,78,62
45,79,13,245,224,174,50
45,79,15,3,179,152,27
45,79,17,31,90,101,-11
45,79,17,43,30,37,-7
45,79,18,97,27,0,27
45,79,20,61,37,112,-75
45,79,20,161,0,68,-68
45,79,21,47,155,54,101
45,79,21,67,27,0,27
45,79,21,93,32,57,-25
45,79,21,111,38,43,-5
45,79,22,33,0,34,-34
45,79,22,71,0,29,-29
45,79,22,115,136,0,136
45,79,24,3,94,77,17
45,79,24,5,45,46,-1
45,79,24,21,0,33,-33
45,79,24,25,38,45,-7
45,79,24,27,48,0,48
45,79,24,31,80,84,-4
45,79,24,33,149,59,90
45,79,24,510,48,28,20
45,79,25,17,43,29,14
45,79,25,25,0,28,-28
45,79,25,27,63,0,63
45,79,26,99,33,0,33
45,79,26,125,47,45,2
45,79,26,163,92,32,60
45,79,29,19,28,0,28
45,79,29,169,52,43,9
45,79,29,189,43,35,8
45,79,32,3,47,74,-27
45,79,34,3,26,0,26
45,79,34,5,32,0,32
45,79,34,13,43,44,-1
45,79,34,17,0,27,-27
45,79,34,23,33,0,33
45,79,34,25,42,0,42
45,79,34,31,37,0,37
45,79,35,1,35,0,35
45,79,35,9,29,0,29
45,79,36,5,110,0,110
45,79,36,29,62,28,34
45,79,36,45,305,93,212
45,79,36,47,125,83,42
45,79,36,55,43,0,43
45,79,36,59,68,0,68
45,79,36,61,109,72,37
45,79,36,71,43,0,43
45,79,36,81,107,64,43
45,79,36,87,38,0,38
45,79,36,103,53,0,53
45,79,36,119,62,0,62
45,79,37,21,50,78,-28
45,79,37,25,32,50,-18
45,79,37,51,392,335,57
45,79,37,63,60,70,-10
45,79,37,67,60,74,-14
45,79,37,71,39,50,-11
45,79,37,81,102,119,-17
45,79,37,85,0,49,-49
45,79,37,89,24,0,24
45,79,37,93,0,38,-38
45,79,37,97,44,31,13
45,79,37,119,512,796,-284
45,79,37,129,62,38,24
45,79,37,133,80,33,47
45,79,37,135,0,35,-35
45,79,37,147,36,0,36
45,79,37,159,0,38,-38
45,79,37,179,43,74,-31
45,79,37,183,141,232,-91
45,79,39,35,59,0,59
45,79,39,49,77,0,77
45,79,39,61,44,35,9
45,79,39,95,27,0,27
45,79,39,113,44,0,44
45,79,39,151,28,0,28
45,79,40,31,108,67,41
45,79,41,67,0,31,-31
45,79,42,3,67,68,-1
45,79,42,29,29,0,29
45,79,42,41,34,0,34
45,79,42,91,33,0,33
45,79,42,101,73,50,23
45,79,45,3,395,252,143
45,79,45,5,62,0,62
45,79,45,7,136,135,1
45,79,45,9,105,59,46
45,79,45,11,67,34,33
45,79,45,13,244,249,-5
45,79,45,15,232,265,-33
45,79,45,17,198,122,76
45,79,45,19,606,886,-280
45,79,45,21,37,0,37
45,79,45,23,65,37,28
45,79,45,25,48,45,3
45,79,45,27,134,103,31
45,79,45,29,90,49,41
45,79,45,31,159,117,42
45,79,45,33,49,41,8
45,79,45,35,186,199,-13
45,79,45,37,47,0,47
45,79,45,39,569,522,47
45,79,45,41,432,243,189
45,79,45,43,146,134,12
45,79,45,45,590,628,-38
45,79,45,47,126,112,14
45,79,45,49,49,29,20
45,79,45,51,357,374,-17
45,79,45,53,52,0,52
45,79,45,55,981,1107,-126
45,79,45,57,161,125,36
45,79,45,59,106,34,72
45,79,45,61,136,78,58
45,79,45,63,6668,7605,-937
45,79,45,67,86,74,12
45,79,45,69,46,45,1
45,79,45,71,293,284,9
45,79,45,73,86,36,50
45,79,45,75,630,338,292
45,79,45,77,91,82,9
45,79,45,81,69,0,69
45,79,45,83,352,282,70
45,79,45,85,863,541,322
45,79,45,87,37,34,3
45,79,45,89,139,60,79
45,79,45,91,343,422,-79
45,79,47,37,45,88,-43
45,79,47,65,34,0,34
45,79,47,93,44,59,-15
45,79,47,125,221,139,82
45,79,47,157,55,48,7
45,79,48,27,434,328,106
45,79,48,29,87,180,-93
45,79,48,85,0,61,-61
45,79,48,99,86,94,-8
45,79,48,113,71,46,25
45,79,48,141,130,119,11
45,79,48,201,108,97,11
45,79,48,439,49,40,9
45,79,48,453,44,46,-2
45,79,51,13,38,20,18
45,79,51,41,45,41,4
45,79,51,59,138,135,3
45,79,51,107,0,47,-47
45,79,51,153,68,80,-12
45,79,51,179,37,0,37
45,79,51,510,24,0,24
45,79,51,550,55,0,55
45,79,51,650,50,68,-18
45,79,51,700,92,69,23
45,79,51,710,43,38,5
45,79,51,760,22,0,22
45,79,51,810,55,44,11
45,79,53,33,55,28,27
45,79,53,53,109,137,-28
45,79,55,79,32,0,32
45,81,45,3,102,125,-23
45,81,45,37,64,73,-9
45,81,45,47,96,107,-11
45,81,45,63,290,438,-148
45,81,45,71,37,103,-66
45,81,45,79,0,69,-69
45,83,4,13,56,0,56
45,83,6,37,54,42,12
45,83,6,67,68,0,68
45,83,6,73,43,0,43
45,83,9,1,52,0,52
45,83,9,9,35,0,35
45,83,12,9,41,0,41
45,83,12,11,120,23,97
45,83,12,31,98,62,36
45,83,12,57,92,39,53
45,83,12,69,41,0,41
45,83,12,71,44,0,44
45,83,12,81,40,0,40
45,83,12,83,42,0,42
45,83,12,86,102,0,102
45,83,12,95,73,58,15
45,83,12,99,133,0,133
45,83,12,103,76,0,76
45,83,12,105,47,0,47
45,83,12,117,69,0,69
45,83,12,127,51,0,51
45,83,13,51,29,35,-6
45,83,13,63,41,0,41
45,83,13,67,55,40,15
45,83,13,73,0,35,-35
45,83,13,89,45,62,-17
45,83,13,121,48,55,-7
45,83,13,135,80,81,-1
45,83,17,31,46,36,10
45,83,25,27,48,0,48
45,83,26,81,39,0,39
45,83,26,125,42,0,42
45,83,26,163,42,0,42
45,83,32,3,42,0,42
45,83,34,23,65,0,65
45,83,34,29,28,0,28
45,83,34,31,39,0,39
45,83,36,47,42,0,42
45,83,36,55,37,0,37
45,83,36,61,76,28,48
45,83,36,103,46,0,46
45,83,37,19,0,29,-29
45,83,37,21,156,73,83
45,83,37,25,0,37,-37
45,83,37,35,40,0,40
45,83,37,45,94,90,4
45,83,37,51,33,0,33
45,83,37,63,35,0,35
45,83,37,67,40,56,-16
45,83,37,71,80,67,13
45,83,37,81,50,129,-79
45,83,37,89,137,78,59
45,83,37,119,223,250,-27
45,83,37,133,35,50,-15
45,83,37,149,273,180,93
45,83,37,161,235,188,47
45,83,37,175,40,0,40
45,83,37,183,37,75,-38
45,83,39,35,40,0,40
45,83,39,49,0,32,-32
45,83,39,85,28,0,28
45,83,42,49,38,0,38
45,83,42,101,42,0,42
45,83,44,7,73,0,73
45,83,45,3,60,35,25
45,83,45,7,317,248,69
45,83,45,13,71,51,20
45,83,45,15,67,103,-36
45,83,45,19,160,310,-150
45,83,45,21,960,975,-15
45,83,45,25,35,0,35
45,83,45,35,79,39,40
45,83,45,41,44,45,-1
45,83,45,43,36,32,4
45,83,45,45,3863,3507,356
45,83,45,47,111,82,29
45,83,45,51,157,106,51
45,83,45,55,49,0,49
45,83,45,57,36,0,36
45,83,45,59,428,346,82
45,83,45,63,146,143,3
45,83,45,71,72,64,8
45,83,45,73,75,66,9
45,83,45,75,32,25,7
45,83,45,77,226,218,8
45,83,45,79,282,352,-70
45,83,45,85,47,29,18
45,83,45,87,452,400,52
45,83,45,91,197,173,24
45,83,47,37,0,34,-34
45,83,47,65,50,0,50
45,83,47,93,36,44,-8
45,83,48,27,0,28,-28
45,83,48,201,0,46,-46
45,83,48,439,46,0,46
45,83,51,810,29,0,29
45,83,53,61,36,0,36
45,85,1,101,50,0,50
45,85,2,20,47,50,-3
45,85,2,90,54,0,54
45,85,4,13,87,68,19
45,85,6,37,0,44,-44
45,85,8,41,40,69,-29
45,85,12,11,33,0,33
45,85,12,57,34,53,-19
45,85,12,91,33,48,-15
45,85,12,113,0,33,-33
45,85,13,51,0,35,-35
45,85,13,89,41,36,5
45,85,13,121,0,37,-37
45,85,13,135,0,28,-28
45,85,13,153,30,82,-52
45,85,13,245,43,0,43
45,85,15,3,30,38,-8
45,85,16,39,41,0,41
45,85,17,31,0,28,-28
45,85,22,15,0,42,-42
45,85,24,33,39,35,4
45,85,28,47,31,0,31
45,85,32,3,36,45,-9
45,85,35,9,200,0,200
45,85,36,47,37,0,37
45,85,37,51,66,66,0
45,85,37,119,107,113,-6
45,85,37,183,0,46,-46
45,85,37,191,0,34,-34
45,85,45,3,0,33,-33
45,85,45,7,0,29,-29
45,85,45,13,24,31,-7
45,85,45,15,35,59,-24
45,85,45,19,88,137,-49
45,85,45,27,500,434,66
45,85,45,31,65,68,-3
45,85,45,35,41,99,-58
45,85,45,41,156,169,-13
45,85,45,43,27,0,27
45,85,45,45,45,107,-62
45,85,45,51,64,128,-64
45,85,45,55,167,198,-31
45,85,45,61,400,330,70
45,85,45,63,166,224,-58
45,85,45,71,27,0,27
45,85,45,75,57,31,26
45,85,45,79,541,863,-322
45,85,45,83,29,47,-18
45,85,45,89,54,33,21
45,85,45,91,45,80,-35
45,85,47,125,34,0,34
45,85,48,29,66,84,-18
45,85,48,201,40,0,40
45,85,48,485,38,0,38
45,85,51,59,39,43,-4
45,87,45,21,71,55,16
45,87,45,23,40,37,3
45,87,45,45,0,89,-89
45,87,45,59,41,0,41
45,87,45,71,67,49,18
45,87,45,79,34,37,-3
45,87,45,83,400,452,-52
45,87,45,91,38,31,7
45,89,37,119,0,37,-37
45,89,45,15,0,66,-66
45,89,45,19,29,0,29
45,89,45,27,66,81,-15
45,89,45,41,376,530,-154
45,89,45,43,114,150,-36
45,89,45,51,78,159,-81
45,89,45,63,39,35,4
45,89,45,75,0,31,-31
45,89,45,79,60,139,-79
45,89,45,85,33,54,-21
45,91,4,13,98,44,54
45,91,6,37,90,33,57
45,91,6,59,58,0,58
45,91,6,71,40,0,40
45,91,6,73,63,36,27
45,91,9,1,41,0,41
45,91,9,3,41,0,41
45,91,12,9,32,0,32
45,91,12,11,288,36,252
45,91,12,19,37,0,37
45,91,12,31,76,32,44
45,91,12,57,92,56,36
45,91,12,71,37,0,37
45,91,12,81,45,0,45
45,91,12,86,100,25,75
45,91,12,95,127,50,77
45,91,12,97,41,0,41
45,91,12,99,192,36,156
45,91,12,101,38,0,38
45,91,12,103,75,0,75
45,91,12,115,60,0,60
45,91,12,117,49,0,49
45,91,12,127,63,0,63
45,91,13,51,0,29,-29
45,91,13,67,50,0,50
45,91,13,89,37,31,6
45,91,13,121,54,45,9
45,91,13,135,33,50,-17
45,91,13,245,0,33,-33
45,91,17,31,57,57,0
45,91,18,57,62,0,62
45,91,18,97,35,0,35
45,91,24,3,46,0,46
45,91,24,27,29,0,29
45,91,24,31,65,0,65
45,91,24,33,56,0,56
45,91,25,13,35,0,35
45,91,25,17,39,0,39
45,91,26,99,37,0,37
45,91,26,125,72,0,72
45,91,26,163,44,0,44
45,91,32,3,37,0,37
45,91,34,3,65,0,65
45,91,34,7,44,0,44
45,91,34,13,53,0,53
45,91,34,23,51,0,51
45,91,34,25,54,0,54
45,91,34,27,36,0,36
45,91,34,29,57,0,57
45,91,34,35,47,0,47
45,91,36,5,37,0,37
45,91,36,27,40,0,40
45,91,36,29,56,0,56
45,91,36,47,47,37,10
45,91,36,55,60,0,60
45,91,36,59,126,0,126
45,91,36,67,60,0,60
45,91,36,71,29,0,29
45,91,36,81,101,0,101
45,91,36,103,189,0,189
45,91,36,119,45,0,45
45,91,37,19,60,0,60
45,91,37,21,53,57,-4
45,91,37,25,226,99,127
45,91,37,35,49,0,49
45,91,37,45,94,131,-37
45,91,37,51,33,25,8
45,91,37,63,38,0,38
45,91,37,67,92,69,23
45,91,37,71,733,588,145
45,91,37,81,108,55,53
45,91,37,89,31,0,31
45,91,37,97,85,52,33
45,91,37,109,56,58,-2
45,91,37,119,5812,2393,3419
45,91,37,129,56,50,6
45,91,37,133,38,0,38
45,91,37,159,0,76,-76
45,91,37,179,494,252,242
45,91,37,183,90,118,-28
45,91,39,35,30,0,30
45,91,39,49,55,31,24
45,91,39,61,28,0,28
45,91,39,153,29,0,29
45,91,42,3,75,0,75
45,91,42,17,37,0,37
45,91,42,29,40,0,40
45,91,42,91,32,0,32
45,91,42,129,35,0,35
45,91,42,133,38,0,38
45,91,45,3,59,54,5
45,91,45,7,65,54,11
45,91,45,13,87,77,10
45,91,45,15,104,52,52
45,91,45,19,205,243,-38
45,91,45,21,108,172,-64
45,91,45,23,836,830,6
45,91,45,25,47,63,-16
45,91,45,31,34,0,34
45,91,45,35,75,64,11
45,91,45,39,48,49,-1
45,91,45,41,73,58,15
45,91,45,45,289,237,52
45,91,45,47,49,27,22
45,91,45,51,219,218,1
45,91,45,55,50,86,-36
45,91,45,57,676,1203,-527
45,91,45,59,0,34,-34
45,91,45,61,33,0,33
45,91,45,63,186,164,22
45,91,45,73,41,37,4
45,91,45,75,63,38,25
45,91,45,77,77,66,11
45,91,45,79,422,343,79
45,91,45,83,173,197,-24
45,91,45,85,80,45,35
45,91,45,87,31,38,-7
45,91,47,93,35,43,-8
45,91,47,157,64,0,64
45,91,48,29,37,0,37
45,91,48,85,0,56,-56
45,91,48,113,0,190,-190
45,91,48,121,33,0,33
45,91,48,201,51,0,51
45,91,48,439,44,37,7
45,91,50,7,46,0,46
45,91,51,41,0,32,-32
45,91,51,59,74,41,33
45,91,51,87,49,0,49
45,91,51,107,39,0,39
45,91,51,153,48,0,48
45,91,51,700,29,0,29
45,91,51,710,34,0,34
45,91,51,810,47,0,47
45,91,53,53,44,0,44
46,3,46,35,54,35,19
46,3,46,99,0,27,-27
46,5,27,123,81,0,81
46,5,46,11,29,44,-15
46,5,46,13,0,28,-28
46,5,46,29,59,0,59
46,5,46,35,86,58,28
46,5,46,73,66,0,66
46,5,46,77,40,44,-4
46,5,46,83,0,36,-36
46,5,46,99,105,141,-36
46,5,46,103,0,51,-51
46,7,46,103,25,47,-22
46,7,46,113,40,0,40
46,9,46,99,71,70,1
46,9,46,135,52,126,-74
46,11,27,53,33,43,-10
46,11,27,81,30,57,-27
46,11,27,83,32,0,32
46,11,27,117,28,0,28
46,11,27,127,31,0,31
46,11,31,109,28,0,28
46,11,38,17,28,35,-7
46,11,46,5,44,29,15
46,11,46,13,54,40,14
46,11,46,27,27,27,0
46,11,46,29,109,87,22
46,11,46,35,35,27,8
46,11,46,39,76,0,76
46,11,46,57,49,60,-11
46,11,46,65,48,23,25
46,11,46,77,103,75,28
46,11,46,79,87,49,38
46,11,46,81,0,23,-23
46,11,46,83,50,121,-71
46,11,46,99,279,619,-340
46,11,46,101,81,49,32
46,11,46,103,78,62,16
46,11,46,109,29,0,29
46,11,46,135,33,0,33
46,13,27,53,33,52,-19
46,13,27,123,0,20,-20
46,13,38,15,0,31,-31
46,13,38,17,33,69,-36
46,13,38,21,22,47,-25
46,13,46,5,28,0,28
46,13,46,11,40,54,-14
46,13,46,29,96,87,9
46,13,46,35,31,37,-6
46,13,46,37,77,31,46
46,13,46,45,110,113,-3
46,13,46,49,27,0,27
46,13,46,65,50,30,20
46,13,46,83,0,40,-40
46,13,46,89,51,0,51
46,13,46,91,48,26,22
46,13,46,99,150,275,-125
46,13,46,103,47,74,-27
46,13,46,115,116,93,23
46,13,46,129,38,0,38
46,15,46,17,0,35,-35
46,15,46,35,28,41,-13
46,15,46,85,74,0,74
46,15,46,99,33,52,-19
46,15,46,103,0,38,-38
46,17,46,15,35,0,35
46,19,46,81,342,261,81
46,19,46,93,105,86,19
46,19,46,103,109,95,14
46,19,56,5,33,54,-21
46,23,46,35,33,51,-18
46,23,46,99,68,97,-29
46,23,46,135,0,31,-31
46,25,46,29,41,61,-20
46,27,19,149,24,0,24
46,27,19,193,50,60,-10
46,27,31,55,0,37,-37
46,27,46,11,27,27,0
46,27,46,65,26,0,26
46,27,46,83,55,68,-13
46,27,46,99,171,288,-117
46,27,46,103,45,64,-19
46,27,46,125,29,0,29
46,27,46,127,95,57,38
46,27,46,135,108,117,-9
46,29,27,53,28,49,-21
46,29,38,17,0,25,-25
46,29,46,5,0,59,-59
46,29,46,11,87,109,-22
46,29,46,13,87,96,-9
46,29,46,25,61,41,20
46,29,46,35,27,0,27
46,29,46,37,58,81,-23
46,29,46,39,59,82,-23
46,29,46,51,118,59,59
46,29,46,57,127,114,13
46,29,46,77,40,25,15
46,29,46,83,0,42,-42
46,29,46,99,164,305,-141
46,29,46,103,53,54,-1
46,29,46,109,88,64,24
46,31,38,15,0,57,-57
46,31,46,129,44,54,-10
46,33,46,47,64,60,4
46,33,46,99,35,0,35
46,33,46,103,183,214,-31
46,35,46,3,35,54,-19
46,35,46,5,58,86,-28
46,35,46,11,27,35,-8
46,35,46,13,37,31,6
46,35,46,15,41,28,13
46,35,46,23,51,33,18
46,35,46,29,0,27,-27
46,35,46,43,41,0,41
46,35,46,61,74,57,17
46,35,46,65,35,32,3
46,35,46,67,66,31,35
46,35,46,81,0,30,-30
46,35,46,83,37,69,-32
46,35,46,99,162,290,-128
46,35,46,103,0,77,-77
46,35,46,111,43,57,-14
46,35,46,135,36,31,5
46,37,46,13,31,77,-46
46,37,46,29,81,58,23
46,37,46,99,0,48,-48
46,37,46,109,0,40,-40
46,39,46,11,0,76,-76
46,39,46,29,82,59,23
46,39,46,99,26,29,-3
46,41,46,65,0,42,-42
46,41,46,103,67,82,-15
46,41,46,129,0,30,-30
46,41,46,137,38,0,38
46,43,46,35,0,41,-41
46,45,46,13,113,110,3
46,47,46,33,60,64,-4
46,47,46,93,0,30,-30
46,47,46,103,115,150,-35
46,49,46,13,0,27,-27
46,51,27,11,41,0,41
46,51,46,29,59,118,-59
46,51,46,99,32,47,-15
46,51,46,109,57,40,17
46,53,46,99,31,48,-17
46,57,46,11,60,49,11
46,57,46,29,114,127,-13
46,57,46,99,30,26,4
46,61,46,35,57,74,-17
46,61,46,99,0,29,-29
46,65,46,11,23,48,-25
46,65,46,13,30,50,-20
46,65,46,27,0,26,-26
46,65,46,35,32,35,-3
46,65,46,41,42,0,42
46,65,46,81,0,40,-40
46,65,46,83,0,35,-35
46,65,46,85,40,0,40
46,65,46,99,115,142,-27
46,65,46,103,93,179,-86
46,65,46,117,198,194,4
46,65,46,119,39,0,39
46,67,46,35,31,66,-35
46,67,46,99,79,77,2
46,67,46,135,0,32,-32
46,71,46,103,36,87,-51
46,73,46,111,28,0,28
46,77,46,5,44,40,4
46,77,46,11,75,103,-28
46,77,46,29,25,40,-15
46,77,46,99,32,65,-33
46,79,27,53,0,22,-22
46,79,46,11,49,87,-38
46,79,46,83,0,49,-49
46,79,46,97,30,0,30
46,79,46,99,167,296,-129
46,79,46,101,29,32,-3
46,79,48,373,30,0,30
46,81,4,13,42,0,42
46,81,8,69,0,33,-33
46,81,46,11,23,0,23
46,81,46,19,261,342,-81
46,81,46,35,30,0,30
46,81,46,65,40,0,40
46,81,46,83,0,33,-33
46,81,46,93,256,302,-46
46,81,46,99,30,59,-29
46,81,46,103,317,358,-41
46,81,56,5,88,111,-23
46,81,56,11,49,35,14
46,81,56,33,0,28,-28
46,81,56,45,34,0,34
46,83,4,13,33,0,33
46,83,19,119,50,0,50
46,83,19,167,54,37,17
46,83,19,193,50,0,50
46,83,27,53,35,44,-9
46,83,31,55,34,41,-7
46,83,32,3,31,0,31
46,83,46,5,36,0,36
46,83,46,11,121,50,71
46,83,46,13,40,0,40
46,83,46,27,68,55,13
46,83,46,29,42,0,42
46,83,46,35,69,37,32
46,83,46,65,35,0,35
46,83,46,79,49,0,49
46,83,46,81,33,0,33
46,83,46,87,60,37,23
46,83,46,99,3211,2375,836
46,83,46,103,46,40,6
46,83,46,125,128,80,48
46,83,46,127,98,34,64
46,83,46,135,52,0,52
46,85,46,15,0,74,-74
46,85,46,65,0,40,-40
46,87,46,83,37,60,-23
46,87,46,99,136,210,-74
46,89,46,13,0,51,-51
46,91,46,13,26,48,-22
46,91,46,109,36,39,-3
46,93,4,13,37,0,37
46,93,8,41,49,33,16
46,93,32,3,0,44,-44
46,93,35,9,49,0,49
46,93,46,19,86,105,-19
46,93,46,47,30,0,30
46,93,46,81,302,256,46
46,93,46,99,52,72,-20
46,93,46,103,1425,1713,-288
46,93,48,29,28,0,28
46,93,48,485,22,0,22
46,93,56,5,36,76,-40
46,99,4,13,164,199,-35
46,99,4,19,41,56,-15
46,99,4,21,31,47,-16
46,99,6,37,106,77,29
46,99,6,59,54,33,21
46,99,6,65,29,34,-5
46,99,6,73,79,53,26
46,99,8,5,33,56,-23
46,99,8,31,44,32,12
46,99,8,41,31,38,-7
46,99,8,59,31,0,31
46,99,8,123,0,26,-26
46,99,12,31,24,0,24
46,99,12,95,0,22,-22
46,99,12,103,0,40,-40
46,99,17,31,58,69,-11
46,99,19,21,34,0,34
46,99,19,41,30,0,30
46,99,19,59,40,0,40
46,99,19,119,140,95,45
46,99,19,141,63,0,63
46,99,19,149,47,33,14
46,99,19,153,113,95,18
46,99,19,167,166,64,102
46,99,19,169,0,29,-29
46,99,19,193,201,134,67
46,99,20,91,63,54,9
46,99,20,173,38,34,4
46,99,27,3,52,0,52
46,99,27,13,50,52,-2
46,99,27,27,45,0,45
46,99,27,33,33,0,33
46,99,27,37,69,80,-11
46,99,27,53,243,295,-52
46,99,27,63,21,0,21
46,99,27,83,90,56,34
46,99,27,91,42,0,42
46,99,27,101,39,0,39
46,99,27,105,176,194,-18
46,99,27,109,37,41,-4
46,99,27,117,107,95,12
46,99,27,123,120,110,10
46,99,27,133,176,119,57
46,99,27,139,40,0,40
46,99,27,145,39,35,4
46,99,27,163,32,0,32
46,99,27,171,36,0,36
46,99,29,95,0,60,-60
46,99,29,189,40,0,40
46,99,30,111,30,0,30
46,99,31,43,35,0,35
46,99,31,55,146,225,-79
46,99,31,109,111,79,32
46,99,31,119,28,0,28
46,99,31,153,61,59,2
46,99,32,3,70,102,-32
46,99,38,15,0,45,-45
46,99,38,17,103,103,0
46,99,38,35,56,0,56
46,99,39,49,0,34,-34
46,99,39,61,32,0,32
46,99,41,51,0,24,-24
46,99,46,3,27,0,27
46,99,46,5,141,105,36
46,99,46,9,70,71,-1
46,99,46,11,619,279,340
46,99,46,13,275,150,125
46,99,46,15,52,33,19
46,99,46,23,97,68,29
46,99,46,27,288,171,117
46,99,46,29,305,164,141
46,99,46,33,0,35,-35
46,99,46,35,290,162,128
46,99,46,37,48,0,48
46,99,46,39,29,26,3
46,99,46,51,47,32,15
46,99,46,53,48,31,17
46,99,46,57,26,30,-4
46,99,46,61,29,0,29
46,99,46,65,142,115,27
46,99,46,67,77,79,-2
46,99,46,77,65,32,33
46,99,46,79,296,167,129
46,99,46,81,59,30,29
46,99,46,83,2375,3211,-836
46,99,46,87,210,136,74
46,99,46,93,72,52,20
46,99,46,97,53,0,53
46,99,46,101,189,99,90
46,99,46,103,287,345,-58
46,99,46,109,36,34,2
46,99,46,115,46,0,46
46,99,46,121,48,0,48
46,99,46,123,36,0,36
46,99,46,125,210,200,10
46,99,46,127,145,127,18
46,99,46,135,238,138,100
46,99,47,37,0,30,-30
46,99,47,157,33,0,33
46,99,48,29,32,38,-6
46,99,48,113,33,40,-7
46,99,48,121,0,26,-26
46,99,48,201,0,38,-38
46,99,48,215,0,36,-36
46,99,48,373,45,0,45
46,99,48,439,0,57,-57
46,99,48,453,33,0,33
46,99,49,35,0,28,-28
46,99,53,33,49,44,5
46,99,55,25,0,41,-41
46,99,56,25,26,0,26
46,101,46,11,49,81,-32
46,101,46,79,32,29,3
46,101,46,99,99,189,-90
46,103,2,20,46,37,9
46,103,2,90,49,0,49
46,103,4,13,152,143,9
46,103,4,19,33,34,-1
46,103,6,37,46,29,17
46,103,6,59,35,0,35
46,103,6,71,30,0,30
46,103,6,73,61,31,30
46,103,6,77,32,0,32
46,103,8,1,46,32,14
46,103,8,5,59,32,27
46,103,8,13,27,0,27
46,103,8,31,52,55,-3
46,103,8,41,89,68,21
46,103,8,59,36,37,-1
46,103,8,69,49,77,-28
46,103,8,123,0,32,-32
46,103,15,3,34,0,34
46,103,16,1,0,37,-37
46,103,16,39,39,0,39
46,103,20,91,0,28,-28
46,103,27,53,35,69,-34
46,103,27,123,0,21,-21
46,103,30,31,0,37,-37
46,103,30,111,35,0,35
46,103,31,13,48,0,48
46,103,31,19,30,0,30
46,103,31,45,67,0,67
46,103,31,55,58,53,5
46,103,31,109,0,41,-41
46,103,31,153,0,38,-38
46,103,31,157,41,28,13
46,103,31,161,0,26,-26
46,103,32,3,107,47,60
46,103,38,15,51,32,19
46,103,46,5,51,0,51
46,103,46,7,47,25,22
46,103,46,11,62,78,-16
46,103,46,13,74,47,27
46,103,46,15,38,0,38
46,103,46,19,95,109,-14
46,103,46,27,64,45,19
46,103,46,29,54,53,1
46,103,46,33,214,183,31
46,103,46,35,77,0,77
46,103,46,41,82,67,15
46,103,46,47,150,115,35
46,103,46,65,179,93,86
46,103,46,71,87,36,51
46,103,46,81,358,317,41
46,103,46,83,40,46,-6
46,103,46,93,1713,1425,288
46,103,46,99,345,287,58
46,103,46,113,282,168,114
46,103,46,121,110,43,67
46,103,46,129,0,37,-37
46,103,46,135,43,27,16
46,103,48,29,0,65,-65
46,103,48,373,28,0,28
46,103,48,441,61,60,1
46,103,49,35,29,0,29
46,103,53,33,41,40,1
46,103,53,53,38,0,38
46,103,53,61,0,23,-23
46,103,56,1,30,0,30
46,103,56,5,140,176,-36
46,103,56,11,0,41,-41
46,103,56,21,33,72,-39
46,103,56,25,75,97,-22
46,103,56,33,32,31,1
46,103,56,37,33,0,33
46,103,56,45,0,32,-32
46,109,27,155,43,26,17
46,109,38,17,0,46,-46
46,109,38,77,0,28,-28
46,109,46,11,0,29,-29
46,109,46,29,64,88,-24
46,109,46,37,40,0,40
46,109,46,51,40,57,-17
46,109,46,91,39,36,3
46,109,46,99,34,36,-2
46,111,46,35,57,43,14
46,111,46,73,0,28,-28
46,113,31,161,0,47,-47
46,113,46,7,0,40,-40
46,113,46,103,168,282,-114
46,115,46,13,93,116,-23
46,115,46,99,0,46,-46
46,117,46,65,194,198,-4
46,119,46,65,0,39,-39
46,121,31,31,0,64,-64
46,121,46,99,0,48,-48
46,121,46,103,43,110,-67
46,121,46,123,0,33,-33
46,123,46,99,0,36,-36
46,123,46,121,33,0,33
46,125,46,27,0,29,-29
46,125,46,83,80,128,-48
46,125,46,99,200,210,-10
46,127,19,149,38,56,-18
46,127,19,193,518,325,193
46,127,31,43,89,25,64
46,127,31,55,31,55,-24
46,127,46,27,57,95,-38
46,127,46,83,34,98,-64
46,127,46,99,127,145,-18
46,127,46,135,0,29,-29
46,129,46,13,0,38,-38
46,129,46,31,54,44,10
46,129,46,41,30,0,30
46,129,46,103,37,0,37
46,135,4,13,0,28,-28
46,135,31,27,80,37,43
46,135,31,107,85,35,50
46,135,46,9,126,52,74
46,135,46,11,0,33,-33
46,135,46,23,31,0,31
46,135,46,27,117,108,9
46,135,46,35,31,36,-5
46,135,46,67,32,0,32
46,135,46,83,0,52,-52
46,135,46,99,138,238,-100
46,135,46,103,27,43,-16
46,135,46,127,29,0,29
47,1,12,103,38,0,38
47,1,17,43,0,40,-40
47,1,47,9,136,128,8
47,1,47,13,430,314,116
47,1,47,37,55,60,-5
47,1,47,63,0,29,-29
47,1,47,65,39,54,-15
47,1,47,89,52,42,10
47,1,47,93,2024,1932,92
47,1,47,105,54,81,-27
47,1,47,107,29,0,29
47,1,47,123,0,37,-37
47,1,47,129,192,216,-24
47,1,47,141,32,0,32
47,1,47,145,374,433,-59
47,1,47,149,33,46,-13
47,1,47,151,0,45,-45
47,1,47,155,67,85,-18
47,1,47,163,32,0,32
47,1,47,173,87,71,16
47,1,47,179,40,25,15
47,3,1,89,0,27,-27
47,3,4,13,0,40,-40
47,3,39,49,33,46,-13
47,3,47,31,300,334,-34
47,3,47,37,189,178,11
47,3,47,51,106,102,4
47,3,47,103,74,101,-27
47,3,47,117,170,153,17
47,3,47,119,53,44,9
47,3,47,127,72,44,28
47,3,47,149,939,662,277
47,3,47,177,0,36,-36
47,3,47,187,61,32,29
47,3,47,189,0,37,-37
47,5,47,17,103,135,-32
47,5,47,37,0,37,-37
47,5,47,39,38,28,10
47,5,47,53,40,0,40
47,5,47,79,104,155,-51
47,5,47,85,77,67,10
47,5,47,113,0,36,-36
47,5,47,183,29,31,-2
47,7,47,35,73,75,-2
47,7,47,65,192,177,15
47,7,47,143,128,86,42
47,7,47,153,72,64,8
47,9,4,13,0,30,-30
47,9,6,37,45,0,45
47,9,12,11,82,0,82
47,9,12,15,40,0,40
47,9,12,31,35,0,35
47,9,12,57,25,0,25
47,9,12,69,40,0,40
47,9,12,71,54,0,54
47,9,12,81,51,0,51
47,9,12,95,79,0,79
47,9,12,99,55,0,55
47,9,12,101,42,0,42
47,9,12,103,77,0,77
47,9,12,105,60,0,60
47,9,12,115,43,0,43
47,9,12,127,50,0,50
47,9,13,121,27,32,-5
47,9,17,31,30,0,30
47,9,26,163,38,0,38
47,9,47,1,128,136,-8
47,9,47,11,25,40,-15
47,9,47,37,53,98,-45
47,9,47,59,38,0,38
47,9,47,63,0,50,-50
47,9,47,65,67,59,8
47,9,47,89,85,86,-1
47,9,47,93,2224,2128,96
47,9,47,105,392,337,55
47,9,47,107,54,88,-34
47,9,47,123,242,230,12
47,9,47,145,110,129,-19
47,9,47,149,38,44,-6
47,9,47,155,360,374,-14
47,9,47,157,56,31,25
47,9,47,163,0,47,-47
47,9,47,173,28,0,28
47,9,47,179,59,79,-20
47,9,47,189,0,33,-33
47,9,48,201,0,34,-34
47,11,12,9,27,0,27
47,11,12,11,39,0,39
47,11,12,71,65,29,36
47,11,12,99,56,0,56
47,11,12,101,44,0,44
47,11,12,103,25,0,25
47,11,12,105,69,0,69
47,11,13,47,103,95,8
47,11,13,67,38,36,2
47,11,13,129,0,40,-40
47,11,13,135,0,55,-55
47,11,13,213,53,53,0
47,11,13,295,44,44,0
47,11,13,313,107,116,-9
47,11,26,163,40,0,40
47,11,47,9,40,25,15
47,11,47,37,36,65,-29
47,11,47,65,1067,1110,-43
47,11,47,93,92,126,-34
47,11,47,107,492,477,15
47,11,47,121,208,203,5
47,11,47,123,24,87,-63
47,11,47,125,0,34,-34
47,11,47,139,539,487,52
47,11,47,141,39,0,39
47,11,47,143,61,66,-5
47,11,47,149,45,54,-9
47,11,47,155,28,25,3
47,11,47,157,30,0,30
47,13,21,235,102,146,-44
47,13,26,163,33,0,33
47,13,39,113,54,0,54
47,13,47,1,314,430,-116
47,13,47,25,111,82,29
47,13,47,93,198,255,-57
47,13,47,151,70,80,-10
47,15,47,31,68,45,23
47,15,47,37,59,0,59
47,15,47,41,47,88,-41
47,15,47,149,587,373,214
47,15,47,177,87,86,1
47,15,47,189,38,37,1
47,17,47,5,135,103,32
47,17,47,23,25,0,25
47,17,47,33,35,0,35
47,17,47,37,50,62,-12
47,17,47,53,260,377,-117
47,17,47,77,121,214,-93
47,17,47,79,130,198,-68
47,17,47,113,300,324,-24
47,17,47,157,64,79,-15
47,17,47,183,122,201,-79
47,19,37,11,88,58,30
47,19,37,189,29,0,29
47,19,47,59,54,0,54
47,19,47,73,36,55,-19
47,19,47,91,100,49,51
47,19,47,93,73,62,11
47,19,47,163,429,444,-15
47,19,47,171,156,173,-17
47,19,47,179,1182,1409,-227
47,21,47,37,1407,1084,323
47,21,47,43,223,264,-41
47,21,47,81,0,24,-24
47,21,47,125,252,302,-50
47,21,47,147,203,297,-94
47,21,47,149,132,147,-15
47,21,47,165,116,151,-35
47,21,47,187,110,106,4
47,21,47,189,86,53,33
47,23,47,17,0,25,-25
47,23,47,53,29,43,-14
47,23,47,69,67,32,35
47,23,47,71,40,0,40
47,23,47,77,113,102,11
47,23,47,109,138,111,27
47,23,47,113,337,342,-5
47,23,47,157,56,62,-6
47,25,21,13,369,372,-3
47,25,21,95,46,0,46
47,25,21,235,0,29,-29
47,25,47,13,82,111,-29
47,25,47,57,43,80,-37
47,25,47,67,29,0,29
47,25,47,93,138,153,-15
47,25,47,173,69,84,-15
47,25,51,105,85,67,18
47,27,21,171,27,33,-6
47,27,47,111,60,58,2
47,27,47,133,43,46,-3
47,27,47,141,0,58,-58
47,29,47,57,28,0,28
47,29,47,59,72,127,-55
47,29,47,63,155,182,-27
47,29,47,89,291,296,-5
47,29,47,93,94,78,16
47,29,47,155,323,266,57
47,31,1,89,0,73,-73
47,31,12,103,34,0,34
47,31,47,3,334,300,34
47,31,47,15,45,68,-23
47,31,47,37,133,149,-16
47,31,47,51,572,595,-23
47,31,47,61,65,74,-9
47,31,47,65,54,85,-31
47,31,47,93,0,36,-36
47,31,47,103,37,67,-30
47,31,47,117,0,44,-44
47,31,47,119,37,0,37
47,31,47,127,112,135,-23
47,31,47,141,26,30,-4
47,31,47,149,531,467,64
47,31,47,165,29,30,-1
47,31,47,177,166,177,-11
47,33,47,17,0,35,-35
47,33,47,45,102,96,6
47,33,47,53,154,206,-52
47,33,47,75,93,70,23
47,33,47,97,68,0,68
47,33,47,113,244,253,-9
47,33,47,157,46,34,12
47,35,12,9,29,0,29
47,35,12,11,26,0,26
47,35,12,69,30,0,30
47,35,12,71,44,0,44
47,35,12,95,32,0,32
47,35,12,99,43,0,43
47,35,12,101,41,0,41
47,35,12,103,31,0,31
47,35,12,115,39,0,39
47,35,26,163,37,0,37
47,35,47,7,75,73,2
47,35,47,37,75,92,-17
47,35,47,49,128,114,14
47,35,47,65,59,62,-3
47,35,47,93,133,121,12
47,35,47,105,40,0,40
47,35,47,129,50,41,9
47,35,47,133,0,32,-32
47,35,47,141,200,180,20
47,35,47,143,71,53,18
47,35,47,145,111,101,10
47,35,47,149,37,38,-1
47,35,47,155,0,22,-22
47,35,47,185,63,118,-55
47,35,47,187,30,0,30
47,37,1,3,59,66,-7
47,37,1,15,31,0,31
47,37,1,33,0,33,-33
47,37,1,55,25,0,25
47,37,1,69,23,0,23
47,37,1,73,349,251,98
47,37,1,77,86,65,21
47,37,1,81,41,34,7
47,37,1,83,55,40,15
47,37,1,89,255,271,-16
47,37,1,97,112,80,32
47,37,1,101,85,82,3
47,37,1,103,45,39,6
47,37,1,117,123,72,51
47,37,1,125,72,51,21
47,37,4,13,273,289,-16
47,37,4,19,38,74,-36
47,37,5,7,29,39,-10
47,37,5,31,53,0,53
47,37,5,35,28,0,28
47,37,5,119,101,83,18
47,37,5,143,51,30,21
47,37,5,145,37,0,37
47,37,6,1,65,61,4
47,37,6,13,25,32,-7
47,37,6,19,38,0,38
47,37,6,37,642,379,263
47,37,6,59,114,144,-30
47,37,6,65,74,68,6
47,37,6,67,67,48,19
47,37,6,71,117,41,76
47,37,6,73,206,303,-97
47,37,6,75,79,75,4
47,37,6,77,29,0,29
47,37,6,81,35,50,-15
47,37,6,85,74,89,-15
47,37,6,111,0,31,-31
47,37,8,5,58,52,6
47,37,8,13,0,29,-29
47,37,8,31,56,119,-63
47,37,8,35,38,0,38
47,37,8,41,63,37,26
47,37,8,59,28,43,-15
47,37,8,69,22,0,22
47,37,9,1,55,0,55
47,37,9,3,51,27,24
47,37,9,9,57,36,21
47,37,9,11,25,0,25
47,37,10,3,57,0,57
47,37,11,1,123,111,12
47,37,12,1,46,33,13
47,37,12,5,66,0,66
47,37,12,9,54,52,2
47,37,12,11,310,127,183
47,37,12,21,55,39,16
47,37,12,31,109,141,-32
47,37,12,33,66,59,7
47,37,12,57,228,178,50
47,37,12,69,43,0,43
47,37,12,71,152,43,109
47,37,12,73,82,44,38
47,37,12,81,49,27,22
47,37,12,83,52,24,28
47,37,12,86,190,146,44
47,37,12,91,86,35,51
47,37,12,95,241,209,32
47,37,12,97,37,0,37
47,37,12,99,179,98,81
47,37,12,101,62,40,22
47,37,12,103,197,123,74
47,37,12,105,57,64,-7
47,37,12,109,36,0,36
47,37,12,113,0,30,-30
47,37,12,115,80,35,45
47,37,12,117,85,67,18
47,37,12,127,74,44,30
47,37,12,131,0,37,-37
47,37,13,51,73,47,26
47,37,13,57,47,35,12
47,37,13,59,70,22,48
47,37,13,63,39,55,-16
47,37,13,67,227,222,5
47,37,13,89,308,292,16
47,37,13,117,54,38,16
47,37,13,121,309,367,-58
47,37,13,135,205,166,39
47,37,13,139,0,31,-31
47,37,13,151,32,31,1
47,37,13,215,30,27,3
47,37,13,245,34,36,-2
47,37,15,3,71,55,16
47,37,17,19,57,39,18
47,37,17,31,569,481,88
47,37,17,43,92,59,33
47,37,17,77,26,0,26
47,37,17,89,42,42,0
47,37,17,91,30,0,30
47,37,17,97,43,39,4
47,37,17,111,34,0,34
47,37,17,115,33,0,33
47,37,17,119,26,0,26
47,37,17,143,44,34,10
47,37,17,163,26,0,26
47,37,17,167,45,0,45
47,37,17,197,62,47,15
47,37,17,201,32,33,-1
47,37,18,3,83,37,46
47,37,18,35,31,0,31
47,37,18,39,33,0,33
47,37,18,57,24,66,-42
47,37,18,89,50,38,12
47,37,18,97,201,203,-2
47,37,18,105,58,0,58
47,37,18,127,34,0,34
47,37,18,141,48,39,9
47,37,18,157,36,0,36
47,37,18,163,125,48,77
47,37,18,173,26,0,26
47,37,19,103,0,40,-40
47,37,19,153,25,0,25
47,37,20,91,68,63,5
47,37,20,161,29,0,29
47,37,20,173,36,48,-12
47,37,21,9,27,0,27
47,37,21,35,56,40,16
47,37,21,47,162,78,84
47,37,21,59,45,45,0
47,37,21,67,163,98,65
47,37,21,83,48,0,48
47,37,21,93,46,30,16
47,37,21,111,348,341,7
47,37,21,117,30,31,-1
47,37,21,141,23,43,-20
47,37,21,145,116,72,44
47,37,21,151,27,0,27
47,37,21,213,49,42,7
47,37,21,227,308,178,130
47,37,22,17,0,24,-24
47,37,22,33,55,59,-4
47,37,22,51,57,61,-4
47,37,22,71,41,111,-70
47,37,22,103,32,54,-22
47,37,23,1,0,32,-32
47,37,23,5,45,33,12
47,37,24,3,36,49,-13
47,37,24,5,43,52,-9
47,37,24,27,30,24,6
47,37,24,31,68,110,-42
47,37,24,33,57,60,-3
47,37,24,510,66,50,16
47,37,25,9,35,24,11
47,37,25,13,0,26,-26
47,37,25,17,112,97,15
47,37,25,21,60,39,21
47,37,25,25,79,77,2
47,37,25,27,31,0,31
47,37,26,49,119,43,76
47,37,26,65,74,39,35
47,37,26,75,30,0,30
47,37,26,77,36,0,36
47,37,26,81,88,61,27
47,37,26,93,33,0,33
47,37,26,99,100,0,100
47,37,26,125,235,77,158
47,37,26,145,36,0,36
47,37,26,161,71,27,44
47,37,26,163,329,126,203
47,37,27,3,27,0,27
47,37,27,37,38,0,38
47,37,27,53,134,138,-4
47,37,27,123,29,56,-27
47,37,28,3,24,0,24
47,37,28,33,68,80,-12
47,37,28,35,27,0,27
47,37,28,47,27,34,-7
47,37,28,49,128,56,72
47,37,28,59,0,30,-30
47,37,28,71,60,0,60
47,37,28,75,36,0,36
47,37,28,81,44,39,5
47,37,28,87,0,24,-24
47,37,28,89,38,35,3
47,37,28,105,30,0,30
47,37,28,121,52,22,30
47,37,28,151,39,0,39
47,37,29,19,25,0,25
47,37,29,31,30,0,30
47,37,29,77,30,0,30
47,37,29,95,53,38,15
47,37,29,183,37,32,5
47,37,29,189,217,165,52
47,37,29,213,30,0,30
47,37,29,510,99,72,27
47,37,31,55,40,28,12
47,37,31,109,34,34,0
47,37,32,3,224,151,73
47,37,32,31,26,0,26
47,37,33,11,40,0,40
47,37,34,3,37,34,3
47,37,34,17,85,34,51
47,37,34,25,26,0,26
47,37,34,27,45,0,45
47,37,34,31,42,0,42
47,37,35,1,44,56,-12
47,37,36,1,0,25,-25
47,37,36,5,62,0,62
47,37,36,27,23,0,23
47,37,36,29,70,35,35
47,37,36,47,140,140,0
47,37,36,55,48,0,48
47,37,36,59,40,35,5
47,37,36,61,210,208,2
47,37,36,67,36,0,36
47,37,36,81,103,88,15
47,37,36,103,41,34,7
47,37,37,21,38,58,-20
47,37,37,25,0,29,-29
47,37,37,51,42,32,10
47,37,37,63,67,37,30
47,37,37,67,68,43,25
47,37,37,81,74,43,31
47,37,37,89,23,0,23
47,37,37,119,175,173,2
47,37,37,129,0,39,-39
47,37,37,133,36,36,0
47,37,37,135,47,28,19
47,37,37,147,32,0,32
47,37,37,183,131,91,40
47,37,39,17,49,35,14
47,37,39,25,26,0,26
47,37,39,35,154,122,32
47,37,39,49,204,185,19
47,37,39,61,167,118,49
47,37,39,95,69,28,41
47,37,39,103,31,0,31
47,37,39,113,115,54,61
47,37,39,151,48,0,48
47,37,39,153,45,31,14
47,37,39,165,28,0,28
47,37,40,27,0,33,-33
47,37,40,109,81,77,4
47,37,40,143,81,60,21
47,37,41,5,30,0,30
47,37,41,51,46,51,-5
47,37,41,67,0,32,-32
47,37,42,3,100,93,7
47,37,42,27,25,0,25
47,37,42,29,35,0,35
47,37,42,49,22,0,22
47,37,42,71,0,41,-41
47,37,42,91,51,31,20
47,37,42,101,86,57,29
47,37,42,133,21,0,21
47,37,45,7,24,0,24
47,37,45,13,35,40,-5
47,37,45,15,32,0,32
47,37,45,19,108,68,40
47,37,45,45,76,55,21
47,37,45,51,40,57,-17
47,37,45,63,0,34,-34
47,37,45,79,88,45,43
47,37,45,83,34,0,34
47,37,46,99,30,0,30
47,37,47,1,60,55,5
47,37,47,3,178,189,-11
47,37,47,5,37,0,37
47,37,47,9,98,53,45
47,37,47,11,65,36,29
47,37,47,15,0,59,-59
47,37,47,17,62,50,12
47,37,47,21,1084,1407,-323
47,37,47,31,149,133,16
47,37,47,35,92,75,17
47,37,47,39,23,29,-6
47,37,47,41,74,103,-29
47,37,47,43,558,756,-198
47,37,47,45,70,35,35
47,37,47,47,39,0,39
47,37,47,51,76,91,-15
47,37,47,53,87,53,34
47,37,47,55,64,85,-21
47,37,47,59,22,0,22
47,37,47,63,0,26,-26
47,37,47,65,519,387,132
47,37,47,69,33,37,-4
47,37,47,71,32,29,3
47,37,47,73,24,0,24
47,37,47,75,36,0,36
47,37,47,77,39,37,2
47,37,47,79,82,38,44
47,37,47,81,169,217,-48
47,37,47,85,106,56,50
47,37,47,87,0,29,-29
47,37,47,93,740,573,167
47,37,47,97,46,0,46
47,37,47,99,72,64,8
47,37,47,101,33,0,33
47,37,47,103,48,39,9
47,37,47,105,47,0,47
47,37,47,107,30,23,7
47,37,47,109,33,0,33
47,37,47,111,49,87,-38
47,37,47,113,381,212,169
47,37,47,115,27,0,27
47,37,47,117,126,178,-52
47,37,47,119,543,815,-272
47,37,47,125,944,712,232
47,37,47,131,54,0,54
47,37,47,133,37,0,37
47,37,47,141,296,206,90
47,37,47,145,32,43,-11
47,37,47,147,1180,1897,-717
47,37,47,149,5132,8146,-3014
47,37,47,155,42,49,-7
47,37,47,157,1385,910,475
47,37,47,159,79,110,-31
47,37,47,161,27,31,-4
47,37,47,163,84,40,44
47,37,47,165,3167,4235,-1068
47,37,47,167,32,42,-10
47,37,47,169,0,62,-62
47,37,47,177,80,57,23
47,37,47,179,117,67,50
47,37,47,183,48,53,-5
47,37,47,185,55,38,17
47,37,47,187,3959,5569,-1610
47,37,47,189,2201,4338,-2137
47,37,48,27,0,49,-49
47,37,48,29,137,84,53
47,37,48,85,80,99,-19
47,37,48,113,276,294,-18
47,37,48,121,80,71,9
47,37,48,141,55,50,5
47,37,48,157,37,56,-19
47,37,48,201,372,401,-29
47,37,48,215,44,44,0
47,37,48,303,26,0,26
47,37,48,339,0,48,-48
47,37,48,439,213,227,-14
47,37,48,453,158,147,11
47,37,48,491,50,46,4
47,37,49,35,59,61,-2
47,37,51,13,49,56,-7
47,37,51,59,136,109,27
47,37,51,87,51,44,7
47,37,51,107,28,44,-16
47,37,51,153,44,55,-11
47,37,51,510,0,34,-34
47,37,51,700,42,0,42
47,37,51,810,85,45,40
47,37,53,33,134,231,-97
47,37,53,53,49,62,-13
47,37,53,61,51,0,51
47,37,54,39,33,0,33
47,37,55,25,68,39,29
47,37,55,79,185,94,91
47,39,47,5,28,38,-10
47,39,47,37,29,23,6
47,39,47,77,247,201,46
47,39,47,113,31,48,-17
47,39,47,135,53,43,10
47,39,47,157,43,0,43
47,41,47,15,88,47,41
47,41,47,37,103,74,29
47,41,47,141,88,130,-42
47,41,47,149,141,84,57
47,41,47,159,75,97,-22
47,41,47,177,206,187,19
47,41,47,185,68,67,1
47,41,47,189,148,124,24
47,43,47,21,264,223,41
47,43,47,37,756,558,198
47,43,47,81,412,376,36
47,43,47,83,50,47,3
47,43,47,85,243,293,-50
47,43,47,119,48,54,-6
47,43,47,125,213,182,31
47,43,47,147,32,41,-9
47,43,47,149,141,89,52
47,43,47,157,33,0,33
47,43,47,165,37,63,-26
47,43,47,187,182,159,23
47,43,47,189,57,59,-2
47,45,29,155,71,65,6
47,45,47,33,96,102,-6
47,45,47,37,35,70,-35
47,45,47,53,131,184,-53
47,45,47,79,0,43,-43
47,45,47,95,179,116,63
47,45,47,97,281,211,70
47,45,47,113,79,117,-38
47,45,47,131,196,200,-4
47,45,47,157,85,114,-29
47,45,47,167,0,37,-37
47,45,47,183,63,44,19
47,47,28,33,104,125,-21
47,47,28,93,56,53,3
47,47,47,37,0,39,-39
47,47,47,69,163,211,-48
47,47,47,75,61,40,21
47,47,47,113,0,54,-54
47,47,47,157,2746,1341,1405
47,47,47,167,110,151,-41
47,49,47,35,114,128,-14
47,49,47,93,28,0,28
47,49,47,129,51,39,12
47,49,47,137,0,25,-25
47,49,47,141,72,73,-1
47,51,1,71,28,38,-10
47,51,1,89,33,90,-57
47,51,47,3,102,106,-4
47,51,47,31,595,572,23
47,51,47,37,91,76,15
47,51,47,61,67,84,-17
47,51,47,65,44,52,-8
47,51,47,93,30,24,6
47,51,47,103,132,118,14
47,51,47,115,0,44,-44
47,51,47,127,56,90,-34
47,51,47,149,125,119,6
47,51,47,177,0,63,-63
47,53,17,31,30,0,30
47,53,47,5,0,40,-40
47,53,47,17,377,260,117
47,53,47,23,43,29,14
47,53,47,33,206,154,52
47,53,47,37,53,87,-34
47,53,47,45,184,131,53
47,53,47,75,47,32,15
47,53,47,77,94,32,62
47,53,47,79,53,31,22
47,53,47,113,1042,695,347
47,53,47,131,139,129,10
47,53,47,149,48,72,-24
47,53,47,157,146,113,33
47,53,47,183,181,150,31
47,55,1,83,245,243,2
47,55,1,89,136,155,-19
47,55,47,37,85,64,21
47,55,47,99,211,183,28
47,55,47,103,74,73,1
47,55,47,117,118,118,0
47,55,47,119,208,245,-37
47,55,47,149,44,50,-6
47,55,47,187,32,0,32
47,57,47,25,80,43,37
47,57,47,29,0,28,-28
47,57,47,59,36,0,36
47,57,47,63,349,324,25
47,57,47,73,92,127,-35
47,57,47,89,188,166,22
47,57,47,93,321,319,2
47,57,47,155,40,55,-15
47,57,47,173,107,91,16
47,59,12,9,36,0,36
47,59,12,57,49,0,49
47,59,12,71,40,0,40
47,59,12,95,38,0,38
47,59,37,21,44,0,44
47,59,47,9,0,38,-38
47,59,47,19,0,54,-54
47,59,47,29,127,72,55
47,59,47,37,0,22,-22
47,59,47,57,0,36,-36
47,59,47,63,229,197,32
47,59,47,73,179,173,6
47,59,47,89,58,63,-5
47,59,47,93,84,114,-30
47,59,47,155,32,39,-7
47,59,47,163,149,175,-26
47,59,47,171,39,27,12
47,59,47,179,454,592,-138
47,61,47,31,74,65,9
47,61,47,51,84,67,17
47,61,47,65,28,0,28
47,61,47,115,105,119,-14
47,61,47,149,33,0,33
47,61,47,153,37,0,37
47,61,47,177,0,50,-50
47,63,47,1,29,0,29
47,63,47,9,50,0,50
47,63,47,29,182,155,27
47,63,47,37,26,0,26
47,63,47,57,324,349,-25
47,63,47,59,197,229,-32
47,63,47,65,0,39,-39
47,63,47,67,73,0,73
47,63,47,73,337,356,-19
47,63,47,89,728,840,-112
47,63,47,93,230,366,-136
47,63,47,155,136,115,21
47,63,47,163,55,51,4
47,63,47,179,81,82,-1
47,65,1,15,31,0,31
47,65,1,49,90,80,10
47,65,1,71,106,136,-30
47,65,1,73,116,108,8
47,65,1,83,0,35,-35
47,65,1,89,87,149,-62
47,65,1,97,40,0,40
47,65,1,101,47,0,47
47,65,1,117,49,43,6
47,65,1,125,25,0,25
47,65,4,13,62,53,9
47,65,5,119,52,0,52
47,65,6,37,99,54,45
47,65,6,71,47,41,6
47,65,6,73,62,50,12
47,65,8,41,32,0,32
47,65,10,3,0,37,-37
47,65,11,1,0,33,-33
47,65,12,5,0,22,-22
47,65,12,9,65,0,65
47,65,12,11,156,36,120
47,65,12,21,27,0,27
47,65,12,31,137,89,48
47,65,12,33,48,52,-4
47,65,12,57,139,68,71
47,65,12,69,38,0,38
47,65,12,71,66,0,66
47,65,12,81,39,0,39
47,65,12,83,28,0,28
47,65,12,86,74,0,74
47,65,12,91,33,31,2
47,65,12,95,172,59,113
47,65,12,99,102,63,39
47,65,12,101,55,0,55
47,65,12,103,62,42,20
47,65,12,105,66,29,37
47,65,12,111,46,0,46
47,65,12,115,30,0,30
47,65,12,117,57,54,3
47,65,12,127,74,37,37
47,65,13,15,41,69,-28
47,65,13,21,46,0,46
47,65,13,45,35,0,35
47,65,13,47,1618,1971,-353
47,65,13,51,0,32,-32
47,65,13,57,63,49,14
47,65,13,59,43,0,43
47,65,13,63,33,43,-10
47,65,13,67,186,220,-34
47,65,13,83,320,315,5
47,65,13,89,165,100,65
47,65,13,97,0,26,-26
47,65,13,115,51,0,51
47,65,13,117,42,33,9
47,65,13,121,156,289,-133
47,65,13,129,48,45,3
47,65,13,135,104,134,-30
47,65,13,139,0,38,-38
47,65,13,185,27,0,27
47,65,13,213,44,39,5
47,65,13,223,0,58,-58
47,65,13,245,35,0,35
47,65,13,295,1211,1338,-127
47,65,13,313,284,234,50
47,65,17,31,85,104,-19
47,65,17,43,21,0,21
47,65,17,89,23,0,23
47,65,18,97,0,31,-31
47,65,20,91,0,34,-34
47,65,20,173,36,32,4
47,65,21,67,30,0,30
47,65,21,111,35,48,-13
47,65,21,227,0,24,-24
47,65,22,71,0,38,-38
47,65,24,31,29,0,29
47,65,26,21,32,0,32
47,65,26,81,33,0,33
47,65,26,99,39,0,39
47,65,26,125,59,0,59
47,65,26,163,86,0,86
47,65,27,53,0,31,-31
47,65,32,3,46,30,16
47,65,36,27,30,0,30
47,65,36,61,0,24,-24
47,65,37,21,73,26,47
47,65,37,51,0,45,-45
47,65,37,81,0,53,-53
47,65,37,119,77,108,-31
47,65,37,129,0,28,-28
47,65,37,133,27,0,27
47,65,37,183,67,45,22
47,65,39,35,28,0,28
47,65,39,61,44,0,44
47,65,42,3,33,0,33
47,65,42,101,27,0,27
47,65,45,13,34,0,34
47,65,45,19,27,43,-16
47,65,45,45,23,53,-30
47,65,45,79,0,34,-34
47,65,45,83,0,50,-50
47,65,47,1,54,39,15
47,65,47,7,177,192,-15
47,65,47,9,59,67,-8
47,65,47,11,1110,1067,43
47,65,47,31,85,54,31
47,65,47,35,62,59,3
47,65,47,37,387,519,-132
47,65,47,51,52,44,8
47,65,47,61,0,28,-28
47,65,47,63,39,0,39
47,65,47,93,466,508,-42
47,65,47,105,31,38,-7
47,65,47,107,156,97,59
47,65,47,113,41,0,41
47,65,47,115,471,420,51
47,65,47,119,44,0,44
47,65,47,121,78,134,-56
47,65,47,123,33,0,33
47,65,47,125,91,45,46
47,65,47,139,97,61,36
47,65,47,141,65,56,9
47,65,47,143,438,459,-21
47,65,47,145,36,36,0
47,65,47,149,195,240,-45
47,65,47,153,273,330,-57
47,65,47,155,34,45,-11
47,65,47,157,283,227,56
47,65,47,163,35,50,-15
47,65,47,165,57,75,-18
47,65,47,177,47,25,22
47,65,47,179,75,71,4
47,65,47,185,0,33,-33
47,65,47,187,91,117,-26
47,65,47,189,54,49,5
47,65,48,113,36,38,-2
47,65,48,201,78,90,-12
47,65,48,439,50,33,17
47,65,48,453,24,0,24
47,65,51,59,31,0,31
47,65,51,710,35,0,35
47,65,51,810,37,0,37
47,65,53,33,0,30,-30
47,65,53,53,0,31,-31
47,67,47,25,0,29,-29
47,67,47,63,0,73,-73
47,67,47,73,47,43,4
47,69,28,9,51,40,11
47,69,28,33,0,30,-30
47,69,28,139,28,36,-8
47,69,47,23,32,67,-35
47,69,47,37,37,33,4
47,69,47,47,211,163,48
47,69,47,71,0,35,-35
47,69,47,75,32,43,-11
47,69,47,109,40,72,-32
47,69,47,113,160,297,-137
47,69,47,157,299,188,111
47,71,1,77,0,39,-39
47,71,28,3,0,61,-61
47,71,28,33,0,30,-30
47,71,28,141,0,30,-30
47,71,47,23,0,40,-40
47,71,47,37,29,32,-3
47,71,47,69,35,0,35
47,71,47,77,51,57,-6
47,71,47,109,316,389,-73
47,71,47,113,34,31,3
47,71,47,149,31,0,31
47,71,47,157,127,37,90
47,71,47,181,82,41,41
47,73,12,57,29,0,29
47,73,47,19,55,36,19
47,73,47,37,0,24,-24
47,73,47,57,127,92,35
47,73,47,59,173,179,-6
47,73,47,63,356,337,19
47,73,47,67,43,47,-4
47,73,47,89,97,75,22
47,73,47,93,31,95,-64
47,73,47,163,1132,1090,42
47,73,47,179,133,206,-73
47,73,51,105,32,0,32
47,73,51,169,129,101,28
47,73,51,195,0,33,-33
47,75,47,33,70,93,-23
47,75,47,37,0,36,-36
47,75,47,47,40,61,-21
47,75,47,53,32,47,-15
47,75,47,69,43,32,11
47,75,47,97,87,105,-18
47,75,47,113,200,292,-92
47,75,47,157,187,171,16
47,75,47,167,99,106,-7
47,77,47,17,214,121,93
47,77,47,23,102,113,-11
47,77,47,37,37,39,-2
47,77,47,39,201,247,-46
47,77,47,53,32,94,-62
47,77,47,71,57,51,6
47,77,47,109,48,32,16
47,77,47,113,299,229,70
47,77,47,157,56,43,13
47,79,21,35,100,118,-18
47,79,47,5,155,104,51
47,79,47,17,198,130,68
47,79,47,37,38,82,-44
47,79,47,45,43,0,43
47,79,47,53,31,53,-22
47,79,47,113,29,49,-20
47,79,47,125,29,48,-19
47,79,47,131,28,0,28
47,79,47,149,34,30,4
47,79,47,157,74,34,40
47,79,47,161,35,0,35
47,79,47,183,108,112,-4
47,81,47,21,24,0,24
47,81,47,37,217,169,48
47,81,47,43,376,412,-36
47,81,47,85,49,71,-22
47,81,47,101,44,55,-11
47,81,47,119,139,86,53
47,81,47,135,31,36,-5
47,81,47,149,57,58,-1
47,81,47,187,208,149,59
47,83,47,43,47,50,-3
47,83,47,85,43,48,-5
47,83,47,125,149,92,57
47,83,47,161,91,99,-8
47,85,47,5,67,77,-10
47,85,47,37,56,106,-50
47,85,47,43,293,243,50
47,85,47,81,71,49,22
47,85,47,83,48,43,5
47,85,47,125,37,26,11
47,85,47,149,0,32,-32
47,87,47,37,29,0,29
47,87,47,111,43,38,5
47,87,47,133,77,92,-15
47,87,47,141,362,358,4
47,87,47,159,42,32,10
47,87,47,185,33,0,33
47,87,47,189,29,0,29
47,89,12,71,37,0,37
47,89,12,127,26,0,26
47,89,21,195,34,0,34
47,89,47,1,42,52,-10
47,89,47,9,86,85,1
47,89,47,29,296,291,5
47,89,47,57,166,188,-22
47,89,47,59,63,58,5
47,89,47,63,840,728,112
47,89,47,73,75,97,-22
47,89,47,93,749,855,-106
47,89,47,145,31,0,31
47,89,47,155,905,708,197
47,89,47,163,45,0,45
47,89,47,173,0,46,-46
47,89,47,179,49,60,-11
47,91,37,9,36,0,36
47,91,37,189,104,103,1
47,91,47,19,49,100,-51
47,91,47,163,35,37,-2
47,91,47,179,72,65,7
47,91,51,191,45,35,10
47,93,1,3,0,36,-36
47,93,1,73,63,100,-37
47,93,1,89,59,72,-13
47,93,1,97,29,31,-2
47,93,1,101,0,30,-30
47,93,1,117,56,33,23
47,93,1,125,25,0,25
47,93,4,13,145,117,28
47,93,4,19,38,40,-2
47,93,5,119,0,42,-42
47,93,5,143,30,0,30
47,93,6,1,0,34,-34
47,93,6,13,0,26,-26
47,93,6,37,172,137,35
47,93,6,59,58,55,3
47,93,6,65,38,0,38
47,93,6,67,23,0,23
47,93,6,71,60,0,60
47,93,6,73,149,85,64
47,93,6,85,37,43,-6
47,93,6,111,26,0,26
47,93,8,5,0,24,-24
47,93,8,41,0,31,-31
47,93,8,59,33,0,33
47,93,9,3,0,33,-33
47,93,11,1,39,38,1
47,93,12,1,82,33,49
47,93,12,5,53,42,11
47,93,12,9,101,59,42
47,93,12,11,289,86,203
47,93,12,17,29,0,29
47,93,12,21,38,0,38
47,93,12,31,92,96,-4
47,93,12,33,51,24,27
47,93,12,57,179,127,52
47,93,12,61,26,0,26
47,93,12,69,49,0,49
47,93,12,71,172,78,94
47,93,12,73,31,36,-5
47,93,12,81,52,0,52
47,93,12,83,49,0,49
47,93,12,86,90,65,25
47,93,12,91,38,0,38
47,93,12,95,127,77,50
47,93,12,97,67,0,67
47,93,12,99,126,57,69
47,93,12,101,87,0,87
47,93,12,103,146,97,49
47,93,12,105,69,37,32
47,93,12,109,0,35,-35
47,93,12,111,42,0,42
47,93,12,113,40,30,10
47,93,12,115,80,0,80
47,93,12,117,87,30,57
47,93,12,127,77,30,47
47,93,13,47,0,30,-30
47,93,13,51,50,75,-25
47,93,13,57,82,0,82
47,93,13,59,23,0,23
47,93,13,63,34,31,3
47,93,13,67,130,144,-14
47,93,13,89,121,130,-9
47,93,13,97,0,29,-29
47,93,13,117,0,37,-37
47,93,13,121,134,175,-41
47,93,13,135,123,130,-7
47,93,13,139,0,45,-45
47,93,13,245,0,26,-26
47,93,13,313,39,0,39
47,93,15,3,38,0,38
47,93,17,31,118,116,2
47,93,17,43,27,53,-26
47,93,17,89,25,0,25
47,93,17,201,35,0,35
47,93,18,3,58,0,58
47,93,18,57,29,0,29
47,93,18,97,50,44,6
47,93,18,141,39,0,39
47,93,18,157,0,26,-26
47,93,20,91,30,0,30
47,93,21,13,33,0,33
47,93,21,67,93,77,16
47,93,21,93,29,0,29
47,93,21,111,88,73,15
47,93,21,125,0,34,-34
47,93,21,199,31,0,31
47,93,21,227,24,0,24
47,93,21,235,35,24,11
47,93,22,33,0,40,-40
47,93,22,51,66,27,39
47,93,22,71,0,62,-62
47,93,22,103,37,0,37
47,93,24,3,0,33,-33
47,93,24,5,29,0,29
47,93,24,21,60,0,60
47,93,24,31,42,40,2
47,93,25,17,0,41,-41
47,93,25,25,28,22,6
47,93,26,65,43,0,43
47,93,26,75,28,0,28
47,93,26,81,57,0,57
47,93,26,99,49,0,49
47,93,26,125,115,37,78
47,93,26,161,63,0,63
47,93,26,163,170,66,104
47,93,28,33,0,26,-26
47,93,28,47,39,0,39
47,93,29,189,27,59,-32
47,93,32,3,111,87,24
47,93,33,11,38,0,38
47,93,35,1,56,0,56
47,93,36,47,45,45,0
47,93,36,55,32,0,32
47,93,36,61,32,56,-24
47,93,36,81,31,0,31
47,93,36,103,45,0,45
47,93,37,21,116,90,26
47,93,37,35,0,31,-31
47,93,37,51,31,0,31
47,93,37,63,52,27,25
47,93,37,67,44,54,-10
47,93,37,81,50,51,-1
47,93,37,97,0,31,-31
47,93,37,119,168,180,-12
47,93,37,129,47,0,47
47,93,37,133,52,43,9
47,93,37,179,0,31,-31
47,93,37,183,71,123,-52
47,93,39,17,55,43,12
47,93,39,35,62,41,21
47,93,39,49,82,79,3
47,93,39,57,0,32,-32
47,93,39,61,71,59,12
47,93,39,113,50,55,-5
47,93,39,153,39,0,39
47,93,40,109,33,32,1
47,93,42,3,58,25,33
47,93,45,3,64,45,19
47,93,45,13,38,0,38
47,93,45,19,69,68,1
47,93,45,45,55,103,-48
47,93,45,51,46,37,9
47,93,45,63,52,0,52
47,93,45,77,34,0,34
47,93,45,79,59,44,15
47,93,45,83,44,36,8
47,93,45,91,43,35,8
47,93,47,1,1932,2024,-92
47,93,47,9,2128,2224,-96
47,93,47,11,126,92,34
47,93,47,13,255,198,57
47,93,47,19,62,73,-11
47,93,47,25,153,138,15
47,93,47,29,78,94,-16
47,93,47,31,36,0,36
47,93,47,35,121,133,-12
47,93,47,37,573,740,-167
47,93,47,49,0,28,-28
47,93,47,51,24,30,-6
47,93,47,57,319,321,-2
47,93,47,59,114,84,30
47,93,47,63,366,230,136
47,93,47,65,508,466,42
47,93,47,73,95,31,64
47,93,47,89,855,749,106
47,93,47,105,839,1193,-354
47,93,47,107,179,106,73
47,93,47,113,59,58,1
47,93,47,119,44,0,44
47,93,47,123,230,237,-7
47,93,47,125,137,75,62
47,93,47,129,112,136,-24
47,93,47,141,143,113,30
47,93,47,143,63,42,21
47,93,47,145,705,630,75
47,93,47,147,34,26,8
47,93,47,149,242,255,-13
47,93,47,151,86,43,43
47,93,47,155,1395,1108,287
47,93,47,157,544,369,175
47,93,47,163,294,218,76
47,93,47,165,102,132,-30
47,93,47,173,637,757,-120
47,93,47,179,363,286,77
47,93,47,187,199,250,-51
47,93,47,189,91,68,23
47,93,48,27,0,41,-41
47,93,48,29,40,50,-10
47,93,48,113,49,92,-43
47,93,48,121,42,44,-2
47,93,48,201,126,140,-14
47,93,48,439,45,105,-60
47,93,48,453,42,80,-38
47,93,49,49,0,39,-39
47,93,51,13,0,29,-29
47,93,51,59,81,72,9
47,93,51,87,0,28,-28
47,93,51,107,0,36,-36
47,93,51,121,34,33,1
47,93,51,153,29,0,29
47,93,51,700,31,0,31
47,93,51,710,38,40,-2
47,93,51,760,0,25,-25
47,93,51,810,41,24,17
47,93,53,33,42,65,-23
47,93,53,53,45,65,-20
47,93,53,61,0,39,-39
47,93,55,25,35,0,35
47,93,55,79,31,0,31
47,95,47,45,116,179,-63
47,95,47,131,95,100,-5
47,97,47,33,0,68,-68
47,97,47,37,0,46,-46
47,97,47,45,211,281,-70
47,97,47,75,105,87,18
47,97,47,113,51,57,-6
47,97,47,157,129,163,-34
47,97,47,167,351,261,90
47,99,1,33,0,27,-27
47,99,1,77,129,129,0
47,99,47,37,64,72,-8
47,99,47,55,183,211,-28
47,99,47,101,73,76,-3
47,99,47,117,32,45,-13
47,99,47,119,247,276,-29
47,99,47,149,45,59,-14
47,99,47,157,24,0,24
47,99,47,181,97,92,5
47,101,47,37,0,33,-33
47,101,47,81,55,44,11
47,101,47,99,76,73,3
47,101,47,119,108,141,-33
47,101,47,135,0,22,-22
47,101,47,149,31,35,-4
47,101,47,181,0,36,-36
47,103,1,83,77,73,4
47,103,1,89,515,386,129
47,103,47,3,101,74,27
47,103,47,31,67,37,30
47,103,47,37,39,48,-9
47,103,47,51,118,132,-14
47,103,47,55,73,74,-1
47,103,47,117,148,66,82
47,103,47,119,0,31,-31
47,103,47,149,60,57,3
47,105,12,21,34,0,34
47,105,26,163,29,0,29
47,105,47,1,81,54,27
47,105,47,9,337,392,-55
47,105,47,35,0,40,-40
47,105,47,37,0,47,-47
47,105,47,65,38,31,7
47,105,47,93,1193,839,354
47,105,47,107,90,106,-16
47,105,47,123,397,468,-71
47,105,47,145,272,261,11
47,105,47,155,39,37,2
47,107,47,1,0,29,-29
47,107,47,9,88,54,34
47,107,47,11,477,492,-15
47,107,47,37,23,30,-7
47,107,47,65,97,156,-59
47,107,47,93,106,179,-73
47,107,47,105,106,90,16
47,107,47,121,243,239,4
47,107,47,123,528,401,127
47,107,47,139,127,158,-31
47,107,47,143,75,39,36
47,107,47,145,66,74,-8
47,107,47,149,0,36,-36
47,109,28,3,136,174,-38
47,109,28,141,31,0,31
47,109,47,23,111,138,-27
47,109,47,37,0,33,-33
47,109,47,69,72,40,32
47,109,47,71,389,316,73
47,109,47,77,32,48,-16
47,109,47,113,107,108,-1
47,109,47,157,119,69,50
47,111,21,3,53,35,18
47,111,21,171,105,63,42
47,111,47,27,58,60,-2
47,111,47,37,87,49,38
47,111,47,87,38,43,-5
47,111,47,141,23,38,-15
47,111,47,147,55,0,55
47,111,47,149,40,42,-2
47,111,47,159,43,90,-47
47,111,47,165,385,357,28
47,111,47,169,121,72,49
47,111,47,189,83,66,17
47,113,1,73,0,30,-30
47,113,12,31,34,0,34
47,113,13,67,0,29,-29
47,113,13,89,0,30,-30
47,113,13,121,0,28,-28
47,113,17,31,50,34,16
47,113,26,125,31,0,31
47,113,26,163,0,36,-36
47,113,28,33,45,40,5
47,113,47,5,36,0,36
47,113,47,17,324,300,24
47,113,47,23,342,337,5
47,113,47,33,253,244,9
47,113,47,37,212,381,-169
47,113,47,39,48,31,17
47,113,47,45,117,79,38
47,113,47,47,54,0,54
47,113,47,53,695,1042,-347
47,113,47,65,0,41,-41
47,113,47,69,297,160,137
47,113,47,71,31,34,-3
47,113,47,75,292,200,92
47,113,47,77,229,299,-70
47,113,47,79,49,29,20
47,113,47,93,58,59,-1
47,113,47,97,57,51,6
47,113,47,109,108,107,1
47,113,47,125,0,39,-39
47,113,47,131,66,0,66
47,113,47,149,91,159,-68
47,113,47,157,427,585,-158
47,113,47,165,0,41,-41
47,113,47,167,39,37,2
47,113,47,183,78,73,5
47,113,47,187,0,103,-103
47,113,55,79,34,0,34
47,115,1,71,151,186,-35
47,115,13,47,0,46,-46
47,115,13,83,60,70,-10
47,115,13,295,0,34,-34
47,115,47,37,0,27,-27
47,115,47,51,44,0,44
47,115,47,61,119,105,14
47,115,47,65,420,471,-51
47,115,47,149,25,0,25
47,115,47,153,81,74,7
47,117,47,3,153,170,-17
47,117,47,31,44,0,44
47,117,47,37,178,126,52
47,117,47,55,118,118,0
47,117,47,99,45,32,13
47,117,47,103,66,148,-82
47,117,47,119,376,369,7
47,117,47,149,221,123,98
47,117,47,187,253,117,136
47,117,47,189,36,0,36
47,119,1,77,0,33,-33
47,119,1,89,56,51,5
47,119,6,37,37,0,37
47,119,12,11,61,0,61
47,119,12,71,42,0,42
47,119,12,86,35,0,35
47,119,12,99,32,0,32
47,119,12,103,52,0,52
47,119,26,49,38,0,38
47,119,26,125,27,33,-6
47,119,26,163,58,0,58
47,119,32,3,33,0,33
47,119,47,3,44,53,-9
47,119,47,31,0,37,-37
47,119,47,37,815,543,272
47,119,47,43,54,48,6
47,119,47,55,245,208,37
47,119,47,65,0,44,-44
47,119,47,81,86,139,-53
47,119,47,93,0,44,-44
47,119,47,99,276,247,29
47,119,47,101,141,108,33
47,119,47,103,31,0,31
47,119,47,117,369,376,-7
47,119,47,125,37,0,37
47,119,47,141,28,0,28
47,119,47,147,0,33,-33
47,119,47,149,274,385,-111
47,119,47,157,105,41,64
47,119,47,165,60,67,-7
47,119,47,181,28,0,28
47,119,47,187,1410,751,659
47,119,47,189,58,0,58
47,121,47,11,203,208,-5
47,121,47,65,134,78,56
47,121,47,107,239,243,-4
47,121,47,123,42,51,-9
47,121,47,143,79,43,36
47,123,12,71,40,0,40
47,123,12,97,39,0,39
47,123,12,127,49,0,49
47,123,47,1,37,0,37
47,123,47,9,230,242,-12
47,123,47,11,87,24,63
47,123,47,65,0,33,-33
47,123,47,93,237,230,7
47,123,47,105,468,397,71
47,123,47,107,401,528,-127
47,123,47,121,51,42,9
47,123,47,139,0,29,-29
47,123,47,145,99,90,9
47,123,47,155,29,0,29
47,125,1,3,0,33,-33
47,125,1,31,104,186,-82
47,125,1,45,322,222,100
47,125,1,73,36,42,-6
47,125,1,81,0,44,-44
47,125,1,89,82,189,-107
47,125,1,101,39,0,39
47,125,1,103,0,37,-37
47,125,1,113,0,32,-32
47,125,2,20,74,80,-6
47,125,2,90,120,122,-2
47,125,4,3,123,177,-54
47,125,4,13,111,140,-29
47,125,4,19,0,73,-73
47,125,6,37,118,110,8
47,125,6,53,43,67,-24
47,125,6,59,37,34,3
47,125,6,65,47,52,-5
47,125,6,67,0,34,-34
47,125,6,71,190,168,22
47,125,6,73,105,91,14
47,125,8,5,0,39,-39
47,125,8,41,162,215,-53
47,125,12,1,30,0,30
47,125,12,5,30,32,-2
47,125,12,9,41,0,41
47,125,12,11,81,31,50
47,125,12,31,81,44,37
47,125,12,33,41,0,41
47,125,12,57,59,99,-40
47,125,12,71,42,33,9
47,125,12,81,43,0,43
47,125,12,83,31,0,31
47,125,12,86,83,54,29
47,125,12,91,51,117,-66
47,125,12,95,45,31,14
47,125,12,99,46,0,46
47,125,12,101,0,54,-54
47,125,12,103,38,41,-3
47,125,12,105,0,43,-43
47,125,12,117,38,0,38
47,125,13,51,59,92,-33
47,125,13,53,156,113,43
47,125,13,63,0,31,-31
47,125,13,67,0,69,-69
47,125,13,73,48,67,-19
47,125,13,89,40,56,-16
47,125,13,121,40,82,-42
47,125,13,135,36,43,-7
47,125,13,151,0,42,-42
47,125,13,179,89,50,39
47,125,13,187,0,48,-48
47,125,13,215,164,187,-23
47,125,13,245,112,137,-25
47,125,15,3,187,222,-35
47,125,17,31,97,66,31
47,125,17,163,34,32,2
47,125,17,197,0,39,-39
47,125,18,97,74,54,20
47,125,18,163,0,33,-33
47,125,20,61,71,86,-15
47,125,20,103,289,135,154
47,125,20,161,0,56,-56
47,125,20,173,0,34,-34
47,125,21,35,45,0,45
47,125,21,47,3713,2510,1203
47,125,21,67,36,77,-41
47,125,21,93,157,234,-77
47,125,21,107,43,36,7
47,125,21,111,58,127,-69
47,125,21,141,62,53,9
47,125,21,145,0,35,-35
47,125,21,163,0,42,-42
47,125,21,219,114,174,-60
47,125,21,221,42,56,-14
47,125,21,227,45,89,-44
47,125,22,115,213,154,59
47,125,24,3,65,73,-8
47,125,24,25,38,51,-13
47,125,24,31,65,81,-16
47,125,24,33,0,36,-36
47,125,25,17,36,37,-1
47,125,26,125,73,0,73
47,125,26,163,68,54,14
47,125,27,53,0,28,-28
47,125,28,47,0,42,-42
47,125,29,99,0,36,-36
47,125,29,169,129,147,-18
47,125,29,189,58,43,15
47,125,32,3,30,66,-36
47,125,36,45,185,111,74
47,125,36,47,37,0,37
47,125,36,71,47,48,-1
47,125,36,81,46,30,16
47,125,37,51,689,433,256
47,125,37,85,54,86,-32
47,125,37,93,86,62,24
47,125,37,119,0,45,-45
47,125,37,125,0,60,-60
47,125,37,133,38,57,-19
47,125,37,183,51,41,10
47,125,39,35,58,0,58
47,125,39,49,50,33,17
47,125,39,61,43,24,19
47,125,39,113,0,26,-26
47,125,40,31,220,180,40
47,125,40,109,0,46,-46
47,125,45,63,0,46,-46
47,125,45,79,139,221,-82
47,125,45,85,0,34,-34
47,125,47,11,34,0,34
47,125,47,21,302,252,50
47,125,47,37,712,944,-232
47,125,47,43,182,213,-31
47,125,47,65,45,91,-46
47,125,47,79,48,29,19
47,125,47,83,92,149,-57
47,125,47,85,26,37,-11
47,125,47,93,75,137,-62
47,125,47,113,39,0,39
47,125,47,119,0,37,-37
47,125,47,141,0,31,-31
47,125,47,147,264,341,-77
47,125,47,149,129,253,-124
47,125,47,157,107,159,-52
47,125,47,161,272,399,-127
47,125,47,165,148,168,-20
47,125,47,187,79,127,-48
47,125,47,189,33,68,-35
47,125,48,27,241,287,-46
47,125,48,29,197,291,-94
47,125,48,39,0,47,-47
47,125,48,85,0,35,-35
47,125,48,99,81,58,23
47,125,48,113,40,44,-4
47,125,48,121,0,49,-49
47,125,48,141,237,292,-55
47,125,48,167,0,36,-36
47,125,48,201,101,115,-14
47,125,48,439,46,101,-55
47,125,48,453,0,34,-34
47,125,49,35,0,43,-43
47,125,51,41,33,55,-22
47,125,51,59,67,273,-206
47,125,51,149,119,55,64
47,125,51,153,0,160,-160
47,125,51,179,0,44,-44
47,125,51,199,0,40,-40
47,125,51,700,124,118,6
47,125,51,710,0,41,-41
47,125,51,810,78,46,32
47,125,53,33,0,58,-58
47,125,53,53,197,381,-184
47,125,53,67,0,161,-161
47,127,47,3,44,72,-28
47,127,47,31,135,112,23
47,127,47,51,90,56,34
47,129,47,1,216,192,24
47,129,47,35,41,50,-9
47,129,47,49,39,51,-12
47,129,47,93,136,112,24
47,129,47,145,266,313,-47
47,129,47,151,40,47,-7
47,131,21,75,207,274,-67
47,131,21,83,80,56,24
47,131,21,105,50,0,50
47,131,21,145,0,36,-36
47,131,47,37,0,54,-54
47,131,47,45,200,196,4
47,131,47,53,129,139,-10
47,131,47,79,0,28,-28
47,131,47,95,100,95,5
47,131,47,113,0,66,-66
47,131,47,157,77,56,21
47,131,47,183,280,361,-81
47,133,47,27,46,43,3
47,133,47,35,32,0,32
47,133,47,37,0,37,-37
47,133,47,87,92,77,15
47,133,47,137,66,42,24
47,133,47,141,459,464,-5
47,133,47,185,0,32,-32
47,135,47,39,43,53,-10
47,135,47,81,36,31,5
47,135,47,101,22,0,22
47,137,21,53,42,0,42
47,137,47,49,25,0,25
47,137,47,133,42,66,-24
47,137,47,141,30,0,30
47,139,13,111,129,84,45
47,139,13,213,43,38,5
47,139,37,39,33,36,-3
47,139,47,11,487,539,-52
47,139,47,65,61,97,-36
47,139,47,107,158,127,31
47,139,47,123,29,0,29
47,141,4,13,30,0,30
47,141,6,37,44,0,44
47,141,12,11,45,0,45
47,141,12,86,33,0,33
47,141,26,163,40,0,40
47,141,28,47,101,0,101
47,141,47,1,0,32,-32
47,141,47,11,0,39,-39
47,141,47,27,58,0,58
47,141,47,31,30,26,4
47,141,47,35,180,200,-20
47,141,47,37,206,296,-90
47,141,47,41,130,88,42
47,141,47,49,73,72,1
47,141,47,65,56,65,-9
47,141,47,87,358,362,-4
47,141,47,93,113,143,-30
47,141,47,111,38,23,15
47,141,47,119,0,28,-28
47,141,47,125,31,0,31
47,141,47,133,464,459,5
47,141,47,137,0,30,-30
47,141,47,145,54,22,32
47,141,47,149,99,153,-54
47,141,47,157,48,0,48
47,141,47,159,111,75,36
47,141,47,163,31,0,31
47,141,47,165,45,79,-34
47,141,47,175,34,31,3
47,141,47,177,74,54,20
47,141,47,179,36,0,36
47,141,47,185,451,411,40
47,141,47,187,40,0,40
47,141,47,189,97,169,-72
47,143,47,7,86,128,-42
47,143,47,11,66,61,5
47,143,47,35,53,71,-18
47,143,47,65,459,438,21
47,143,47,93,42,63,-21
47,143,47,107,39,75,-36
47,143,47,121,43,79,-36
47,143,47,145,89,68,21
47,145,47,1,433,374,59
47,145,47,9,129,110,19
47,145,47,35,101,111,-10
47,145,47,37,43,32,11
47,145,47,65,36,36,0
47,145,47,89,0,31,-31
47,145,47,93,630,705,-75
47,145,47,105,261,272,-11
47,145,47,107,74,66,8
47,145,47,123,90,99,-9
47,145,47,129,313,266,47
47,145,47,141,22,54,-32
47,145,47,143,68,89,-21
47,145,47,149,22,35,-13
47,147,21,47,40,0,40
47,147,21,141,92,110,-18
47,147,21,213,72,62,10
47,147,21,227,29,32,-3
47,147,47,21,297,203,94
47,147,47,37,1897,1180,717
47,147,47,43,41,32,9
47,147,47,93,26,34,-8
47,147,47,111,0,55,-55
47,147,47,119,33,0,33
47,147,47,125,341,264,77
47,147,47,149,188,120,68
47,147,47,157,27,27,0
47,147,47,165,1289,1119,170
47,147,47,187,73,47,26
47,147,47,189,122,83,39
47,149,1,3,36,0,36
47,149,1,73,67,61,6
47,149,1,77,28,0,28
47,149,1,89,96,59,37
47,149,1,101,0,36,-36
47,149,1,117,40,0,40
47,149,4,13,96,69,27
47,149,4,19,0,35,-35
47,149,5,7,0,36,-36
47,149,6,37,144,76,68
47,149,6,59,39,0,39
47,149,6,65,33,0,33
47,149,6,67,34,0,34
47,149,6,71,36,0,36
47,149,6,73,134,63,71
47,149,8,41,35,0,35
47,149,12,9,35,24,11
47,149,12,11,125,64,61
47,149,12,31,51,44,7
47,149,12,57,100,68,32
47,149,12,71,90,0,90
47,149,12,86,67,34,33
47,149,12,91,35,0,35
47,149,12,95,84,42,42
47,149,12,99,92,32,60
47,149,12,101,56,49,7
47,149,12,103,86,47,39
47,149,12,105,42,32,10
47,149,12,113,30,0,30
47,149,12,117,56,0,56
47,149,12,127,64,0,64
47,149,13,63,36,0,36
47,149,13,67,73,48,25
47,149,13,89,32,40,-8
47,149,13,121,82,64,18
47,149,13,135,69,46,23
47,149,15,3,0,34,-34
47,149,17,31,116,49,67
47,149,17,113,43,0,43
47,149,18,97,60,30,30
47,149,18,163,32,0,32
47,149,21,47,37,39,-2
47,149,21,67,45,43,2
47,149,21,111,78,49,29
47,149,21,145,38,0,38
47,149,21,227,49,80,-31
47,149,22,51,31,0,31
47,149,24,31,34,0,34
47,149,26,49,53,0,53
47,149,26,99,62,0,62
47,149,26,125,62,0,62
47,149,26,139,35,0,35
47,149,26,161,30,0,30
47,149,26,163,139,43,96
47,149,28,33,29,48,-19
47,149,29,189,32,39,-7
47,149,32,3,84,48,36
47,149,36,55,38,0,38
47,149,36,59,41,0,41
47,149,37,21,0,27,-27
47,149,37,51,0,44,-44
47,149,37,119,45,42,3
47,149,39,17,67,0,67
47,149,39,35,38,0,38
47,149,39,49,78,40,38
47,149,39,113,66,0,66
47,149,40,109,44,0,44
47,149,42,3,25,0,25
47,149,47,1,46,33,13
47,149,47,3,662,939,-277
47,149,47,9,44,38,6
47,149,47,11,54,45,9
47,149,47,15,373,587,-214
47,149,47,21,147,132,15
47,149,47,31,467,531,-64
47,149,47,35,38,37,1
47,149,47,37,8146,5132,3014
47,149,47,41,84,141,-57
47,149,47,43,89,141,-52
47,149,47,51,119,125,-6
47,149,47,53,72,48,24
47,149,47,55,50,44,6
47,149,47,61,0,33,-33
47,149,47,65,240,195,45
47,149,47,71,0,31,-31
47,149,47,79,30,34,-4
47,149,47,81,58,57,1
47,149,47,85,32,0,32
47,149,47,93,255,242,13
47,149,47,99,59,45,14
47,149,47,101,35,31,4
47,149,47,103,57,60,-3
47,149,47,107,36,0,36
47,149,47,111,42,40,2
47,149,47,113,159,91,68
47,149,47,115,0,25,-25
47,149,47,117,123,221,-98
47,149,47,119,385,274,111
47,149,47,125,253,129,124
47,149,47,141,153,99,54
47,149,47,145,35,22,13
47,149,47,147,120,188,-68
47,149,47,155,54,0,54
47,149,47,157,427,265,162
47,149,47,159,78,96,-18
47,149,47,165,484,387,97
47,149,47,167,29,0,29
47,149,47,177,233,175,58
47,149,47,179,56,51,5
47,149,47,183,27,42,-15
47,149,47,187,1097,821,276
47,149,47,189,830,850,-20
47,149,48,29,0,25,-25
47,149,48,113,43,59,-16
47,149,48,201,62,83,-21
47,149,48,439,53,125,-72
47,149,48,453,0,54,-54
47,149,48,491,0,36,-36
47,149,51,59,31,0,31
47,149,51,153,28,0,28
47,149,51,810,41,0,41
47,149,55,79,45,0,45
47,151,21,147,92,109,-17
47,151,47,1,45,0,45
47,151,47,13,80,70,10
47,151,47,93,43,86,-43
47,151,47,129,47,40,7
47,153,47,7,64,72,-8
47,153,47,61,0,37,-37
47,153,47,65,330,273,57
47,153,47,115,74,81,-7
47,155,12,9,43,0,43
47,155,12,11,59,0,59
47,155,12,21,47,0,47
47,155,12,31,35,0,35
47,155,12,53,59,0,59
47,155,12,57,58,0,58
47,155,12,69,32,0,32
47,155,12,71,106,0,106
47,155,12,81,29,0,29
47,155,12,86,59,0,59
47,155,12,95,64,26,38
47,155,12,99,37,0,37
47,155,12,103,84,36,48
47,155,12,105,77,0,77
47,155,12,115,58,0,58
47,155,12,117,33,0,33
47,155,12,127,43,0,43
47,155,13,67,33,0,33
47,155,17,31,65,0,65
47,155,26,99,31,0,31
47,155,39,49,30,0,30
47,155,45,51,42,32,10
47,155,47,1,85,67,18
47,155,47,9,374,360,14
47,155,47,11,25,28,-3
47,155,47,29,266,323,-57
47,155,47,35,22,0,22
47,155,47,37,49,42,7
47,155,47,57,55,40,15
47,155,47,59,39,32,7
47,155,47,63,115,136,-21
47,155,47,65,45,34,11
47,155,47,89,708,905,-197
47,155,47,93,1108,1395,-287
47,155,47,105,37,39,-2
47,155,47,123,0,29,-29
47,155,47,149,0,54,-54
47,155,47,157,41,0,41
47,155,47,163,52,34,18
47,155,47,165,0,31,-31
47,155,47,173,32,0,32
47,155,47,179,59,54,5
47,155,47,189,0,26,-26
47,157,1,3,52,105,-53
47,157,1,33,0,40,-40
47,157,1,73,173,231,-58
47,157,1,77,0,43,-43
47,157,1,89,104,109,-5
47,157,1,97,84,113,-29
47,157,1,101,59,58,1
47,157,1,117,72,137,-65
47,157,1,125,63,45,18
47,157,2,20,48,48,0
47,157,4,13,193,359,-166
47,157,4,19,46,102,-56
47,157,4,21,0,27,-27
47,157,5,7,56,124,-68
47,157,5,23,0,80,-80
47,157,5,31,202,207,-5
47,157,5,35,927,1169,-242
47,157,5,37,42,55,-13
47,157,5,45,56,60,-4
47,157,5,51,50,60,-10
47,157,5,55,0,32,-32
47,157,5,63,0,28,-28
47,157,5,69,77,51,26
47,157,5,77,43,38,5
47,157,5,93,83,122,-39
47,157,5,107,94,67,27
47,157,5,111,41,53,-12
47,157,5,119,414,406,8
47,157,5,123,115,95,20
47,157,5,125,40,42,-2
47,157,5,143,49,83,-34
47,157,5,145,41,41,0
47,157,6,1,74,91,-17
47,157,6,13,53,38,15
47,157,6,37,454,429,25
47,157,6,53,47,0,47
47,157,6,59,145,107,38
47,157,6,65,99,128,-29
47,157,6,67,48,61,-13
47,157,6,71,81,56,25
47,157,6,73,347,341,6
47,157,6,75,0,52,-52
47,157,6,81,0,31,-31
47,157,6,83,0,36,-36
47,157,6,85,75,79,-4
47,157,6,111,79,46,33
47,157,8,1,43,0,43
47,157,8,5,85,57,28
47,157,8,13,0,55,-55
47,157,8,31,45,102,-57
47,157,8,35,0,58,-58
47,157,8,41,96,102,-6
47,157,8,59,0,42,-42
47,157,9,1,0,53,-53
47,157,9,3,42,40,2
47,157,9,9,31,37,-6
47,157,10,3,0,31,-31
47,157,11,1,74,99,-25
47,157,12,1,0,35,-35
47,157,12,5,40,42,-2
47,157,12,9,38,25,13
47,157,12,11,189,141,48
47,157,12,15,0,27,-27
47,157,12,19,54,70,-16
47,157,12,21,0,34,-34
47,157,12,31,256,288,-32
47,157,12,33,116,88,28
47,157,12,57,121,183,-62
47,157,12,71,49,63,-14
47,157,12,73,41,34,7
47,157,12,83,0,28,-28
47,157,12,86,150,138,12
47,157,12,91,58,54,4
47,157,12,95,183,189,-6
47,157,12,97,0,43,-43
47,157,12,99,106,102,4
47,157,12,101,0,68,-68
47,157,12,103,100,94,6
47,157,12,105,44,77,-33
47,157,12,109,0,36,-36
47,157,12,113,39,58,-19
47,157,12,115,0,30,-30
47,157,12,117,70,55,15
47,157,12,127,35,56,-21
47,157,12,131,0,46,-46
47,157,13,51,50,54,-4
47,157,13,57,42,45,-3
47,157,13,63,57,81,-24
47,157,13,67,168,269,-101
47,157,13,73,0,43,-43
47,157,13,77,0,39,-39
47,157,13,89,221,283,-62
47,157,13,97,0,43,-43
47,157,13,113,39,0,39
47,157,13,117,0,40,-40
47,157,13,121,276,409,-133
47,157,13,127,0,30,-30
47,157,13,135,165,260,-95
47,157,13,139,46,0,46
47,157,13,151,39,61,-22
47,157,13,153,0,24,-24
47,157,13,215,0,57,-57
47,157,13,245,33,48,-15
47,157,15,3,101,86,15
47,157,16,1,0,31,-31
47,157,17,19,57,0,57
47,157,17,31,696,745,-49
47,157,17,43,73,122,-49
47,157,17,77,43,0,43
47,157,17,89,46,0,46
47,157,17,97,69,100,-31
47,157,17,119,0,28,-28
47,157,17,143,33,43,-10
47,157,17,163,49,80,-31
47,157,17,167,44,41,3
47,157,17,197,82,63,19
47,157,17,201,42,0,42
47,157,18,3,40,38,2
47,157,18,57,31,38,-7
47,157,18,89,66,75,-9
47,157,18,97,128,99,29
47,157,18,105,38,0,38
47,157,18,141,0,32,-32
47,157,18,157,36,0,36
47,157,18,163,36,0,36
47,157,19,153,0,51,-51
47,157,19,163,50,47,3
47,157,20,61,0,35,-35
47,157,20,91,69,78,-9
47,157,20,173,25,65,-40
47,157,20,177,0,27,-27
47,157,21,15,29,34,-5
47,157,21,35,23,29,-6
47,157,21,47,0,35,-35
47,157,21,67,81,72,9
47,157,21,111,160,167,-7
47,157,21,145,22,0,22
47,157,21,227,0,25,-25
47,157,22,5,0,38,-38
47,157,22,15,26,39,-13
47,157,22,17,86,52,34
47,157,22,19,0,34,-34
47,157,22,33,79,117,-38
47,157,22,51,99,215,-116
47,157,22,55,26,0,26
47,157,22,71,107,327,-220
47,157,22,73,47,31,16
47,157,22,103,55,85,-30
47,157,22,105,33,0,33
47,157,23,5,0,29,-29
47,157,24,3,38,74,-36
47,157,24,5,0,30,-30
47,157,24,27,44,33,11
47,157,24,31,81,63,18
47,157,24,33,74,98,-24
47,157,24,510,34,24,10
47,157,25,9,36,0,36
47,157,25,17,47,53,-6
47,157,25,21,0,54,-54
47,157,25,25,26,51,-25
47,157,25,27,38,0,38
47,157,26,49,102,30,72
47,157,26,65,31,0,31
47,157,26,77,43,0,43
47,157,26,81,59,36,23
47,157,26,99,84,46,38
47,157,26,125,139,102,37
47,157,26,145,30,0,30
47,157,26,161,32,47,-15
47,157,26,163,394,138,256
47,157,27,37,41,36,5
47,157,27,53,126,149,-23
47,157,27,123,47,63,-16
47,157,28,3,58,69,-11
47,157,28,9,81,79,2
47,157,28,11,283,156,127
47,157,28,15,35,0,35
47,157,28,27,217,113,104
47,157,28,33,3990,7744,-3754
47,157,28,35,58,43,15
47,157,28,43,68,45,23
47,157,28,47,108,76,32
47,157,28,49,320,239,81
47,157,28,51,63,29,34
47,157,28,59,38,72,-34
47,157,28,71,183,201,-18
47,157,28,73,26,27,-1
47,157,28,75,54,33,21
47,157,28,81,150,122,28
47,157,28,83,171,133,38
47,157,28,87,75,55,20
47,157,28,89,128,121,7
47,157,28,93,835,1045,-210
47,157,28,95,0,35,-35
47,157,28,105,122,79,43
47,157,28,107,237,211,26
47,157,28,117,37,0,37
47,157,28,119,35,0,35
47,157,28,121,69,97,-28
47,157,28,133,212,66,146
47,157,28,135,62,72,-10
47,157,28,137,202,360,-158
47,157,28,139,37,88,-51
47,157,28,141,0,46,-46
47,157,28,143,176,253,-77
47,157,28,145,33,40,-7
47,157,28,149,88,0,88
47,157,28,151,396,243,153
47,157,28,161,43,41,2
47,157,28,163,36,46,-10
47,157,29,19,55,72,-17
47,157,29,31,50,31,19
47,157,29,47,0,33,-33
47,157,29,77,0,46,-46
47,157,29,95,56,64,-8
47,157,29,99,0,25,-25
47,157,29,155,0,53,-53
47,157,29,183,40,74,-34
47,157,29,189,159,276,-117
47,157,29,201,27,0,27
47,157,29,510,109,122,-13
47,157,31,55,81,74,7
47,157,31,109,28,39,-11
47,157,31,153,0,32,-32
47,157,32,3,170,249,-79
47,157,32,31,42,35,7
47,157,34,17,45,37,8
47,157,34,23,42,44,-2
47,157,35,1,42,39,3
47,157,36,5,37,33,4
47,157,36,29,39,34,5
47,157,36,45,39,0,39
47,157,36,47,65,80,-15
47,157,36,55,0,32,-32
47,157,36,59,22,0,22
47,157,36,61,90,165,-75
47,157,36,67,0,31,-31
47,157,36,81,70,53,17
47,157,36,103,56,40,16
47,157,36,119,48,0,48
47,157,37,21,0,41,-41
47,157,37,51,63,58,5
47,157,37,63,45,53,-8
47,157,37,67,53,49,4
47,157,37,81,43,61,-18
47,157,37,119,114,239,-125
47,157,37,129,0,38,-38
47,157,37,133,64,63,1
47,157,37,183,64,149,-85
47,157,39,17,29,0,29
47,157,39,35,173,78,95
47,157,39,49,138,116,22
47,157,39,61,78,111,-33
47,157,39,95,54,0,54
47,157,39,113,59,0,59
47,157,39,153,29,41,-12
47,157,39,165,0,48,-48
47,157,40,31,34,0,34
47,157,40,109,61,131,-70
47,157,40,143,64,118,-54
47,157,41,39,0,34,-34
47,157,41,51,38,75,-37
47,157,42,3,52,77,-25
47,157,42,29,0,37,-37
47,157,42,91,28,45,-17
47,157,42,101,46,60,-14
47,157,45,13,0,31,-31
47,157,45,15,27,0,27
47,157,45,19,72,96,-24
47,157,45,45,45,40,5
47,157,45,63,0,50,-50
47,157,45,79,48,55,-7
47,157,45,91,0,64,-64
47,157,46,99,0,33,-33
47,157,47,9,31,56,-25
47,157,47,11,0,30,-30
47,157,47,17,79,64,15
47,157,47,23,62,56,6
47,157,47,33,34,46,-12
47,157,47,37,910,1385,-475
47,157,47,39,0,43,-43
47,157,47,43,0,33,-33
47,157,47,45,114,85,29
47,157,47,47,1341,2746,-1405
47,157,47,53,113,146,-33
47,157,47,65,227,283,-56
47,157,47,69,188,299,-111
47,157,47,71,37,127,-90
47,157,47,75,171,187,-16
47,157,47,77,43,56,-13
47,157,47,79,34,74,-40
47,157,47,93,369,544,-175
47,157,47,97,163,129,34
47,157,47,99,0,24,-24
47,157,47,109,69,119,-50
47,157,47,113,585,427,158
47,157,47,119,41,105,-64
47,157,47,125,159,107,52
47,157,47,131,56,77,-21
47,157,47,141,0,48,-48
47,157,47,147,27,27,0
47,157,47,149,265,427,-162
47,157,47,155,0,41,-41
47,157,47,163,0,36,-36
47,157,47,165,72,117,-45
47,157,47,167,1606,2812,-1206
47,157,47,179,68,65,3
47,157,47,183,74,95,-21
47,157,47,187,145,405,-260
47,157,47,189,57,113,-56
47,157,48,27,58,81,-23
47,157,48,29,108,191,-83
47,157,48,85,73,214,-141
47,157,48,113,251,489,-238
47,157,48,121,121,133,-12
47,157,48,141,37,60,-23
47,157,48,157,40,145,-105
47,157,48,167,0,33,-33
47,157,48,201,319,526,-207
47,157,48,215,0,38,-38
47,157,48,257,0,37,-37
47,157,48,303,0,30,-30
47,157,48,339,37,76,-39
47,157,48,355,0,37,-37
47,157,48,439,188,371,-183
47,157,48,453,88,222,-134
47,157,48,491,0,68,-68
47,157,49,35,49,65,-16
47,157,49,49,56,51,5
47,157,51,13,35,45,-10
47,157,51,41,51,0,51
47,157,51,59,75,134,-59
47,157,51,87,47,31,16
47,157,51,107,0,49,-49
47,157,51,153,38,66,-28
47,157,51,510,42,41,1
47,157,51,550,60,83,-23
47,157,51,650,32,0,32
47,157,51,700,35,0,35
47,157,51,710,70,74,-4
47,157,51,810,193,139,54
47,157,53,29,35,0,35
47,157,53,33,131,134,-3
47,157,53,35,52,38,14
47,157,53,53,47,73,-26
47,157,53,61,36,41,-5
47,157,55,25,43,32,11
47,157,55,79,233,140,93
47,159,47,37,110,79,31
47,159,47,41,97,75,22
47,159,47,87,32,42,-10
47,159,47,111,90,43,47
47,159,47,141,75,111,-36
47,159,47,149,96,78,18
47,159,47,165,73,0,73
47,159,47,169,44,51,-7
47,159,47,189,429,363,66
47,161,21,47,81,48,33
47,161,47,37,31,27,4
47,161,47,79,0,35,-35
47,161,47,83,99,91,8
47,161,47,125,399,272,127
47,163,4,13,40,0,40
47,163,6,37,25,29,-4
47,163,12,57,30,0,30
47,163,12,95,33,0,33
47,163,12,103,44,0,44
47,163,12,105,31,0,31
47,163,13,89,0,28,-28
47,163,13,121,25,0,25
47,163,13,135,38,0,38
47,163,32,3,28,0,28
47,163,37,21,51,50,1
47,163,37,35,38,0,38
47,163,37,119,0,23,-23
47,163,37,183,33,0,33
47,163,45,45,0,25,-25
47,163,45,51,31,0,31
47,163,47,1,0,32,-32
47,163,47,9,47,0,47
47,163,47,19,444,429,15
47,163,47,37,40,84,-44
47,163,47,59,175,149,26
47,163,47,63,51,55,-4
47,163,47,65,50,35,15
47,163,47,73,1090,1132,-42
47,163,47,89,0,45,-45
47,163,47,91,37,35,2
47,163,47,93,218,294,-76
47,163,47,141,0,31,-31
47,163,47,155,34,52,-18
47,163,47,157,36,0,36
47,163,47,171,98,75,23
47,163,47,179,1740,1795,-55
47,163,48,201,35,0,35
47,163,51,27,30,0,30
47,163,51,105,47,43,4
47,163,51,121,33,0,33
47,163,51,167,71,47,24
47,163,51,169,397,363,34
47,163,51,173,62,40,22
47,163,51,191,558,481,77
47,163,51,195,123,68,55
47,163,51,520,644,632,12
47,165,1,73,0,46,-46
47,165,1,89,0,29,-29
47,165,4,13,69,37,32
47,165,6,37,76,0,76
47,165,6,59,44,0,44
47,165,6,65,53,0,53
47,165,6,71,29,0,29
47,165,6,73,51,45,6
47,165,12,9,46,0,46
47,165,12,11,60,0,60
47,165,12,31,31,0,31
47,165,12,57,35,0,35
47,165,12,81,34,0,34
47,165,12,95,35,31,4
47,165,12,99,40,0,40
47,165,12,103,87,0,87
47,165,12,105,29,0,29
47,165,13,121,0,30,-30
47,165,17,31,68,40,28
47,165,18,57,35,0,35
47,165,18,97,51,0,51
47,165,18,163,25,0,25
47,165,21,3,72,103,-31
47,165,21,47,45,0,45
47,165,21,111,75,79,-4
47,165,21,141,65,44,21
47,165,21,213,136,161,-25
47,165,21,227,125,145,-20
47,165,26,49,43,0,43
47,165,26,125,60,0,60
47,165,26,163,74,0,74
47,165,28,33,0,30,-30
47,165,37,119,42,0,42
47,165,39,49,28,0,28
47,165,45,51,0,34,-34
47,165,47,21,151,116,35
47,165,47,31,30,29,1
47,165,47,37,4235,3167,1068
47,165,47,43,63,37,26
47,165,47,65,75,57,18
47,165,47,93,132,102,30
47,165,47,111,357,385,-28
47,165,47,113,41,0,41
47,165,47,119,67,60,7
47,165,47,125,168,148,20
47,165,47,141,79,45,34
47,165,47,147,1119,1289,-170
47,165,47,149,387,484,-97
47,165,47,155,31,0,31
47,165,47,157,117,72,45
47,165,47,159,0,73,-73
47,165,47,169,104,194,-90
47,165,47,177,0,29,-29
47,165,47,187,191,245,-54
47,165,47,189,572,590,-18
47,165,48,121,36,0,36
47,165,48,201,38,0,38
47,165,48,439,48,0,48
47,167,6,73,40,0,40
47,167,12,31,42,0,42
47,167,17,31,28,0,28
47,167,28,33,70,130,-60
47,167,47,37,42,32,10
47,167,47,45,37,0,37
47,167,47,47,151,110,41
47,167,47,75,106,99,7
47,167,47,97,261,351,-90
47,167,47,113,37,39,-2
47,167,47,149,0,29,-29
47,167,47,157,2812,1606,1206
47,169,47,37,62,0,62
47,169,47,111,72,121,-49
47,169,47,159,51,44,7
47,169,47,165,194,104,90
47,169,47,189,166,134,32
47,171,37,21,26,30,-4
47,171,47,19,173,156,17
47,171,47,59,27,39,-12
47,171,47,163,75,98,-23
47,171,47,179,371,430,-59
47,173,47,1,71,87,-16
47,173,47,9,0,28,-28
47,173,47,25,84,69,15
47,173,47,57,91,107,-16
47,173,47,89,46,0,46
47,173,47,93,757,637,120
47,173,47,155,0,32,-32
47,175,47,141,31,34,-3
47,175,47,177,74,49,25
47,175,47,185,84,71,13
47,177,47,3,36,0,36
47,177,47,15,86,87,-1
47,177,47,31,177,166,11
47,177,47,37,57,80,-23
47,177,47,41,187,206,-19
47,177,47,51,63,0,63
47,177,47,61,50,0,50
47,177,47,65,25,47,-22
47,177,47,141,54,74,-20
47,177,47,149,175,233,-58
47,177,47,165,29,0,29
47,177,47,175,49,74,-25
47,177,47,185,73,80,-7
47,179,4,13,0,21,-21
47,179,12,9,38,0,38
47,179,12,11,44,0,44
47,179,12,31,28,0,28
47,179,12,33,28,0,28
47,179,12,57,38,0,38
47,179,12,83,50,0,50
47,179,12,86,37,0,37
47,179,12,95,39,31,8
47,179,12,101,37,0,37
47,179,12,103,60,32,28
47,179,12,105,33,0,33
47,179,12,117,33,0,33
47,179,12,127,51,0,51
47,179,13,89,0,26,-26
47,179,13,121,0,45,-45
47,179,17,31,34,0,34
47,179,26,163,37,0,37
47,179,32,3,33,0,33
47,179,37,21,99,72,27
47,179,37,51,23,0,23
47,179,37,67,0,34,-34
47,179,37,81,44,26,18
47,179,37,119,43,88,-45
47,179,37,121,31,0,31
47,179,37,183,0,53,-53
47,179,37,189,27,0,27
47,179,39,49,41,0,41
47,179,45,19,30,32,-2
47,179,45,45,41,0,41
47,179,45,51,0,29,-29
47,179,47,1,25,40,-15
47,179,47,9,79,59,20
47,179,47,19,1409,1182,227
47,179,47,37,67,117,-50
47,179,47,59,592,454,138
47,179,47,63,82,81,1
47,179,47,65,71,75,-4
47,179,47,73,206,133,73
47,179,47,89,60,49,11
47,179,47,91,65,72,-7
47,179,47,93,286,363,-77
47,179,47,141,0,36,-36
47,179,47,149,51,56,-5
47,179,47,155,54,59,-5
47,179,47,157,65,68,-3
47,179,47,163,1795,1740,55
47,179,47,171,430,371,59
47,179,48,27,33,0,33
47,179,48,201,0,27,-27
47,179,51,59,26,0,26
47,179,51,105,34,0,34
47,179,51,167,0,23,-23
47,179,51,169,44,0,44
47,179,51,191,101,72,29
47,179,51,195,46,30,16
47,179,51,520,59,67,-8
47,179,51,810,39,0,39
47,181,1,77,73,84,-11
47,181,47,71,41,82,-41
47,181,47,99,92,97,-5
47,181,47,101,36,0,36
47,181,47,119,0,28,-28
47,183,21,75,46,50,-4
47,183,21,83,37,0,37
47,183,47,5,31,29,2
47,183,47,17,201,122,79
47,183,47,37,53,48,5
47,183,47,45,44,63,-19
47,183,47,53,150,181,-31
47,183,47,79,112,108,4
47,183,47,113,73,78,-5
47,183,47,131,361,280,81
47,183,47,149,42,27,15
47,183,47,157,95,74,21
47,185,12,9,44,0,44
47,185,47,35,118,63,55
47,185,47,37,38,55,-17
47,185,47,41,67,68,-1
47,185,47,65,33,0,33
47,185,47,87,0,33,-33
47,185,47,133,32,0,32
47,185,47,141,411,451,-40
47,185,47,175,71,84,-13
47,185,47,177,80,73,7
47,185,47,189,26,0,26
47,187,1,73,82,72,10
47,187,1,89,59,53,6
47,187,1,117,77,0,77
47,187,4,13,124,103,21
47,187,4,19,45,0,45
47,187,6,13,48,0,48
47,187,6,37,224,68,156
47,187,6,59,187,71,116
47,187,6,65,69,0,69
47,187,6,71,46,0,46
47,187,6,73,106,30,76
47,187,6,111,34,0,34
47,187,11,1,0,20,-20
47,187,12,11,134,39,95
47,187,12,21,36,0,36
47,187,12,31,46,25,21
47,187,12,57,100,33,67
47,187,12,71,41,0,41
47,187,12,86,62,0,62
47,187,12,95,93,53,40
47,187,12,99,84,0,84
47,187,12,103,72,30,42
47,187,12,115,37,0,37
47,187,12,117,46,0,46
47,187,13,57,33,0,33
47,187,13,67,104,59,45
47,187,13,89,58,52,6
47,187,13,121,115,73,42
47,187,13,135,87,0,87
47,187,17,31,99,61,38
47,187,17,43,47,0,47
47,187,17,97,47,0,47
47,187,18,57,32,0,32
47,187,21,67,36,27,9
47,187,21,111,104,62,42
47,187,21,227,45,29,16
47,187,26,99,66,0,66
47,187,26,125,73,0,73
47,187,26,161,42,0,42
47,187,26,163,103,38,65
47,187,28,33,52,0,52
47,187,29,189,70,31,39
47,187,32,3,80,38,42
47,187,36,47,0,21,-21
47,187,36,61,0,44,-44
47,187,37,119,58,65,-7
47,187,37,183,59,43,16
47,187,39,35,43,0,43
47,187,39,49,49,0,49
47,187,39,61,0,40,-40
47,187,39,153,35,0,35
47,187,40,143,32,0,32
47,187,42,17,34,0,34
47,187,47,3,32,61,-29
47,187,47,21,106,110,-4
47,187,47,35,0,30,-30
47,187,47,37,5569,3959,1610
47,187,47,43,159,182,-23
47,187,47,55,0,32,-32
47,187,47,65,117,91,26
47,187,47,81,149,208,-59
47,187,47,93,250,199,51
47,187,47,113,103,0,103
47,187,47,117,117,253,-136
47,187,47,119,751,1410,-659
47,187,47,125,127,79,48
47,187,47,141,0,40,-40
47,187,47,147,47,73,-26
47,187,47,149,821,1097,-276
47,187,47,157,405,145,260
47,187,47,165,245,191,54
47,187,47,189,180,226,-46
47,187,48,29,42,36,6
47,187,48,85,117,65,52
47,187,48,113,51,58,-7
47,187,48,121,52,0,52
47,187,48,201,54,41,13
47,187,48,439,67,61,6
47,187,48,453,0,58,-58
47,187,48,491,0,48,-48
47,187,51,59,57,0,57
47,187,51,107,38,0,38
47,187,53,33,69,0,69
47,189,4,13,42,30,12
47,189,6,37,50,0,50
47,189,6,73,0,31,-31
47,189,12,11,60,0,60
47,189,12,57,0,31,-31
47,189,12,99,31,0,31
47,189,12,103,37,0,37
47,189,12,105,37,0,37
47,189,17,31,58,0,58
47,189,21,227,26,0,26
47,189,26,163,31,0,31
47,189,32,3,40,0,40
47,189,37,133,38,0,38
47,189,47,3,37,0,37
47,189,47,9,33,0,33
47,189,47,15,37,38,-1
47,189,47,21,53,86,-33
47,189,47,37,4338,2201,2137
47,189,47,41,124,148,-24
47,189,47,43,59,57,2
47,189,47,65,49,54,-5
47,189,47,87,0,29,-29
47,189,47,93,68,91,-23
47,189,47,111,66,83,-17
47,189,47,117,0,36,-36
47,189,47,119,0,58,-58
47,189,47,125,68,33,35
47,189,47,141,169,97,72
47,189,47,147,83,122,-39
47,189,47,149,850,830,20
47,189,47,155,26,0,26
47,189,47,157,113,57,56
47,189,47,159,363,429,-66
47,189,47,165,590,572,18
47,189,47,169,134,166,-32
47,189,47,185,0,26,-26
47,189,47,187,226,180,46
48,1,48,5,38,46,-8
48,1,48,29,39,40,-1
48,1,48,39,40,0,40
48,1,48,41,0,41,-41
48,1,48,73,192,203,-11
48,1,48,85,62,66,-4
48,1,48,113,192,226,-34
48,1,48,121,31,30,1
48,1,48,161,95,66,29
48,1,48,167,26,0,26
48,1,48,183,56,36,20
48,1,48,201,158,212,-54
48,1,48,213,208,195,13
48,1,48,225,135,115,20
48,1,48,251,0,24,-24
48,1,48,289,95,112,-17
48,1,48,309,0,33,-33
48,1,48,339,37,69,-32
48,1,48,347,36,33,3
48,1,48,349,38,0,38
48,1,48,423,316,333,-17
48,1,48,439,80,113,-33
48,1,48,453,28,62,-34
48,1,48,471,0,34,-34
48,1,48,491,0,33,-33
48,3,35,25,77,0,77
48,3,48,113,43,0,43
48,3,48,135,181,203,-22
48,3,48,303,42,36,6
48,3,48,329,114,135,-21
48,3,48,439,0,26,-26
48,5,48,1,46,38,8
48,5,48,27,39,44,-5
48,5,48,29,46,77,-31
48,5,48,39,43,59,-16
48,5,48,41,40,67,-27
48,5,48,73,139,157,-18
48,5,48,85,0,31,-31
48,5,48,113,112,113,-1
48,5,48,121,39,45,-6
48,5,48,157,0,30,-30
48,5,48,167,0,69,-69
48,5,48,183,54,34,20
48,5,48,199,44,89,-45
48,5,48,201,445,604,-159
48,5,48,209,0,30,-30
48,5,48,225,92,105,-13
48,5,48,241,83,74,9
48,5,48,245,69,100,-31
48,5,48,291,45,0,45
48,5,48,303,0,36,-36
48,5,48,339,76,139,-63
48,5,48,347,525,449,76
48,5,48,355,0,32,-32
48,5,48,361,40,61,-21
48,5,48,373,242,236,6
48,5,48,401,41,0,41
48,5,48,403,86,58,28
48,5,48,405,44,70,-26
48,5,48,419,48,43,5
48,5,48,423,94,134,-40
48,5,48,439,73,116,-43
48,5,48,453,61,86,-25
48,5,48,455,138,135,3
48,5,48,457,40,74,-34
48,5,48,471,31,0,31
48,5,48,491,30,55,-25
48,7,48,29,139,152,-13
48,7,48,39,0,38,-38
48,7,48,61,46,0,46
48,7,48,91,46,40,6
48,7,48,113,37,0,37
48,7,48,201,127,98,29
48,7,48,215,55,0,55
48,7,48,355,234,330,-96
48,7,48,391,31,0,31
48,7,48,409,497,457,40
48,7,48,439,28,36,-8
48,7,48,453,59,58,1
48,7,48,469,49,29,20
48,7,48,491,31,0,31
48,9,48,77,0,37,-37
48,9,48,439,41,46,-5
48,9,48,485,473,385,88
48,9,48,503,45,0,45
48,11,48,375,86,86,0
48,11,48,381,115,69,46
48,13,48,29,1912,2015,-103
48,13,48,91,0,54,-54
48,13,48,113,35,0,35
48,13,48,141,33,42,-9
48,13,48,163,42,0,42
48,13,48,187,39,61,-22
48,13,48,201,30,77,-47
48,13,48,209,0,42,-42
48,13,48,325,162,155,7
48,13,48,355,65,41,24
48,13,48,439,0,33,-33
48,13,48,453,39,60,-21
48,13,48,469,27,0,27
48,13,48,493,66,83,-17
48,15,48,27,30,0,30
48,15,48,29,50,0,50
48,15,48,39,46,25,21
48,15,48,41,0,37,-37
48,15,48,89,127,99,28
48,15,48,149,37,30,7
48,15,48,157,309,282,27
48,15,48,201,673,634,39
48,15,48,339,0,37,-37
48,15,48,453,48,25,23
48,15,48,473,171,123,48
48,15,48,477,110,186,-76
48,15,48,481,62,45,17
48,15,48,491,0,28,-28
48,17,35,9,47,69,-22
48,17,48,279,41,60,-19
48,17,48,303,64,49,15
48,17,48,369,45,65,-20
48,19,48,29,676,515,161
48,19,48,91,44,35,9
48,19,48,201,46,43,3
48,19,48,259,99,108,-9
48,19,48,265,113,161,-48
48,19,48,325,41,0,41
48,19,48,355,42,0,42
48,19,48,453,28,35,-7
48,19,48,463,34,0,34
48,19,48,491,0,30,-30
48,21,4,13,46,33,13
48,21,6,37,39,0,39
48,21,6,59,23,0,23
48,21,48,27,57,105,-48
48,21,48,29,143,102,41
48,21,48,41,33,49,-16
48,21,48,53,22,0,22
48,21,48,55,127,211,-84
48,21,48,85,31,0,31
48,21,48,113,82,32,50
48,21,48,121,0,34,-34
48,21,48,149,103,97,6
48,21,48,167,28,0,28
48,21,48,187,39,0,39
48,21,48,201,317,180,137
48,21,48,209,212,261,-49
48,21,48,215,65,0,65
48,21,48,287,111,112,-1
48,21,48,303,30,0,30
48,21,48,309,37,0,37
48,21,48,339,29,37,-8
48,21,48,355,30,0,30
48,21,48,439,44,79,-35
48,21,48,453,2833,2264,569
48,21,48,469,0,33,-33
48,21,48,491,490,588,-98
48,23,48,275,32,0,32
48,23,48,485,33,71,-38
48,25,48,29,99,114,-15
48,25,48,113,0,28,-28
48,25,48,157,0,38,-38
48,25,48,201,54,88,-34
48,25,48,249,38,32,6
48,25,48,255,78,78,0
48,25,48,297,65,74,-9
48,25,48,355,256,316,-60
48,25,48,391,51,0,51
48,25,48,409,173,100,73
48,25,48,453,31,52,-21
48,25,48,469,49,107,-58
48,27,1,15,35,0,35
48,27,1,31,156,89,67
48,27,1,45,218,178,40
48,27,1,73,81,58,23
48,27,1,81,48,0,48
48,27,1,89,74,150,-76
48,27,1,97,59,49,10
48,27,1,101,67,0,67
48,27,1,113,38,0,38
48,27,2,20,86,131,-45
48,27,2,90,161,157,4
48,27,4,3,352,262,90
48,27,4,13,262,288,-26
48,27,4,15,43,0,43
48,27,4,19,125,127,-2
48,27,4,21,0,43,-43
48,27,4,27,0,52,-52
48,27,5,7,0,45,-45
48,27,5,45,33,0,33
48,27,5,119,54,76,-22
48,27,5,131,44,0,44
48,27,6,1,49,40,9
48,27,6,13,59,27,32
48,27,6,17,36,0,36
48,27,6,19,0,35,-35
48,27,6,29,67,57,10
48,27,6,37,420,268,152
48,27,6,47,34,0,34
48,27,6,53,112,108,4
48,27,6,59,103,100,3
48,27,6,65,113,109,4
48,27,6,67,108,59,49
48,27,6,71,471,378,93
48,27,6,73,278,223,55
48,27,6,77,60,23,37
48,27,6,81,37,0,37
48,27,6,83,0,35,-35
48,27,6,85,63,41,22
48,27,6,95,60,47,13
48,27,6,99,59,34,25
48,27,6,107,35,51,-16
48,27,6,111,41,0,41
48,27,8,5,29,38,-9
48,27,8,31,39,35,4
48,27,8,35,32,0,32
48,27,8,41,369,1861,-1492
48,27,8,59,0,30,-30
48,27,8,77,26,0,26
48,27,8,101,0,45,-45
48,27,8,123,31,0,31
48,27,9,1,31,0,31
48,27,9,3,50,0,50
48,27,11,1,25,30,-5
48,27,12,5,55,0,55
48,27,12,9,68,28,40
48,27,12,11,144,122,22
48,27,12,19,51,0,51
48,27,12,31,101,84,17
48,27,12,33,30,29,1
48,27,12,57,170,131,39
48,27,12,71,51,43,8
48,27,12,86,143,122,21
48,27,12,91,100,83,17
48,27,12,95,126,96,30
48,27,12,97,69,0,69
48,27,12,99,90,56,34
48,27,12,101,52,0,52
48,27,12,103,74,77,-3
48,27,12,105,63,37,26
48,27,12,111,34,0,34
48,27,12,117,60,32,28
48,27,12,127,28,33,-5
48,27,13,51,93,93,0
48,27,13,53,171,149,22
48,27,13,63,37,65,-28
48,27,13,67,52,59,-7
48,27,13,73,103,61,42
48,27,13,89,48,52,-4
48,27,13,121,52,50,2
48,27,13,135,60,36,24
48,27,13,151,37,0,37
48,27,13,153,31,34,-3
48,27,13,179,98,195,-97
48,27,13,215,290,209,81
48,27,13,245,220,242,-22
48,27,15,3,478,596,-118
48,27,17,31,271,144,127
48,27,17,43,0,30,-30
48,27,17,97,42,54,-12
48,27,17,119,37,0,37
48,27,17,163,31,0,31
48,27,17,197,63,0,63
48,27,17,201,37,0,37
48,27,18,3,31,0,31
48,27,18,89,54,34,20
48,27,18,97,65,69,-4
48,27,19,163,0,38,-38
48,27,20,61,148,94,54
48,27,20,91,37,29,8
48,27,20,103,336,115,221
48,27,20,161,61,60,1
48,27,20,173,76,0,76
48,27,21,47,198,162,36
48,27,21,67,0,27,-27
48,27,21,93,379,307,72
48,27,21,111,32,70,-38
48,27,21,163,112,165,-53
48,27,22,15,45,0,45
48,27,22,17,82,62,20
48,27,22,19,31,0,31
48,27,22,33,57,61,-4
48,27,22,51,56,54,2
48,27,22,55,28,30,-2
48,27,22,71,0,98,-98
48,27,22,79,43,34,9
48,27,22,103,0,41,-41
48,27,22,115,214,105,109
48,27,24,3,113,190,-77
48,27,24,5,63,0,63
48,27,24,21,51,0,51
48,27,24,25,124,114,10
48,27,24,27,0,31,-31
48,27,24,31,72,75,-3
48,27,24,33,88,60,28
48,27,25,13,41,0,41
48,27,25,17,61,0,61
48,27,26,49,35,60,-25
48,27,26,81,50,0,50
48,27,26,99,66,0,66
48,27,26,125,35,38,-3
48,27,26,145,32,0,32
48,27,26,163,123,58,65
48,27,27,3,23,0,23
48,27,27,53,60,0,60
48,27,28,47,47,44,3
48,27,29,77,0,23,-23
48,27,29,95,79,0,79
48,27,29,169,265,282,-17
48,27,29,183,27,0,27
48,27,29,189,66,45,21
48,27,30,13,36,0,36
48,27,31,55,25,29,-4
48,27,31,109,38,0,38
48,27,31,153,39,0,39
48,27,32,3,177,142,35
48,27,32,31,31,0,31
48,27,34,5,56,33,23
48,27,34,13,27,0,27
48,27,34,25,34,0,34
48,27,34,29,37,0,37
48,27,35,1,48,40,8
48,27,35,13,50,50,0
48,27,35,35,30,0,30
48,27,35,43,41,0,41
48,27,36,5,97,38,59
48,27,36,29,57,30,27
48,27,36,45,260,131,129
48,27,36,47,120,84,36
48,27,36,55,42,42,0
48,27,36,59,29,0,29
48,27,36,61,24,34,-10
48,27,36,71,93,85,8
48,27,36,81,77,27,50
48,27,36,103,71,42,29
48,27,37,51,453,570,-117
48,27,37,81,45,0,45
48,27,37,85,37,52,-15
48,27,37,93,0,49,-49
48,27,37,119,54,53,1
48,27,37,125,0,35,-35
48,27,37,133,0,36,-36
48,27,37,183,52,53,-1
48,27,37,191,37,0,37
48,27,39,35,71,76,-5
48,27,39,49,84,56,28
48,27,39,61,57,0,57
48,27,39,113,47,29,18
48,27,39,151,46,0,46
48,27,39,153,41,28,13
48,27,40,27,0,49,-49
48,27,40,31,609,335,274
48,27,40,109,108,111,-3
48,27,40,143,83,109,-26
48,27,41,51,30,0,30
48,27,41,67,39,0,39
48,27,42,3,69,45,24
48,27,42,17,26,0,26
48,27,42,41,76,0,76
48,27,42,49,0,31,-31
48,27,42,77,49,29,20
48,27,42,79,31,36,-5
48,27,42,91,32,0,32
48,27,42,101,65,41,24
48,27,42,133,38,0,38
48,27,45,45,0,47,-47
48,27,45,63,38,39,-1
48,27,45,79,328,434,-106
48,27,45,83,28,0,28
48,27,47,37,49,0,49
48,27,47,93,41,0,41
48,27,47,125,287,241,46
48,27,47,157,81,58,23
48,27,47,179,0,33,-33
48,27,48,5,44,39,5
48,27,48,15,0,30,-30
48,27,48,21,105,57,48
48,27,48,29,1037,1226,-189
48,27,48,35,37,0,37
48,27,48,37,0,44,-44
48,27,48,39,119,105,14
48,27,48,41,232,241,-9
48,27,48,49,59,42,17
48,27,48,53,56,81,-25
48,27,48,55,41,0,41
48,27,48,61,119,96,23
48,27,48,85,181,261,-80
48,27,48,91,74,96,-22
48,27,48,99,3571,3560,11
48,27,48,113,644,657,-13
48,27,48,121,206,205,1
48,27,48,135,54,39,15
48,27,48,139,71,56,15
48,27,48,141,702,510,192
48,27,48,143,42,51,-9
48,27,48,145,191,185,6
48,27,48,157,104,129,-25
48,27,48,167,114,104,10
48,27,48,181,54,57,-3
48,27,48,183,54,51,3
48,27,48,187,109,98,11
48,27,48,193,45,0,45
48,27,48,199,0,39,-39
48,27,48,201,876,986,-110
48,27,48,209,106,160,-54
48,27,48,213,51,41,10
48,27,48,215,164,147,17
48,27,48,217,35,44,-9
48,27,48,221,0,48,-48
48,27,48,231,40,42,-2
48,27,48,245,95,77,18
48,27,48,251,108,68,40
48,27,48,257,49,45,4
48,27,48,265,47,40,7
48,27,48,273,29,0,29
48,27,48,281,271,387,-116
48,27,48,293,0,33,-33
48,27,48,303,176,61,115
48,27,48,309,841,924,-83
48,27,48,325,37,0,37
48,27,48,329,70,78,-8
48,27,48,331,268,250,18
48,27,48,339,120,134,-14
48,27,48,347,43,0,43
48,27,48,349,34,0,34
48,27,48,355,152,154,-2
48,27,48,363,0,37,-37
48,27,48,367,31,54,-23
48,27,48,373,0,44,-44
48,27,48,375,36,48,-12
48,27,48,381,49,38,11
48,27,48,409,42,27,15
48,27,48,423,93,83,10
48,27,48,439,592,745,-153
48,27,48,441,113,104,9
48,27,48,451,123,87,36
48,27,48,453,897,1315,-418
48,27,48,465,0,43,-43
48,27,48,469,56,63,-7
48,27,48,471,31,38,-7
48,27,48,477,23,0,23
48,27,48,479,0,60,-60
48,27,48,485,175,86,89
48,27,48,491,978,1376,-398
48,27,48,493,0,31,-31
48,27,49,11,39,0,39
48,27,49,35,45,45,0
48,27,49,57,34,0,34
48,27,51,41,69,83,-14
48,27,51,59,190,303,-113
48,27,51,149,100,75,25
48,27,51,153,79,68,11
48,27,51,199,0,33,-33
48,27,51,510,0,30,-30
48,27,51,650,38,50,-12
48,27,51,670,35,33,2
48,27,51,700,154,182,-28
48,27,51,710,55,0,55
48,27,51,730,51,33,18
48,27,51,740,34,0,34
48,27,51,810,95,76,19
48,27,53,11,31,0,31
48,27,53,33,80,96,-16
48,27,53,35,28,0,28
48,27,53,53,378,495,-117
48,27,53,61,32,43,-11
48,27,53,63,38,43,-5
48,27,53,67,94,137,-43
48,27,55,79,66,34,32
48,29,1,1,47,54,-7
48,29,1,3,0,37,-37
48,29,1,45,45,43,2
48,29,1,73,64,39,25
48,29,1,81,41,0,41
48,29,1,89,55,88,-33
48,29,1,97,53,45,8
48,29,1,101,115,121,-6
48,29,2,20,340,266,74
48,29,2,90,144,153,-9
48,29,4,3,91,175,-84
48,29,4,13,1324,772,552
48,29,4,15,33,29,4
48,29,4,19,354,319,35
48,29,4,21,59,43,16
48,29,4,25,37,45,-8
48,29,4,27,89,63,26
48,29,5,7,44,73,-29
48,29,5,31,36,0,36
48,29,5,45,38,0,38
48,29,5,85,39,35,4
48,29,5,119,197,124,73
48,29,5,143,52,56,-4
48,29,6,1,205,156,49
48,29,6,13,137,64,73
48,29,6,19,84,55,29
48,29,6,29,151,87,64
48,29,6,31,35,0,35
48,29,6,37,3364,936,2428
48,29,6,47,51,0,51
48,29,6,53,282,159,123
48,29,6,59,801,301,500
48,29,6,61,40,43,-3
48,29,6,65,699,253,446
48,29,6,67,249,140,109
48,29,6,71,1012,334,678
48,29,6,73,1306,732,574
48,29,6,75,86,76,10
48,29,6,77,129,0,129
48,29,6,79,46,0,46
48,29,6,81,44,42,2
48,29,6,83,132,76,56
48,29,6,85,294,141,153
48,29,6,95,289,228,61
48,29,6,97,55,27,28
48,29,6,99,153,43,110
48,29,6,107,0,44,-44
48,29,6,111,220,50,170
48,29,6,115,55,46,9
48,29,8,1,83,66,17
48,29,8,5,143,155,-12
48,29,8,13,39,76,-37
48,29,8,14,37,0,37
48,29,8,31,159,156,3
48,29,8,35,93,113,-20
48,29,8,41,610,581,29
48,29,8,59,100,90,10
48,29,8,69,60,34,26
48,29,8,101,0,33,-33
48,29,8,123,73,53,20
48,29,9,1,41,40,1
48,29,9,3,80,99,-19
48,29,9,9,79,29,50
48,29,9,11,36,0,36
48,29,10,1,98,39,59
48,29,10,3,48,48,0
48,29,11,1,147,129,18
48,29,12,1,45,51,-6
48,29,12,5,114,106,8
48,29,12,9,206,122,84
48,29,12,11,285,156,129
48,29,12,19,57,0,57
48,29,12,21,61,0,61
48,29,12,31,278,188,90
48,29,12,33,236,94,142
48,29,12,53,30,0,30
48,29,12,57,396,286,110
48,29,12,69,62,42,20
48,29,12,71,103,50,53
48,29,12,73,52,27,25
48,29,12,81,77,27,50
48,29,12,83,40,37,3
48,29,12,86,421,243,178
48,29,12,91,253,274,-21
48,29,12,95,278,162,116
48,29,12,97,95,0,95
48,29,12,99,164,133,31
48,29,12,101,88,41,47
48,29,12,103,138,108,30
48,29,12,105,72,26,46
48,29,12,109,38,0,38
48,29,12,111,72,0,72
48,29,12,113,85,94,-9
48,29,12,115,86,0,86
48,29,12,117,77,70,7
48,29,12,127,75,71,4
48,29,13,51,99,65,34
48,29,13,53,67,97,-30
48,29,13,57,48,0,48
48,29,13,59,29,0,29
48,29,13,63,40,27,13
48,29,13,67,183,118,65
48,29,13,73,71,103,-32
48,29,13,89,78,84,-6
48,29,13,117,0,66,-66
48,29,13,121,194,160,34
48,29,13,135,125,57,68
48,29,13,151,42,37,5
48,29,13,153,143,103,40
48,29,13,179,140,166,-26
48,29,13,185,80,36,44
48,29,13,215,161,123,38
48,29,13,245,147,126,21
48,29,15,1,0,29,-29
48,29,15,3,894,591,303
48,29,15,9,44,26,18
48,29,16,1,79,57,22
48,29,16,27,54,0,54
48,29,17,19,0,35,-35
48,29,17,31,775,462,313
48,29,17,43,153,107,46
48,29,17,77,28,0,28
48,29,17,89,104,38,66
48,29,17,97,133,71,62
48,29,17,111,63,0,63
48,29,17,113,40,0,40
48,29,17,119,63,0,63
48,29,17,143,33,0,33
48,29,17,161,43,0,43
48,29,17,163,213,95,118
48,29,17,197,97,55,42
48,29,17,201,48,0,48
48,29,18,3,30,0,30
48,29,18,57,45,31,14
48,29,18,89,93,0,93
48,29,18,97,140,93,47
48,29,18,157,31,0,31
48,29,19,13,0,31,-31
48,29,19,103,42,34,8
48,29,19,113,0,23,-23
48,29,19,153,78,32,46
48,29,19,163,73,50,23
48,29,20,45,30,0,30
48,29,20,61,114,108,6
48,29,20,91,145,121,24
48,29,20,103,59,78,-19
48,29,20,161,78,47,31
48,29,20,173,195,131,64
48,29,20,177,42,0,42
48,29,21,47,113,143,-30
48,29,21,67,38,0,38
48,29,21,93,81,86,-5
48,29,21,111,80,97,-17
48,29,22,15,143,134,9
48,29,22,17,122,78,44
48,29,22,19,51,50,1
48,29,22,33,124,120,4
48,29,22,51,191,127,64
48,29,22,55,52,61,-9
48,29,22,71,130,401,-271
48,29,22,73,42,0,42
48,29,22,79,37,40,-3
48,29,22,103,44,67,-23
48,29,22,115,242,108,134
48,29,24,3,250,277,-27
48,29,24,5,100,32,68
48,29,24,17,43,40,3
48,29,24,21,68,64,4
48,29,24,25,53,0,53
48,29,24,27,122,58,64
48,29,24,31,370,250,120
48,29,24,33,184,111,73
48,29,24,510,45,34,11
48,29,25,9,29,0,29
48,29,25,13,35,0,35
48,29,25,17,143,125,18
48,29,25,21,53,0,53
48,29,25,25,50,61,-11
48,29,25,27,54,38,16
48,29,26,49,46,0,46
48,29,26,65,57,43,14
48,29,26,75,28,0,28
48,29,26,77,35,0,35
48,29,26,81,96,0,96
48,29,26,99,95,0,95
48,29,26,125,137,65,72
48,29,26,139,63,0,63
48,29,26,145,92,32,60
48,29,26,161,56,33,23
48,29,26,163,211,66,145
48,29,27,37,44,86,-42
48,29,27,53,170,94,76
48,29,27,123,59,37,22
48,29,28,33,42,0,42
48,29,28,35,40,0,40
48,29,28,47,150,171,-21
48,29,28,49,34,0,34
48,29,28,59,37,95,-58
48,29,28,87,28,85,-57
48,29,29,19,60,34,26
48,29,29,47,29,25,4
48,29,29,77,50,44,6
48,29,29,95,131,57,74
48,29,29,101,40,32,8
48,29,29,169,60,99,-39
48,29,29,183,69,47,22
48,29,29,189,197,154,43
48,29,29,510,44,0,44
48,29,30,13,57,34,23
48,29,30,31,32,0,32
48,29,31,55,159,103,56
48,29,31,109,61,0,61
48,29,31,153,172,258,-86
48,29,32,3,739,644,95
48,29,32,31,105,62,43
48,29,33,11,45,0,45
48,29,34,3,45,0,45
48,29,34,5,145,55,90
48,29,34,7,34,0,34
48,29,34,13,48,0,48
48,29,34,17,59,54,5
48,29,34,21,22,0,22
48,29,34,23,65,46,19
48,29,34,25,37,0,37
48,29,34,27,32,28,4
48,29,34,35,56,0,56
48,29,35,1,359,368,-9
48,29,35,5,0,40,-40
48,29,35,9,84,56,28
48,29,35,13,139,90,49
48,29,35,35,85,57,28
48,29,35,43,67,78,-11
48,29,35,49,47,38,9
48,29,36,1,28,0,28
48,29,36,5,101,47,54
48,29,36,29,96,57,39
48,29,36,45,190,178,12
48,29,36,47,128,100,28
48,29,36,55,86,0,86
48,29,36,59,82,26,56
48,29,36,61,122,179,-57
48,29,36,67,46,34,12
48,29,36,71,68,60,8
48,29,36,81,129,92,37
48,29,36,103,117,39,78
48,29,36,119,36,0,36
48,29,37,49,28,28,0
48,29,37,51,368,439,-71
48,29,37,63,47,35,12
48,29,37,67,37,50,-13
48,29,37,81,43,66,-23
48,29,37,85,0,60,-60
48,29,37,93,52,42,10
48,29,37,119,123,147,-24
48,29,37,133,158,168,-10
48,29,37,183,121,87,34
48,29,37,191,76,0,76
48,29,38,15,34,0,34
48,29,38,35,47,38,9
48,29,38,101,73,52,21
48,29,39,17,55,0,55
48,29,39,35,153,58,95
48,29,39,41,33,0,33
48,29,39,49,182,113,69
48,29,39,57,116,106,10
48,29,39,61,75,54,21
48,29,39,95,55,0,55
48,29,39,113,186,106,80
48,29,39,151,32,0,32
48,29,39,153,38,0,38
48,29,39,165,31,0,31
48,29,40,27,145,114,31
48,29,40,31,171,163,8
48,29,40,47,51,50,1
48,29,40,65,172,0,172
48,29,40,109,353,308,45
48,29,40,119,24,0,24
48,29,40,143,152,132,20
48,29,41,5,0,43,-43
48,29,41,39,26,51,-25
48,29,41,47,26,0,26
48,29,41,51,64,115,-51
48,29,41,67,87,92,-5
48,29,42,3,76,59,17
48,29,42,17,62,36,26
48,29,42,29,35,38,-3
48,29,42,41,34,35,-1
48,29,42,43,50,27,23
48,29,42,77,33,0,33
48,29,42,91,58,59,-1
48,29,42,101,79,56,23
48,29,42,133,34,0,34
48,29,44,7,28,0,28
48,29,45,13,53,42,11
48,29,45,15,0,33,-33
48,29,45,19,57,48,9
48,29,45,35,0,31,-31
48,29,45,45,41,0,41
48,29,45,51,56,0,56
48,29,45,79,180,87,93
48,29,45,85,84,66,18
48,29,45,91,0,37,-37
48,29,46,93,0,28,-28
48,29,46,99,38,32,6
48,29,46,103,65,0,65
48,29,47,37,84,137,-53
48,29,47,93,50,40,10
48,29,47,125,291,197,94
48,29,47,149,25,0,25
48,29,47,157,191,108,83
48,29,47,187,36,42,-6
48,29,48,1,40,39,1
48,29,48,5,77,46,31
48,29,48,7,152,139,13
48,29,48,13,2015,1912,103
48,29,48,15,0,50,-50
48,29,48,19,515,676,-161
48,29,48,21,102,143,-41
48,29,48,25,114,99,15
48,29,48,27,1226,1037,189
48,29,48,31,73,121,-48
48,29,48,37,45,33,12
48,29,48,39,300,255,45
48,29,48,41,434,332,102
48,29,48,43,41,0,41
48,29,48,49,73,43,30
48,29,48,53,155,144,11
48,29,48,55,135,100,35
48,29,48,57,0,37,-37
48,29,48,61,1178,878,300
48,29,48,73,29,0,29
48,29,48,85,641,748,-107
48,29,48,89,42,0,42
48,29,48,91,2463,3861,-1398
48,29,48,99,273,256,17
48,29,48,113,1999,1787,212
48,29,48,117,43,0,43
48,29,48,121,597,661,-64
48,29,48,123,67,61,6
48,29,48,127,89,104,-15
48,29,48,131,62,50,12
48,29,48,135,156,150,6
48,29,48,139,96,87,9
48,29,48,141,1746,1015,731
48,29,48,143,26,54,-28
48,29,48,149,28,0,28
48,29,48,157,514,549,-35
48,29,48,163,275,207,68
48,29,48,165,32,0,32
48,29,48,167,320,323,-3
48,29,48,171,130,190,-60
48,29,48,177,81,97,-16
48,29,48,181,46,51,-5
48,29,48,183,65,69,-4
48,29,48,187,3271,5874,-2603
48,29,48,189,59,0,59
48,29,48,201,3937,3838,99
48,29,48,203,28,0,28
48,29,48,209,920,857,63
48,29,48,215,1424,1208,216
48,29,48,221,29,49,-20
48,29,48,223,28,0,28
48,29,48,227,28,47,-19
48,29,48,231,61,56,5
48,29,48,239,46,0,46
48,29,48,245,227,155,72
48,29,48,247,34,26,8
48,29,48,249,180,104,76
48,29,48,251,88,112,-24
48,29,48,255,156,138,18
48,29,48,257,37,40,-3
48,29,48,259,885,1653,-768
48,29,48,265,458,368,90
48,29,48,267,0,25,-25
48,29,48,271,24,0,24
48,29,48,273,151,97,54
48,29,48,277,31,0,31
48,29,48,281,36,0,36
48,29,48,283,65,49,16
48,29,48,285,0,24,-24
48,29,48,297,44,67,-23
48,29,48,299,53,82,-29
48,29,48,303,473,333,140
48,29,48,309,383,256,127
48,29,48,321,76,0,76
48,29,48,323,744,591,153
48,29,48,325,1703,1916,-213
48,29,48,329,241,153,88
48,29,48,339,327,420,-93
48,29,48,347,70,33,37
48,29,48,355,2082,1336,746
48,29,48,361,59,39,20
48,29,48,367,55,69,-14
48,29,48,371,0,34,-34
48,29,48,373,61,27,34
48,29,48,375,121,82,39
48,29,48,381,118,78,40
48,29,48,389,37,0,37
48,29,48,397,57,71,-14
48,29,48,409,329,295,34
48,29,48,423,139,167,-28
48,29,48,427,48,80,-32
48,29,48,439,1497,1497,0
48,29,48,441,407,224,183
48,29,48,451,460,323,137
48,29,48,453,3164,3614,-450
48,29,48,463,359,206,153
48,29,48,465,618,416,202
48,29,48,469,357,207,150
48,29,48,471,45,51,-6
48,29,48,473,26,35,-9
48,29,48,477,28,0,28
48,29,48,479,1705,852,853
48,29,48,481,51,0,51
48,29,48,485,237,170,67
48,29,48,489,60,32,28
48,29,48,491,936,1183,-247
48,29,48,493,1436,1954,-518
48,29,48,499,0,26,-26
48,29,48,507,94,43,51
48,29,49,11,146,68,78
48,29,49,35,197,149,48
48,29,49,49,128,103,25
48,29,49,57,57,28,29
48,29,51,13,86,103,-17
48,29,51,41,50,30,20
48,29,51,59,486,426,60
48,29,51,87,62,42,20
48,29,51,107,121,74,47
48,29,51,149,38,0,38
48,29,51,153,126,171,-45
48,29,51,177,46,0,46
48,29,51,179,73,33,40
48,29,51,199,82,68,14
48,29,51,510,66,85,-19
48,29,51,550,70,50,20
48,29,51,650,98,70,28
48,29,51,700,147,142,5
48,29,51,710,144,69,75
48,29,51,760,31,0,31
48,29,51,810,247,154,93
48,29,53,11,67,53,14
48,29,53,29,54,41,13
48,29,53,33,284,297,-13
48,29,53,35,85,55,30
48,29,53,53,551,540,11
48,29,53,57,0,33,-33
48,29,53,61,170,135,35
48,29,53,63,100,93,7
48,29,53,67,96,144,-48
48,29,53,73,38,0,38
48,29,53,77,0,32,-32
48,29,55,9,28,0,28
48,29,55,25,44,39,5
48,29,55,59,45,0,45
48,29,55,79,129,98,31
48,29,55,133,71,0,71
48,29,56,21,112,80,32
48,31,48,29,121,73,48
48,31,48,53,66,66,0
48,31,48,91,74,66,8
48,31,48,209,80,56,24
48,31,48,453,103,83,20
48,31,48,491,0,26,-26
48,35,48,27,0,37,-37
48,35,48,99,0,45,-45
48,35,48,113,52,29,23
48,35,48,121,0,26,-26
48,35,48,143,32,0,32
48,35,48,193,0,33,-33
48,35,48,201,29,0,29
48,35,48,217,128,184,-56
48,35,48,221,46,44,2
48,35,48,251,100,121,-21
48,35,48,309,344,429,-85
48,35,48,425,41,59,-18
48,35,48,439,130,60,70
48,37,4,13,39,0,39
48,37,5,7,0,30,-30
48,37,5,19,42,0,42
48,37,5,27,49,32,17
48,37,5,45,31,0,31
48,37,5,51,89,43,46
48,37,5,57,113,74,39
48,37,5,61,0,32,-32
48,37,5,73,39,0,39
48,37,5,81,137,131,6
48,37,5,91,1973,1923,50
48,37,5,99,34,0,34
48,37,5,119,66,123,-57
48,37,5,125,0,30,-30
48,37,5,133,46,0,46
48,37,5,139,35,0,35
48,37,5,143,45,46,-1
48,37,6,37,36,0,36
48,37,22,15,0,53,-53
48,37,22,17,64,62,2
48,37,40,89,60,48,12
48,37,40,109,30,0,30
48,37,48,27,44,0,44
48,37,48,29,33,45,-12
48,37,48,67,421,321,100
48,37,48,85,41,89,-48
48,37,48,113,313,296,17
48,37,48,121,80,93,-13
48,37,48,183,53,73,-20
48,37,48,201,74,126,-52
48,37,48,203,0,57,-57
48,37,48,339,0,37,-37
48,37,48,343,69,0,69
48,37,48,387,82,91,-9
48,37,48,423,85,86,-1
48,37,48,439,135,163,-28
48,37,48,449,41,57,-16
48,37,48,453,0,34,-34
48,39,4,13,102,56,46
48,39,6,1,38,0,38
48,39,6,13,0,41,-41
48,39,6,37,217,85,132
48,39,6,59,59,0,59
48,39,6,65,70,0,70
48,39,6,71,49,0,49
48,39,6,73,128,66,62
48,39,6,85,0,52,-52
48,39,8,41,45,43,2
48,39,12,11,72,0,72
48,39,12,31,40,0,40
48,39,12,86,62,0,62
48,39,12,95,50,0,50
48,39,12,99,37,0,37
48,39,15,3,31,34,-3
48,39,17,31,82,59,23
48,39,17,43,35,0,35
48,39,22,15,39,0,39
48,39,22,19,45,70,-25
48,39,22,33,133,52,81
48,39,22,51,71,38,33
48,39,22,55,33,42,-9
48,39,22,71,0,81,-81
48,39,22,103,38,0,38
48,39,22,109,36,0,36
48,39,24,33,35,0,35
48,39,26,111,0,57,-57
48,39,26,125,32,0,32
48,39,26,163,81,0,81
48,39,32,3,85,49,36
48,39,35,1,50,0,50
48,39,37,51,33,0,33
48,39,39,35,59,0,59
48,39,40,109,28,0,28
48,39,40,143,54,47,7
48,39,47,125,47,0,47
48,39,48,1,0,40,-40
48,39,48,5,59,43,16
48,39,48,7,38,0,38
48,39,48,15,25,46,-21
48,39,48,27,105,119,-14
48,39,48,29,255,300,-45
48,39,48,41,138,114,24
48,39,48,57,0,55,-55
48,39,48,61,153,111,42
48,39,48,71,39,41,-2
48,39,48,85,102,96,6
48,39,48,91,30,73,-43
48,39,48,113,159,171,-12
48,39,48,121,129,124,5
48,39,48,141,58,51,7
48,39,48,157,1740,1485,255
48,39,48,167,1739,2013,-274
48,39,48,183,52,35,17
48,39,48,187,49,43,6
48,39,48,199,40,47,-7
48,39,48,201,12056,7975,4081
48,39,48,209,58,73,-15
48,39,48,215,242,181,61
48,39,48,225,0,40,-40
48,39,48,245,235,149,86
48,39,48,265,0,42,-42
48,39,48,291,61,124,-63
48,39,48,303,59,35,24
48,39,48,309,49,47,2
48,39,48,321,432,384,48
48,39,48,329,24,37,-13
48,39,48,331,0,37,-37
48,39,48,339,296,491,-195
48,39,48,347,30,0,30
48,39,48,355,132,123,9
48,39,48,361,50,59,-9
48,39,48,373,45,78,-33
48,39,48,407,0,44,-44
48,39,48,409,49,39,10
48,39,48,423,47,49,-2
48,39,48,439,228,207,21
48,39,48,441,47,35,12
48,39,48,453,245,321,-76
48,39,48,455,0,32,-32
48,39,48,469,116,141,-25
48,39,48,471,91,100,-9
48,39,48,477,0,29,-29
48,39,48,481,86,94,-8
48,39,48,491,91,156,-65
48,39,49,49,39,0,39
48,39,51,810,36,0,36
48,39,53,33,33,39,-6
48,41,4,13,85,57,28
48,41,4,19,30,0,30
48,41,5,119,27,0,27
48,41,6,1,0,29,-29
48,41,6,37,81,105,-24
48,41,6,59,38,0,38
48,41,6,71,26,30,-4
48,41,6,73,81,80,1
48,41,6,85,0,83,-83
48,41,8,31,0,20,-20
48,41,8,41,0,42,-42
48,41,12,1,0,35,-35
48,41,12,11,30,0,30
48,41,12,33,31,0,31
48,41,12,95,34,0,34
48,41,13,121,0,26,-26
48,41,17,31,24,33,-9
48,41,20,173,43,0,43
48,41,22,33,0,32,-32
48,41,22,71,0,36,-36
48,41,24,33,33,0,33
48,41,25,17,0,28,-28
48,41,27,53,31,0,31
48,41,32,3,44,38,6
48,41,36,61,22,50,-28
48,41,37,183,0,37,-37
48,41,39,49,0,31,-31
48,41,40,109,31,0,31
48,41,40,143,0,28,-28
48,41,48,1,41,0,41
48,41,48,5,67,40,27
48,41,48,15,37,0,37
48,41,48,21,49,33,16
48,41,48,27,241,232,9
48,41,48,29,332,434,-102
48,41,48,39,114,138,-24
48,41,48,51,508,376,132
48,41,48,53,30,0,30
48,41,48,55,35,0,35
48,41,48,61,75,35,40
48,41,48,71,29,0,29
48,41,48,85,157,233,-76
48,41,48,91,29,61,-32
48,41,48,99,40,0,40
48,41,48,113,402,580,-178
48,41,48,121,171,297,-126
48,41,48,135,36,30,6
48,41,48,139,32,40,-8
48,41,48,141,78,31,47
48,41,48,143,27,29,-2
48,41,48,149,34,0,34
48,41,48,157,216,306,-90
48,41,48,167,124,153,-29
48,41,48,183,57,52,5
48,41,48,185,555,412,143
48,41,48,187,34,52,-18
48,41,48,201,1569,2466,-897
48,41,48,203,28,0,28
48,41,48,209,60,130,-70
48,41,48,213,37,0,37
48,41,48,215,81,55,26
48,41,48,221,33,0,33
48,41,48,231,41,0,41
48,41,48,245,67,69,-2
48,41,48,251,34,38,-4
48,41,48,257,24,28,-4
48,41,48,265,24,0,24
48,41,48,281,30,0,30
48,41,48,285,26,0,26
48,41,48,287,59,49,10
48,41,48,289,112,95,17
48,41,48,291,44,31,13
48,41,48,303,67,105,-38
48,41,48,309,189,194,-5
48,41,48,313,149,94,55
48,41,48,321,37,0,37
48,41,48,329,39,34,5
48,41,48,331,107,91,16
48,41,48,339,341,395,-54
48,41,48,347,0,36,-36
48,41,48,355,154,122,32
48,41,48,361,34,0,34
48,41,48,367,39,31,8
48,41,48,373,34,0,34
48,41,48,381,35,47,-12
48,41,48,395,542,419,123
48,41,48,397,0,30,-30
48,41,48,423,98,84,14
48,41,48,439,345,430,-85
48,41,48,441,61,45,16
48,41,48,451,82,32,50
48,41,48,453,439,690,-251
48,41,48,469,62,44,18
48,41,48,471,149,136,13
48,41,48,473,51,24,27
48,41,48,477,223,178,45
48,41,48,479,37,0,37
48,41,48,481,43,27,16
48,41,48,485,25,0,25
48,41,48,491,238,334,-96
48,41,48,493,0,28,-28
48,41,51,13,0,37,-37
48,41,51,59,0,76,-76
48,41,53,33,0,44,-44
48,43,48,29,0,41,-41
48,43,48,135,0,53,-53
48,43,48,141,59,50,9
48,43,48,329,52,149,-97
48,43,48,371,0,44,-44
48,43,48,377,89,64,25
48,43,48,451,0,22,-22
48,43,48,453,0,42,-42
48,47,48,215,57,58,-1
48,47,48,249,95,106,-11
48,47,48,273,67,41,26
48,47,48,355,47,57,-10
48,49,48,27,42,59,-17
48,49,48,29,43,73,-30
48,49,48,59,38,24,14
48,49,48,83,101,120,-19
48,49,48,85,40,0,40
48,49,48,93,102,99,3
48,49,48,113,77,63,14
48,49,48,121,33,35,-2
48,49,48,133,111,48,63
48,49,48,135,29,53,-24
48,49,48,143,78,78,0
48,49,48,201,45,34,11
48,49,48,221,0,43,-43
48,49,48,303,44,30,14
48,49,48,307,41,30,11
48,49,48,309,0,42,-42
48,49,48,329,33,38,-5
48,49,48,333,43,38,5
48,49,48,355,0,39,-39
48,49,48,411,62,0,62
48,49,48,439,130,107,23
48,49,48,441,138,176,-38
48,49,48,451,51,87,-36
48,49,48,453,70,117,-47
48,49,48,491,35,70,-35
48,51,48,41,376,508,-132
48,51,48,201,114,75,39
48,51,48,287,37,49,-12
48,51,48,331,40,53,-13
48,51,48,453,44,0,44
48,51,48,477,66,67,-1
48,51,48,491,30,0,30
48,53,4,13,41,0,41
48,53,48,21,0,22,-22
48,53,48,27,81,56,25
48,53,48,29,144,155,-11
48,53,48,31,66,66,0
48,53,48,41,0,30,-30
48,53,48,61,0,33,-33
48,53,48,85,35,0,35
48,53,48,91,0,55,-55
48,53,48,99,39,51,-12
48,53,48,113,61,44,17
48,53,48,201,217,116,101
48,53,48,209,61,47,14
48,53,48,265,46,0,46
48,53,48,281,64,45,19
48,53,48,299,453,460,-7
48,53,48,303,42,32,10
48,53,48,309,27,0,27
48,53,48,339,30,0,30
48,53,48,439,39,74,-35
48,53,48,453,607,452,155
48,53,48,491,446,440,6
48,55,48,21,211,127,84
48,55,48,27,0,41,-41
48,55,48,29,100,135,-35
48,55,48,41,0,35,-35
48,55,48,91,0,53,-53
48,55,48,113,0,27,-27
48,55,48,177,97,91,6
48,55,48,187,148,199,-51
48,55,48,201,91,94,-3
48,55,48,209,751,873,-122
48,55,48,355,50,0,50
48,55,48,439,0,40,-40
48,55,48,453,926,616,310
48,55,48,491,125,121,4
48,57,48,29,37,0,37
48,57,48,39,55,0,55
48,57,48,113,29,0,29
48,57,48,157,0,30,-30
48,57,48,167,31,0,31
48,57,48,201,130,101,29
48,57,48,215,0,33,-33
48,57,48,239,69,62,7
48,57,48,321,66,45,21
48,57,48,355,42,81,-39
48,57,48,453,33,25,8
48,57,48,469,252,455,-203
48,59,48,49,24,38,-14
48,59,48,133,51,55,-4
48,59,48,253,57,56,1
48,59,48,439,38,34,4
48,59,48,441,690,655,35
48,59,48,451,0,37,-37
48,61,4,13,65,83,-18
48,61,4,19,48,54,-6
48,61,6,37,112,63,49
48,61,6,59,30,0,30
48,61,6,65,46,0,46
48,61,6,71,75,33,42
48,61,6,73,145,85,60
48,61,6,111,0,33,-33
48,61,8,31,0,23,-23
48,61,8,41,54,55,-1
48,61,12,11,53,0,53
48,61,12,21,136,67,69
48,61,12,31,38,0,38
48,61,12,57,296,92,204
48,61,12,71,137,60,77
48,61,12,81,184,74,110
48,61,12,86,133,51,82
48,61,12,95,35,29,6
48,61,12,99,126,41,85
48,61,12,105,37,0,37
48,61,13,67,42,0,42
48,61,13,139,43,0,43
48,61,15,3,0,32,-32
48,61,17,31,136,37,99
48,61,22,51,48,44,4
48,61,26,81,36,0,36
48,61,27,85,42,0,42
48,61,31,55,36,0,36
48,61,32,3,59,82,-23
48,61,40,109,44,0,44
48,61,40,143,32,34,-2
48,61,48,7,0,46,-46
48,61,48,27,96,119,-23
48,61,48,29,878,1178,-300
48,61,48,39,111,153,-42
48,61,48,41,35,75,-40
48,61,48,53,33,0,33
48,61,48,85,64,112,-48
48,61,48,91,0,71,-71
48,61,48,113,490,378,112
48,61,48,121,75,96,-21
48,61,48,139,0,57,-57
48,61,48,141,130,164,-34
48,61,48,157,84,153,-69
48,61,48,167,101,148,-47
48,61,48,183,0,40,-40
48,61,48,187,0,56,-56
48,61,48,201,1485,1813,-328
48,61,48,209,60,104,-44
48,61,48,215,2051,2569,-518
48,61,48,245,54,78,-24
48,61,48,249,0,42,-42
48,61,48,273,79,64,15
48,61,48,303,55,47,8
48,61,48,309,0,38,-38
48,61,48,323,45,0,45
48,61,48,339,55,94,-39
48,61,48,355,345,385,-40
48,61,48,373,29,0,29
48,61,48,409,76,98,-22
48,61,48,423,39,43,-4
48,61,48,427,75,50,25
48,61,48,439,246,313,-67
48,61,48,453,422,581,-159
48,61,48,469,0,36,-36
48,61,48,479,141,144,-3
48,61,48,489,398,333,65
48,61,48,491,80,191,-111
48,61,51,13,32,0,32
48,61,51,59,64,42,22
48,61,51,107,0,44,-44
48,61,51,153,44,0,44
48,61,51,810,31,0,31
48,63,48,113,67,79,-12
48,63,48,159,64,57,7
48,63,48,183,70,106,-36
48,63,48,223,30,0,30
48,63,48,343,100,40,60
48,63,48,423,0,35,-35
48,63,48,439,40,0,40
48,63,48,449,211,202,9
48,63,48,459,63,68,-5
48,63,48,499,58,0,58
48,65,48,179,78,83,-5
48,65,48,233,53,51,2
48,65,48,375,131,123,8
48,65,48,381,109,126,-17
48,67,5,91,148,132,16
48,67,22,15,31,0,31
48,67,22,17,78,85,-7
48,67,48,37,321,421,-100
48,67,48,85,35,0,35
48,67,48,113,74,67,7
48,67,48,183,112,132,-20
48,67,48,201,50,0,50
48,67,48,203,73,90,-17
48,67,48,315,111,65,46
48,67,48,343,175,184,-9
48,67,48,423,35,65,-30
48,67,48,439,43,40,3
48,67,48,449,51,59,-8
48,67,48,459,45,40,5
48,69,48,117,41,86,-45
48,69,48,189,33,71,-38
48,69,48,279,43,0,43
48,69,48,303,42,82,-40
48,69,48,369,0,43,-43
48,69,48,375,34,77,-43
48,69,48,381,49,94,-45
48,71,48,39,41,39,2
48,71,48,41,0,29,-29
48,71,48,157,38,0,38
48,71,48,167,91,84,7
48,71,48,199,56,59,-3
48,71,48,201,2222,1732,490
48,71,48,245,281,201,80
48,71,48,291,259,281,-22
48,71,48,339,52,51,1
48,71,48,361,57,0,57
48,71,48,439,0,22,-22
48,71,48,453,0,23,-23
48,73,48,1,203,192,11
48,73,48,5,157,139,18
48,73,48,29,0,29,-29
48,73,48,85,0,24,-24
48,73,48,113,91,124,-33
48,73,48,121,33,49,-16
48,73,48,167,0,35,-35
48,73,48,183,71,85,-14
48,73,48,201,141,101,40
48,73,48,213,101,144,-43
48,73,48,225,32,0,32
48,73,48,339,0,44,-44
48,73,48,347,57,146,-89
48,73,48,401,245,257,-12
48,73,48,423,751,839,-88
48,73,48,439,75,44,31
48,73,48,453,0,40,-40
48,73,48,491,0,36,-36
48,73,48,499,0,43,-43
48,75,48,191,34,0,34
48,75,48,197,42,0,42
48,75,48,375,0,50,-50
48,75,48,381,31,53,-22
48,75,48,439,0,30,-30
48,77,48,9,37,0,37
48,77,48,337,52,42,10
48,77,48,439,39,33,6
48,77,48,485,409,546,-137
48,79,48,219,52,125,-73
48,79,48,303,46,52,-6
48,81,48,451,85,107,-22
48,83,48,49,120,101,19
48,83,48,439,28,0,28
48,83,48,441,50,65,-15
48,83,48,451,32,29,3
48,85,1,3,0,45,-45
48,85,1,73,73,0,73
48,85,1,89,42,55,-13
48,85,1,101,31,0,31
48,85,1,117,42,0,42
48,85,2,20,56,37,19
48,85,4,13,679,527,152
48,85,4,19,210,123,87
48,85,5,7,94,100,-6
48,85,5,51,47,27,20
48,85,5,69,31,0,31
48,85,5,91,41,0,41
48,85,5,119,209,123,86
48,85,5,125,38,0,38
48,85,5,131,62,0,62
48,85,5,143,93,53,40
48,85,6,1,263,199,64
48,85,6,13,139,37,102
48,85,6,19,53,0,53
48,85,6,29,50,0,50
48,85,6,37,1413,569,844
48,85,6,53,42,0,42
48,85,6,59,656,261,395
48,85,6,61,33,38,-5
48,85,6,65,319,112,207
48,85,6,67,126,60,66
48,85,6,71,315,123,192
48,85,6,73,532,324,208
48,85,6,75,60,62,-2
48,85,6,77,53,0,53
48,85,6,81,76,66,10
48,85,6,85,391,369,22
48,85,6,95,65,34,31
48,85,6,97,35,0,35
48,85,6,99,49,33,16
48,85,6,111,161,70,91
48,85,8,1,63,81,-18
48,85,8,5,90,87,3
48,85,8,13,35,61,-26
48,85,8,31,104,85,19
48,85,8,35,171,120,51
48,85,8,41,144,100,44
48,85,8,59,79,82,-3
48,85,8,69,55,48,7
48,85,9,1,104,98,6
48,85,9,3,113,50,63
48,85,9,9,48,27,21
48,85,10,3,51,41,10
48,85,11,1,28,30,-2
48,85,12,1,38,0,38
48,85,12,9,70,40,30
48,85,12,11,316,149,167
48,85,12,19,40,0,40
48,85,12,21,46,0,46
48,85,12,31,99,84,15
48,85,12,33,43,33,10
48,85,12,57,219,178,41
48,85,12,71,108,0,108
48,85,12,81,37,0,37
48,85,12,86,242,68,174
48,85,12,91,39,0,39
48,85,12,95,238,87,151
48,85,12,97,41,0,41
48,85,12,99,178,105,73
48,85,12,101,71,72,-1
48,85,12,103,80,65,15
48,85,12,105,59,37,22
48,85,12,115,51,31,20
48,85,12,117,89,51,38
48,85,12,127,44,0,44
48,85,13,51,48,0,48
48,85,13,67,177,127,50
48,85,13,89,144,64,80
48,85,13,117,70,43,27
48,85,13,121,232,128,104
48,85,13,135,165,60,105
48,85,13,179,30,0,30
48,85,15,3,101,104,-3
48,85,16,1,42,36,6
48,85,17,19,44,0,44
48,85,17,31,524,270,254
48,85,17,43,162,93,69
48,85,17,89,67,61,6
48,85,17,97,142,55,87
48,85,17,111,53,0,53
48,85,17,113,47,0,47
48,85,17,119,40,0,40
48,85,17,143,43,0,43
48,85,17,161,36,0,36
48,85,17,163,48,0,48
48,85,17,197,90,68,22
48,85,18,3,0,40,-40
48,85,18,57,64,111,-47
48,85,18,97,66,34,32
48,85,18,141,36,0,36
48,85,19,113,101,37,64
48,85,19,153,69,60,9
48,85,19,163,0,102,-102
48,85,20,91,272,135,137
48,85,20,173,162,66,96
48,85,21,67,0,30,-30
48,85,21,111,56,0,56
48,85,22,15,95,44,51
48,85,22,17,138,107,31
48,85,22,19,39,31,8
48,85,22,33,138,83,55
48,85,22,51,160,111,49
48,85,22,55,66,66,0
48,85,22,61,34,0,34
48,85,22,71,100,181,-81
48,85,22,73,63,36,27
48,85,22,79,38,0,38
48,85,22,103,87,36,51
48,85,22,115,35,0,35
48,85,24,3,74,36,38
48,85,24,5,57,0,57
48,85,24,21,28,0,28
48,85,24,27,70,43,27
48,85,24,31,92,100,-8
48,85,24,33,79,53,26
48,85,24,510,39,24,15
48,85,25,17,174,144,30
48,85,25,21,54,0,54
48,85,25,25,81,59,22
48,85,25,27,70,53,17
48,85,26,49,68,0,68
48,85,26,65,38,0,38
48,85,26,77,28,0,28
48,85,26,81,39,0,39
48,85,26,99,91,0,91
48,85,26,125,298,72,226
48,85,26,161,38,0,38
48,85,26,163,187,48,139
48,85,27,3,32,0,32
48,85,27,37,43,33,10
48,85,27,53,127,91,36
48,85,27,123,0,23,-23
48,85,28,33,30,0,30
48,85,28,49,51,0,51
48,85,28,121,59,0,59
48,85,29,19,35,0,35
48,85,29,47,33,0,33
48,85,29,77,74,0,74
48,85,29,95,118,71,47
48,85,29,165,37,0,37
48,85,29,183,105,58,47
48,85,29,189,223,115,108
48,85,29,510,31,28,3
48,85,31,55,149,90,59
48,85,31,109,38,0,38
48,85,31,153,54,0,54
48,85,32,3,381,269,112
48,85,32,31,49,55,-6
48,85,33,11,44,52,-8
48,85,34,3,103,37,66
48,85,34,5,43,0,43
48,85,34,7,47,0,47
48,85,34,13,48,0,48
48,85,34,17,76,67,9
48,85,34,21,40,0,40
48,85,34,23,111,91,20
48,85,34,25,61,0,61
48,85,34,27,72,59,13
48,85,34,29,47,0,47
48,85,34,35,54,0,54
48,85,35,1,115,89,26
48,85,35,9,32,0,32
48,85,35,13,46,36,10
48,85,36,5,28,0,28
48,85,36,29,65,35,30
48,85,36,47,89,63,26
48,85,36,55,91,51,40
48,85,36,59,118,33,85
48,85,36,61,119,165,-46
48,85,36,81,155,83,72
48,85,36,103,119,37,82
48,85,36,119,65,23,42
48,85,37,51,0,48,-48
48,85,37,63,33,28,5
48,85,37,67,31,0,31
48,85,37,81,50,40,10
48,85,37,119,156,133,23
48,85,37,133,30,38,-8
48,85,37,183,145,153,-8
48,85,39,17,34,0,34
48,85,39,35,90,64,26
48,85,39,41,39,0,39
48,85,39,49,215,111,104
48,85,39,61,53,33,20
48,85,39,113,51,0,51
48,85,39,153,57,0,57
48,85,39,165,62,0,62
48,85,40,13,107,72,35
48,85,40,17,53,36,17
48,85,40,27,196,114,82
48,85,40,31,51,47,4
48,85,40,109,480,319,161
48,85,40,119,66,0,66
48,85,40,121,0,30,-30
48,85,40,143,360,266,94
48,85,41,51,76,43,33
48,85,41,67,119,63,56
48,85,42,3,90,42,48
48,85,42,17,44,0,44
48,85,42,29,53,53,0
48,85,42,45,37,0,37
48,85,42,77,38,0,38
48,85,42,91,91,39,52
48,85,42,101,39,39,0
48,85,44,7,45,0,45
48,85,45,19,0,45,-45
48,85,45,45,39,0,39
48,85,45,51,30,0,30
48,85,45,79,61,0,61
48,85,45,91,56,0,56
48,85,47,37,99,80,19
48,85,47,125,35,0,35
48,85,47,157,214,73,141
48,85,47,187,65,117,-52
48,85,48,1,66,62,4
48,85,48,5,31,0,31
48,85,48,21,0,31,-31
48,85,48,27,261,181,80
48,85,48,29,748,641,107
48,85,48,37,89,41,48
48,85,48,39,96,102,-6
48,85,48,41,233,157,76
48,85,48,49,0,40,-40
48,85,48,53,0,35,-35
48,85,48,61,112,64,48
48,85,48,67,0,35,-35
48,85,48,73,24,0,24
48,85,48,91,35,65,-30
48,85,48,97,87,96,-9
48,85,48,113,33862,19836,14026
48,85,48,121,9690,10104,-414
48,85,48,135,65,48,17
48,85,48,139,333,370,-37
48,85,48,141,303,156,147
48,85,48,143,0,30,-30
48,85,48,147,370,538,-168
48,85,48,157,348,262,86
48,85,48,159,40,34,6
48,85,48,167,86,117,-31
48,85,48,181,1276,1194,82
48,85,48,183,178,106,72
48,85,48,187,48,32,16
48,85,48,201,1417,1421,-4
48,85,48,203,50,53,-3
48,85,48,209,115,136,-21
48,85,48,213,134,165,-31
48,85,48,215,67,74,-7
48,85,48,217,61,0,61
48,85,48,221,57,39,18
48,85,48,223,80,76,4
48,85,48,227,31,0,31
48,85,48,231,757,626,131
48,85,48,245,98,54,44
48,85,48,251,96,98,-2
48,85,48,257,361,339,22
48,85,48,265,25,0,25
48,85,48,277,99,67,32
48,85,48,303,567,259,308
48,85,48,309,263,138,125
48,85,48,329,147,91,56
48,85,48,339,198,268,-70
48,85,48,347,75,33,42
48,85,48,349,69,45,24
48,85,48,355,134,114,20
48,85,48,367,80,91,-11
48,85,48,373,29,40,-11
48,85,48,375,68,47,21
48,85,48,379,0,44,-44
48,85,48,381,126,60,66
48,85,48,387,28,0,28
48,85,48,397,773,773,0
48,85,48,401,36,0,36
48,85,48,409,0,37,-37
48,85,48,423,326,251,75
48,85,48,439,3361,3015,346
48,85,48,441,185,92,93
48,85,48,451,90,62,28
48,85,48,453,854,1072,-218
48,85,48,467,110,136,-26
48,85,48,469,32,30,2
48,85,48,471,0,23,-23
48,85,48,473,26,0,26
48,85,48,485,199,85,114
48,85,48,491,378,470,-92
48,85,48,497,52,51,1
48,85,48,499,91,105,-14
48,85,49,35,115,108,7
48,85,49,49,124,121,3
48,85,51,13,29,45,-16
48,85,51,41,61,43,18
48,85,51,59,228,216,12
48,85,51,87,77,52,25
48,85,51,107,93,75,18
48,85,51,153,71,34,37
48,85,51,179,39,0,39
48,85,51,510,28,23,5
48,85,51,810,75,28,47
48,85,53,11,38,47,-9
48,85,53,33,303,299,4
48,85,53,53,64,44,20
48,85,53,61,108,51,57
48,85,53,67,34,0,34
48,85,55,25,62,0,62
48,85,55,79,110,33,77
48,85,55,133,81,0,81
48,89,48,15,99,127,-28
48,89,48,29,0,42,-42
48,89,48,149,94,100,-6
48,89,48,157,123,102,21
48,89,48,201,304,187,117
48,89,48,453,37,41,-4
48,89,48,481,94,74,20
48,91,4,13,95,44,51
48,91,6,37,168,0,168
48,91,6,59,65,0,65
48,91,6,65,96,0,96
48,91,6,67,38,0,38
48,91,6,71,70,0,70
48,91,6,73,78,45,33
48,91,6,85,45,0,45
48,91,15,3,37,0,37
48,91,17,31,28,0,28
48,91,32,3,78,36,42
48,91,48,7,40,46,-6
48,91,48,13,54,0,54
48,91,48,19,35,44,-9
48,91,48,27,96,74,22
48,91,48,29,3861,2463,1398
48,91,48,31,66,74,-8
48,91,48,39,73,30,43
48,91,48,41,61,29,32
48,91,48,53,55,0,55
48,91,48,55,53,0,53
48,91,48,61,71,0,71
48,91,48,85,65,35,30
48,91,48,113,167,76,91
48,91,48,121,111,50,61
48,91,48,139,30,0,30
48,91,48,141,63,37,26
48,91,48,157,98,47,51
48,91,48,167,95,46,49
48,91,48,177,31,42,-11
48,91,48,187,1391,1145,246
48,91,48,201,580,303,277
48,91,48,209,644,493,151
48,91,48,215,70,42,28
48,91,48,245,36,0,36
48,91,48,259,98,81,17
48,91,48,265,53,33,20
48,91,48,303,47,28,19
48,91,48,309,45,32,13
48,91,48,325,45,36,9
48,91,48,329,41,36,5
48,91,48,339,107,77,30
48,91,48,355,150,75,75
48,91,48,381,29,0,29
48,91,48,409,36,0,36
48,91,48,439,163,102,61
48,91,48,451,27,0,27
48,91,48,453,475,488,-13
48,91,48,469,44,0,44
48,91,48,479,0,40,-40
48,91,48,491,149,135,14
48,91,48,493,70,113,-43
48,93,48,49,99,102,-3
48,93,48,133,66,84,-18
48,93,48,143,195,191,4
48,93,48,193,50,28,22
48,93,48,201,0,25,-25
48,93,48,221,0,26,-26
48,93,48,309,0,32,-32
48,93,48,439,31,47,-16
48,93,48,441,33,50,-17
48,95,48,451,86,0,86
48,97,40,19,0,50,-50
48,97,40,85,85,125,-40
48,97,48,85,96,87,9
48,97,48,113,131,115,16
48,97,48,121,703,786,-83
48,97,48,181,358,402,-44
48,97,48,221,0,30,-30
48,97,48,337,158,132,26
48,97,48,439,158,170,-12
48,97,48,485,37,0,37
48,97,48,497,49,42,7
48,99,1,45,50,0,50
48,99,2,20,0,48,-48
48,99,2,90,83,65,18
48,99,4,3,123,60,63
48,99,4,13,59,65,-6
48,99,6,37,87,46,41
48,99,6,71,120,80,40
48,99,6,73,42,0,42
48,99,8,41,48,550,-502
48,99,12,95,28,0,28
48,99,13,179,43,0,43
48,99,13,215,86,42,44
48,99,13,245,69,0,69
48,99,15,3,91,154,-63
48,99,21,47,53,45,8
48,99,21,93,105,138,-33
48,99,21,163,0,56,-56
48,99,22,115,49,49,0
48,99,24,25,0,55,-55
48,99,29,169,85,76,9
48,99,32,3,49,0,49
48,99,36,45,80,47,33
48,99,36,71,25,0,25
48,99,37,51,104,105,-1
48,99,40,31,143,111,32
48,99,45,79,94,86,8
48,99,47,125,58,81,-23
48,99,48,27,3560,3571,-11
48,99,48,29,256,273,-17
48,99,48,35,45,0,45
48,99,48,41,0,40,-40
48,99,48,53,51,39,12
48,99,48,113,107,115,-8
48,99,48,121,35,24,11
48,99,48,141,196,153,43
48,99,48,143,0,40,-40
48,99,48,167,34,0,34
48,99,48,193,75,44,31
48,99,48,201,177,179,-2
48,99,48,209,0,28,-28
48,99,48,215,41,0,41
48,99,48,281,253,366,-113
48,99,48,303,39,39,0
48,99,48,309,216,320,-104
48,99,48,339,31,62,-31
48,99,48,355,34,0,34
48,99,48,439,140,158,-18
48,99,48,441,55,38,17
48,99,48,451,0,48,-48
48,99,48,453,140,156,-16
48,99,48,491,110,201,-91
48,99,51,59,0,49,-49
48,99,51,700,0,60,-60
48,99,53,53,84,111,-27
48,99,53,63,0,42,-42
48,103,48,135,173,144,29
48,103,48,329,56,62,-6
48,105,48,439,32,0,32
48,105,48,451,67,0,67
48,107,48,303,292,356,-64
48,109,48,141,0,45,-45
48,111,6,99,38,0,38
48,111,35,59,51,32,19
48,111,48,375,46,64,-18
48,111,48,381,41,77,-36
48,113,1,3,35,35,0
48,113,1,73,151,124,27
48,113,1,81,34,0,34
48,113,1,89,43,70,-27
48,113,1,97,84,85,-1
48,113,1,101,50,49,1
48,113,1,117,42,42,0
48,113,1,125,0,30,-30
48,113,2,20,48,80,-32
48,113,4,3,54,0,54
48,113,4,13,1014,791,223
48,113,4,15,30,0,30
48,113,4,19,205,223,-18
48,113,4,21,0,36,-36
48,113,4,25,0,33,-33
48,113,4,27,0,49,-49
48,113,5,7,171,136,35
48,113,5,27,112,0,112
48,113,5,31,44,36,8
48,113,5,45,97,51,46
48,113,5,51,68,71,-3
48,113,5,69,112,61,51
48,113,5,91,95,62,33
48,113,5,113,0,31,-31
48,113,5,115,33,31,2
48,113,5,119,524,385,139
48,113,5,125,28,55,-27
48,113,5,131,85,80,5
48,113,5,139,31,36,-5
48,113,5,143,189,137,52
48,113,5,145,31,0,31
48,113,6,1,274,254,20
48,113,6,13,158,134,24
48,113,6,19,95,107,-12
48,113,6,29,132,78,54
48,113,6,31,41,0,41
48,113,6,37,3112,1510,1602
48,113,6,41,31,43,-12
48,113,6,47,27,0,27
48,113,6,53,103,72,31
48,113,6,59,1080,494,586
48,113,6,61,43,0,43
48,113,6,65,446,298,148
48,113,6,67,198,180,18
48,113,6,71,539,263,276
48,113,6,73,1043,781,262
48,113,6,75,205,263,-58
48,113,6,77,98,70,28
48,113,6,81,113,114,-1
48,113,6,83,70,42,28
48,113,6,85,453,449,4
48,113,6,95,84,61,23
48,113,6,97,63,0,63
48,113,6,99,81,43,38
48,113,6,107,31,44,-13
48,113,6,111,191,97,94
48,113,8,1,74,75,-1
48,113,8,5,244,205,39
48,113,8,13,72,119,-47
48,113,8,14,0,39,-39
48,113,8,31,244,348,-104
48,113,8,35,92,118,-26
48,113,8,37,27,39,-12
48,113,8,41,235,248,-13
48,113,8,59,110,111,-1
48,113,8,69,51,82,-31
48,113,8,77,0,36,-36
48,113,8,123,59,45,14
48,113,9,1,124,151,-27
48,113,9,3,104,72,32
48,113,9,9,124,66,58
48,113,10,3,95,96,-1
48,113,11,1,220,239,-19
48,113,12,1,52,49,3
48,113,12,5,81,0,81
48,113,12,9,62,72,-10
48,113,12,11,506,304,202
48,113,12,15,30,0,30
48,113,12,19,27,33,-6
48,113,12,21,125,73,52
48,113,12,31,289,181,108
48,113,12,33,86,100,-14
48,113,12,57,379,328,51
48,113,12,69,51,28,23
48,113,12,71,209,61,148
48,113,12,73,94,31,63
48,113,12,81,61,69,-8
48,113,12,83,35,0,35
48,113,12,85,44,0,44
48,113,12,86,511,351,160
48,113,12,91,60,55,5
48,113,12,95,367,253,114
48,113,12,97,88,52,36
48,113,12,99,343,221,122
48,113,12,101,78,35,43
48,113,12,103,131,139,-8
48,113,12,105,99,78,21
48,113,12,109,0,33,-33
48,113,12,111,59,0,59
48,113,12,113,0,36,-36
48,113,12,115,71,36,35
48,113,12,117,105,82,23
48,113,12,127,65,56,9
48,113,13,51,67,43,24
48,113,13,57,39,0,39
48,113,13,59,42,26,16
48,113,13,63,74,79,-5
48,113,13,67,264,266,-2
48,113,13,89,277,235,42
48,113,13,97,0,53,-53
48,113,13,113,38,39,-1
48,113,13,117,42,43,-1
48,113,13,121,375,383,-8
48,113,13,135,285,226,59
48,113,13,151,0,32,-32
48,113,13,179,48,0,48
48,113,13,215,67,46,21
48,113,13,245,24,40,-16
48,113,15,1,28,23,5
48,113,15,3,221,170,51
48,113,15,9,25,27,-2
48,113,16,1,45,36,9
48,113,16,27,34,0,34
48,113,17,19,94,0,94
48,113,17,31,1476,1125,351
48,113,17,37,34,0,34
48,113,17,43,208,149,59
48,113,17,89,105,98,7
48,113,17,97,217,113,104
48,113,17,111,37,0,37
48,113,17,113,27,0,27
48,113,17,119,30,0,30
48,113,17,143,67,41,26
48,113,17,161,29,0,29
48,113,17,163,41,40,1
48,113,17,167,44,0,44
48,113,17,197,99,52,47
48,113,17,201,58,0,58
48,113,18,3,65,35,30
48,113,18,39,58,0,58
48,113,18,57,41,52,-11
48,113,18,89,76,55,21
48,113,18,97,177,129,48
48,113,18,105,40,0,40
48,113,18,141,96,71,25
48,113,18,157,51,0,51
48,113,19,103,58,38,20
48,113,19,113,38,36,2
48,113,19,153,101,62,39
48,113,19,163,45,104,-59
48,113,19,169,37,0,37
48,113,20,45,41,42,-1
48,113,20,55,29,0,29
48,113,20,61,46,45,1
48,113,20,91,352,266,86
48,113,20,161,62,0,62
48,113,20,173,259,179,80
48,113,20,177,68,32,36
48,113,20,209,45,33,12
48,113,21,67,72,46,26
48,113,21,93,35,0,35
48,113,21,111,142,125,17
48,113,22,5,0,41,-41
48,113,22,15,152,167,-15
48,113,22,17,584,474,110
48,113,22,19,111,86,25
48,113,22,31,40,0,40
48,113,22,33,363,327,36
48,113,22,41,0,37,-37
48,113,22,45,0,44,-44
48,113,22,51,333,526,-193
48,113,22,55,117,131,-14
48,113,22,61,85,66,19
48,113,22,63,0,39,-39
48,113,22,67,51,79,-28
48,113,22,69,52,66,-14
48,113,22,71,370,1146,-776
48,113,22,73,329,161,168
48,113,22,79,99,56,43
48,113,22,89,0,33,-33
48,113,22,95,29,49,-20
48,113,22,101,0,29,-29
48,113,22,103,75,94,-19
48,113,22,105,34,49,-15
48,113,22,115,58,50,8
48,113,22,117,0,47,-47
48,113,22,119,0,33,-33
48,113,23,5,0,30,-30
48,113,24,3,93,76,17
48,113,24,5,163,72,91
48,113,24,27,68,69,-1
48,113,24,31,255,277,-22
48,113,24,33,193,130,63
48,113,24,510,84,75,9
48,113,25,5,38,0,38
48,113,25,9,41,69,-28
48,113,25,17,323,265,58
48,113,25,21,120,76,44
48,113,25,23,43,0,43
48,113,25,25,182,143,39
48,113,25,27,91,54,37
48,113,26,49,68,27,41
48,113,26,65,56,0,56
48,113,26,77,45,0,45
48,113,26,81,142,50,92
48,113,26,93,23,0,23
48,113,26,99,124,30,94
48,113,26,125,328,109,219
48,113,26,139,0,37,-37
48,113,26,161,132,61,71
48,113,26,163,372,107,265
48,113,27,3,27,35,-8
48,113,27,37,55,46,9
48,113,27,53,309,233,76
48,113,27,123,122,78,44
48,113,27,163,40,0,40
48,113,28,1,41,0,41
48,113,28,33,33,48,-15
48,113,28,35,48,0,48
48,113,28,47,57,51,6
48,113,28,49,172,70,102
48,113,28,71,24,0,24
48,113,28,89,36,46,-10
48,113,28,105,23,0,23
48,113,28,121,47,32,15
48,113,28,133,29,0,29
48,113,28,149,49,37,12
48,113,28,151,79,0,79
48,113,29,19,67,37,30
48,113,29,37,0,24,-24
48,113,29,47,65,61,4
48,113,29,77,97,95,2
48,113,29,95,255,172,83
48,113,29,97,61,0,61
48,113,29,99,0,29,-29
48,113,29,165,0,45,-45
48,113,29,183,75,62,13
48,113,29,189,350,248,102
48,113,29,213,0,26,-26
48,113,29,510,138,91,47
48,113,30,63,0,32,-32
48,113,31,55,212,120,92
48,113,31,109,64,50,14
48,113,31,153,55,0,55
48,113,32,3,667,673,-6
48,113,32,31,80,42,38
48,113,33,11,67,31,36
48,113,33,15,33,0,33
48,113,34,1,49,0,49
48,113,34,3,139,99,40
48,113,34,5,0,42,-42
48,113,34,7,51,0,51
48,113,34,13,96,68,28
48,113,34,17,164,117,47
48,113,34,21,51,44,7
48,113,34,23,234,162,72
48,113,34,25,55,67,-12
48,113,34,27,42,58,-16
48,113,34,29,40,0,40
48,113,34,31,35,0,35
48,113,34,35,83,0,83
48,113,34,39,103,0,103
48,113,35,1,250,235,15
48,113,35,5,27,0,27
48,113,35,9,28,0,28
48,113,35,13,105,137,-32
48,113,35,15,38,0,38
48,113,35,25,75,54,21
48,113,35,43,37,49,-12
48,113,35,45,0,27,-27
48,113,35,49,67,104,-37
48,113,36,1,28,0,28
48,113,36,5,304,138,166
48,113,36,27,0,30,-30
48,113,36,29,81,55,26
48,113,36,45,51,56,-5
48,113,36,47,252,227,25
48,113,36,55,59,98,-39
48,113,36,59,174,104,70
48,113,36,61,452,585,-133
48,113,36,67,35,23,12
48,113,36,71,56,0,56
48,113,36,81,280,238,42
48,113,36,85,45,0,45
48,113,36,103,115,104,11
48,113,36,119,140,76,64
48,113,37,21,38,32,6
48,113,37,51,71,107,-36
48,113,37,63,76,70,6
48,113,37,67,52,33,19
48,113,37,81,88,62,26
48,113,37,119,359,292,67
48,113,37,129,0,38,-38
48,113,37,133,92,119,-27
48,113,37,183,216,191,25
48,113,39,17,41,31,10
48,113,39,35,231,137,94
48,113,39,41,0,33,-33
48,113,39,49,281,154,127
48,113,39,57,31,0,31
48,113,39,61,144,123,21
48,113,39,93,36,0,36
48,113,39,95,72,0,72
48,113,39,113,61,32,29
48,113,39,151,36,0,36
48,113,39,153,65,31,34
48,113,39,165,24,0,24
48,113,40,13,80,97,-17
48,113,40,17,54,59,-5
48,113,40,19,50,85,-35
48,113,40,27,256,209,47
48,113,40,31,169,141,28
48,113,40,47,40,0,40
48,113,40,65,38,0,38
48,113,40,83,0,30,-30
48,113,40,89,0,27,-27
48,113,40,95,41,0,41
48,113,40,101,39,51,-12
48,113,40,109,963,703,260
48,113,40,113,41,0,41
48,113,40,119,97,47,50
48,113,40,121,0,47,-47
48,113,40,125,30,39,-9
48,113,40,131,26,45,-19
48,113,40,137,31,44,-13
48,113,40,143,725,525,200
48,113,40,145,28,32,-4
48,113,40,147,33,34,-1
48,113,41,5,0,51,-51
48,113,41,29,0,36,-36
48,113,41,39,37,0,37
48,113,41,51,92,159,-67
48,113,41,67,109,113,-4
48,113,42,3,138,115,23
48,113,42,17,85,0,85
48,113,42,27,23,0,23
48,113,42,29,73,45,28
48,113,42,43,46,37,9
48,113,42,45,48,48,0
48,113,42,71,39,32,7
48,113,42,77,49,0,49
48,113,42,91,97,67,30
48,113,42,95,27,0,27
48,113,42,101,159,126,33
48,113,42,129,25,0,25
48,113,42,133,27,0,27
48,113,44,7,106,31,75
48,113,45,13,36,29,7
48,113,45,15,28,38,-10
48,113,45,19,68,57,11
48,113,45,45,81,73,8
48,113,45,51,52,0,52
48,113,45,79,46,71,-25
48,113,45,91,190,0,190
48,113,46,99,40,33,7
48,113,47,37,294,276,18
48,113,47,65,38,36,2
48,113,47,93,92,49,43
48,113,47,125,44,40,4
48,113,47,149,59,43,16
48,113,47,157,489,251,238
48,113,47,187,58,51,7
48,113,48,1,226,192,34
48,113,48,3,0,43,-43
48,113,48,5,113,112,1
48,113,48,7,0,37,-37
48,113,48,13,0,35,-35
48,113,48,21,32,82,-50
48,113,48,25,28,0,28
48,113,48,27,657,644,13
48,113,48,29,1787,1999,-212
48,113,48,35,29,52,-23
48,113,48,37,296,313,-17
48,113,48,39,171,159,12
48,113,48,41,580,402,178
48,113,48,49,63,77,-14
48,113,48,53,44,61,-17
48,113,48,55,27,0,27
48,113,48,57,0,29,-29
48,113,48,61,378,490,-112
48,113,48,63,79,67,12
48,113,48,67,67,74,-7
48,113,48,73,124,91,33
48,113,48,85,19836,33862,-14026
48,113,48,91,76,167,-91
48,113,48,97,115,131,-16
48,113,48,99,115,107,8
48,113,48,119,77,88,-11
48,113,48,121,15572,21848,-6276
48,113,48,133,35,0,35
48,113,48,135,232,179,53
48,113,48,139,3294,5789,-2495
48,113,48,141,799,686,113
48,113,48,143,130,84,46
48,113,48,145,36,0,36
48,113,48,147,183,212,-29
48,113,48,149,0,31,-31
48,113,48,157,424,497,-73
48,113,48,159,82,80,2
48,113,48,161,89,86,3
48,113,48,167,314,325,-11
48,113,48,171,0,36,-36
48,113,48,181,682,767,-85
48,113,48,183,574,477,97
48,113,48,185,0,45,-45
48,113,48,187,75,93,-18
48,113,48,189,85,66,19
48,113,48,193,0,27,-27
48,113,48,199,0,34,-34
48,113,48,201,4653,4865,-212
48,113,48,203,213,166,47
48,113,48,209,187,289,-102
48,113,48,213,699,901,-202
48,113,48,215,585,722,-137
48,113,48,217,149,199,-50
48,113,48,221,139,189,-50
48,113,48,223,157,229,-72
48,113,48,225,44,41,3
48,113,48,227,39,36,3
48,113,48,231,1494,1623,-129
48,113,48,245,254,210,44
48,113,48,249,0,35,-35
48,113,48,251,628,879,-251
48,113,48,257,3153,6003,-2850
48,113,48,259,29,53,-24
48,113,48,265,37,87,-50
48,113,48,273,48,34,14
48,113,48,277,252,286,-34
48,113,48,281,32,0,32
48,113,48,289,34,77,-43
48,113,48,291,72,0,72
48,113,48,293,90,60,30
48,113,48,303,1032,552,480
48,113,48,309,870,628,242
48,113,48,313,30,0,30
48,113,48,315,48,50,-2
48,113,48,323,63,87,-24
48,113,48,329,250,255,-5
48,113,48,337,44,46,-2
48,113,48,339,332,464,-132
48,113,48,341,0,39,-39
48,113,48,343,75,43,32
48,113,48,347,231,146,85
48,113,48,349,521,607,-86
48,113,48,353,71,41,30
48,113,48,355,373,349,24
48,113,48,361,62,63,-1
48,113,48,363,48,51,-3
48,113,48,365,27,62,-35
48,113,48,367,254,310,-56
48,113,48,373,42,61,-19
48,113,48,375,178,164,14
48,113,48,379,108,137,-29
48,113,48,381,225,217,8
48,113,48,387,60,64,-4
48,113,48,397,2311,4189,-1878
48,113,48,401,89,139,-50
48,113,48,407,35,0,35
48,113,48,409,66,59,7
48,113,48,415,0,33,-33
48,113,48,419,0,60,-60
48,113,48,423,1040,906,134
48,113,48,425,0,39,-39
48,113,48,427,38,0,38
48,113,48,439,24900,29704,-4804
48,113,48,441,415,275,140
48,113,48,449,151,111,40
48,113,48,451,171,159,12
48,113,48,453,2204,2800,-596
48,113,48,459,100,101,-1
48,113,48,463,29,0,29
48,113,48,465,76,46,30
48,113,48,467,425,605,-180
48,113,48,469,78,66,12
48,113,48,471,124,93,31
48,113,48,473,62,52,10
48,113,48,477,31,0,31
48,113,48,479,369,416,-47
48,113,48,485,476,260,216
48,113,48,487,43,0,43
48,113,48,491,567,791,-224
48,113,48,493,0,28,-28
48,113,48,497,153,188,-35
48,113,48,499,216,340,-124
48,113,48,503,26,34,-8
48,113,49,11,35,0,35
48,113,49,35,175,176,-1
48,113,49,49,87,73,14
48,113,49,57,0,33,-33
48,113,51,3,44,0,44
48,113,51,13,142,96,46
48,113,51,41,30,67,-37
48,113,51,59,336,309,27
48,113,51,87,96,71,25
48,113,51,107,129,79,50
48,113,51,153,159,71,88
48,113,51,510,85,87,-2
48,113,51,550,42,51,-9
48,113,51,650,98,29,69
48,113,51,700,0,40,-40
48,113,51,710,124,79,45
48,113,51,740,29,0,29
48,113,51,760,51,30,21
48,113,51,810,132,61,71
48,113,53,11,76,26,50
48,113,53,29,31,0,31
48,113,53,33,467,598,-131
48,113,53,35,0,40,-40
48,113,53,53,160,192,-32
48,113,53,61,99,106,-7
48,113,53,63,47,38,9
48,113,53,67,50,29,21
48,113,55,9,45,0,45
48,113,55,25,81,50,31
48,113,55,79,245,101,144
48,113,55,133,27,29,-2
48,115,48,135,37,0,37
48,115,48,227,36,84,-48
48,115,48,303,143,156,-13
48,115,48,329,99,118,-19
48,115,48,439,0,39,-39
48,117,6,37,43,0,43
48,117,48,29,0,43,-43
48,117,48,69,86,41,45
48,117,48,303,41,64,-23
48,117,48,341,0,30,-30
48,117,48,369,122,54,68
48,117,48,375,176,234,-58
48,117,48,381,142,213,-71
48,119,48,113,88,77,11
48,119,48,223,74,65,9
48,119,48,231,148,128,20
48,119,48,277,60,81,-21
48,121,1,73,30,55,-25
48,121,1,89,32,34,-2
48,121,1,101,32,0,32
48,121,1,117,48,0,48
48,121,2,20,0,47,-47
48,121,4,3,0,37,-37
48,121,4,13,565,388,177
48,121,4,19,126,107,19
48,121,4,21,28,0,28
48,121,5,7,67,129,-62
48,121,5,45,37,0,37
48,121,5,51,42,41,1
48,121,5,119,172,92,80
48,121,5,131,44,25,19
48,121,5,143,42,51,-9
48,121,6,1,149,71,78
48,121,6,13,74,70,4
48,121,6,19,29,0,29
48,121,6,29,49,0,49
48,121,6,37,834,365,469
48,121,6,53,42,0,42
48,121,6,59,507,199,308
48,121,6,61,34,0,34
48,121,6,65,246,109,137
48,121,6,67,77,59,18
48,121,6,71,240,78,162
48,121,6,73,439,234,205
48,121,6,75,27,39,-12
48,121,6,81,48,0,48
48,121,6,83,44,0,44
48,121,6,85,109,122,-13
48,121,6,95,46,0,46
48,121,6,111,137,63,74
48,121,8,1,44,40,4
48,121,8,5,87,106,-19
48,121,8,13,47,49,-2
48,121,8,31,45,75,-30
48,121,8,35,139,103,36
48,121,8,41,122,156,-34
48,121,8,59,64,63,1
48,121,8,69,28,43,-15
48,121,9,1,70,0,70
48,121,9,3,32,0,32
48,121,9,9,47,0,47
48,121,11,1,0,31,-31
48,121,12,9,51,44,7
48,121,12,11,184,103,81
48,121,12,21,28,0,28
48,121,12,31,95,57,38
48,121,12,33,69,29,40
48,121,12,57,167,90,77
48,121,12,69,41,0,41
48,121,12,71,56,51,5
48,121,12,73,38,0,38
48,121,12,81,37,0,37
48,121,12,86,163,108,55
48,121,12,91,37,0,37
48,121,12,95,140,94,46
48,121,12,97,37,0,37
48,121,12,99,196,80,116
48,121,12,101,66,0,66
48,121,12,103,133,37,96
48,121,12,105,31,0,31
48,121,12,109,58,0,58
48,121,12,115,0,30,-30
48,121,12,117,73,37,36
48,121,12,127,63,0,63
48,121,13,51,44,0,44
48,121,13,57,0,51,-51
48,121,13,67,112,77,35
48,121,13,89,70,49,21
48,121,13,117,42,0,42
48,121,13,121,109,145,-36
48,121,13,135,91,94,-3
48,121,15,3,83,73,10
48,121,16,1,43,0,43
48,121,17,31,363,218,145
48,121,17,43,80,64,16
48,121,17,89,53,48,5
48,121,17,97,93,50,43
48,121,17,111,38,0,38
48,121,17,113,28,0,28
48,121,17,163,27,0,27
48,121,17,197,54,38,16
48,121,17,201,35,0,35
48,121,18,3,43,0,43
48,121,18,39,27,0,27
48,121,18,57,45,0,45
48,121,18,97,100,42,58
48,121,19,153,28,37,-9
48,121,20,91,196,121,75
48,121,20,161,40,0,40
48,121,20,173,123,106,17
48,121,20,177,56,0,56
48,121,21,67,0,32,-32
48,121,21,111,28,45,-17
48,121,22,15,55,69,-14
48,121,22,17,121,63,58
48,121,22,19,49,0,49
48,121,22,33,97,75,22
48,121,22,51,100,110,-10
48,121,22,55,53,46,7
48,121,22,61,35,32,3
48,121,22,71,50,188,-138
48,121,22,73,100,0,100
48,121,22,103,59,44,15
48,121,22,115,32,0,32
48,121,24,3,54,40,14
48,121,24,5,31,0,31
48,121,24,31,73,37,36
48,121,24,33,49,0,49
48,121,24,510,32,0,32
48,121,25,9,31,0,31
48,121,25,17,101,69,32
48,121,25,23,36,0,36
48,121,25,25,34,0,34
48,121,25,27,68,0,68
48,121,26,81,50,36,14
48,121,26,99,54,0,54
48,121,26,125,158,66,92
48,121,26,161,43,0,43
48,121,26,163,173,32,141
48,121,27,37,46,0,46
48,121,27,53,86,54,32
48,121,28,49,43,0,43
48,121,29,47,63,0,63
48,121,29,77,41,0,41
48,121,29,95,91,62,29
48,121,29,165,30,0,30
48,121,29,183,55,64,-9
48,121,29,189,125,99,26
48,121,31,55,35,62,-27
48,121,31,109,29,33,-4
48,121,32,3,329,169,160
48,121,32,31,50,49,1
48,121,33,11,57,0,57
48,121,34,3,45,0,45
48,121,34,17,32,0,32
48,121,34,23,54,39,15
48,121,34,27,36,0,36
48,121,34,35,42,0,42
48,121,35,1,141,92,49
48,121,35,13,35,27,8
48,121,36,29,0,36,-36
48,121,36,45,37,0,37
48,121,36,47,58,47,11
48,121,36,55,62,0,62
48,121,36,59,62,0,62
48,121,36,61,66,87,-21
48,121,36,81,84,33,51
48,121,36,103,82,28,54
48,121,36,119,36,0,36
48,121,37,51,0,29,-29
48,121,37,81,45,0,45
48,121,37,119,127,78,49
48,121,37,133,34,0,34
48,121,37,183,75,166,-91
48,121,39,35,98,0,98
48,121,39,41,49,0,49
48,121,39,49,101,83,18
48,121,39,61,31,27,4
48,121,39,113,42,0,42
48,121,39,153,50,0,50
48,121,40,13,39,50,-11
48,121,40,17,45,34,11
48,121,40,19,62,68,-6
48,121,40,27,98,163,-65
48,121,40,31,88,57,31
48,121,40,109,362,268,94
48,121,40,119,61,0,61
48,121,40,125,39,0,39
48,121,40,143,277,189,88
48,121,41,5,30,0,30
48,121,41,39,0,31,-31
48,121,41,51,0,46,-46
48,121,41,67,44,57,-13
48,121,42,3,60,57,3
48,121,42,91,67,0,67
48,121,42,101,34,0,34
48,121,44,7,35,33,2
48,121,45,19,24,0,24
48,121,45,45,28,32,-4
48,121,45,91,0,33,-33
48,121,46,99,26,0,26
48,121,47,37,71,80,-9
48,121,47,93,44,42,2
48,121,47,125,49,0,49
48,121,47,157,133,121,12
48,121,47,165,0,36,-36
48,121,47,187,0,52,-52
48,121,48,1,30,31,-1
48,121,48,5,45,39,6
48,121,48,21,34,0,34
48,121,48,27,205,206,-1
48,121,48,29,661,597,64
48,121,48,35,26,0,26
48,121,48,37,93,80,13
48,121,48,39,124,129,-5
48,121,48,41,297,171,126
48,121,48,49,35,33,2
48,121,48,61,96,75,21
48,121,48,73,49,33,16
48,121,48,85,10104,9690,414
48,121,48,91,50,111,-61
48,121,48,97,786,703,83
48,121,48,99,24,35,-11
48,121,48,113,21848,15572,6276
48,121,48,135,94,71,23
48,121,48,139,319,296,23
48,121,48,141,263,198,65
48,121,48,143,60,37,23
48,121,48,147,93,111,-18
48,121,48,157,186,258,-72
48,121,48,159,28,24,4
48,121,48,167,114,158,-44
48,121,48,181,602,580,22
48,121,48,183,169,151,18
48,121,48,187,49,50,-1
48,121,48,189,47,40,7
48,121,48,201,1382,1139,243
48,121,48,203,74,32,42
48,121,48,209,127,132,-5
48,121,48,213,143,112,31
48,121,48,215,155,126,29
48,121,48,217,53,47,6
48,121,48,221,74,91,-17
48,121,48,223,61,79,-18
48,121,48,227,29,0,29
48,121,48,231,196,204,-8
48,121,48,245,100,58,42
48,121,48,251,226,229,-3
48,121,48,257,254,332,-78
48,121,48,277,87,91,-4
48,121,48,303,453,237,216
48,121,48,309,295,201,94
48,121,48,329,146,97,49
48,121,48,337,117,128,-11
48,121,48,339,211,219,-8
48,121,48,347,115,25,90
48,121,48,349,85,64,21
48,121,48,355,139,115,24
48,121,48,363,50,33,17
48,121,48,367,209,269,-60
48,121,48,373,0,48,-48
48,121,48,375,86,82,4
48,121,48,381,141,72,69
48,121,48,397,249,217,32
48,121,48,423,341,230,111
48,121,48,439,8444,7755,689
48,121,48,441,218,116,102
48,121,48,449,36,34,2
48,121,48,451,109,119,-10
48,121,48,453,619,789,-170
48,121,48,459,0,36,-36
48,121,48,467,70,60,10
48,121,48,469,0,37,-37
48,121,48,471,40,0,40
48,121,48,479,46,47,-1
48,121,48,485,297,199,98
48,121,48,487,27,0,27
48,121,48,491,314,403,-89
48,121,48,497,594,478,116
48,121,48,499,68,78,-10
48,121,48,503,48,66,-18
48,121,49,35,124,110,14
48,121,49,49,88,0,88
48,121,51,41,39,0,39
48,121,51,59,139,93,46
48,121,51,87,62,0,62
48,121,51,107,65,61,4
48,121,51,153,79,35,44
48,121,51,700,26,0,26
48,121,51,810,37,0,37
48,121,53,33,197,255,-58
48,121,53,53,49,59,-10
48,121,53,61,97,66,31
48,121,53,63,51,0,51
48,121,55,79,75,0,75
48,121,55,133,44,0,44
48,123,48,29,61,67,-6
48,123,48,175,38,0,38
48,123,48,177,48,0,48
48,123,48,201,67,77,-10
48,123,48,255,35,0,35
48,123,48,285,97,106,-9
48,123,48,355,31,39,-8
48,123,48,453,0,45,-45
48,123,48,469,295,350,-55
48,127,48,29,104,89,15
48,127,48,453,0,36,-36
48,127,48,463,38,0,38
48,127,48,479,0,36,-36
48,127,48,507,105,87,18
48,129,48,179,0,42,-42
48,129,48,375,39,57,-18
48,129,48,381,46,0,46
48,131,48,29,50,62,-12
48,131,48,215,0,30,-30
48,131,48,249,281,310,-29
48,131,48,273,44,39,5
48,131,48,355,56,96,-40
48,133,48,49,48,111,-63
48,133,48,59,55,51,4
48,133,48,93,84,66,18
48,133,48,113,0,35,-35
48,133,48,143,78,98,-20
48,133,48,221,0,33,-33
48,133,48,363,0,42,-42
48,133,48,367,41,54,-13
48,133,48,429,50,45,5
48,133,48,439,128,133,-5
48,133,48,441,107,70,37
48,135,4,13,106,74,32
48,135,4,19,37,0,37
48,135,6,37,67,0,67
48,135,6,71,0,31,-31
48,135,6,73,79,27,52
48,135,17,31,28,0,28
48,135,32,3,0,49,-49
48,135,35,1,36,0,36
48,135,35,5,34,0,34
48,135,35,13,83,0,83
48,135,35,15,75,71,4
48,135,35,25,278,123,155
48,135,35,45,50,0,50
48,135,40,109,0,47,-47
48,135,40,143,0,31,-31
48,135,48,3,203,181,22
48,135,48,27,39,54,-15
48,135,48,29,150,156,-6
48,135,48,41,30,36,-6
48,135,48,43,53,0,53
48,135,48,49,53,29,24
48,135,48,85,48,65,-17
48,135,48,103,144,173,-29
48,135,48,113,179,232,-53
48,135,48,115,0,37,-37
48,135,48,121,71,94,-23
48,135,48,141,301,178,123
48,135,48,165,39,0,39
48,135,48,183,0,27,-27
48,135,48,189,45,0,45
48,135,48,201,178,206,-28
48,135,48,209,28,32,-4
48,135,48,215,50,29,21
48,135,48,219,45,0,45
48,135,48,221,0,39,-39
48,135,48,227,119,54,65
48,135,48,251,0,82,-82
48,135,48,303,297,243,54
48,135,48,309,0,43,-43
48,135,48,329,1353,1554,-201
48,135,48,339,0,50,-50
48,135,48,367,0,88,-88
48,135,48,371,123,143,-20
48,135,48,375,87,49,38
48,135,48,377,368,142,226
48,135,48,381,67,35,32
48,135,48,389,265,103,162
48,135,48,415,48,44,4
48,135,48,423,0,31,-31
48,135,48,439,221,322,-101
48,135,48,441,126,105,21
48,135,48,451,169,139,30
48,135,48,453,105,123,-18
48,135,48,461,34,55,-21
48,135,48,465,27,0,27
48,135,48,475,229,210,19
48,135,48,491,52,81,-29
48,135,48,495,147,156,-9
48,139,4,13,0,55,-55
48,139,6,37,183,0,183
48,139,6,59,45,0,45
48,139,6,71,45,0,45
48,139,6,73,53,33,20
48,139,17,31,55,0,55
48,139,32,3,45,0,45
48,139,40,109,58,0,58
48,139,40,143,41,0,41
48,139,48,27,56,71,-15
48,139,48,29,87,96,-9
48,139,48,41,40,32,8
48,139,48,61,57,0,57
48,139,48,85,370,333,37
48,139,48,91,0,30,-30
48,139,48,113,5789,3294,2495
48,139,48,121,296,319,-23
48,139,48,141,32,0,32
48,139,48,167,0,31,-31
48,139,48,181,33,74,-41
48,139,48,183,0,41,-41
48,139,48,201,191,160,31
48,139,48,209,0,42,-42
48,139,48,213,162,170,-8
48,139,48,215,27,0,27
48,139,48,217,121,178,-57
48,139,48,221,0,61,-61
48,139,48,231,65,46,19
48,139,48,251,337,319,18
48,139,48,257,158,183,-25
48,139,48,303,51,71,-20
48,139,48,309,107,78,29
48,139,48,329,33,0,33
48,139,48,339,35,38,-3
48,139,48,349,569,498,71
48,139,48,355,41,0,41
48,139,48,367,36,48,-12
48,139,48,397,44,35,9
48,139,48,423,75,56,19
48,139,48,439,1609,1274,335
48,139,48,441,0,43,-43
48,139,48,453,83,87,-4
48,139,48,467,53,83,-30
48,139,48,485,39,31,8
48,139,48,491,33,43,-10
48,141,1,45,64,42,22
48,141,1,73,39,46,-7
48,141,1,89,53,106,-53
48,141,2,20,79,99,-20
48,141,2,90,182,73,109
48,141,4,3,165,111,54
48,141,4,5,30,0,30
48,141,4,13,1418,1585,-167
48,141,4,19,371,449,-78
48,141,4,21,77,150,-73
48,141,4,27,108,49,59
48,141,5,7,36,41,-5
48,141,5,119,47,47,0
48,141,6,1,62,97,-35
48,141,6,13,31,60,-29
48,141,6,19,50,48,2
48,141,6,25,50,0,50
48,141,6,29,75,51,24
48,141,6,37,1374,763,611
48,141,6,47,41,0,41
48,141,6,53,51,50,1
48,141,6,59,213,168,45
48,141,6,65,251,178,73
48,141,6,67,99,102,-3
48,141,6,71,533,306,227
48,141,6,73,680,618,62
48,141,6,75,40,30,10
48,141,6,77,99,51,48
48,141,6,81,35,25,10
48,141,6,83,42,38,4
48,141,6,85,110,83,27
48,141,6,95,0,33,-33
48,141,6,99,56,44,12
48,141,6,107,61,39,22
48,141,6,111,67,67,0
48,141,8,1,269,235,34
48,141,8,5,213,193,20
48,141,8,13,99,47,52
48,141,8,14,0,31,-31
48,141,8,31,364,248,116
48,141,8,35,0,29,-29
48,141,8,37,56,0,56
48,141,8,41,410,429,-19
48,141,8,59,123,142,-19
48,141,8,69,52,0,52
48,141,8,77,0,44,-44
48,141,8,123,135,80,55
48,141,11,1,42,41,1
48,141,12,9,0,40,-40
48,141,12,11,95,49,46
48,141,12,31,88,86,2
48,141,12,33,29,28,1
48,141,12,57,139,98,41
48,141,12,86,112,126,-14
48,141,12,91,34,38,-4
48,141,12,95,57,82,-25
48,141,12,97,38,39,-1
48,141,12,99,51,34,17
48,141,12,101,33,0,33
48,141,12,103,55,46,9
48,141,12,105,42,0,42
48,141,12,117,38,27,11
48,141,12,127,34,34,0
48,141,13,51,92,53,39
48,141,13,53,68,62,6
48,141,13,67,59,42,17
48,141,13,73,0,56,-56
48,141,13,89,43,0,43
48,141,13,121,54,69,-15
48,141,13,135,52,69,-17
48,141,13,179,77,122,-45
48,141,13,215,132,72,60
48,141,13,245,128,109,19
48,141,15,3,484,375,109
48,141,16,1,0,36,-36
48,141,17,31,268,185,83
48,141,17,43,66,32,34
48,141,17,89,47,0,47
48,141,17,97,52,0,52
48,141,17,163,44,0,44
48,141,18,97,78,51,27
48,141,19,113,0,24,-24
48,141,19,153,48,0,48
48,141,20,55,71,149,-78
48,141,20,57,72,43,29
48,141,20,61,90,107,-17
48,141,20,91,65,59,6
48,141,20,103,79,61,18
48,141,20,161,39,80,-41
48,141,20,173,81,81,0
48,141,20,175,131,0,131
48,141,20,209,60,58,2
48,141,21,47,183,121,62
48,141,21,93,136,67,69
48,141,21,111,58,0,58
48,141,22,51,0,45,-45
48,141,22,71,34,41,-7
48,141,22,115,132,107,25
48,141,24,3,55,76,-21
48,141,24,25,48,0,48
48,141,24,31,73,93,-20
48,141,24,33,53,0,53
48,141,25,17,50,54,-4
48,141,26,49,34,0,34
48,141,26,81,43,0,43
48,141,26,99,44,0,44
48,141,26,125,59,66,-7
48,141,26,163,88,43,45
48,141,27,53,49,0,49
48,141,29,77,31,0,31
48,141,29,95,40,49,-9
48,141,29,169,87,106,-19
48,141,29,189,44,40,4
48,141,31,55,69,48,21
48,141,31,153,0,43,-43
48,141,32,3,622,614,8
48,141,32,31,60,49,11
48,141,35,1,627,832,-205
48,141,35,5,77,71,6
48,141,35,9,72,36,36
48,141,35,13,2893,2925,-32
48,141,35,15,64,147,-83
48,141,35,17,38,44,-6
48,141,35,25,90,201,-111
48,141,35,27,40,98,-58
48,141,35,29,102,80,22
48,141,35,35,309,412,-103
48,141,35,43,85,109,-24
48,141,35,45,57,58,-1
48,141,35,49,82,106,-24
48,141,35,51,0,34,-34
48,141,35,61,41,45,-4
48,141,36,29,52,33,19
48,141,36,45,216,113,103
48,141,36,47,52,41,11
48,141,36,55,0,30,-30
48,141,36,61,37,61,-24
48,141,36,71,78,44,34
48,141,36,81,0,53,-53
48,141,37,51,381,691,-310
48,141,37,85,43,54,-11
48,141,37,93,0,51,-51
48,141,37,119,36,50,-14
48,141,37,133,50,79,-29
48,141,37,183,0,72,-72
48,141,39,35,40,0,40
48,141,39,49,75,50,25
48,141,39,61,26,0,26
48,141,39,113,38,0,38
48,141,40,27,28,0,28
48,141,40,31,217,226,-9
48,141,40,109,194,185,9
48,141,40,139,43,0,43
48,141,40,143,99,76,23
48,141,41,51,39,34,5
48,141,41,67,37,33,4
48,141,42,3,0,41,-41
48,141,42,91,35,0,35
48,141,42,101,34,0,34
48,141,45,79,119,130,-11
48,141,47,37,50,55,-5
48,141,47,125,292,237,55
48,141,47,157,60,37,23
48,141,48,13,42,33,9
48,141,48,27,510,702,-192
48,141,48,29,1015,1746,-731
48,141,48,39,51,58,-7
48,141,48,41,31,78,-47
48,141,48,43,50,59,-9
48,141,48,61,164,130,34
48,141,48,85,156,303,-147
48,141,48,91,37,63,-26
48,141,48,99,153,196,-43
48,141,48,109,45,0,45
48,141,48,113,686,799,-113
48,141,48,121,198,263,-65
48,141,48,135,178,301,-123
48,141,48,139,0,32,-32
48,141,48,157,83,128,-45
48,141,48,167,47,62,-15
48,141,48,183,30,0,30
48,141,48,187,39,101,-62
48,141,48,189,0,38,-38
48,141,48,201,624,882,-258
48,141,48,209,51,96,-45
48,141,48,215,231,192,39
48,141,48,229,121,79,42
48,141,48,245,36,46,-10
48,141,48,251,0,33,-33
48,141,48,273,0,30,-30
48,141,48,303,220,207,13
48,141,48,309,36,68,-32
48,141,48,323,0,61,-61
48,141,48,329,114,187,-73
48,141,48,339,54,108,-54
48,141,48,341,64,116,-52
48,141,48,355,123,126,-3
48,141,48,367,0,49,-49
48,141,48,369,45,0,45
48,141,48,371,66,85,-19
48,141,48,375,126,105,21
48,141,48,377,82,72,10
48,141,48,381,41,46,-5
48,141,48,389,0,67,-67
48,141,48,397,0,35,-35
48,141,48,423,0,32,-32
48,141,48,439,684,839,-155
48,141,48,441,82,76,6
48,141,48,451,33,74,-41
48,141,48,453,420,712,-292
48,141,48,465,68,57,11
48,141,48,479,162,87,75
48,141,48,485,0,51,-51
48,141,48,491,117,326,-209
48,141,49,35,66,123,-57
48,141,49,49,44,60,-16
48,141,51,13,30,0,30
48,141,51,59,173,112,61
48,141,51,153,46,73,-27
48,141,51,650,0,33,-33
48,141,51,700,67,65,2
48,141,51,710,72,39,33
48,141,51,810,75,50,25
48,141,53,11,0,34,-34
48,141,53,33,99,133,-34
48,141,53,35,54,28,26
48,141,53,53,327,303,24
48,141,53,61,0,61,-61
48,141,53,63,37,44,-7
48,141,53,67,44,96,-52
48,141,55,25,0,33,-33
48,141,55,79,49,38,11
48,143,48,27,51,42,9
48,143,48,29,54,26,28
48,143,48,35,0,32,-32
48,143,48,41,29,27,2
48,143,48,49,78,78,0
48,143,48,85,30,0,30
48,143,48,93,191,195,-4
48,143,48,99,40,0,40
48,143,48,113,84,130,-46
48,143,48,121,37,60,-23
48,143,48,133,98,78,20
48,143,48,193,107,141,-34
48,143,48,201,43,59,-16
48,143,48,221,156,247,-91
48,143,48,251,115,75,40
48,143,48,309,50,72,-22
48,143,48,363,94,47,47
48,143,48,367,65,123,-58
48,143,48,425,37,0,37
48,143,48,439,292,324,-32
48,143,48,441,0,35,-35
48,143,48,453,0,58,-58
48,143,48,491,28,40,-12
48,145,48,27,185,191,-6
48,145,48,113,0,36,-36
48,145,48,201,37,53,-16
48,145,48,293,0,30,-30
48,145,48,309,372,459,-87
48,145,48,331,37,45,-8
48,145,48,439,39,33,6
48,145,48,453,31,0,31
48,147,4,13,27,0,27
48,147,40,13,0,32,-32
48,147,48,85,538,370,168
48,147,48,113,212,183,29
48,147,48,121,111,93,18
48,147,48,181,425,506,-81
48,147,48,231,138,190,-52
48,147,48,277,156,149,7
48,147,48,397,0,28,-28
48,147,48,439,125,48,77
48,149,48,15,30,37,-7
48,149,48,21,97,103,-6
48,149,48,29,0,28,-28
48,149,48,41,0,34,-34
48,149,48,89,100,94,6
48,149,48,113,31,0,31
48,149,48,157,38,32,6
48,149,48,167,31,0,31
48,149,48,201,262,164,98
48,149,48,285,42,36,6
48,149,48,287,79,0,79
48,149,48,453,122,95,27
48,149,48,469,0,30,-30
48,149,48,477,60,49,11
48,149,48,491,51,49,2
48,151,48,353,62,0,62
48,151,48,441,37,0,37
48,153,48,189,124,185,-61
48,153,48,303,57,92,-35
48,155,48,487,31,0,31
48,157,1,73,37,32,5
48,157,1,97,59,0,59
48,157,2,20,94,62,32
48,157,4,13,240,170,70
48,157,4,19,40,32,8
48,157,5,119,42,0,42
48,157,6,1,160,39,121
48,157,6,13,127,189,-62
48,157,6,29,50,47,3
48,157,6,37,774,306,468
48,157,6,59,268,150,118
48,157,6,65,129,56,73
48,157,6,67,77,29,48
48,157,6,71,104,53,51
48,157,6,73,382,142,240
48,157,6,75,64,39,25
48,157,6,81,39,0,39
48,157,6,85,200,74,126
48,157,6,111,44,0,44
48,157,8,5,98,42,56
48,157,8,31,0,40,-40
48,157,8,35,44,58,-14
48,157,8,41,57,47,10
48,157,8,59,0,36,-36
48,157,9,1,87,0,87
48,157,9,9,51,0,51
48,157,10,3,52,0,52
48,157,11,1,28,23,5
48,157,12,11,304,50,254
48,157,12,31,44,0,44
48,157,12,33,48,26,22
48,157,12,57,90,27,63
48,157,12,71,52,0,52
48,157,12,86,237,81,156
48,157,12,95,113,43,70
48,157,12,97,32,0,32
48,157,12,99,86,50,36
48,157,12,103,45,0,45
48,157,12,117,0,35,-35
48,157,13,67,65,63,2
48,157,13,89,96,0,96
48,157,13,121,92,88,4
48,157,13,135,97,41,56
48,157,15,3,83,40,43
48,157,17,31,321,155,166
48,157,17,43,87,38,49
48,157,17,89,50,0,50
48,157,17,197,69,0,69
48,157,18,97,61,0,61
48,157,20,91,100,61,39
48,157,20,173,52,0,52
48,157,21,67,38,0,38
48,157,21,111,60,0,60
48,157,22,15,44,0,44
48,157,22,17,64,0,64
48,157,22,19,91,87,4
48,157,22,33,230,70,160
48,157,22,51,196,109,87
48,157,22,55,175,71,104
48,157,22,71,126,202,-76
48,157,22,73,36,0,36
48,157,22,79,41,0,41
48,157,22,103,141,87,54
48,157,22,109,53,0,53
48,157,24,3,30,0,30
48,157,24,5,37,0,37
48,157,24,31,61,51,10
48,157,24,33,86,0,86
48,157,25,9,43,0,43
48,157,25,17,61,0,61
48,157,25,25,46,28,18
48,157,26,99,75,0,75
48,157,26,125,98,0,98
48,157,26,163,99,0,99
48,157,27,53,43,30,13
48,157,29,95,38,0,38
48,157,29,189,111,0,111
48,157,32,3,173,91,82
48,157,32,31,35,0,35
48,157,34,3,81,0,81
48,157,34,13,62,0,62
48,157,34,17,87,0,87
48,157,34,23,93,0,93
48,157,34,27,44,0,44
48,157,34,39,52,0,52
48,157,35,1,80,32,48
48,157,36,5,54,0,54
48,157,36,47,139,43,96
48,157,36,55,38,0,38
48,157,36,59,139,0,139
48,157,36,61,75,86,-11
48,157,36,81,165,0,165
48,157,36,103,94,0,94
48,157,36,119,70,0,70
48,157,37,119,66,62,4
48,157,37,129,40,0,40
48,157,37,133,31,0,31
48,157,37,183,82,0,82
48,157,39,35,58,0,58
48,157,39,49,47,0,47
48,157,39,113,28,0,28
48,157,39,153,47,0,47
48,157,40,27,49,0,49
48,157,40,109,96,103,-7
48,157,40,143,250,121,129
48,157,40,147,66,89,-23
48,157,41,67,37,0,37
48,157,42,3,80,0,80
48,157,42,91,40,0,40
48,157,42,101,53,0,53
48,157,45,45,41,0,41
48,157,47,37,56,37,19
48,157,47,157,145,40,105
48,157,48,5,30,0,30
48,157,48,15,282,309,-27
48,157,48,25,38,0,38
48,157,48,27,129,104,25
48,157,48,29,549,514,35
48,157,48,39,1485,1740,-255
48,157,48,41,306,216,90
48,157,48,57,30,0,30
48,157,48,61,153,84,69
48,157,48,71,0,38,-38
48,157,48,85,262,348,-86
48,157,48,89,102,123,-21
48,157,48,91,47,98,-51
48,157,48,113,497,424,73
48,157,48,121,258,186,72
48,157,48,141,128,83,45
48,157,48,149,32,38,-6
48,157,48,167,478,381,97
48,157,48,185,38,45,-7
48,157,48,187,40,39,1
48,157,48,199,48,0,48
48,157,48,201,37326,23653,13673
48,157,48,209,94,117,-23
48,157,48,215,184,104,80
48,157,48,239,0,30,-30
48,157,48,241,31,0,31
48,157,48,245,313,250,63
48,157,48,259,0,36,-36
48,157,48,265,0,47,-47
48,157,48,291,64,60,4
48,157,48,303,108,35,73
48,157,48,309,76,58,18
48,157,48,321,158,103,55
48,157,48,329,65,94,-29
48,157,48,339,463,683,-220
48,157,48,347,43,32,11
48,157,48,355,286,106,180
48,157,48,361,40,0,40
48,157,48,373,0,35,-35
48,157,48,397,36,0,36
48,157,48,409,70,43,27
48,157,48,423,65,61,4
48,157,48,439,405,374,31
48,157,48,453,613,625,-12
48,157,48,469,172,65,107
48,157,48,471,71,61,10
48,157,48,473,211,251,-40
48,157,48,477,52,74,-22
48,157,48,479,43,32,11
48,157,48,481,600,416,184
48,157,48,491,211,262,-51
48,157,49,35,52,33,19
48,157,49,49,48,0,48
48,157,51,59,98,73,25
48,157,51,107,47,0,47
48,157,51,153,32,0,32
48,157,51,810,59,31,28
48,157,53,33,133,76,57
48,157,53,53,41,0,41
48,157,53,61,80,0,80
48,157,55,79,56,0,56
48,159,48,63,57,64,-7
48,159,48,85,34,40,-6
48,159,48,113,80,82,-2
48,159,48,121,24,28,-4
48,159,48,223,105,133,-28
48,159,48,343,54,66,-12
48,159,48,439,36,35,1
48,159,48,449,240,506,-266
48,159,48,499,84,92,-8
48,161,48,1,66,95,-29
48,161,48,113,86,89,-3
48,161,48,201,62,45,17
48,161,48,289,114,93,21
48,161,48,293,263,242,21
48,161,48,309,71,87,-16
48,161,48,339,34,0,34
48,161,48,349,78,87,-9
48,161,48,423,38,0,38
48,161,48,439,28,61,-33
48,163,48,13,0,42,-42
48,163,48,29,207,275,-68
48,163,48,201,26,31,-5
48,163,48,283,64,42,22
48,163,48,325,88,86,2
48,163,48,355,0,25,-25
48,163,48,463,0,33,-33
48,165,35,25,121,82,39
48,165,48,29,0,32,-32
48,165,48,135,0,39,-39
48,165,48,303,66,124,-58
48,165,48,329,44,60,-16
48,165,48,445,55,43,12
48,165,48,501,61,60,1
48,167,1,89,0,55,-55
48,167,1,97,27,44,-17
48,167,4,13,115,85,30
48,167,4,19,0,24,-24
48,167,6,1,0,33,-33
48,167,6,37,208,108,100
48,167,6,59,73,56,17
48,167,6,65,58,0,58
48,167,6,67,28,31,-3
48,167,6,71,59,0,59
48,167,6,73,117,129,-12
48,167,8,1,32,0,32
48,167,8,5,0,34,-34
48,167,8,41,0,52,-52
48,167,12,9,48,0,48
48,167,12,11,55,0,55
48,167,12,33,31,0,31
48,167,12,86,77,25,52
48,167,12,91,22,0,22
48,167,12,95,28,34,-6
48,167,12,99,33,0,33
48,167,12,117,33,0,33
48,167,13,121,28,0,28
48,167,15,3,73,35,38
48,167,17,31,62,45,17
48,167,20,173,37,0,37
48,167,22,15,35,0,35
48,167,22,17,31,32,-1
48,167,22,19,120,52,68
48,167,22,33,77,51,26
48,167,22,51,46,55,-9
48,167,22,55,52,47,5
48,167,22,71,0,115,-115
48,167,22,103,45,33,12
48,167,24,31,29,0,29
48,167,29,183,0,31,-31
48,167,32,3,74,53,21
48,167,35,1,30,41,-11
48,167,36,61,0,23,-23
48,167,37,51,0,26,-26
48,167,37,133,29,0,29
48,167,39,35,28,0,28
48,167,39,49,33,0,33
48,167,40,109,54,36,18
48,167,40,143,38,0,38
48,167,47,125,36,0,36
48,167,47,157,33,0,33
48,167,48,1,0,26,-26
48,167,48,5,69,0,69
48,167,48,21,0,28,-28
48,167,48,27,104,114,-10
48,167,48,29,323,320,3
48,167,48,39,2013,1739,274
48,167,48,41,153,124,29
48,167,48,57,0,31,-31
48,167,48,61,148,101,47
48,167,48,71,84,91,-7
48,167,48,73,35,0,35
48,167,48,85,117,86,31
48,167,48,91,46,95,-49
48,167,48,99,0,34,-34
48,167,48,113,325,314,11
48,167,48,121,158,114,44
48,167,48,139,31,0,31
48,167,48,141,62,47,15
48,167,48,149,0,31,-31
48,167,48,157,381,478,-97
48,167,48,183,46,0,46
48,167,48,187,0,42,-42
48,167,48,199,74,42,32
48,167,48,201,10599,8623,1976
48,167,48,209,73,78,-5
48,167,48,215,178,119,59
48,167,48,245,296,227,69
48,167,48,251,33,0,33
48,167,48,265,0,34,-34
48,167,48,289,0,35,-35
48,167,48,291,135,144,-9
48,167,48,303,48,45,3
48,167,48,309,103,62,41
48,167,48,321,38,43,-5
48,167,48,329,41,29,12
48,167,48,339,307,567,-260
48,167,48,347,43,38,5
48,167,48,355,118,135,-17
48,167,48,361,65,81,-16
48,167,48,373,57,93,-36
48,167,48,407,31,36,-5
48,167,48,409,73,0,73
48,167,48,423,66,62,4
48,167,48,439,330,241,89
48,167,48,453,245,404,-159
48,167,48,455,0,50,-50
48,167,48,457,0,52,-52
48,167,48,469,47,41,6
48,167,48,471,53,84,-31
48,167,48,473,0,36,-36
48,167,48,477,0,35,-35
48,167,48,479,34,0,34
48,167,48,491,93,162,-69
48,167,53,33,64,51,13
48,169,48,303,141,225,-84
48,171,48,29,190,130,60
48,171,48,113,36,0,36
48,171,48,201,96,37,59
48,171,48,209,0,35,-35
48,171,48,259,0,25,-25
48,171,48,265,248,166,82
48,171,48,439,34,33,1
48,171,48,453,101,106,-5
48,171,48,491,34,30,4
48,175,48,123,0,38,-38
48,175,48,201,0,39,-39
48,175,48,469,288,270,18
48,177,48,29,97,81,16
48,177,48,55,91,97,-6
48,177,48,91,42,31,11
48,177,48,123,0,48,-48
48,177,48,187,71,177,-106
48,177,48,201,51,0,51
48,177,48,209,44,29,15
48,177,48,285,53,62,-9
48,177,48,453,94,87,7
48,177,48,469,33,28,5
48,177,48,493,0,41,-41
48,179,6,37,39,0,39
48,179,40,109,0,34,-34
48,179,48,65,83,78,5
48,179,48,129,42,0,42
48,179,48,201,44,0,44
48,179,48,233,109,90,19
48,179,48,303,41,48,-7
48,179,48,341,48,0,48
48,179,48,375,189,156,33
48,179,48,381,115,210,-95
48,179,48,439,77,45,32
48,179,48,483,39,0,39
48,181,4,13,38,42,-4
48,181,6,73,34,0,34
48,181,32,3,38,34,4
48,181,40,5,36,39,-3
48,181,40,13,377,539,-162
48,181,40,19,31,0,31
48,181,40,27,25,0,25
48,181,40,95,46,25,21
48,181,40,109,38,49,-11
48,181,40,143,0,61,-61
48,181,48,27,57,54,3
48,181,48,29,51,46,5
48,181,48,85,1194,1276,-82
48,181,48,97,402,358,44
48,181,48,113,767,682,85
48,181,48,121,580,602,-22
48,181,48,139,74,33,41
48,181,48,147,506,425,81
48,181,48,183,33,0,33
48,181,48,201,97,92,5
48,181,48,213,32,32,0
48,181,48,231,93,49,44
48,181,48,257,40,0,40
48,181,48,277,53,47,6
48,181,48,303,29,62,-33
48,181,48,337,0,64,-64
48,181,48,367,0,52,-52
48,181,48,397,31,29,2
48,181,48,423,0,47,-47
48,181,48,439,341,300,41
48,181,48,441,47,0,47
48,181,48,453,52,81,-29
48,181,48,485,54,33,21
48,181,48,491,0,48,-48
48,181,48,497,35,45,-10
48,183,4,13,45,37,8
48,183,6,37,89,38,51
48,183,6,73,40,29,11
48,183,22,15,52,85,-33
48,183,22,17,129,132,-3
48,183,40,109,48,44,4
48,183,40,143,37,35,2
48,183,48,1,36,56,-20
48,183,48,5,34,54,-20
48,183,48,27,51,54,-3
48,183,48,29,69,65,4
48,183,48,37,73,53,20
48,183,48,39,35,52,-17
48,183,48,41,52,57,-5
48,183,48,61,40,0,40
48,183,48,63,106,70,36
48,183,48,67,132,112,20
48,183,48,73,85,71,14
48,183,48,85,106,178,-72
48,183,48,113,477,574,-97
48,183,48,121,151,169,-18
48,183,48,135,27,0,27
48,183,48,139,41,0,41
48,183,48,141,0,30,-30
48,183,48,167,0,46,-46
48,183,48,181,0,33,-33
48,183,48,201,241,302,-61
48,183,48,203,1396,1439,-43
48,183,48,213,38,62,-24
48,183,48,215,41,0,41
48,183,48,223,27,0,27
48,183,48,231,26,44,-18
48,183,48,245,35,56,-21
48,183,48,251,0,48,-48
48,183,48,277,29,0,29
48,183,48,303,34,0,34
48,183,48,309,66,41,25
48,183,48,315,180,105,75
48,183,48,329,28,0,28
48,183,48,339,51,71,-20
48,183,48,343,95,71,24
48,183,48,347,123,105,18
48,183,48,355,0,35,-35
48,183,48,365,164,157,7
48,183,48,397,0,28,-28
48,183,48,401,1065,1003,62
48,183,48,419,32,0,32
48,183,48,423,678,820,-142
48,183,48,439,278,334,-56
48,183,48,449,100,54,46
48,183,48,453,72,98,-26
48,183,48,459,1109,1349,-240
48,183,48,467,44,0,44
48,183,48,491,0,50,-50
48,183,48,499,152,103,49
48,185,48,41,412,555,-143
48,185,48,113,45,0,45
48,185,48,157,45,38,7
48,185,48,201,540,312,228
48,185,48,313,57,50,7
48,185,48,339,311,316,-5
48,185,48,453,0,31,-31
48,185,48,471,64,80,-16
48,185,48,473,57,44,13
48,185,48,477,73,59,14
48,187,2,20,38,0,38
48,187,4,13,128,58,70
48,187,4,19,41,0,41
48,187,6,37,174,57,117
48,187,6,59,48,0,48
48,187,6,65,62,0,62
48,187,6,67,39,0,39
48,187,6,71,71,0,71
48,187,6,73,69,41,28
48,187,8,41,96,50,46
48,187,15,3,105,29,76
48,187,17,31,45,0,45
48,187,24,31,39,0,39
48,187,32,3,83,30,53
48,187,35,1,38,0,38
48,187,40,109,34,0,34
48,187,48,13,61,39,22
48,187,48,21,0,39,-39
48,187,48,27,98,109,-11
48,187,48,29,5874,3271,2603
48,187,48,39,43,49,-6
48,187,48,41,52,34,18
48,187,48,55,199,148,51
48,187,48,61,56,0,56
48,187,48,85,32,48,-16
48,187,48,91,1145,1391,-246
48,187,48,113,93,75,18
48,187,48,121,50,49,1
48,187,48,141,101,39,62
48,187,48,157,39,40,-1
48,187,48,167,42,0,42
48,187,48,177,177,71,106
48,187,48,201,293,308,-15
48,187,48,209,425,429,-4
48,187,48,215,67,56,11
48,187,48,255,29,0,29
48,187,48,259,43,0,43
48,187,48,265,36,41,-5
48,187,48,303,74,41,33
48,187,48,309,0,27,-27
48,187,48,325,35,40,-5
48,187,48,339,38,38,0
48,187,48,355,145,85,60
48,187,48,439,115,129,-14
48,187,48,441,45,34,11
48,187,48,451,0,32,-32
48,187,48,453,319,349,-30
48,187,48,465,57,0,57
48,187,48,469,47,47,0
48,187,48,479,36,0,36
48,187,48,485,37,0,37
48,187,48,491,133,102,31
48,187,48,493,199,260,-61
48,187,51,59,0,58,-58
48,187,53,53,63,37,26
48,189,48,29,0,59,-59
48,189,48,69,71,33,38
48,189,48,113,66,85,-19
48,189,48,121,40,47,-7
48,189,48,135,0,45,-45
48,189,48,141,38,0,38
48,189,48,153,185,124,61
48,189,48,215,0,34,-34
48,189,48,219,0,38,-38
48,189,48,279,60,47,13
48,189,48,303,459,788,-329
48,189,48,329,0,37,-37
48,189,48,341,0,40,-40
48,189,48,375,58,141,-83
48,189,48,381,65,124,-59
48,189,48,437,135,142,-7
48,189,48,439,42,87,-45
48,189,48,451,0,39,-39
48,191,48,75,0,34,-34
48,193,48,27,0,45,-45
48,193,48,35,33,0,33
48,193,48,93,28,50,-22
48,193,48,99,44,75,-31
48,193,48,113,27,0,27
48,193,48,143,141,107,34
48,193,48,309,0,30,-30
48,193,48,439,47,0,47
48,195,40,139,33,0,33
48,195,48,357,44,60,-16
48,195,48,375,39,40,-1
48,195,48,381,40,25,15
48,197,48,75,0,42,-42
48,197,48,439,0,36,-36
48,197,48,485,0,26,-26
48,197,48,487,46,60,-14
48,199,22,19,0,28,-28
48,199,48,5,89,44,45
48,199,48,27,39,0,39
48,199,48,39,47,40,7
48,199,48,71,59,56,3
48,199,48,113,34,0,34
48,199,48,157,0,48,-48
48,199,48,167,42,74,-32
48,199,48,201,283,239,44
48,199,48,209,0,27,-27
48,199,48,241,279,239,40
48,199,48,245,1621,1345,276
48,199,48,291,183,137,46
48,199,48,339,67,88,-21
48,199,48,347,43,0,43
48,199,48,351,45,48,-3
48,199,48,361,353,407,-54
48,199,48,373,53,0,53
48,199,48,403,34,34,0
48,199,48,439,43,36,7
48,199,48,453,46,38,8
48,199,48,457,214,274,-60
48,199,48,491,48,0,48
48,201,1,3,121,104,17
48,201,1,15,24,0,24
48,201,1,31,0,39,-39
48,201,1,73,204,174,30
48,201,1,81,37,27,10
48,201,1,89,96,195,-99
48,201,1,97,305,205,100
48,201,1,101,96,56,40
48,201,1,103,0,30,-30
48,201,1,117,73,83,-10
48,201,1,125,49,30,19
48,201,2,20,246,315,-69
48,201,2,90,67,49,18
48,201,4,3,53,44,9
48,201,4,5,0,35,-35
48,201,4,13,1400,1019,381
48,201,4,15,44,46,-2
48,201,4,19,271,243,28
48,201,4,21,39,62,-23
48,201,4,25,29,47,-18
48,201,4,27,64,66,-2
48,201,5,7,167,135,32
48,201,5,27,41,0,41
48,201,5,33,48,0,48
48,201,5,45,52,71,-19
48,201,5,51,55,122,-67
48,201,5,69,59,45,14
48,201,5,91,0,27,-27
48,201,5,119,361,225,136
48,201,5,125,59,87,-28
48,201,5,131,88,0,88
48,201,5,139,36,0,36
48,201,5,143,163,78,85
48,201,6,1,495,341,154
48,201,6,13,428,704,-276
48,201,6,17,43,38,5
48,201,6,19,176,117,59
48,201,6,25,33,0,33
48,201,6,29,328,220,108
48,201,6,31,48,31,17
48,201,6,37,5103,2207,2896
48,201,6,41,40,47,-7
48,201,6,53,116,75,41
48,201,6,59,1439,697,742
48,201,6,61,59,64,-5
48,201,6,65,718,316,402
48,201,6,67,419,274,145
48,201,6,71,944,393,551
48,201,6,73,1670,1166,504
48,201,6,75,241,290,-49
48,201,6,77,194,76,118
48,201,6,79,29,46,-17
48,201,6,81,181,170,11
48,201,6,83,114,58,56
48,201,6,85,720,522,198
48,201,6,87,0,29,-29
48,201,6,89,0,27,-27
48,201,6,95,151,73,78
48,201,6,97,64,70,-6
48,201,6,99,131,59,72
48,201,6,107,70,0,70
48,201,6,111,305,164,141
48,201,6,113,43,0,43
48,201,8,1,161,184,-23
48,201,8,5,343,355,-12
48,201,8,13,107,147,-40
48,201,8,14,29,55,-26
48,201,8,31,370,450,-80
48,201,8,35,158,207,-49
48,201,8,37,0,25,-25
48,201,8,41,355,390,-35
48,201,8,45,49,74,-25
48,201,8,59,228,207,21
48,201,8,67,42,48,-6
48,201,8,69,115,88,27
48,201,8,77,46,99,-53
48,201,8,101,42,48,-6
48,201,8,117,0,23,-23
48,201,8,123,64,87,-23
48,201,9,1,226,119,107
48,201,9,3,194,102,92
48,201,9,5,33,0,33
48,201,9,7,33,0,33
48,201,9,9,181,95,86
48,201,9,11,77,34,43
48,201,10,1,39,0,39
48,201,10,3,158,85,73
48,201,11,1,275,315,-40
48,201,12,1,138,63,75
48,201,12,5,141,59,82
48,201,12,9,191,95,96
48,201,12,11,870,401,469
48,201,12,15,43,0,43
48,201,12,19,65,61,4
48,201,12,21,228,81,147
48,201,12,31,462,286,176
48,201,12,33,228,133,95
48,201,12,35,0,25,-25
48,201,12,53,0,37,-37
48,201,12,55,26,0,26
48,201,12,57,609,341,268
48,201,12,61,48,26,22
48,201,12,69,102,84,18
48,201,12,71,436,113,323
48,201,12,73,175,48,127
48,201,12,81,119,54,65
48,201,12,83,83,38,45
48,201,12,85,35,0,35
48,201,12,86,1663,630,1033
48,201,12,87,34,36,-2
48,201,12,91,153,71,82
48,201,12,95,674,330,344
48,201,12,97,206,59,147
48,201,12,99,575,249,326
48,201,12,101,157,70,87
48,201,12,103,286,157,129
48,201,12,105,297,110,187
48,201,12,109,42,52,-10
48,201,12,111,131,0,131
48,201,12,113,66,39,27
48,201,12,115,107,65,42
48,201,12,117,196,113,83
48,201,12,127,151,96,55
48,201,13,39,29,0,29
48,201,13,51,134,93,41
48,201,13,57,70,63,7
48,201,13,59,33,0,33
48,201,13,63,164,92,72
48,201,13,67,591,314,277
48,201,13,73,40,0,40
48,201,13,77,36,39,-3
48,201,13,89,337,315,22
48,201,13,97,71,43,28
48,201,13,113,52,0,52
48,201,13,117,42,59,-17
48,201,13,121,543,486,57
48,201,13,127,0,27,-27
48,201,13,129,55,0,55
48,201,13,135,518,358,160
48,201,13,139,79,0,79
48,201,13,151,122,41,81
48,201,13,153,52,0,52
48,201,13,179,90,52,38
48,201,13,215,89,73,16
48,201,13,223,33,40,-7
48,201,13,245,71,55,16
48,201,13,313,57,0,57
48,201,15,1,40,47,-7
48,201,15,3,485,350,135
48,201,15,9,50,25,25
48,201,16,1,79,79,0
48,201,16,27,34,0,34
48,201,16,65,0,32,-32
48,201,17,19,100,45,55
48,201,17,31,1827,1169,658
48,201,17,37,30,0,30
48,201,17,43,341,205,136
48,201,17,77,27,0,27
48,201,17,89,171,105,66
48,201,17,97,207,99,108
48,201,17,111,46,42,4
48,201,17,113,38,0,38
48,201,17,115,33,0,33
48,201,17,119,53,47,6
48,201,17,143,131,56,75
48,201,17,161,48,0,48
48,201,17,163,68,0,68
48,201,17,167,50,26,24
48,201,17,179,31,0,31
48,201,17,197,198,152,46
48,201,17,199,0,28,-28
48,201,17,201,69,36,33
48,201,18,3,102,59,43
48,201,18,39,50,0,50
48,201,18,57,84,44,40
48,201,18,81,31,35,-4
48,201,18,89,131,68,63
48,201,18,97,317,177,140
48,201,18,105,60,44,16
48,201,18,127,30,36,-6
48,201,18,141,56,57,-1
48,201,18,157,103,0,103
48,201,18,163,40,28,12
48,201,18,167,37,0,37
48,201,19,13,0,27,-27
48,201,19,71,0,44,-44
48,201,19,103,66,28,38
48,201,19,113,65,38,27
48,201,19,153,123,61,62
48,201,19,163,44,114,-70
48,201,19,169,27,0,27
48,201,19,193,56,0,56
48,201,20,45,71,38,33
48,201,20,61,76,59,17
48,201,20,91,290,218,72
48,201,20,103,38,0,38
48,201,20,161,61,40,21
48,201,20,169,31,0,31
48,201,20,173,361,150,211
48,201,20,175,42,0,42
48,201,20,177,73,41,32
48,201,20,209,50,33,17
48,201,21,15,37,0,37
48,201,21,47,62,68,-6
48,201,21,67,75,59,16
48,201,21,93,0,59,-59
48,201,21,111,245,164,81
48,201,21,117,28,0,28
48,201,22,1,116,72,44
48,201,22,3,35,54,-19
48,201,22,5,230,198,32
48,201,22,9,54,55,-1
48,201,22,11,62,60,2
48,201,22,15,165,120,45
48,201,22,17,512,327,185
48,201,22,19,819,705,114
48,201,22,31,0,37,-37
48,201,22,33,1244,925,319
48,201,22,39,41,44,-3
48,201,22,45,133,108,25
48,201,22,49,43,0,43
48,201,22,51,1422,1902,-480
48,201,22,53,36,46,-10
48,201,22,55,1110,540,570
48,201,22,57,70,92,-22
48,201,22,61,120,42,78
48,201,22,63,124,110,14
48,201,22,67,27,0,27
48,201,22,69,66,104,-38
48,201,22,71,1403,4562,-3159
48,201,22,73,218,152,66
48,201,22,75,75,55,20
48,201,22,77,0,58,-58
48,201,22,79,277,166,111
48,201,22,87,36,172,-136
48,201,22,89,141,137,4
48,201,22,91,37,0,37
48,201,22,95,95,142,-47
48,201,22,97,182,186,-4
48,201,22,99,72,97,-25
48,201,22,101,412,156,256
48,201,22,103,379,439,-60
48,201,22,105,160,98,62
48,201,22,109,259,140,119
48,201,22,113,80,44,36
48,201,22,115,227,71,156
48,201,22,117,32,55,-23
48,201,22,119,30,35,-5
48,201,23,5,77,0,77
48,201,24,3,190,115,75
48,201,24,5,264,152,112
48,201,24,17,25,0,25
48,201,24,21,74,0,74
48,201,24,27,130,72,58
48,201,24,31,487,296,191
48,201,24,33,349,233,116
48,201,24,37,36,0,36
48,201,24,510,125,94,31
48,201,25,1,31,25,6
48,201,25,5,68,0,68
48,201,25,9,186,57,129
48,201,25,13,57,31,26
48,201,25,15,31,0,31
48,201,25,17,423,247,176
48,201,25,21,166,97,69
48,201,25,23,50,0,50
48,201,25,25,330,173,157
48,201,25,27,172,66,106
48,201,26,21,38,0,38
48,201,26,25,32,0,32
48,201,26,45,38,0,38
48,201,26,49,157,58,99
48,201,26,65,94,50,44
48,201,26,75,43,0,43
48,201,26,77,100,0,100
48,201,26,81,157,36,121
48,201,26,93,40,0,40
48,201,26,99,175,70,105
48,201,26,111,39,0,39
48,201,26,125,601,132,469
48,201,26,139,66,0,66
48,201,26,145,46,0,46
48,201,26,161,157,85,72
48,201,26,163,669,172,497
48,201,27,3,37,39,-2
48,201,27,13,27,0,27
48,201,27,37,64,46,18
48,201,27,53,412,231,181
48,201,27,109,45,36,9
48,201,27,123,117,62,55
48,201,27,163,36,37,-1
48,201,28,1,53,35,18
48,201,28,11,30,0,30
48,201,28,33,62,36,26
48,201,28,35,62,52,10
48,201,28,45,0,42,-42
48,201,28,47,165,167,-2
48,201,28,49,195,91,104
48,201,28,59,176,99,77
48,201,28,67,44,0,44
48,201,28,71,26,0,26
48,201,28,73,36,30,6
48,201,28,75,33,0,33
48,201,28,81,29,0,29
48,201,28,85,28,0,28
48,201,28,89,114,58,56
48,201,28,105,45,0,45
48,201,28,109,33,32,1
48,201,28,113,35,0,35
48,201,28,121,82,64,18
48,201,28,149,55,40,15
48,201,28,151,50,34,16
48,201,29,19,88,58,30
48,201,29,21,37,0,37
48,201,29,31,25,0,25
48,201,29,43,38,0,38
48,201,29,47,108,57,51
48,201,29,77,77,64,13
48,201,29,95,261,198,63
48,201,29,99,31,0,31
48,201,29,161,52,0,52
48,201,29,165,40,53,-13
48,201,29,169,49,0,49
48,201,29,183,157,60,97
48,201,29,189,480,273,207
48,201,29,213,39,0,39
48,201,29,510,168,125,43
48,201,30,63,0,33,-33
48,201,30,111,56,44,12
48,201,31,55,231,153,78
48,201,31,109,103,28,75
48,201,31,153,87,20,67
48,201,32,3,974,972,2
48,201,32,31,175,99,76
48,201,33,11,93,47,46
48,201,33,13,28,0,28
48,201,33,15,34,0,34
48,201,34,1,68,0,68
48,201,34,3,193,86,107
48,201,34,5,97,72,25
48,201,34,7,119,0,119
48,201,34,13,251,70,181
48,201,34,15,39,0,39
48,201,34,17,309,133,176
48,201,34,21,102,62,40
48,201,34,23,362,214,148
48,201,34,25,93,38,55
48,201,34,27,121,92,29
48,201,34,29,87,30,57
48,201,34,31,80,57,23
48,201,34,35,100,47,53
48,201,34,37,37,0,37
48,201,34,39,228,50,178
48,201,35,1,262,221,41
48,201,35,9,32,0,32
48,201,35,13,153,64,89
48,201,35,15,0,40,-40
48,201,35,25,45,0,45
48,201,35,35,50,28,22
48,201,35,43,73,69,4
48,201,35,45,50,61,-11
48,201,35,49,49,62,-13
48,201,36,1,68,45,23
48,201,36,5,406,161,245
48,201,36,7,43,0,43
48,201,36,27,50,0,50
48,201,36,29,183,109,74
48,201,36,45,101,85,16
48,201,36,47,560,371,189
48,201,36,55,149,63,86
48,201,36,59,457,125,332
48,201,36,61,754,837,-83
48,201,36,63,51,0,51
48,201,36,65,27,0,27
48,201,36,67,104,30,74
48,201,36,71,122,55,67
48,201,36,81,666,248,418
48,201,36,83,48,0,48
48,201,36,85,80,47,33
48,201,36,87,32,0,32
48,201,36,91,52,36,16
48,201,36,103,432,153,279
48,201,36,109,45,0,45
48,201,36,119,208,105,103
48,201,37,1,42,0,42
48,201,37,21,53,75,-22
48,201,37,49,45,52,-7
48,201,37,51,200,235,-35
48,201,37,63,140,128,12
48,201,37,67,54,64,-10
48,201,37,81,117,59,58
48,201,37,89,39,0,39
48,201,37,97,36,37,-1
48,201,37,101,29,0,29
48,201,37,119,460,320,140
48,201,37,129,51,37,14
48,201,37,133,241,186,55
48,201,37,135,38,65,-27
48,201,37,147,27,30,-3
48,201,37,183,292,191,101
48,201,37,191,49,0,49
48,201,38,17,23,0,23
48,201,38,101,28,0,28
48,201,39,17,100,61,39
48,201,39,25,31,0,31
48,201,39,35,368,184,184
48,201,39,41,41,41,0
48,201,39,49,383,227,156
48,201,39,61,229,77,152
48,201,39,63,28,0,28
48,201,39,85,59,0,59
48,201,39,93,47,0,47
48,201,39,95,90,53,37
48,201,39,99,34,0,34
48,201,39,103,59,0,59
48,201,39,113,111,74,37
48,201,39,151,67,43,24
48,201,39,153,140,66,74
48,201,39,155,31,0,31
48,201,39,165,74,55,19
48,201,39,173,29,0,29
48,201,40,17,83,51,32
48,201,40,19,45,31,14
48,201,40,27,262,138,124
48,201,40,31,177,100,77
48,201,40,37,32,0,32
48,201,40,47,43,28,15
48,201,40,51,0,31,-31
48,201,40,71,47,57,-10
48,201,40,109,639,554,85
48,201,40,119,95,43,52
48,201,40,131,33,0,33
48,201,40,137,38,31,7
48,201,40,143,894,593,301
48,201,40,145,46,30,16
48,201,40,147,136,309,-173
48,201,41,5,58,30,28
48,201,41,29,33,0,33
48,201,41,39,43,52,-9
48,201,41,47,35,40,-5
48,201,41,51,147,195,-48
48,201,41,67,163,102,61
48,201,42,3,297,183,114
48,201,42,7,34,0,34
48,201,42,11,66,34,32
48,201,42,17,108,97,11
48,201,42,27,39,0,39
48,201,42,29,92,64,28
48,201,42,43,91,37,54
48,201,42,45,98,48,50
48,201,42,49,37,0,37
48,201,42,71,64,37,27
48,201,42,77,83,40,43
48,201,42,89,45,0,45
48,201,42,91,121,116,5
48,201,42,95,88,0,88
48,201,42,101,314,214,100
48,201,42,125,35,0,35
48,201,42,129,33,29,4
48,201,42,133,46,0,46
48,201,44,3,25,0,25
48,201,44,7,114,72,42
48,201,45,3,50,0,50
48,201,45,13,75,35,40
48,201,45,15,64,78,-14
48,201,45,19,96,77,19
48,201,45,45,117,102,15
48,201,45,51,42,29,13
48,201,45,63,47,0,47
48,201,45,79,97,108,-11
48,201,45,83,46,0,46
48,201,45,85,0,40,-40
48,201,45,91,0,51,-51
48,201,46,99,38,0,38
48,201,47,9,34,0,34
48,201,47,37,401,372,29
48,201,47,65,90,78,12
48,201,47,93,140,126,14
48,201,47,125,115,101,14
48,201,47,149,83,62,21
48,201,47,157,526,319,207
48,201,47,163,0,35,-35
48,201,47,165,0,38,-38
48,201,47,179,27,0,27
48,201,47,187,41,54,-13
48,201,48,1,212,158,54
48,201,48,5,604,445,159
48,201,48,7,98,127,-29
48,201,48,13,77,30,47
48,201,48,15,634,673,-39
48,201,48,19,43,46,-3
48,201,48,21,180,317,-137
48,201,48,25,88,54,34
48,201,48,27,986,876,110
48,201,48,29,3838,3937,-99
48,201,48,35,0,29,-29
48,201,48,37,126,74,52
48,201,48,39,7975,12056,-4081
48,201,48,41,2466,1569,897
48,201,48,49,34,45,-11
48,201,48,51,75,114,-39
48,201,48,53,116,217,-101
48,201,48,55,94,91,3
48,201,48,57,101,130,-29
48,201,48,61,1813,1485,328
48,201,48,67,0,50,-50
48,201,48,71,1732,2222,-490
48,201,48,73,101,141,-40
48,201,48,85,1421,1417,4
48,201,48,89,187,304,-117
48,201,48,91,303,580,-277
48,201,48,93,25,0,25
48,201,48,99,179,177,2
48,201,48,113,4865,4653,212
48,201,48,121,1139,1382,-243
48,201,48,123,77,67,10
48,201,48,135,206,178,28
48,201,48,139,160,191,-31
48,201,48,141,882,624,258
48,201,48,143,59,43,16
48,201,48,145,53,37,16
48,201,48,149,164,262,-98
48,201,48,157,23653,37326,-13673
48,201,48,161,45,62,-17
48,201,48,163,31,26,5
48,201,48,167,8623,10599,-1976
48,201,48,171,37,96,-59
48,201,48,175,39,0,39
48,201,48,177,0,51,-51
48,201,48,179,0,44,-44
48,201,48,181,92,97,-5
48,201,48,183,302,241,61
48,201,48,185,312,540,-228
48,201,48,187,308,293,15
48,201,48,199,239,283,-44
48,201,48,203,88,101,-13
48,201,48,209,643,749,-106
48,201,48,213,88,76,12
48,201,48,215,1959,2084,-125
48,201,48,217,60,46,14
48,201,48,219,31,0,31
48,201,48,221,50,68,-18
48,201,48,223,38,37,1
48,201,48,225,129,243,-114
48,201,48,227,34,31,3
48,201,48,231,100,68,32
48,201,48,233,47,38,9
48,201,48,239,51,90,-39
48,201,48,241,208,180,28
48,201,48,245,2936,2119,817
48,201,48,249,127,61,66
48,201,48,251,110,154,-44
48,201,48,257,96,74,22
48,201,48,259,57,196,-139
48,201,48,265,135,200,-65
48,201,48,273,178,103,75
48,201,48,277,52,0,52
48,201,48,281,0,39,-39
48,201,48,285,137,68,69
48,201,48,287,91,77,14
48,201,48,289,103,232,-129
48,201,48,291,2475,2732,-257
48,201,48,293,61,75,-14
48,201,48,299,31,49,-18
48,201,48,303,621,371,250
48,201,48,309,710,472,238
48,201,48,313,120,83,37
48,201,48,321,317,355,-38
48,201,48,323,125,124,1
48,201,48,325,37,38,-1
48,201,48,329,307,391,-84
48,201,48,331,79,126,-47
48,201,48,339,13479,21315,-7836
48,201,48,347,503,338,165
48,201,48,349,106,63,43
48,201,48,351,47,45,2
48,201,48,355,1389,1076,313
48,201,48,361,430,385,45
48,201,48,363,43,0,43
48,201,48,365,57,53,4
48,201,48,367,149,103,46
48,201,48,373,548,804,-256
48,201,48,375,192,91,101
48,201,48,381,127,117,10
48,201,48,391,0,30,-30
48,201,48,395,86,94,-8
48,201,48,397,131,165,-34
48,201,48,401,123,110,13
48,201,48,403,41,95,-54
48,201,48,405,41,0,41
48,201,48,407,458,548,-90
48,201,48,409,274,263,11
48,201,48,419,108,114,-6
48,201,48,423,559,521,38
48,201,48,427,327,298,29
48,201,48,439,3004,3020,-16
48,201,48,441,176,175,1
48,201,48,449,44,0,44
48,201,48,451,233,140,93
48,201,48,453,4690,5244,-554
48,201,48,455,153,209,-56
48,201,48,457,122,137,-15
48,201,48,459,43,0,43
48,201,48,463,41,45,-4
48,201,48,465,112,99,13
48,201,48,467,30,31,-1
48,201,48,469,599,357,242
48,201,48,471,879,820,59
48,201,48,473,1670,1725,-55
48,201,48,477,332,418,-86
48,201,48,479,531,537,-6
48,201,48,481,396,417,-21
48,201,48,485,192,135,57
48,201,48,489,76,48,28
48,201,48,491,1263,1461,-198
48,201,48,493,49,47,2
48,201,48,497,34,42,-8
48,201,48,499,51,62,-11
48,201,48,505,33,31,2
48,201,49,5,61,0,61
48,201,49,11,33,69,-36
48,201,49,35,375,283,92
48,201,49,49,288,127,161
48,201,49,57,49,35,14
48,201,51,3,39,0,39
48,201,51,13,163,179,-16
48,201,51,41,97,64,33
48,201,51,59,599,435,164
48,201,51,87,150,106,44
48,201,51,107,168,110,58
48,201,51,121,49,0,49
48,201,51,153,383,140,243
48,201,51,177,42,0,42
48,201,51,179,72,66,6
48,201,51,510,112,106,6
48,201,51,550,83,25,58
48,201,51,650,121,86,35
48,201,51,683,45,0,45
48,201,51,685,44,0,44
48,201,51,700,166,82,84
48,201,51,710,206,134,72
48,201,51,740,45,56,-11
48,201,51,760,48,0,48
48,201,51,810,300,169,131
48,201,53,5,0,44,-44
48,201,53,11,112,104,8
48,201,53,21,39,0,39
48,201,53,29,62,0,62
48,201,53,33,619,733,-114
48,201,53,35,138,66,72
48,201,53,53,241,273,-32
48,201,53,57,32,45,-13
48,201,53,61,221,167,54
48,201,53,63,118,56,62
48,201,53,67,33,47,-14
48,201,53,73,36,55,-19
48,201,54,39,37,31,6
48,201,54,61,37,0,37
48,201,55,25,148,82,66
48,201,55,79,315,152,163
48,201,55,133,87,38,49
48,201,55,139,36,0,36
48,201,56,1,23,0,23
48,201,56,21,40,35,5
48,201,56,25,69,33,36
48,201,56,37,28,46,-18
48,203,22,15,99,73,26
48,203,22,17,294,220,74
48,203,48,29,0,28,-28
48,203,48,37,57,0,57
48,203,48,41,0,28,-28
48,203,48,67,90,73,17
48,203,48,85,53,50,3
48,203,48,113,166,213,-47
48,203,48,121,32,74,-42
48,203,48,183,1439,1396,43
48,203,48,201,101,88,13
48,203,48,315,183,201,-18
48,203,48,339,30,41,-11
48,203,48,347,37,35,2
48,203,48,365,211,193,18
48,203,48,401,182,173,9
48,203,48,423,107,208,-101
48,203,48,439,168,120,48
48,203,48,453,30,50,-20
48,203,48,459,197,179,18
48,205,48,375,0,40,-40
48,205,48,381,46,69,-23
48,207,48,253,58,36,22
48,207,48,275,55,43,12
48,207,48,303,0,44,-44
48,207,48,441,90,64,26
48,209,4,13,120,52,68
48,209,4,25,26,0,26
48,209,6,37,175,46,129
48,209,6,59,73,28,45
48,209,6,65,100,0,100
48,209,6,67,39,0,39
48,209,6,71,66,0,66
48,209,6,73,110,51,59
48,209,6,85,56,0,56
48,209,6,111,41,0,41
48,209,8,35,43,0,43
48,209,8,41,33,0,33
48,209,12,86,30,0,30
48,209,15,3,45,0,45
48,209,17,31,53,36,17
48,209,22,17,30,0,30
48,209,32,3,82,0,82
48,209,48,5,30,0,30
48,209,48,13,42,0,42
48,209,48,21,261,212,49
48,209,48,27,160,106,54
48,209,48,29,857,920,-63
48,209,48,31,56,80,-24
48,209,48,39,73,58,15
48,209,48,41,130,60,70
48,209,48,53,47,61,-14
48,209,48,55,873,751,122
48,209,48,61,104,60,44
48,209,48,85,136,115,21
48,209,48,91,493,644,-151
48,209,48,99,28,0,28
48,209,48,113,289,187,102
48,209,48,121,132,127,5
48,209,48,135,32,28,4
48,209,48,139,42,0,42
48,209,48,141,96,51,45
48,209,48,157,117,94,23
48,209,48,167,78,73,5
48,209,48,171,35,0,35
48,209,48,177,29,44,-15
48,209,48,187,429,425,4
48,209,48,199,27,0,27
48,209,48,201,749,643,106
48,209,48,215,136,113,23
48,209,48,245,72,0,72
48,209,48,251,0,29,-29
48,209,48,255,27,0,27
48,209,48,259,26,28,-2
48,209,48,265,42,36,6
48,209,48,303,106,51,55
48,209,48,309,133,90,43
48,209,48,321,30,0,30
48,209,48,329,27,50,-23
48,209,48,331,21,0,21
48,209,48,339,149,126,23
48,209,48,355,163,108,55
48,209,48,381,36,0,36
48,209,48,409,0,46,-46
48,209,48,423,23,0,23
48,209,48,439,235,226,9
48,209,48,441,58,28,30
48,209,48,451,44,34,10
48,209,48,453,7599,4592,3007
48,209,48,465,36,31,5
48,209,48,469,58,66,-8
48,209,48,479,83,31,52
48,209,48,491,700,687,13
48,209,48,493,26,27,-1
48,211,48,375,0,39,-39
48,213,6,73,33,0,33
48,213,48,1,195,208,-13
48,213,48,27,41,51,-10
48,213,48,41,0,37,-37
48,213,48,73,144,101,43
48,213,48,85,165,134,31
48,213,48,113,901,699,202
48,213,48,121,112,143,-31
48,213,48,139,170,162,8
48,213,48,181,32,32,0
48,213,48,183,62,38,24
48,213,48,201,76,88,-12
48,213,48,231,46,55,-9
48,213,48,251,39,69,-30
48,213,48,257,816,891,-75
48,213,48,309,40,30,10
48,213,48,339,0,50,-50
48,213,48,349,125,130,-5
48,213,48,397,30,53,-23
48,213,48,401,0,29,-29
48,213,48,423,853,999,-146
48,213,48,439,330,272,58
48,213,48,453,35,53,-18
48,213,48,467,312,292,20
48,213,48,499,41,30,11
48,215,4,13,142,118,24
48,215,4,19,40,37,3
48,215,5,7,75,45,30
48,215,5,143,41,0,41
48,215,6,1,0,28,-28
48,215,6,19,52,45,7
48,215,6,29,126,59,67
48,215,6,37,281,220,61
48,215,6,53,44,49,-5
48,215,6,59,45,61,-16
48,215,6,65,94,0,94
48,215,6,67,31,0,31
48,215,6,71,114,34,80
48,215,6,73,175,113,62
48,215,6,77,55,0,55
48,215,6,85,56,37,19
48,215,6,107,41,0,41
48,215,8,41,41,57,-16
48,215,12,11,44,38,6
48,215,12,21,103,0,103
48,215,12,51,79,0,79
48,215,12,57,148,52,96
48,215,12,69,43,0,43
48,215,12,71,86,0,86
48,215,12,81,81,45,36
48,215,12,86,189,41,148
48,215,12,95,71,40,31
48,215,12,99,128,59,69
48,215,12,105,63,0,63
48,215,13,135,86,36,50
48,215,15,3,33,43,-10
48,215,16,27,32,0,32
48,215,17,19,0,44,-44
48,215,17,31,215,130,85
48,215,17,43,47,50,-3
48,215,17,89,51,49,2
48,215,17,97,50,0,50
48,215,17,197,38,41,-3
48,215,18,39,73,0,73
48,215,18,97,122,39,83
48,215,18,141,58,0,58
48,215,19,21,51,36,15
48,215,19,153,46,0,46
48,215,20,91,48,0,48
48,215,20,173,34,0,34
48,215,22,51,0,40,-40
48,215,25,17,0,29,-29
48,215,26,5,60,46,14
48,215,26,65,57,0,57
48,215,26,81,63,47,16
48,215,26,99,66,0,66
48,215,26,121,35,0,35
48,215,26,125,52,39,13
48,215,26,127,72,43,29
48,215,26,139,166,133,33
48,215,26,159,72,43,29
48,215,26,163,147,65,82
48,215,27,3,0,40,-40
48,215,27,15,32,45,-13
48,215,27,53,39,0,39
48,215,27,67,65,0,65
48,215,27,123,24,0,24
48,215,27,129,61,0,61
48,215,27,161,0,48,-48
48,215,28,47,0,42,-42
48,215,29,95,0,27,-27
48,215,29,119,44,0,44
48,215,31,47,50,0,50
48,215,31,55,0,37,-37
48,215,32,3,83,70,13
48,215,35,1,48,31,17
48,215,36,61,32,37,-5
48,215,37,51,36,0,36
48,215,37,133,56,0,56
48,215,37,183,0,42,-42
48,215,39,49,0,29,-29
48,215,40,109,41,38,3
48,215,40,143,0,66,-66
48,215,46,99,36,0,36
48,215,47,37,44,44,0
48,215,47,157,38,0,38
48,215,48,7,0,55,-55
48,215,48,21,0,65,-65
48,215,48,27,147,164,-17
48,215,48,29,1208,1424,-216
48,215,48,39,181,242,-61
48,215,48,41,55,81,-26
48,215,48,47,58,57,1
48,215,48,57,33,0,33
48,215,48,61,2569,2051,518
48,215,48,85,74,67,7
48,215,48,91,42,70,-28
48,215,48,99,0,41,-41
48,215,48,113,722,585,137
48,215,48,121,126,155,-29
48,215,48,131,30,0,30
48,215,48,135,29,50,-21
48,215,48,139,0,27,-27
48,215,48,141,192,231,-39
48,215,48,157,104,184,-80
48,215,48,167,119,178,-59
48,215,48,183,0,41,-41
48,215,48,187,56,67,-11
48,215,48,189,34,0,34
48,215,48,201,2084,1959,125
48,215,48,209,113,136,-23
48,215,48,245,124,115,9
48,215,48,249,110,73,37
48,215,48,251,0,39,-39
48,215,48,259,0,28,-28
48,215,48,265,0,29,-29
48,215,48,273,107,119,-12
48,215,48,303,64,76,-12
48,215,48,309,0,53,-53
48,215,48,321,0,29,-29
48,215,48,323,65,48,17
48,215,48,339,93,83,10
48,215,48,341,0,66,-66
48,215,48,355,575,496,79
48,215,48,373,103,0,103
48,215,48,375,32,37,-5
48,215,48,409,96,79,17
48,215,48,423,49,0,49
48,215,48,427,1315,635,680
48,215,48,439,414,379,35
48,215,48,441,0,39,-39
48,215,48,453,575,674,-99
48,215,48,463,46,0,46
48,215,48,465,51,0,51
48,215,48,469,99,69,30
48,215,48,473,39,0,39
48,215,48,479,449,364,85
48,215,48,489,238,166,72
48,215,48,491,126,272,-146
48,215,48,505,36,38,-2
48,215,49,5,0,37,-37
48,215,51,59,43,0,43
48,215,51,153,39,0,39
48,215,53,25,47,0,47
48,215,53,33,0,38,-38
48,215,53,53,0,33,-33
48,215,53,77,48,0,48
48,217,48,27,44,35,9
48,217,48,35,184,128,56
48,217,48,85,0,61,-61
48,217,48,113,199,149,50
48,217,48,121,47,53,-6
48,217,48,139,178,121,57
48,217,48,201,46,60,-14
48,217,48,221,38,43,-5
48,217,48,251,369,348,21
48,217,48,293,41,0,41
48,217,48,309,444,565,-121
48,217,48,349,91,71,20
48,217,48,439,325,334,-9
48,217,48,453,38,37,1
48,219,48,79,125,52,73
48,219,48,135,0,45,-45
48,219,48,189,38,0,38
48,219,48,201,0,31,-31
48,219,48,279,99,81,18
48,219,48,303,680,1005,-325
48,219,48,329,0,50,-50
48,219,48,439,0,51,-51
48,219,48,445,73,30,43
48,219,48,501,0,39,-39
48,221,4,13,46,0,46
48,221,6,37,31,0,31
48,221,6,73,46,0,46
48,221,8,77,34,0,34
48,221,26,137,44,0,44
48,221,48,27,48,0,48
48,221,48,29,49,29,20
48,221,48,35,44,46,-2
48,221,48,41,0,33,-33
48,221,48,49,43,0,43
48,221,48,85,39,57,-18
48,221,48,93,26,0,26
48,221,48,97,30,0,30
48,221,48,113,189,139,50
48,221,48,121,91,74,17
48,221,48,133,33,0,33
48,221,48,135,39,0,39
48,221,48,139,61,0,61
48,221,48,143,247,156,91
48,221,48,201,68,50,18
48,221,48,217,43,38,5
48,221,48,251,325,306,19
48,221,48,309,37,0,37
48,221,48,329,86,40,46
48,221,48,355,28,0,28
48,221,48,363,69,40,29
48,221,48,367,391,323,68
48,221,48,423,28,0,28
48,221,48,425,171,115,56
48,221,48,439,1217,1199,18
48,221,48,441,54,0,54
48,221,48,451,61,0,61
48,221,48,453,48,31,17
48,221,48,497,67,37,30
48,223,6,37,35,0,35
48,223,48,29,0,28,-28
48,223,48,63,0,30,-30
48,223,48,85,76,80,-4
48,223,48,113,229,157,72
48,223,48,119,65,74,-9
48,223,48,121,79,61,18
48,223,48,159,133,105,28
48,223,48,183,0,27,-27
48,223,48,201,37,38,-1
48,223,48,231,284,252,32
48,223,48,277,72,70,2
48,223,48,379,99,102,-3
48,223,48,397,43,49,-6
48,223,48,423,36,66,-30
48,223,48,439,84,86,-2
48,223,48,449,52,57,-5
48,223,48,499,218,163,55
48,225,48,1,115,135,-20
48,225,48,5,105,92,13
48,225,48,39,40,0,40
48,225,48,73,0,32,-32
48,225,48,113,41,44,-3
48,225,48,201,243,129,114
48,225,48,339,0,72,-72
48,225,48,347,0,42,-42
48,225,48,423,0,32,-32
48,225,48,439,0,27,-27
48,225,48,455,87,53,34
48,225,48,471,42,71,-29
48,227,48,29,47,28,19
48,227,48,85,0,31,-31
48,227,48,113,36,39,-3
48,227,48,115,84,36,48
48,227,48,121,0,29,-29
48,227,48,135,54,119,-65
48,227,48,201,31,34,-3
48,227,48,303,74,71,3
48,227,48,317,44,0,44
48,227,48,329,243,246,-3
48,227,48,335,56,32,24
48,227,48,353,0,36,-36
48,227,48,415,38,38,0
48,227,48,439,101,73,28
48,227,48,441,55,56,-1
48,227,48,451,73,108,-35
48,227,48,453,53,23,30
48,229,48,141,79,121,-42
48,231,48,27,42,40,2
48,231,48,29,56,61,-5
48,231,48,41,0,41,-41
48,231,48,85,626,757,-131
48,231,48,113,1623,1494,129
48,231,48,119,128,148,-20
48,231,48,121,204,196,8
48,231,48,139,46,65,-19
48,231,48,147,190,138,52
48,231,48,181,49,93,-44
48,231,48,183,44,26,18
48,231,48,201,68,100,-32
48,231,48,213,55,46,9
48,231,48,223,252,284,-32
48,231,48,257,263,385,-122
48,231,48,277,73,81,-8
48,231,48,303,0,33,-33
48,231,48,309,0,48,-48
48,231,48,349,31,0,31
48,231,48,379,202,173,29
48,231,48,387,29,0,29
48,231,48,397,484,484,0
48,231,48,423,62,45,17
48,231,48,439,266,314,-48
48,231,48,453,30,57,-27
48,231,48,467,119,137,-18
48,231,48,491,0,51,-51
48,231,48,499,58,128,-70
48,233,48,65,51,53,-2
48,233,48,179,90,109,-19
48,233,48,201,38,47,-9
48,233,48,303,0,63,-63
48,233,48,341,58,33,25
48,233,48,375,155,248,-93
48,233,48,381,171,196,-25
48,233,48,439,25,0,25
48,237,48,363,78,104,-26
48,237,48,367,36,81,-45
48,237,48,439,71,32,39
48,237,48,485,0,45,-45
48,237,48,497,57,70,-13
48,237,48,503,89,81,8
48,239,48,29,0,46,-46
48,239,48,57,62,69,-7
48,239,48,157,30,0,30
48,239,48,201,90,51,39
48,239,48,321,40,49,-9
48,239,48,469,218,212,6
48,239,48,481,51,47,4
48,241,22,19,28,0,28
48,241,48,5,74,83,-9
48,241,48,157,0,31,-31
48,241,48,199,239,279,-40
48,241,48,201,180,208,-28
48,241,48,245,280,293,-13
48,241,48,339,39,37,2
48,241,48,351,247,316,-69
48,241,48,361,275,229,46
48,241,48,403,105,102,3
48,241,48,423,0,41,-41
48,241,48,439,33,0,33
48,241,48,453,0,27,-27
48,241,48,457,87,146,-59
48,245,1,97,44,0,44
48,245,4,13,49,50,-1
48,245,6,37,76,62,14
48,245,6,59,51,44,7
48,245,6,65,36,0,36
48,245,6,71,56,0,56
48,245,6,73,72,50,22
48,245,12,11,28,0,28
48,245,12,31,26,0,26
48,245,12,57,52,0,52
48,245,12,86,44,0,44
48,245,12,95,35,26,9
48,245,12,103,44,0,44
48,245,13,89,35,0,35
48,245,15,3,26,22,4
48,245,17,31,56,35,21
48,245,20,173,0,41,-41
48,245,22,5,47,0,47
48,245,22,9,44,0,44
48,245,22,17,37,0,37
48,245,22,19,229,168,61
48,245,22,23,0,70,-70
48,245,22,33,81,91,-10
48,245,22,51,71,48,23
48,245,22,55,85,93,-8
48,245,22,71,0,87,-87
48,245,22,79,48,0,48
48,245,22,97,37,46,-9
48,245,22,101,33,0,33
48,245,22,109,0,33,-33
48,245,26,99,40,0,40
48,245,28,59,32,0,32
48,245,32,3,31,44,-13
48,245,36,119,43,0,43
48,245,40,109,41,0,41
48,245,48,5,100,69,31
48,245,48,27,77,95,-18
48,245,48,29,155,227,-72
48,245,48,39,149,235,-86
48,245,48,41,69,67,2
48,245,48,61,78,54,24
48,245,48,71,201,281,-80
48,245,48,85,54,98,-44
48,245,48,91,0,36,-36
48,245,48,113,210,254,-44
48,245,48,121,58,100,-42
48,245,48,141,46,36,10
48,245,48,157,250,313,-63
48,245,48,167,227,296,-69
48,245,48,183,56,35,21
48,245,48,199,1345,1621,-276
48,245,48,201,2119,2936,-817
48,245,48,209,0,72,-72
48,245,48,215,115,124,-9
48,245,48,241,293,280,13
48,245,48,291,125,106,19
48,245,48,309,42,0,42
48,245,48,329,0,37,-37
48,245,48,339,147,227,-80
48,245,48,347,30,62,-32
48,245,48,351,81,61,20
48,245,48,355,74,78,-4
48,245,48,361,1571,1848,-277
48,245,48,373,56,54,2
48,245,48,403,36,60,-24
48,245,48,409,0,56,-56
48,245,48,423,55,40,15
48,245,48,439,245,206,39
48,245,48,453,208,381,-173
48,245,48,457,120,187,-67
48,245,48,473,0,28,-28
48,245,48,491,35,201,-166
48,247,48,29,26,0,26
48,247,48,355,32,0,32
48,247,48,479,43,0,43
48,249,48,25,32,38,-6
48,249,48,29,104,180,-76
48,249,48,47,106,95,11
48,249,48,61,42,0,42
48,249,48,113,35,0,35
48,249,48,131,310,281,29
48,249,48,201,61,127,-66
48,249,48,215,73,110,-37
48,249,48,273,121,94,27
48,249,48,297,48,38,10
48,249,48,355,641,724,-83
48,249,48,409,137,132,5
48,249,48,453,43,55,-12
48,249,48,469,0,42,-42
48,251,4,13,75,0,75
48,251,6,37,106,0,106
48,251,6,59,50,0,50
48,251,6,71,53,25,28
48,251,6,73,67,0,67
48,251,40,109,0,44,-44
48,251,40,143,0,30,-30
48,251,48,1,24,0,24
48,251,48,27,68,108,-40
48,251,48,29,112,88,24
48,251,48,35,121,100,21
48,251,48,41,38,34,4
48,251,48,85,98,96,2
48,251,48,113,879,628,251
48,251,48,121,229,226,3
48,251,48,135,82,0,82
48,251,48,139,319,337,-18
48,251,48,141,33,0,33
48,251,48,143,75,115,-40
48,251,48,167,0,33,-33
48,251,48,183,48,0,48
48,251,48,201,154,110,44
48,251,48,209,29,0,29
48,251,48,213,69,39,30
48,251,48,215,39,0,39
48,251,48,217,348,369,-21
48,251,48,221,306,325,-19
48,251,48,257,32,0,32
48,251,48,287,74,0,74
48,251,48,303,72,61,11
48,251,48,309,141,96,45
48,251,48,329,54,0,54
48,251,48,339,44,49,-5
48,251,48,349,51,49,2
48,251,48,355,48,0,48
48,251,48,363,42,0,42
48,251,48,367,271,366,-95
48,251,48,423,41,36,5
48,251,48,425,98,86,12
48,251,48,439,6587,5319,1268
48,251,48,441,96,34,62
48,251,48,451,44,0,44
48,251,48,453,79,69,10
48,251,48,485,69,49,20
48,251,48,491,55,59,-4
48,251,48,497,106,60,46
48,251,48,503,59,0,59
48,253,48,59,56,57,-1
48,253,48,151,30,0,30
48,253,48,207,36,58,-22
48,253,48,303,0,56,-56
48,253,48,439,46,47,-1
48,253,48,441,561,648,-87
48,255,48,25,78,78,0
48,255,48,29,138,156,-18
48,255,48,123,0,35,-35
48,255,48,187,0,29,-29
48,255,48,209,0,27,-27
48,255,48,355,44,0,44
48,255,48,453,32,0,32
48,255,48,469,36,33,3
48,255,48,493,61,95,-34
48,257,4,13,42,30,12
48,257,6,37,51,0,51
48,257,6,71,44,0,44
48,257,6,73,62,48,14
48,257,32,3,43,32,11
48,257,47,157,37,0,37
48,257,48,27,45,49,-4
48,257,48,29,40,37,3
48,257,48,41,28,24,4
48,257,48,85,339,361,-22
48,257,48,113,6003,3153,2850
48,257,48,121,332,254,78
48,257,48,139,183,158,25
48,257,48,181,0,40,-40
48,257,48,201,74,96,-22
48,257,48,213,891,816,75
48,257,48,231,385,263,122
48,257,48,251,0,32,-32
48,257,48,349,73,47,26
48,257,48,397,267,293,-26
48,257,48,423,123,124,-1
48,257,48,439,467,305,162
48,257,48,453,36,54,-18
48,257,48,467,453,603,-150
48,257,48,491,41,48,-7
48,257,48,499,41,51,-10
48,259,48,19,108,99,9
48,259,48,29,1653,885,768
48,259,48,91,81,98,-17
48,259,48,113,53,29,24
48,259,48,157,36,0,36
48,259,48,171,25,0,25
48,259,48,187,0,43,-43
48,259,48,201,196,57,139
48,259,48,209,28,26,2
48,259,48,215,28,0,28
48,259,48,265,208,139,69
48,259,48,355,54,29,25
48,259,48,439,62,29,33
48,259,48,453,91,96,-5
48,259,48,491,35,37,-2
48,265,4,19,45,0,45
48,265,6,73,31,0,31
48,265,48,19,161,113,48
48,265,48,27,40,47,-7
48,265,48,29,368,458,-90
48,265,48,39,42,0,42
48,265,48,41,0,24,-24
48,265,48,53,0,46,-46
48,265,48,85,0,25,-25
48,265,48,91,33,53,-20
48,265,48,113,87,37,50
48,265,48,157,47,0,47
48,265,48,167,34,0,34
48,265,48,171,166,248,-82
48,265,48,187,41,36,5
48,265,48,201,200,135,65
48,265,48,209,36,42,-6
48,265,48,215,29,0,29
48,265,48,259,139,208,-69
48,265,48,267,37,0,37
48,265,48,303,0,31,-31
48,265,48,309,0,31,-31
48,265,48,325,34,0,34
48,265,48,339,34,36,-2
48,265,48,355,78,53,25
48,265,48,385,31,0,31
48,265,48,439,66,79,-13
48,265,48,441,31,0,31
48,265,48,451,54,44,10
48,265,48,453,113,123,-10
48,265,48,491,59,61,-2
48,267,48,29,25,0,25
48,267,48,265,0,37,-37
48,271,48,29,0,24,-24
48,271,48,465,0,45,-45
48,273,6,31,0,39,-39
48,273,6,73,31,68,-37
48,273,12,33,98,0,98
48,273,12,113,70,0,70
48,273,48,27,0,29,-29
48,273,48,29,97,151,-54
48,273,48,47,41,67,-26
48,273,48,61,64,79,-15
48,273,48,113,34,48,-14
48,273,48,131,39,44,-5
48,273,48,141,30,0,30
48,273,48,201,103,178,-75
48,273,48,215,119,107,12
48,273,48,247,38,0,38
48,273,48,249,94,121,-27
48,273,48,261,47,0,47
48,273,48,355,654,744,-90
48,273,48,409,69,62,7
48,273,48,439,0,64,-64
48,273,48,453,56,91,-35
48,273,48,469,0,34,-34
48,273,48,479,44,42,2
48,273,48,491,0,24,-24
48,273,51,710,0,33,-33
48,273,51,810,0,101,-101
48,275,48,23,0,32,-32
48,275,48,207,43,55,-12
48,275,48,441,33,0,33
48,277,40,23,130,110,20
48,277,40,89,0,27,-27
48,277,48,29,0,31,-31
48,277,48,85,67,99,-32
48,277,48,113,286,252,34
48,277,48,119,81,60,21
48,277,48,121,91,87,4
48,277,48,147,149,156,-7
48,277,48,181,47,53,-6
48,277,48,183,0,29,-29
48,277,48,201,0,52,-52
48,277,48,223,70,72,-2
48,277,48,231,81,73,8
48,277,48,309,0,28,-28
48,277,48,387,314,250,64
48,277,48,423,32,71,-39
48,277,48,439,107,107,0
48,279,48,17,60,41,19
48,279,48,69,0,43,-43
48,279,48,189,47,60,-13
48,279,48,219,81,99,-18
48,279,48,303,200,401,-201
48,279,48,381,0,41,-41
48,279,48,439,0,32,-32
48,281,8,41,0,44,-44
48,281,48,27,387,271,116
48,281,48,29,0,36,-36
48,281,48,41,0,30,-30
48,281,48,53,45,64,-19
48,281,48,99,366,253,113
48,281,48,113,0,32,-32
48,281,48,201,39,0,39
48,281,48,439,0,32,-32
48,281,48,453,36,69,-33
48,281,48,491,116,65,51
48,283,48,29,0,65,-65
48,283,48,163,0,64,-64
48,283,48,479,0,67,-67
48,285,48,29,24,0,24
48,285,48,41,0,26,-26
48,285,48,123,106,97,9
48,285,48,149,36,42,-6
48,285,48,177,62,53,9
48,285,48,201,68,137,-69
48,285,48,453,51,56,-5
48,285,48,469,99,139,-40
48,287,48,21,112,111,1
48,287,48,41,49,59,-10
48,287,48,51,49,37,12
48,287,48,149,0,79,-79
48,287,48,201,77,91,-14
48,287,48,251,0,74,-74
48,287,48,331,39,42,-3
48,287,48,453,174,158,16
48,287,48,477,50,0,50
48,287,48,491,88,85,3
48,289,48,1,112,95,17
48,289,48,41,95,112,-17
48,289,48,113,77,34,43
48,289,48,161,93,114,-21
48,289,48,167,35,0,35
48,289,48,201,232,103,129
48,289,48,293,46,30,16
48,289,48,309,34,29,5
48,289,48,313,46,35,11
48,289,48,339,103,40,63
48,289,48,395,53,0,53
48,289,48,439,0,43,-43
48,289,48,471,25,32,-7
48,291,6,73,34,0,34
48,291,48,5,0,45,-45
48,291,48,39,124,61,63
48,291,48,41,31,44,-13
48,291,48,71,281,259,22
48,291,48,113,0,72,-72
48,291,48,157,60,64,-4
48,291,48,167,144,135,9
48,291,48,199,137,183,-46
48,291,48,201,2732,2475,257
48,291,48,245,106,125,-19
48,291,48,339,884,877,7
48,291,48,373,179,205,-26
48,291,48,407,270,288,-18
48,291,48,439,51,33,18
48,291,48,453,44,0,44
48,291,48,471,28,0,28
48,293,48,27,33,0,33
48,293,48,113,60,90,-30
48,293,48,145,30,0,30
48,293,48,161,242,263,-21
48,293,48,201,75,61,14
48,293,48,217,0,41,-41
48,293,48,289,30,46,-16
48,293,48,309,189,379,-190
48,293,48,349,52,83,-31
48,293,48,395,30,0,30
48,293,48,439,51,37,14
48,293,48,491,0,38,-38
48,295,48,357,45,49,-4
48,297,48,25,74,65,9
48,297,48,29,67,44,23
48,297,48,249,38,48,-10
48,297,48,355,96,109,-13
48,297,48,409,55,0,55
48,299,48,29,82,53,29
48,299,48,53,460,453,7
48,299,48,201,49,31,18
48,299,48,453,176,123,53
48,299,48,491,111,83,28
48,303,4,13,136,164,-28
48,303,4,19,44,46,-2
48,303,6,37,110,84,26
48,303,6,59,39,22,17
48,303,6,71,33,50,-17
48,303,6,73,104,70,34
48,303,6,85,0,38,-38
48,303,8,1,0,34,-34
48,303,8,5,31,55,-24
48,303,8,13,0,39,-39
48,303,8,31,29,41,-12
48,303,8,41,66,68,-2
48,303,8,123,0,33,-33
48,303,15,3,38,27,11
48,303,17,31,28,29,-1
48,303,20,91,0,31,-31
48,303,29,95,0,30,-30
48,303,32,3,63,86,-23
48,303,35,1,137,135,2
48,303,35,5,107,75,32
48,303,35,9,191,80,111
48,303,35,13,34,27,7
48,303,35,15,92,95,-3
48,303,35,25,251,172,79
48,303,35,27,39,38,1
48,303,35,35,0,38,-38
48,303,35,41,80,28,52
48,303,35,43,32,33,-1
48,303,35,45,0,37,-37
48,303,36,47,0,34,-34
48,303,36,61,0,42,-42
48,303,39,49,0,24,-24
48,303,40,27,37,46,-9
48,303,40,31,30,0,30
48,303,40,109,69,98,-29
48,303,40,143,0,76,-76
48,303,47,37,0,26,-26
48,303,47,157,30,0,30
48,303,48,3,36,42,-6
48,303,48,5,36,0,36
48,303,48,17,49,64,-15
48,303,48,21,0,30,-30
48,303,48,27,61,176,-115
48,303,48,29,333,473,-140
48,303,48,39,35,59,-24
48,303,48,41,105,67,38
48,303,48,49,30,44,-14
48,303,48,53,32,42,-10
48,303,48,61,47,55,-8
48,303,48,69,82,42,40
48,303,48,79,52,46,6
48,303,48,85,259,567,-308
48,303,48,91,28,47,-19
48,303,48,99,39,39,0
48,303,48,107,356,292,64
48,303,48,113,552,1032,-480
48,303,48,115,156,143,13
48,303,48,117,64,41,23
48,303,48,121,237,453,-216
48,303,48,125,80,67,13
48,303,48,135,243,297,-54
48,303,48,139,71,51,20
48,303,48,141,207,220,-13
48,303,48,153,92,57,35
48,303,48,157,35,108,-73
48,303,48,165,124,66,58
48,303,48,167,45,48,-3
48,303,48,169,225,141,84
48,303,48,179,48,41,7
48,303,48,181,62,29,33
48,303,48,183,0,34,-34
48,303,48,187,41,74,-33
48,303,48,189,788,459,329
48,303,48,201,371,621,-250
48,303,48,207,44,0,44
48,303,48,209,51,106,-55
48,303,48,215,76,64,12
48,303,48,219,1005,680,325
48,303,48,227,71,74,-3
48,303,48,231,33,0,33
48,303,48,233,63,0,63
48,303,48,251,61,72,-11
48,303,48,253,56,0,56
48,303,48,265,31,0,31
48,303,48,279,401,200,201
48,303,48,305,330,222,108
48,303,48,309,100,97,3
48,303,48,329,464,514,-50
48,303,48,335,50,32,18
48,303,48,339,58,81,-23
48,303,48,341,49,34,15
48,303,48,353,48,36,12
48,303,48,355,80,61,19
48,303,48,367,31,71,-40
48,303,48,369,43,41,2
48,303,48,375,283,298,-15
48,303,48,381,423,431,-8
48,303,48,397,0,37,-37
48,303,48,415,133,79,54
48,303,48,423,58,70,-12
48,303,48,437,30,0,30
48,303,48,439,584,995,-411
48,303,48,441,308,261,47
48,303,48,445,360,198,162
48,303,48,451,199,218,-19
48,303,48,453,284,526,-242
48,303,48,479,0,35,-35
48,303,48,485,113,94,19
48,303,48,487,31,0,31
48,303,48,491,173,228,-55
48,303,48,497,0,34,-34
48,303,48,501,58,43,15
48,303,49,49,39,0,39
48,303,53,53,0,35,-35
48,305,48,303,222,330,-108
48,307,48,49,30,41,-11
48,307,48,319,34,0,34
48,307,48,451,34,75,-41
48,307,48,453,23,30,-7
48,309,4,13,101,47,54
48,309,4,19,43,0,43
48,309,5,119,33,0,33
48,309,6,37,99,64,35
48,309,6,59,44,25,19
48,309,6,65,49,35,14
48,309,6,71,34,0,34
48,309,6,73,81,97,-16
48,309,8,41,0,66,-66
48,309,12,105,27,0,27
48,309,17,31,31,43,-12
48,309,20,173,31,0,31
48,309,32,3,44,41,3
48,309,40,109,50,54,-4
48,309,40,143,35,0,35
48,309,48,1,33,0,33
48,309,48,21,0,37,-37
48,309,48,27,924,841,83
48,309,48,29,256,383,-127
48,309,48,35,429,344,85
48,309,48,39,47,49,-2
48,309,48,41,194,189,5
48,309,48,49,42,0,42
48,309,48,53,0,27,-27
48,309,48,61,38,0,38
48,309,48,85,138,263,-125
48,309,48,91,32,45,-13
48,309,48,93,32,0,32
48,309,48,99,320,216,104
48,309,48,113,628,870,-242
48,309,48,121,201,295,-94
48,309,48,135,43,0,43
48,309,48,139,78,107,-29
48,309,48,141,68,36,32
48,309,48,143,72,50,22
48,309,48,145,459,372,87
48,309,48,157,58,76,-18
48,309,48,161,87,71,16
48,309,48,167,62,103,-41
48,309,48,183,41,66,-25
48,309,48,187,27,0,27
48,309,48,193,30,0,30
48,309,48,201,472,710,-238
48,309,48,209,90,133,-43
48,309,48,213,30,40,-10
48,309,48,215,53,0,53
48,309,48,217,565,444,121
48,309,48,221,0,37,-37
48,309,48,231,48,0,48
48,309,48,245,0,42,-42
48,309,48,251,96,141,-45
48,309,48,265,31,0,31
48,309,48,277,28,0,28
48,309,48,289,29,34,-5
48,309,48,293,379,189,190
48,309,48,303,97,100,-3
48,309,48,329,38,32,6
48,309,48,331,53,45,8
48,309,48,339,75,158,-83
48,309,48,347,35,0,35
48,309,48,349,153,67,86
48,309,48,355,58,115,-57
48,309,48,367,58,50,8
48,309,48,375,32,0,32
48,309,48,381,28,0,28
48,309,48,395,56,0,56
48,309,48,409,0,26,-26
48,309,48,423,83,105,-22
48,309,48,439,650,805,-155
48,309,48,441,84,61,23
48,309,48,451,39,38,1
48,309,48,453,407,676,-269
48,309,48,469,34,0,34
48,309,48,471,30,0,30
48,309,48,485,0,37,-37
48,309,48,491,243,380,-137
48,309,53,33,0,33,-33
48,313,48,41,94,149,-55
48,313,48,113,0,30,-30
48,313,48,185,50,57,-7
48,313,48,201,83,120,-37
48,313,48,289,35,46,-11
48,313,48,339,64,47,17
48,313,48,471,68,109,-41
48,315,22,17,42,0,42
48,315,48,67,65,111,-46
48,315,48,113,50,48,2
48,315,48,183,105,180,-75
48,315,48,203,201,183,18
48,315,48,459,48,64,-16
48,317,48,329,159,0,159
48,319,48,307,0,34,-34
48,321,48,29,0,76,-76
48,321,48,39,384,432,-48
48,321,48,41,0,37,-37
48,321,48,57,45,66,-21
48,321,48,157,103,158,-55
48,321,48,167,43,38,5
48,321,48,201,355,317,38
48,321,48,209,0,30,-30
48,321,48,215,29,0,29
48,321,48,239,49,40,9
48,321,48,339,31,46,-15
48,321,48,355,34,31,3
48,321,48,453,41,48,-7
48,321,48,469,48,51,-3
48,321,48,481,218,156,62
48,323,6,37,28,40,-12
48,323,48,29,591,744,-153
48,323,48,61,0,45,-45
48,323,48,113,87,63,24
48,323,48,141,61,0,61
48,323,48,201,124,125,-1
48,323,48,215,48,65,-17
48,323,48,439,52,66,-14
48,323,48,453,150,121,29
48,323,48,463,62,83,-21
48,323,48,465,106,99,7
48,323,48,479,104,115,-11
48,323,48,491,0,52,-52
48,325,48,13,155,162,-7
48,325,48,19,0,41,-41
48,325,48,27,0,37,-37
48,325,48,29,1916,1703,213
48,325,48,91,36,45,-9
48,325,48,163,86,88,-2
48,325,48,187,40,35,5
48,325,48,201,38,37,1
48,325,48,265,0,34,-34
48,325,48,355,44,31,13
48,325,48,439,39,39,0
48,325,48,453,40,59,-19
48,325,48,463,97,54,43
48,325,48,479,50,0,50
48,325,48,493,27,0,27
48,329,4,13,112,49,63
48,329,6,29,42,0,42
48,329,6,37,73,31,42
48,329,6,59,34,0,34
48,329,6,65,36,0,36
48,329,6,71,52,0,52
48,329,6,73,75,35,40
48,329,8,31,32,0,32
48,329,32,3,58,0,58
48,329,35,1,32,40,-8
48,329,35,5,47,30,17
48,329,35,13,47,31,16
48,329,35,15,63,43,20
48,329,35,25,208,109,99
48,329,35,41,34,0,34
48,329,35,45,37,0,37
48,329,40,27,36,0,36
48,329,40,109,59,68,-9
48,329,40,143,38,47,-9
48,329,48,3,135,114,21
48,329,48,27,78,70,8
48,329,48,29,153,241,-88
48,329,48,39,37,24,13
48,329,48,41,34,39,-5
48,329,48,43,149,52,97
48,329,48,49,38,33,5
48,329,48,85,91,147,-56
48,329,48,91,36,41,-5
48,329,48,103,62,56,6
48,329,48,113,255,250,5
48,329,48,115,118,99,19
48,329,48,121,97,146,-49
48,329,48,135,1554,1353,201
48,329,48,139,0,33,-33
48,329,48,141,187,114,73
48,329,48,157,94,65,29
48,329,48,165,60,44,16
48,329,48,167,29,41,-12
48,329,48,173,0,51,-51
48,329,48,183,0,28,-28
48,329,48,189,37,0,37
48,329,48,201,391,307,84
48,329,48,209,50,27,23
48,329,48,219,50,0,50
48,329,48,221,40,86,-46
48,329,48,227,246,243,3
48,329,48,245,37,0,37
48,329,48,251,0,54,-54
48,329,48,303,514,464,50
48,329,48,309,32,38,-6
48,329,48,317,173,159,14
48,329,48,335,0,36,-36
48,329,48,339,74,92,-18
48,329,48,353,22,0,22
48,329,48,355,66,30,36
48,329,48,367,32,52,-20
48,329,48,371,97,81,16
48,329,48,375,63,40,23
48,329,48,377,99,62,37
48,329,48,381,99,78,21
48,329,48,383,35,0,35
48,329,48,389,103,60,43
48,329,48,415,65,54,11
48,329,48,423,48,41,7
48,329,48,439,269,415,-146
48,329,48,441,156,116,40
48,329,48,451,294,180,114
48,329,48,453,142,182,-40
48,329,48,461,67,38,29
48,329,48,475,102,87,15
48,329,48,479,44,0,44
48,329,48,485,60,0,60
48,329,48,491,81,120,-39
48,329,48,495,55,44,11
48,329,48,501,76,0,76
48,331,48,27,250,268,-18
48,331,48,39,37,0,37
48,331,48,41,91,107,-16
48,331,48,51,53,40,13
48,331,48,145,45,37,8
48,331,48,201,126,79,47
48,331,48,209,0,21,-21
48,331,48,287,42,39,3
48,331,48,309,45,53,-8
48,331,48,339,43,0,43
48,331,48,395,82,0,82
48,331,48,439,26,46,-20
48,331,48,453,128,150,-22
48,331,48,491,267,298,-31
48,333,48,49,38,43,-5
48,335,48,227,32,56,-24
48,335,48,303,32,50,-18
48,335,48,329,36,0,36
48,335,48,353,0,60,-60
48,335,48,415,49,81,-32
48,335,48,451,0,30,-30
48,337,48,77,42,52,-10
48,337,48,97,132,158,-26
48,337,48,113,46,44,2
48,337,48,121,128,117,11
48,337,48,181,64,0,64
48,337,48,367,0,27,-27
48,337,48,439,173,156,17
48,337,48,485,76,100,-24
48,337,48,497,246,170,76
48,339,1,97,35,30,5
48,339,2,20,55,43,12
48,339,4,13,261,155,106
48,339,4,19,61,34,27
48,339,6,1,35,0,35
48,339,6,13,141,77,64
48,339,6,29,50,0,50
48,339,6,37,427,201,226
48,339,6,59,212,90,122
48,339,6,65,144,56,88
48,339,6,67,54,0,54
48,339,6,71,139,53,86
48,339,6,73,319,127,192
48,339,6,85,136,39,97
48,339,6,111,32,0,32
48,339,8,1,34,42,-8
48,339,8,5,46,57,-11
48,339,8,31,32,44,-12
48,339,8,35,61,135,-74
48,339,8,41,67,91,-24
48,339,8,59,33,79,-46
48,339,9,1,40,0,40
48,339,12,9,35,0,35
48,339,12,11,165,42,123
48,339,12,21,44,0,44
48,339,12,31,63,36,27
48,339,12,57,109,0,109
48,339,12,71,43,0,43
48,339,12,81,40,0,40
48,339,12,86,173,70,103
48,339,12,95,88,31,57
48,339,12,99,87,50,37
48,339,12,103,65,34,31
48,339,12,105,30,0,30
48,339,12,117,52,0,52
48,339,12,127,42,0,42
48,339,13,67,31,47,-16
48,339,13,121,39,35,4
48,339,13,135,93,38,55
48,339,13,139,31,0,31
48,339,15,3,108,61,47
48,339,17,31,189,80,109
48,339,17,43,87,29,58
48,339,17,89,35,0,35
48,339,17,97,48,0,48
48,339,17,197,41,0,41
48,339,18,3,45,0,45
48,339,18,97,39,0,39
48,339,20,91,38,36,2
48,339,20,173,78,0,78
48,339,21,111,26,0,26
48,339,22,5,51,0,51
48,339,22,15,41,0,41
48,339,22,17,50,37,13
48,339,22,19,85,75,10
48,339,22,33,109,54,55
48,339,22,51,132,97,35
48,339,22,55,160,70,90
48,339,22,71,67,141,-74
48,339,22,103,133,63,70
48,339,22,105,0,31,-31
48,339,24,31,41,0,41
48,339,26,81,35,0,35
48,339,26,125,113,0,113
48,339,26,163,81,0,81
48,339,27,53,56,0,56
48,339,28,47,26,0,26
48,339,29,189,76,50,26
48,339,31,55,43,0,43
48,339,32,3,200,89,111
48,339,32,31,34,0,34
48,339,35,1,94,27,67
48,339,36,47,30,0,30
48,339,36,59,70,0,70
48,339,36,61,0,43,-43
48,339,36,81,40,0,40
48,339,36,103,51,0,51
48,339,37,119,50,0,50
48,339,37,133,0,57,-57
48,339,37,183,37,46,-9
48,339,39,35,67,0,67
48,339,39,49,57,0,57
48,339,40,27,38,29,9
48,339,40,109,126,143,-17
48,339,40,143,135,74,61
48,339,41,51,40,0,40
48,339,42,3,42,0,42
48,339,42,91,32,0,32
48,339,45,19,32,0,32
48,339,47,37,48,0,48
48,339,47,157,76,37,39
48,339,48,1,69,37,32
48,339,48,5,139,76,63
48,339,48,15,37,0,37
48,339,48,21,37,29,8
48,339,48,27,134,120,14
48,339,48,29,420,327,93
48,339,48,37,37,0,37
48,339,48,39,491,296,195
48,339,48,41,395,341,54
48,339,48,53,0,30,-30
48,339,48,61,94,55,39
48,339,48,71,51,52,-1
48,339,48,73,44,0,44
48,339,48,85,268,198,70
48,339,48,91,77,107,-30
48,339,48,99,62,31,31
48,339,48,113,464,332,132
48,339,48,121,219,211,8
48,339,48,135,50,0,50
48,339,48,139,38,35,3
48,339,48,141,108,54,54
48,339,48,157,683,463,220
48,339,48,161,0,34,-34
48,339,48,167,567,307,260
48,339,48,183,71,51,20
48,339,48,185,316,311,5
48,339,48,187,38,38,0
48,339,48,199,88,67,21
48,339,48,201,21315,13479,7836
48,339,48,203,41,30,11
48,339,48,209,126,149,-23
48,339,48,213,50,0,50
48,339,48,215,83,93,-10
48,339,48,225,72,0,72
48,339,48,241,37,39,-2
48,339,48,245,227,147,80
48,339,48,251,49,44,5
48,339,48,265,36,34,2
48,339,48,289,40,103,-63
48,339,48,291,877,884,-7
48,339,48,303,81,58,23
48,339,48,309,158,75,83
48,339,48,313,47,64,-17
48,339,48,321,46,31,15
48,339,48,329,92,74,18
48,339,48,331,0,43,-43
48,339,48,347,105,58,47
48,339,48,355,250,81,169
48,339,48,361,71,74,-3
48,339,48,367,0,41,-41
48,339,48,373,306,258,48
48,339,48,395,0,47,-47
48,339,48,397,32,0,32
48,339,48,401,35,0,35
48,339,48,407,507,467,40
48,339,48,423,86,132,-46
48,339,48,439,505,465,40
48,339,48,441,41,0,41
48,339,48,451,44,0,44
48,339,48,453,458,540,-82
48,339,48,455,105,102,3
48,339,48,457,41,0,41
48,339,48,459,0,26,-26
48,339,48,469,50,0,50
48,339,48,471,1076,732,344
48,339,48,473,248,249,-1
48,339,48,477,45,51,-6
48,339,48,479,42,0,42
48,339,48,481,31,0,31
48,339,48,491,209,224,-15
48,339,49,35,73,39,34
48,339,49,49,84,45,39
48,339,51,59,87,52,35
48,339,51,153,44,0,44
48,339,53,11,47,0,47
48,339,53,33,115,61,54
48,339,53,53,0,30,-30
48,339,53,61,34,32,2
48,339,55,79,32,0,32
48,341,4,13,35,0,35
48,341,20,55,43,0,43
48,341,20,175,47,0,47
48,341,40,139,47,196,-149
48,341,48,113,39,0,39
48,341,48,117,30,0,30
48,341,48,141,116,64,52
48,341,48,179,0,48,-48
48,341,48,189,40,0,40
48,341,48,215,66,0,66
48,341,48,233,33,58,-25
48,341,48,303,34,49,-15
48,341,48,375,193,302,-109
48,341,48,381,105,217,-112
48,343,48,37,0,69,-69
48,343,48,63,40,100,-60
48,343,48,67,184,175,9
48,343,48,113,43,75,-32
48,343,48,159,66,54,12
48,343,48,183,71,95,-24
48,343,48,423,0,37,-37
48,343,48,449,152,140,12
48,343,48,459,68,52,16
48,347,22,17,0,27,-27
48,347,48,1,33,36,-3
48,347,48,5,449,525,-76
48,347,48,27,0,43,-43
48,347,48,29,33,70,-37
48,347,48,39,0,30,-30
48,347,48,41,36,0,36
48,347,48,73,146,57,89
48,347,48,85,33,75,-42
48,347,48,113,146,231,-85
48,347,48,121,25,115,-90
48,347,48,157,32,43,-11
48,347,48,167,38,43,-5
48,347,48,183,105,123,-18
48,347,48,199,0,43,-43
48,347,48,201,338,503,-165
48,347,48,203,35,37,-2
48,347,48,225,42,0,42
48,347,48,245,62,30,32
48,347,48,309,0,35,-35
48,347,48,339,58,105,-47
48,347,48,361,0,35,-35
48,347,48,365,44,30,14
48,347,48,373,48,41,7
48,347,48,401,116,162,-46
48,347,48,403,33,39,-6
48,347,48,405,132,48,84
48,347,48,419,304,204,100
48,347,48,423,189,161,28
48,347,48,439,86,137,-51
48,347,48,453,63,113,-50
48,347,48,491,0,47,-47
48,349,48,1,0,38,-38
48,349,48,27,0,34,-34
48,349,48,85,45,69,-24
48,349,48,113,607,521,86
48,349,48,121,64,85,-21
48,349,48,139,498,569,-71
48,349,48,161,87,78,9
48,349,48,201,63,106,-43
48,349,48,213,130,125,5
48,349,48,217,71,91,-20
48,349,48,231,0,31,-31
48,349,48,251,49,51,-2
48,349,48,257,47,73,-26
48,349,48,293,83,52,31
48,349,48,309,67,153,-86
48,349,48,423,46,68,-22
48,349,48,439,257,215,42
48,349,48,453,37,47,-10
48,349,48,491,0,30,-30
48,351,22,11,0,28,-28
48,351,22,19,39,0,39
48,351,48,199,48,45,3
48,351,48,201,45,47,-2
48,351,48,241,316,247,69
48,351,48,245,61,81,-20
48,351,48,361,108,194,-86
48,353,48,113,41,71,-30
48,353,48,151,57,62,-5
48,353,48,227,36,0,36
48,353,48,303,36,48,-12
48,353,48,329,0,22,-22
48,353,48,335,60,0,60
48,353,48,415,38,51,-13
48,353,48,439,73,63,10
48,353,48,441,141,189,-48
48,353,48,451,51,74,-23
48,353,48,453,34,0,34
48,355,1,97,0,42,-42
48,355,2,20,31,0,31
48,355,4,13,134,107,27
48,355,4,19,76,51,25
48,355,5,119,0,112,-112
48,355,6,29,40,0,40
48,355,6,37,68,146,-78
48,355,6,53,0,50,-50
48,355,6,59,45,52,-7
48,355,6,65,27,44,-17
48,355,6,71,40,33,7
48,355,6,73,412,319,93
48,355,6,111,0,41,-41
48,355,8,1,30,0,30
48,355,8,31,0,32,-32
48,355,8,41,40,49,-9
48,355,12,11,46,0,46
48,355,12,19,50,36,14
48,355,12,31,96,159,-63
48,355,12,33,196,80,116
48,355,12,57,37,0,37
48,355,12,71,37,0,37
48,355,12,86,34,28,6
48,355,12,91,46,32,14
48,355,12,95,33,0,33
48,355,12,103,25,0,25
48,355,12,113,121,173,-52
48,355,15,3,154,87,67
48,355,17,31,77,44,33
48,355,17,97,0,40,-40
48,355,20,173,30,42,-12
48,355,22,19,23,0,23
48,355,22,33,0,38,-38
48,355,22,51,42,45,-3
48,355,22,55,0,40,-40
48,355,22,71,0,58,-58
48,355,22,101,88,0,88
48,355,24,3,170,0,170
48,355,28,47,25,0,25
48,355,28,75,0,47,-47
48,355,32,3,99,79,20
48,355,35,1,61,43,18
48,355,37,51,48,43,5
48,355,37,133,64,44,20
48,355,39,49,25,0,25
48,355,40,27,37,30,7
48,355,40,47,35,0,35
48,355,40,109,56,76,-20
48,355,40,143,43,0,43
48,355,42,3,0,30,-30
48,355,45,13,34,0,34
48,355,47,157,37,0,37
48,355,48,5,32,0,32
48,355,48,7,330,234,96
48,355,48,13,41,65,-24
48,355,48,19,0,42,-42
48,355,48,21,0,30,-30
48,355,48,25,316,256,60
48,355,48,27,154,152,2
48,355,48,29,1336,2082,-746
48,355,48,39,123,132,-9
48,355,48,41,122,154,-32
48,355,48,47,57,47,10
48,355,48,49,39,0,39
48,355,48,55,0,50,-50
48,355,48,57,81,42,39
48,355,48,61,385,345,40
48,355,48,85,114,134,-20
48,355,48,91,75,150,-75
48,355,48,99,0,34,-34
48,355,48,113,349,373,-24
48,355,48,121,115,139,-24
48,355,48,123,39,31,8
48,355,48,131,96,56,40
48,355,48,139,0,41,-41
48,355,48,141,126,123,3
48,355,48,157,106,286,-180
48,355,48,163,25,0,25
48,355,48,167,135,118,17
48,355,48,183,35,0,35
48,355,48,187,85,145,-60
48,355,48,201,1076,1389,-313
48,355,48,209,108,163,-55
48,355,48,215,496,575,-79
48,355,48,221,0,28,-28
48,355,48,245,78,74,4
48,355,48,247,45,32,13
48,355,48,249,724,641,83
48,355,48,251,0,48,-48
48,355,48,255,0,44,-44
48,355,48,259,29,54,-25
48,355,48,265,53,78,-25
48,355,48,273,744,654,90
48,355,48,297,109,96,13
48,355,48,303,61,80,-19
48,355,48,309,115,58,57
48,355,48,321,31,34,-3
48,355,48,325,31,44,-13
48,355,48,329,30,66,-36
48,355,48,339,81,250,-169
48,355,48,367,0,48,-48
48,355,48,375,0,25,-25
48,355,48,381,25,0,25
48,355,48,391,62,97,-35
48,355,48,409,2037,1860,177
48,355,48,423,37,43,-6
48,355,48,427,45,49,-4
48,355,48,439,283,435,-152
48,355,48,441,92,89,3
48,355,48,451,52,38,14
48,355,48,453,580,829,-249
48,355,48,463,37,36,1
48,355,48,465,87,0,87
48,355,48,469,226,212,14
48,355,48,479,223,172,51
48,355,48,485,36,0,36
48,355,48,489,38,44,-6
48,355,48,491,228,338,-110
48,355,48,493,37,37,0
48,355,51,59,40,62,-22
48,355,51,153,31,0,31
48,355,51,550,48,0,48
48,355,51,710,80,74,6
48,355,51,810,89,122,-33
48,355,53,29,68,0,68
48,355,53,33,48,34,14
48,355,53,35,0,50,-50
48,355,53,53,41,0,41
48,355,53,61,55,25,30
48,357,48,195,60,44,16
48,357,48,295,49,45,4
48,357,48,375,51,41,10
48,357,48,381,46,66,-20
48,359,48,375,46,76,-30
48,359,48,381,54,60,-6
48,361,6,73,26,0,26
48,361,22,19,287,246,41
48,361,22,33,35,0,35
48,361,22,115,34,0,34
48,361,32,3,31,0,31
48,361,48,5,61,40,21
48,361,48,29,39,59,-20
48,361,48,39,59,50,9
48,361,48,41,0,34,-34
48,361,48,71,0,57,-57
48,361,48,113,63,62,1
48,361,48,157,0,40,-40
48,361,48,167,81,65,16
48,361,48,199,407,353,54
48,361,48,201,385,430,-45
48,361,48,241,229,275,-46
48,361,48,245,1848,1571,277
48,361,48,339,74,71,3
48,361,48,347,35,0,35
48,361,48,351,194,108,86
48,361,48,403,46,58,-12
48,361,48,423,0,35,-35
48,361,48,439,39,58,-19
48,361,48,453,72,67,5
48,361,48,457,82,66,16
48,361,48,491,0,61,-61
48,363,48,27,37,0,37
48,363,48,113,51,48,3
48,363,48,121,33,50,-17
48,363,48,133,42,0,42
48,363,48,143,47,94,-47
48,363,48,201,0,43,-43
48,363,48,221,40,69,-29
48,363,48,237,104,78,26
48,363,48,251,0,42,-42
48,363,48,367,484,553,-69
48,363,48,439,319,292,27
48,363,48,485,0,41,-41
48,363,48,497,46,35,11
48,363,48,503,48,53,-5
48,365,22,15,44,66,-22
48,365,22,17,110,80,30
48,365,48,113,62,27,35
48,365,48,183,157,164,-7
48,365,48,201,53,57,-4
48,365,48,203,193,211,-18
48,365,48,347,30,44,-14
48,365,48,401,99,151,-52
48,365,48,419,104,112,-8
48,365,48,423,59,78,-19
48,365,48,439,48,33,15
48,367,4,13,84,85,-1
48,367,6,37,40,0,40
48,367,6,71,37,0,37
48,367,6,73,64,33,31
48,367,40,85,28,0,28
48,367,40,109,34,0,34
48,367,48,27,54,31,23
48,367,48,29,69,55,14
48,367,48,41,31,39,-8
48,367,48,85,91,80,11
48,367,48,113,310,254,56
48,367,48,121,269,209,60
48,367,48,133,54,41,13
48,367,48,135,88,0,88
48,367,48,139,48,36,12
48,367,48,141,49,0,49
48,367,48,143,123,65,58
48,367,48,181,52,0,52
48,367,48,201,103,149,-46
48,367,48,221,323,391,-68
48,367,48,237,81,36,45
48,367,48,251,366,271,95
48,367,48,303,71,31,40
48,367,48,309,50,58,-8
48,367,48,329,52,32,20
48,367,48,337,27,0,27
48,367,48,339,41,0,41
48,367,48,355,48,0,48
48,367,48,363,553,484,69
48,367,48,423,54,0,54
48,367,48,439,5169,3723,1446
48,367,48,441,105,95,10
48,367,48,451,45,0,45
48,367,48,453,59,53,6
48,367,48,485,54,27,27
48,367,48,491,0,35,-35
48,367,48,497,448,411,37
48,367,48,503,55,31,24
48,369,35,9,149,185,-36
48,369,48,17,65,45,20
48,369,48,69,43,0,43
48,369,48,117,54,122,-68
48,369,48,141,0,45,-45
48,369,48,303,41,43,-2
48,369,48,375,27,46,-19
48,369,48,381,0,86,-86
48,371,48,29,34,0,34
48,371,48,43,44,0,44
48,371,48,135,143,123,20
48,371,48,141,85,66,19
48,371,48,329,81,97,-16
48,371,48,389,40,0,40
48,371,48,439,35,0,35
48,371,48,451,58,58,0
48,371,48,465,40,0,40
48,371,48,475,0,60,-60
48,373,4,13,65,135,-70
48,373,4,19,29,53,-24
48,373,4,21,0,75,-75
48,373,4,25,0,33,-33
48,373,4,27,0,44,-44
48,373,6,37,29,0,29
48,373,6,65,33,46,-13
48,373,6,71,31,0,31
48,373,6,73,0,26,-26
48,373,46,79,0,30,-30
48,373,46,99,0,45,-45
48,373,46,103,0,28,-28
48,373,48,5,236,242,-6
48,373,48,27,44,0,44
48,373,48,29,27,61,-34
48,373,48,39,78,45,33
48,373,48,41,0,34,-34
48,373,48,61,0,29,-29
48,373,48,85,40,29,11
48,373,48,113,61,42,19
48,373,48,121,48,0,48
48,373,48,157,35,0,35
48,373,48,167,93,57,36
48,373,48,199,0,53,-53
48,373,48,201,804,548,256
48,373,48,215,0,103,-103
48,373,48,245,54,56,-2
48,373,48,291,205,179,26
48,373,48,339,258,306,-48
48,373,48,347,41,48,-7
48,373,48,407,184,139,45
48,373,48,423,0,60,-60
48,373,48,439,86,33,53
48,373,48,453,43,42,1
48,373,48,455,118,91,27
48,373,48,457,52,65,-13
48,373,48,471,70,70,0
48,373,48,491,0,38,-38
48,375,4,13,84,70,14
48,375,4,19,0,38,-38
48,375,6,37,71,0,71
48,375,6,65,39,0,39
48,375,6,71,47,0,47
48,375,6,73,0,39,-39
48,375,8,1,46,0,46
48,375,8,41,0,39,-39
48,375,15,3,30,0,30
48,375,32,3,60,62,-2
48,375,35,1,66,59,7
48,375,35,9,60,52,8
48,375,35,25,37,0,37
48,375,40,27,28,0,28
48,375,40,31,38,0,38
48,375,40,109,56,58,-2
48,375,40,139,0,28,-28
48,375,40,143,33,42,-9
48,375,41,47,53,0,53
48,375,48,11,86,86,0
48,375,48,27,48,36,12
48,375,48,29,82,121,-39
48,375,48,65,123,131,-8
48,375,48,69,77,34,43
48,375,48,75,50,0,50
48,375,48,85,47,68,-21
48,375,48,111,64,46,18
48,375,48,113,164,178,-14
48,375,48,117,234,176,58
48,375,48,121,82,86,-4
48,375,48,129,57,39,18
48,375,48,135,49,87,-38
48,375,48,141,105,126,-21
48,375,48,179,156,189,-33
48,375,48,189,141,58,83
48,375,48,195,40,39,1
48,375,48,201,91,192,-101
48,375,48,205,40,0,40
48,375,48,211,39,0,39
48,375,48,215,37,32,5
48,375,48,233,248,155,93
48,375,48,303,298,283,15
48,375,48,309,0,32,-32
48,375,48,329,40,63,-23
48,375,48,341,302,193,109
48,375,48,355,25,0,25
48,375,48,357,41,51,-10
48,375,48,359,76,46,30
48,375,48,369,46,27,19
48,375,48,381,5170,5916,-746
48,375,48,437,77,71,6
48,375,48,439,182,322,-140
48,375,48,441,27,48,-21
48,375,48,453,45,152,-107
48,375,48,483,0,31,-31
48,375,48,485,0,31,-31
48,375,48,487,0,24,-24
48,375,48,491,0,29,-29
48,375,53,33,0,43,-43
48,377,48,43,64,89,-25
48,377,48,135,142,368,-226
48,377,48,141,72,82,-10
48,377,48,329,62,99,-37
48,379,48,85,44,0,44
48,379,48,113,137,108,29
48,379,48,223,102,99,3
48,379,48,231,173,202,-29
48,379,48,397,0,48,-48
48,379,48,423,0,28,-28
48,379,48,439,32,31,1
48,379,48,467,71,45,26
48,379,48,499,104,107,-3
48,381,4,13,52,64,-12
48,381,6,37,0,26,-26
48,381,6,71,37,0,37
48,381,8,5,0,29,-29
48,381,8,41,56,41,15
48,381,20,173,33,0,33
48,381,32,3,55,75,-20
48,381,35,1,67,58,9
48,381,35,9,73,37,36
48,381,35,25,0,36,-36
48,381,35,37,28,0,28
48,381,40,27,0,28,-28
48,381,40,31,0,27,-27
48,381,40,109,47,74,-27
48,381,40,143,0,46,-46
48,381,48,11,69,115,-46
48,381,48,27,38,49,-11
48,381,48,29,78,118,-40
48,381,48,41,47,35,12
48,381,48,65,126,109,17
48,381,48,69,94,49,45
48,381,48,75,53,31,22
48,381,48,85,60,126,-66
48,381,48,91,0,29,-29
48,381,48,111,77,41,36
48,381,48,113,217,225,-8
48,381,48,117,213,142,71
48,381,48,121,72,141,-69
48,381,48,129,0,46,-46
48,381,48,135,35,67,-32
48,381,48,141,46,41,5
48,381,48,179,210,115,95
48,381,48,189,124,65,59
48,381,48,195,25,40,-15
48,381,48,201,117,127,-10
48,381,48,205,69,46,23
48,381,48,209,0,36,-36
48,381,48,233,196,171,25
48,381,48,279,41,0,41
48,381,48,303,431,423,8
48,381,48,309,0,28,-28
48,381,48,329,78,99,-21
48,381,48,341,217,105,112
48,381,48,355,0,25,-25
48,381,48,357,66,46,20
48,381,48,359,60,54,6
48,381,48,369,86,0,86
48,381,48,375,5916,5170,746
48,381,48,423,0,29,-29
48,381,48,437,137,77,60
48,381,48,439,228,330,-102
48,381,48,441,74,70,4
48,381,48,453,58,121,-63
48,381,48,483,43,42,1
48,381,48,485,69,0,69
48,381,48,491,0,69,-69
48,381,53,33,0,28,-28
48,383,48,329,0,35,-35
48,383,48,451,25,88,-63
48,383,48,465,55,0,55
48,385,48,265,0,31,-31
48,385,48,463,34,38,-4
48,387,48,37,91,82,9
48,387,48,85,0,28,-28
48,387,48,113,64,60,4
48,387,48,231,0,29,-29
48,387,48,277,250,314,-64
48,387,48,449,57,0,57
48,389,48,29,0,37,-37
48,389,48,135,103,265,-162
48,389,48,141,67,0,67
48,389,48,329,60,103,-43
48,389,48,371,0,40,-40
48,389,48,475,41,75,-34
48,391,48,7,0,31,-31
48,391,48,25,0,51,-51
48,391,48,201,30,0,30
48,391,48,355,97,62,35
48,391,48,409,78,84,-6
48,391,48,469,52,88,-36
48,395,48,41,419,542,-123
48,395,48,201,94,86,8
48,395,48,289,0,53,-53
48,395,48,293,0,30,-30
48,395,48,309,0,56,-56
48,395,48,331,0,82,-82
48,395,48,339,47,0,47
48,397,4,13,33,0,33
48,397,6,37,123,0,123
48,397,6,59,46,0,46
48,397,6,65,68,0,68
48,397,6,73,54,43,11
48,397,17,31,33,0,33
48,397,31,153,43,0,43
48,397,40,109,28,34,-6
48,397,48,29,71,57,14
48,397,48,41,30,0,30
48,397,48,85,773,773,0
48,397,48,113,4189,2311,1878
48,397,48,121,217,249,-32
48,397,48,139,35,44,-9
48,397,48,141,35,0,35
48,397,48,147,28,0,28
48,397,48,157,0,36,-36
48,397,48,181,29,31,-2
48,397,48,183,28,0,28
48,397,48,201,165,131,34
48,397,48,213,53,30,23
48,397,48,223,49,43,6
48,397,48,231,484,484,0
48,397,48,257,293,267,26
48,397,48,303,37,0,37
48,397,48,339,0,32,-32
48,397,48,379,48,0,48
48,397,48,423,85,52,33
48,397,48,439,369,242,127
48,397,48,453,56,92,-36
48,397,48,467,80,57,23
48,397,48,491,55,37,18
48,397,48,499,39,35,4
48,399,48,441,66,105,-39
48,399,48,451,180,248,-68
48,401,48,5,0,41,-41
48,401,48,73,257,245,12
48,401,48,85,0,36,-36
48,401,48,113,139,89,50
48,401,48,183,1003,1065,-62
48,401,48,201,110,123,-13
48,401,48,203,173,182,-9
48,401,48,213,29,0,29
48,401,48,339,0,35,-35
48,401,48,347,162,116,46
48,401,48,365,151,99,52
48,401,48,419,58,0,58
48,401,48,423,459,408,51
48,401,48,439,89,70,19
48,401,48,453,28,0,28
48,401,48,459,101,79,22
48,403,48,5,58,86,-28
48,403,48,199,34,34,0
48,403,48,201,95,41,54
48,403,48,241,102,105,-3
48,403,48,245,60,36,24
48,403,48,347,39,33,6
48,403,48,361,58,46,12
48,403,48,405,63,88,-25
48,405,48,5,70,44,26
48,405,48,201,0,41,-41
48,405,48,347,48,132,-84
48,405,48,403,88,63,25
48,405,48,419,33,57,-24
48,407,48,39,44,0,44
48,407,48,113,0,35,-35
48,407,48,167,36,31,5
48,407,48,201,548,458,90
48,407,48,291,288,270,18
48,407,48,339,467,507,-40
48,407,48,373,139,184,-45
48,407,48,455,26,0,26
48,407,48,471,239,200,39
48,409,6,73,148,182,-34
48,409,12,31,56,72,-16
48,409,12,57,31,0,31
48,409,12,91,0,30,-30
48,409,15,3,42,72,-30
48,409,17,97,0,36,-36
48,409,48,7,457,497,-40
48,409,48,25,100,173,-73
48,409,48,27,27,42,-15
48,409,48,29,295,329,-34
48,409,48,39,39,49,-10
48,409,48,61,98,76,22
48,409,48,85,37,0,37
48,409,48,91,0,36,-36
48,409,48,113,59,66,-7
48,409,48,157,43,70,-27
48,409,48,167,0,73,-73
48,409,48,201,263,274,-11
48,409,48,209,46,0,46
48,409,48,215,79,96,-17
48,409,48,245,56,0,56
48,409,48,249,132,137,-5
48,409,48,273,62,69,-7
48,409,48,297,0,55,-55
48,409,48,309,26,0,26
48,409,48,355,1860,2037,-177
48,409,48,391,84,78,6
48,409,48,439,79,110,-31
48,409,48,453,115,146,-31
48,409,48,469,70,71,-1
48,409,48,479,32,0,32
48,409,48,491,43,32,11
48,409,51,710,43,32,11
48,409,51,810,47,109,-62
48,409,53,61,0,38,-38
48,411,48,49,0,62,-62
48,413,48,451,0,121,-121
48,415,48,113,33,0,33
48,415,48,135,44,48,-4
48,415,48,227,38,38,0
48,415,48,303,79,133,-54
48,415,48,329,54,65,-11
48,415,48,335,81,49,32
48,415,48,353,51,38,13
48,415,48,439,42,46,-4
48,415,48,441,88,59,29
48,415,48,451,0,37,-37
48,417,48,441,48,77,-29
48,419,22,31,117,83,34
48,419,48,5,43,48,-5
48,419,48,113,60,0,60
48,419,48,183,0,32,-32
48,419,48,201,114,108,6
48,419,48,347,204,304,-100
48,419,48,365,112,104,8
48,419,48,401,0,58,-58
48,419,48,405,57,33,24
48,419,48,423,52,41,11
48,423,4,13,70,61,9
48,423,5,119,51,0,51
48,423,6,37,146,54,92
48,423,6,59,64,0,64
48,423,6,65,50,0,50
48,423,6,71,37,0,37
48,423,6,73,97,25,72
48,423,8,41,37,50,-13
48,423,12,11,38,0,38
48,423,12,57,44,0,44
48,423,12,105,33,0,33
48,423,17,31,37,30,7
48,423,22,15,32,61,-29
48,423,22,17,118,100,18
48,423,22,71,0,38,-38
48,423,22,73,57,0,57
48,423,29,95,43,0,43
48,423,32,3,37,53,-16
48,423,37,51,0,49,-49
48,423,40,109,50,47,3
48,423,40,143,67,50,17
48,423,48,1,333,316,17
48,423,48,5,134,94,40
48,423,48,27,83,93,-10
48,423,48,29,167,139,28
48,423,48,37,86,85,1
48,423,48,39,49,47,2
48,423,48,41,84,98,-14
48,423,48,61,43,39,4
48,423,48,63,35,0,35
48,423,48,67,65,35,30
48,423,48,73,839,751,88
48,423,48,85,251,326,-75
48,423,48,113,906,1040,-134
48,423,48,121,230,341,-111
48,423,48,135,31,0,31
48,423,48,139,56,75,-19
48,423,48,141,32,0,32
48,423,48,157,61,65,-4
48,423,48,161,0,38,-38
48,423,48,167,62,66,-4
48,423,48,181,47,0,47
48,423,48,183,820,678,142
48,423,48,201,521,559,-38
48,423,48,203,208,107,101
48,423,48,209,0,23,-23
48,423,48,213,999,853,146
48,423,48,215,0,49,-49
48,423,48,221,0,28,-28
48,423,48,223,66,36,30
48,423,48,225,32,0,32
48,423,48,231,45,62,-17
48,423,48,241,41,0,41
48,423,48,245,40,55,-15
48,423,48,251,36,41,-5
48,423,48,257,124,123,1
48,423,48,277,71,32,39
48,423,48,303,70,58,12
48,423,48,309,105,83,22
48,423,48,329,41,48,-7
48,423,48,339,132,86,46
48,423,48,343,37,0,37
48,423,48,347,161,189,-28
48,423,48,349,68,46,22
48,423,48,355,43,37,6
48,423,48,361,35,0,35
48,423,48,365,78,59,19
48,423,48,367,0,54,-54
48,423,48,373,60,0,60
48,423,48,379,28,0,28
48,423,48,381,29,0,29
48,423,48,397,52,85,-33
48,423,48,401,408,459,-51
48,423,48,419,41,52,-11
48,423,48,439,524,715,-191
48,423,48,441,59,0,59
48,423,48,449,54,29,25
48,423,48,453,135,267,-132
48,423,48,459,226,246,-20
48,423,48,467,558,504,54
48,423,48,471,22,0,22
48,423,48,491,77,118,-41
48,423,48,499,524,432,92
48,425,48,35,59,41,18
48,425,48,113,39,0,39
48,425,48,143,0,37,-37
48,425,48,221,115,171,-56
48,425,48,251,86,98,-12
48,425,48,439,105,89,16
48,427,26,163,49,0,49
48,427,48,29,80,48,32
48,427,48,61,50,75,-25
48,427,48,113,0,38,-38
48,427,48,201,298,327,-29
48,427,48,215,635,1315,-680
48,427,48,355,49,45,4
48,427,48,453,0,31,-31
48,427,48,479,51,52,-1
48,427,48,505,60,60,0
48,429,48,133,45,50,-5
48,429,48,439,76,44,32
48,429,48,441,75,48,27
48,429,48,503,49,41,8
48,431,48,451,47,0,47
48,435,48,439,0,33,-33
48,435,48,451,37,104,-67
48,435,48,465,58,0,58
48,437,48,189,142,135,7
48,437,48,303,0,30,-30
48,437,48,375,71,77,-6
48,437,48,381,77,137,-60
48,439,1,3,36,52,-16
48,439,1,73,80,127,-47
48,439,1,89,92,86,6
48,439,1,97,61,67,-6
48,439,1,101,58,0,58
48,439,1,117,50,35,15
48,439,1,125,34,25,9
48,439,2,20,121,64,57
48,439,2,90,34,39,-5
48,439,4,3,43,0,43
48,439,4,5,30,0,30
48,439,4,13,1180,738,442
48,439,4,15,41,0,41
48,439,4,19,213,220,-7
48,439,4,21,77,88,-11
48,439,4,25,36,0,36
48,439,4,27,66,50,16
48,439,5,5,0,43,-43
48,439,5,7,147,173,-26
48,439,5,31,48,0,48
48,439,5,33,26,0,26
48,439,5,45,66,47,19
48,439,5,51,93,68,25
48,439,5,69,77,40,37
48,439,5,85,36,0,36
48,439,5,91,59,31,28
48,439,5,119,294,275,19
48,439,5,125,53,39,14
48,439,5,131,77,74,3
48,439,5,139,50,0,50
48,439,5,143,100,69,31
48,439,6,1,174,164,10
48,439,6,7,31,0,31
48,439,6,13,177,115,62
48,439,6,19,110,88,22
48,439,6,29,189,92,97
48,439,6,31,61,0,61
48,439,6,37,2748,990,1758
48,439,6,47,30,0,30
48,439,6,53,121,55,66
48,439,6,59,866,407,459
48,439,6,61,50,29,21
48,439,6,65,738,275,463
48,439,6,67,247,152,95
48,439,6,71,792,361,431
48,439,6,73,1181,728,453
48,439,6,75,50,74,-24
48,439,6,77,133,43,90
48,439,6,79,49,0,49
48,439,6,81,69,86,-17
48,439,6,83,77,44,33
48,439,6,85,280,237,43
48,439,6,87,25,0,25
48,439,6,89,50,0,50
48,439,6,95,70,50,20
48,439,6,97,27,39,-12
48,439,6,99,93,66,27
48,439,6,107,75,49,26
48,439,6,111,302,104,198
48,439,8,1,162,116,46
48,439,8,5,226,186,40
48,439,8,13,49,95,-46
48,439,8,14,34,38,-4
48,439,8,31,188,165,23
48,439,8,35,112,182,-70
48,439,8,41,274,323,-49
48,439,8,59,88,155,-67
48,439,8,69,83,85,-2
48,439,8,77,45,30,15
48,439,8,119,0,35,-35
48,439,8,123,48,0,48
48,439,9,1,124,38,86
48,439,9,3,87,58,29
48,439,9,9,61,50,11
48,439,9,11,47,27,20
48,439,10,3,75,39,36
48,439,11,1,100,50,50
48,439,12,1,63,37,26
48,439,12,5,75,33,42
48,439,12,9,123,95,28
48,439,12,11,461,222,239
48,439,12,19,70,62,8
48,439,12,21,84,38,46
48,439,12,31,203,184,19
48,439,12,33,133,128,5
48,439,12,57,328,210,118
48,439,12,61,36,0,36
48,439,12,69,59,44,15
48,439,12,71,131,64,67
48,439,12,73,52,63,-11
48,439,12,81,68,54,14
48,439,12,83,73,41,32
48,439,12,85,0,31,-31
48,439,12,86,497,210,287
48,439,12,91,89,97,-8
48,439,12,95,338,177,161
48,439,12,97,99,46,53
48,439,12,99,204,128,76
48,439,12,101,96,33,63
48,439,12,103,190,106,84
48,439,12,105,90,95,-5
48,439,12,109,43,0,43
48,439,12,111,64,35,29
48,439,12,113,45,41,4
48,439,12,115,36,56,-20
48,439,12,117,159,68,91
48,439,12,127,125,35,90
48,439,13,51,51,77,-26
48,439,13,57,44,35,9
48,439,13,63,90,37,53
48,439,13,67,267,243,24
48,439,13,77,59,89,-30
48,439,13,89,164,101,63
48,439,13,97,32,0,32
48,439,13,113,31,64,-33
48,439,13,117,0,53,-53
48,439,13,121,249,176,73
48,439,13,127,31,0,31
48,439,13,135,252,139,113
48,439,13,151,47,35,12
48,439,13,153,33,30,3
48,439,13,179,37,0,37
48,439,13,185,36,0,36
48,439,13,215,31,0,31
48,439,13,245,34,30,4
48,439,15,3,280,189,91
48,439,16,1,62,55,7
48,439,17,19,55,44,11
48,439,17,31,797,541,256
48,439,17,43,214,109,105
48,439,17,89,123,95,28
48,439,17,93,0,35,-35
48,439,17,97,172,161,11
48,439,17,111,46,0,46
48,439,17,113,28,0,28
48,439,17,119,45,34,11
48,439,17,143,34,0,34
48,439,17,161,45,0,45
48,439,17,163,62,0,62
48,439,17,167,30,0,30
48,439,17,197,147,81,66
48,439,17,201,78,41,37
48,439,18,3,41,58,-17
48,439,18,57,97,35,62
48,439,18,63,56,0,56
48,439,18,89,111,33,78
48,439,18,97,175,105,70
48,439,18,105,47,0,47
48,439,18,141,53,32,21
48,439,18,163,33,0,33
48,439,19,103,0,34,-34
48,439,19,113,0,48,-48
48,439,19,153,104,57,47
48,439,19,163,36,33,3
48,439,19,193,29,0,29
48,439,20,45,46,34,12
48,439,20,61,37,0,37
48,439,20,91,270,163,107
48,439,20,103,0,38,-38
48,439,20,125,29,0,29
48,439,20,161,30,0,30
48,439,20,173,333,279,54
48,439,20,177,89,71,18
48,439,20,209,41,38,3
48,439,21,15,0,38,-38
48,439,21,47,53,0,53
48,439,21,67,34,37,-3
48,439,21,93,0,39,-39
48,439,21,111,77,55,22
48,439,21,117,28,0,28
48,439,22,11,35,0,35
48,439,22,15,148,122,26
48,439,22,17,370,203,167
48,439,22,19,89,126,-37
48,439,22,33,258,233,25
48,439,22,35,38,0,38
48,439,22,51,230,287,-57
48,439,22,55,124,44,80
48,439,22,61,64,46,18
48,439,22,69,41,0,41
48,439,22,71,190,542,-352
48,439,22,73,226,106,120
48,439,22,75,76,65,11
48,439,22,79,65,83,-18
48,439,22,103,154,108,46
48,439,22,109,36,0,36
48,439,22,115,49,0,49
48,439,23,5,56,0,56
48,439,24,3,115,96,19
48,439,24,5,98,83,15
48,439,24,17,37,0,37
48,439,24,21,41,0,41
48,439,24,25,54,0,54
48,439,24,27,42,41,1
48,439,24,31,181,111,70
48,439,24,33,122,115,7
48,439,24,37,0,37,-37
48,439,24,510,43,47,-4
48,439,25,5,107,0,107
48,439,25,9,74,51,23
48,439,25,17,130,154,-24
48,439,25,21,69,54,15
48,439,25,23,40,0,40
48,439,25,25,93,62,31
48,439,25,27,145,40,105
48,439,26,21,41,0,41
48,439,26,49,91,0,91
48,439,26,65,59,0,59
48,439,26,77,37,0,37
48,439,26,81,89,35,54
48,439,26,99,159,51,108
48,439,26,125,359,110,249
48,439,26,139,39,0,39
48,439,26,145,27,0,27
48,439,26,147,31,0,31
48,439,26,161,70,46,24
48,439,26,163,412,61,351
48,439,27,3,38,0,38
48,439,27,37,86,0,86
48,439,27,53,254,144,110
48,439,27,123,84,40,44
48,439,27,163,0,37,-37
48,439,28,11,37,0,37
48,439,28,33,96,42,54
48,439,28,47,82,88,-6
48,439,28,49,123,40,83
48,439,28,75,0,34,-34
48,439,28,89,34,0,34
48,439,28,113,34,0,34
48,439,28,121,60,28,32
48,439,28,149,44,0,44
48,439,28,151,63,0,63
48,439,29,19,60,42,18
48,439,29,47,101,77,24
48,439,29,77,102,119,-17
48,439,29,95,243,141,102
48,439,29,97,55,41,14
48,439,29,101,34,0,34
48,439,29,165,76,51,25
48,439,29,169,0,28,-28
48,439,29,183,111,89,22
48,439,29,189,318,144,174
48,439,29,510,64,46,18
48,439,30,29,0,22,-22
48,439,30,111,0,31,-31
48,439,31,55,123,128,-5
48,439,31,109,94,36,58
48,439,31,153,84,36,48
48,439,32,3,775,466,309
48,439,32,31,100,98,2
48,439,33,11,81,48,33
48,439,34,3,85,28,57
48,439,34,5,87,35,52
48,439,34,7,59,0,59
48,439,34,13,76,0,76
48,439,34,17,73,56,17
48,439,34,21,45,0,45
48,439,34,23,107,69,38
48,439,34,25,38,0,38
48,439,34,27,55,54,1
48,439,34,29,46,0,46
48,439,34,31,67,0,67
48,439,34,39,92,0,92
48,439,35,1,398,285,113
48,439,35,5,50,42,8
48,439,35,9,49,0,49
48,439,35,13,117,67,50
48,439,35,15,56,28,28
48,439,35,25,82,49,33
48,439,35,27,30,0,30
48,439,35,35,50,0,50
48,439,35,43,75,98,-23
48,439,35,49,39,75,-36
48,439,36,5,136,46,90
48,439,36,7,0,46,-46
48,439,36,27,40,0,40
48,439,36,29,94,74,20
48,439,36,45,57,82,-25
48,439,36,47,132,107,25
48,439,36,55,45,35,10
48,439,36,59,134,55,79
48,439,36,61,149,208,-59
48,439,36,67,58,50,8
48,439,36,71,59,37,22
48,439,36,81,274,93,181
48,439,36,103,137,49,88
48,439,36,119,76,36,40
48,439,37,21,0,32,-32
48,439,37,35,35,0,35
48,439,37,49,86,47,39
48,439,37,51,81,113,-32
48,439,37,63,49,63,-14
48,439,37,81,67,68,-1
48,439,37,119,166,166,0
48,439,37,129,30,0,30
48,439,37,133,242,133,109
48,439,37,179,0,34,-34
48,439,37,183,201,202,-1
48,439,38,17,33,0,33
48,439,38,35,47,0,47
48,439,39,17,30,0,30
48,439,39,35,116,97,19
48,439,39,49,214,135,79
48,439,39,57,49,0,49
48,439,39,61,75,66,9
48,439,39,93,46,0,46
48,439,39,95,44,0,44
48,439,39,99,27,0,27
48,439,39,113,81,42,39
48,439,39,151,25,0,25
48,439,39,153,106,43,63
48,439,39,165,35,0,35
48,439,40,13,62,58,4
48,439,40,17,97,106,-9
48,439,40,19,41,78,-37
48,439,40,27,311,249,62
48,439,40,31,221,132,89
48,439,40,41,33,0,33
48,439,40,47,42,0,42
48,439,40,65,61,0,61
48,439,40,83,28,0,28
48,439,40,87,32,29,3
48,439,40,89,29,27,2
48,439,40,101,41,0,41
48,439,40,109,785,579,206
48,439,40,119,77,42,35
48,439,40,121,48,37,11
48,439,40,123,0,35,-35
48,439,40,125,55,40,15
48,439,40,131,30,41,-11
48,439,40,137,57,48,9
48,439,40,143,757,478,279
48,439,40,145,67,29,38
48,439,40,147,33,41,-8
48,439,41,5,42,60,-18
48,439,41,39,32,42,-10
48,439,41,51,81,94,-13
48,439,41,67,98,73,25
48,439,42,3,71,121,-50
48,439,42,17,62,75,-13
48,439,42,29,0,42,-42
48,439,42,45,51,0,51
48,439,42,49,42,0,42
48,439,42,77,38,26,12
48,439,42,91,76,85,-9
48,439,42,101,79,65,14
48,439,42,133,44,0,44
48,439,44,7,89,36,53
48,439,45,13,90,45,45
48,439,45,15,27,32,-5
48,439,45,19,37,33,4
48,439,45,45,42,81,-39
48,439,45,79,40,49,-9
48,439,45,83,0,46,-46
48,439,45,91,37,44,-7
48,439,46,99,57,0,57
48,439,47,37,227,213,14
48,439,47,65,33,50,-17
48,439,47,93,105,45,60
48,439,47,125,101,46,55
48,439,47,149,125,53,72
48,439,47,157,371,188,183
48,439,47,165,0,48,-48
48,439,47,187,61,67,-6
48,439,48,1,113,80,33
48,439,48,3,26,0,26
48,439,48,5,116,73,43
48,439,48,7,36,28,8
48,439,48,9,46,41,5
48,439,48,13,33,0,33
48,439,48,21,79,44,35
48,439,48,27,745,592,153
48,439,48,29,1497,1497,0
48,439,48,35,60,130,-70
48,439,48,37,163,135,28
48,439,48,39,207,228,-21
48,439,48,41,430,345,85
48,439,48,49,107,130,-23
48,439,48,53,74,39,35
48,439,48,55,40,0,40
48,439,48,59,34,38,-4
48,439,48,61,313,246,67
48,439,48,63,0,40,-40
48,439,48,67,40,43,-3
48,439,48,71,22,0,22
48,439,48,73,44,75,-31
48,439,48,75,30,0,30
48,439,48,77,33,39,-6
48,439,48,83,0,28,-28
48,439,48,85,3015,3361,-346
48,439,48,91,102,163,-61
48,439,48,93,47,31,16
48,439,48,97,170,158,12
48,439,48,99,158,140,18
48,439,48,105,0,32,-32
48,439,48,113,29704,24900,4804
48,439,48,115,39,0,39
48,439,48,121,7755,8444,-689
48,439,48,133,133,128,5
48,439,48,135,322,221,101
48,439,48,139,1274,1609,-335
48,439,48,141,839,684,155
48,439,48,143,324,292,32
48,439,48,145,33,39,-6
48,439,48,147,48,125,-77
48,439,48,157,374,405,-31
48,439,48,159,35,36,-1
48,439,48,161,61,28,33
48,439,48,167,241,330,-89
48,439,48,171,33,34,-1
48,439,48,179,45,77,-32
48,439,48,181,300,341,-41
48,439,48,183,334,278,56
48,439,48,187,129,115,14
48,439,48,189,87,42,45
48,439,48,193,0,47,-47
48,439,48,197,36,0,36
48,439,48,199,36,43,-7
48,439,48,201,3020,3004,16
48,439,48,203,120,168,-48
48,439,48,209,226,235,-9
48,439,48,213,272,330,-58
48,439,48,215,379,414,-35
48,439,48,217,334,325,9
48,439,48,219,51,0,51
48,439,48,221,1199,1217,-18
48,439,48,223,86,84,2
48,439,48,225,27,0,27
48,439,48,227,73,101,-28
48,439,48,231,314,266,48
48,439,48,233,0,25,-25
48,439,48,237,32,71,-39
48,439,48,241,0,33,-33
48,439,48,245,206,245,-39
48,439,48,251,5319,6587,-1268
48,439,48,253,47,46,1
48,439,48,257,305,467,-162
48,439,48,259,29,62,-33
48,439,48,265,79,66,13
48,439,48,273,64,0,64
48,439,48,277,107,107,0
48,439,48,279,32,0,32
48,439,48,281,32,0,32
48,439,48,289,43,0,43
48,439,48,291,33,51,-18
48,439,48,293,37,51,-14
48,439,48,303,995,584,411
48,439,48,309,805,650,155
48,439,48,323,66,52,14
48,439,48,325,39,39,0
48,439,48,329,415,269,146
48,439,48,331,46,26,20
48,439,48,337,156,173,-17
48,439,48,339,465,505,-40
48,439,48,347,137,86,51
48,439,48,349,215,257,-42
48,439,48,353,63,73,-10
48,439,48,355,435,283,152
48,439,48,361,58,39,19
48,439,48,363,292,319,-27
48,439,48,365,33,48,-15
48,439,48,367,3723,5169,-1446
48,439,48,371,0,35,-35
48,439,48,373,33,86,-53
48,439,48,375,322,182,140
48,439,48,379,31,32,-1
48,439,48,381,330,228,102
48,439,48,397,242,369,-127
48,439,48,401,70,89,-19
48,439,48,409,110,79,31
48,439,48,415,46,42,4
48,439,48,423,715,524,191
48,439,48,425,89,105,-16
48,439,48,429,44,76,-32
48,439,48,435,33,0,33
48,439,48,441,723,504,219
48,439,48,449,75,55,20
48,439,48,451,376,214,162
48,439,48,453,1363,1576,-213
48,439,48,459,47,90,-43
48,439,48,465,177,108,69
48,439,48,467,138,169,-31
48,439,48,469,74,57,17
48,439,48,471,68,62,6
48,439,48,473,0,35,-35
48,439,48,479,127,128,-1
48,439,48,485,760,458,302
48,439,48,487,63,35,28
48,439,48,491,578,721,-143
48,439,48,493,0,34,-34
48,439,48,497,1479,1798,-319
48,439,48,499,97,196,-99
48,439,48,503,94,80,14
48,439,49,11,71,47,24
48,439,49,35,164,215,-51
48,439,49,49,139,113,26
48,439,49,57,47,0,47
48,439,51,13,55,68,-13
48,439,51,41,50,34,16
48,439,51,59,247,260,-13
48,439,51,87,73,43,30
48,439,51,107,129,52,77
48,439,51,153,117,80,37
48,439,51,179,51,0,51
48,439,51,510,48,44,4
48,439,51,550,53,0,53
48,439,51,650,40,32,8
48,439,51,700,67,32,35
48,439,51,710,108,64,44
48,439,51,810,184,153,31
48,439,53,11,89,74,15
48,439,53,29,55,32,23
48,439,53,33,281,422,-141
48,439,53,35,68,45,23
48,439,53,53,247,212,35
48,439,53,61,99,140,-41
48,439,53,63,52,66,-14
48,439,53,67,0,35,-35
48,439,55,25,52,39,13
48,439,55,79,201,115,86
48,439,55,133,52,38,14
48,439,56,21,32,0,32
48,441,2,20,42,51,-9
48,441,2,90,86,0,86
48,441,4,13,65,93,-28
48,441,4,19,0,56,-56
48,441,5,119,79,0,79
48,441,6,29,48,49,-1
48,441,6,37,65,64,1
48,441,6,73,63,35,28
48,441,8,5,0,34,-34
48,441,8,31,0,29,-29
48,441,8,41,61,76,-15
48,441,12,33,42,0,42
48,441,12,57,0,28,-28
48,441,12,91,0,50,-50
48,441,12,113,0,36,-36
48,441,15,3,60,62,-2
48,441,17,31,0,29,-29
48,441,17,163,0,64,-64
48,441,22,15,0,30,-30
48,441,28,47,27,0,27
48,441,32,3,47,70,-23
48,441,35,1,41,43,-2
48,441,35,9,59,0,59
48,441,40,109,37,41,-4
48,441,40,143,40,48,-8
48,441,46,103,60,61,-1
48,441,48,27,104,113,-9
48,441,48,29,224,407,-183
48,441,48,39,35,47,-12
48,441,48,41,45,61,-16
48,441,48,49,176,138,38
48,441,48,59,655,690,-35
48,441,48,83,65,50,15
48,441,48,85,92,185,-93
48,441,48,93,50,33,17
48,441,48,99,38,55,-17
48,441,48,113,275,415,-140
48,441,48,121,116,218,-102
48,441,48,133,70,107,-37
48,441,48,135,105,126,-21
48,441,48,139,43,0,43
48,441,48,141,76,82,-6
48,441,48,143,35,0,35
48,441,48,151,39,37,2
48,441,48,181,0,47,-47
48,441,48,187,34,45,-11
48,441,48,201,175,176,-1
48,441,48,207,64,90,-26
48,441,48,209,28,58,-30
48,441,48,215,39,0,39
48,441,48,221,0,54,-54
48,441,48,227,56,55,1
48,441,48,251,34,96,-62
48,441,48,253,648,561,87
48,441,48,265,0,31,-31
48,441,48,275,0,33,-33
48,441,48,303,261,308,-47
48,441,48,309,61,84,-23
48,441,48,329,116,156,-40
48,441,48,339,0,41,-41
48,441,48,353,189,141,48
48,441,48,355,89,92,-3
48,441,48,367,95,105,-10
48,441,48,375,48,27,21
48,441,48,381,70,74,-4
48,441,48,399,105,66,39
48,441,48,415,59,88,-29
48,441,48,417,77,48,29
48,441,48,423,0,59,-59
48,441,48,429,48,75,-27
48,441,48,439,504,723,-219
48,441,48,451,233,201,32
48,441,48,453,187,237,-50
48,441,48,465,50,51,-1
48,441,48,485,126,87,39
48,441,48,491,82,130,-48
48,441,48,497,0,43,-43
48,441,48,503,27,30,-3
48,445,48,165,43,55,-12
48,445,48,219,30,73,-43
48,445,48,303,198,360,-162
48,449,48,37,57,41,16
48,449,48,63,202,211,-9
48,449,48,67,59,51,8
48,449,48,113,111,151,-40
48,449,48,121,34,36,-2
48,449,48,159,506,240,266
48,449,48,183,54,100,-46
48,449,48,201,0,44,-44
48,449,48,223,57,52,5
48,449,48,343,140,152,-12
48,449,48,387,0,57,-57
48,449,48,423,29,54,-25
48,449,48,439,55,75,-20
48,451,2,20,0,38,-38
48,451,4,3,42,0,42
48,451,4,13,76,55,21
48,451,4,19,0,60,-60
48,451,6,37,52,0,52
48,451,6,53,502,0,502
48,451,6,73,76,75,1
48,451,6,115,0,37,-37
48,451,8,5,0,33,-33
48,451,8,41,118,84,34
48,451,12,9,0,56,-56
48,451,12,57,43,0,43
48,451,12,91,0,54,-54
48,451,12,113,0,56,-56
48,451,13,245,0,82,-82
48,451,15,3,107,166,-59
48,451,24,3,63,75,-12
48,451,31,153,48,69,-21
48,451,32,3,50,130,-80
48,451,35,1,42,29,13
48,451,35,25,47,0,47
48,451,37,133,39,80,-41
48,451,40,143,0,32,-32
48,451,48,27,87,123,-36
48,451,48,29,323,460,-137
48,451,48,41,32,82,-50
48,451,48,43,22,0,22
48,451,48,49,87,51,36
48,451,48,59,37,0,37
48,451,48,81,107,85,22
48,451,48,83,29,32,-3
48,451,48,85,62,90,-28
48,451,48,91,0,27,-27
48,451,48,95,105,86,19
48,451,48,99,48,0,48
48,451,48,105,52,67,-15
48,451,48,113,159,171,-12
48,451,48,121,119,109,10
48,451,48,135,139,169,-30
48,451,48,141,74,33,41
48,451,48,187,32,0,32
48,451,48,189,39,0,39
48,451,48,201,140,233,-93
48,451,48,209,34,44,-10
48,451,48,221,0,61,-61
48,451,48,227,108,73,35
48,451,48,235,95,72,23
48,451,48,251,0,44,-44
48,451,48,265,44,54,-10
48,451,48,303,218,199,19
48,451,48,307,75,34,41
48,451,48,309,38,39,-1
48,451,48,329,180,294,-114
48,451,48,335,30,0,30
48,451,48,339,0,44,-44
48,451,48,353,74,51,23
48,451,48,355,38,52,-14
48,451,48,367,0,45,-45
48,451,48,371,58,58,0
48,451,48,383,88,25,63
48,451,48,399,248,180,68
48,451,48,413,121,59,62
48,451,48,415,37,0,37
48,451,48,431,40,47,-7
48,451,48,435,104,37,67
48,451,48,439,214,376,-162
48,451,48,441,201,233,-32
48,451,48,453,158,268,-110
48,451,48,465,131,102,29
48,451,48,485,41,45,-4
48,451,48,491,93,175,-82
48,451,49,57,0,30,-30
48,451,51,650,0,25,-25
48,451,53,53,0,30,-30
48,453,1,73,82,30,52
48,453,1,89,36,51,-15
48,453,1,97,34,29,5
48,453,1,101,34,38,-4
48,453,1,125,26,0,26
48,453,2,20,58,41,17
48,453,2,90,22,0,22
48,453,4,5,64,0,64
48,453,4,13,856,540,316
48,453,4,19,185,156,29
48,453,4,21,25,0,25
48,453,4,25,27,41,-14
48,453,5,7,60,45,15
48,453,5,119,127,56,71
48,453,5,131,45,0,45
48,453,5,143,74,47,27
48,453,6,1,290,197,93
48,453,6,13,179,59,120
48,453,6,17,52,0,52
48,453,6,19,58,0,58
48,453,6,29,63,0,63
48,453,6,37,1821,788,1033
48,453,6,41,50,0,50
48,453,6,47,34,0,34
48,453,6,53,35,26,9
48,453,6,59,926,274,652
48,453,6,65,322,153,169
48,453,6,67,215,96,119
48,453,6,71,261,90,171
48,453,6,73,915,522,393
48,453,6,75,388,225,163
48,453,6,77,49,0,49
48,453,6,81,149,128,21
48,453,6,83,98,34,64
48,453,6,85,670,590,80
48,453,6,87,53,44,9
48,453,6,95,61,31,30
48,453,6,97,69,35,34
48,453,6,99,47,0,47
48,453,6,111,170,64,106
48,453,6,113,36,0,36
48,453,8,1,55,57,-2
48,453,8,5,126,114,12
48,453,8,13,113,140,-27
48,453,8,14,48,61,-13
48,453,8,31,192,181,11
48,453,8,35,82,97,-15
48,453,8,41,265,123,142
48,453,8,59,95,98,-3
48,453,8,69,111,102,9
48,453,8,101,39,24,15
48,453,8,123,43,0,43
48,453,9,1,148,40,108
48,453,9,3,74,42,32
48,453,9,9,80,50,30
48,453,9,11,33,0,33
48,453,10,3,53,0,53
48,453,11,1,273,213,60
48,453,12,1,94,24,70
48,453,12,5,42,0,42
48,453,12,9,68,0,68
48,453,12,11,277,95,182
48,453,12,21,42,0,42
48,453,12,31,128,91,37
48,453,12,33,61,41,20
48,453,12,57,200,97,103
48,453,12,61,29,0,29
48,453,12,69,38,0,38
48,453,12,71,133,42,91
48,453,12,73,86,0,86
48,453,12,81,86,0,86
48,453,12,83,65,0,65
48,453,12,86,340,188,152
48,453,12,87,24,0,24
48,453,12,91,34,28,6
48,453,12,95,275,86,189
48,453,12,97,39,0,39
48,453,12,99,256,90,166
48,453,12,101,40,45,-5
48,453,12,103,148,68,80
48,453,12,105,69,0,69
48,453,12,111,32,0,32
48,453,12,115,45,0,45
48,453,12,117,77,39,38
48,453,13,51,58,36,22
48,453,13,57,43,38,5
48,453,13,59,36,0,36
48,453,13,67,185,82,103
48,453,13,89,175,151,24
48,453,13,121,227,208,19
48,453,13,135,70,86,-16
48,453,15,1,25,0,25
48,453,15,3,217,164,53
48,453,15,9,37,41,-4
48,453,16,1,49,39,10
48,453,17,19,63,47,16
48,453,17,31,885,570,315
48,453,17,43,101,55,46
48,453,17,77,26,0,26
48,453,17,89,45,0,45
48,453,17,97,116,36,80
48,453,17,111,41,0,41
48,453,17,113,22,0,22
48,453,17,167,46,0,46
48,453,17,197,64,0,64
48,453,18,3,27,0,27
48,453,18,39,24,0,24
48,453,18,57,36,0,36
48,453,18,89,38,0,38
48,453,18,97,122,61,61
48,453,18,105,39,32,7
48,453,18,141,36,0,36
48,453,18,157,44,0,44
48,453,19,103,32,0,32
48,453,19,113,40,24,16
48,453,19,153,88,0,88
48,453,19,169,26,0,26
48,453,20,45,29,0,29
48,453,20,91,140,90,50
48,453,20,161,33,0,33
48,453,20,173,95,26,69
48,453,20,177,43,0,43
48,453,21,67,55,0,55
48,453,21,111,42,69,-27
48,453,22,15,36,26,10
48,453,22,17,73,42,31
48,453,22,19,86,47,39
48,453,22,33,188,118,70
48,453,22,51,172,105,67
48,453,22,55,104,42,62
48,453,22,61,35,0,35
48,453,22,71,199,310,-111
48,453,22,73,45,0,45
48,453,22,103,41,48,-7
48,453,22,115,28,0,28
48,453,23,5,58,0,58
48,453,24,3,94,24,70
48,453,24,5,81,0,81
48,453,24,21,33,0,33
48,453,24,27,52,0,52
48,453,24,31,214,142,72
48,453,24,33,64,66,-2
48,453,24,510,71,52,19
48,453,25,3,29,0,29
48,453,25,5,0,28,-28
48,453,25,9,64,0,64
48,453,25,13,34,0,34
48,453,25,17,360,240,120
48,453,25,21,77,49,28
48,453,25,25,163,113,50
48,453,25,27,55,38,17
48,453,26,49,59,0,59
48,453,26,65,52,23,29
48,453,26,77,46,0,46
48,453,26,81,99,0,99
48,453,26,93,35,0,35
48,453,26,99,49,0,49
48,453,26,125,191,46,145
48,453,26,145,39,0,39
48,453,26,161,155,42,113
48,453,26,163,96,46,50
48,453,27,37,0,38,-38
48,453,27,53,201,136,65
48,453,27,109,32,0,32
48,453,27,123,69,50,19
48,453,27,163,41,33,8
48,453,28,47,36,0,36
48,453,28,49,71,26,45
48,453,28,105,28,0,28
48,453,29,19,47,39,8
48,453,29,47,23,0,23
48,453,29,77,37,0,37
48,453,29,95,97,90,7
48,453,29,183,44,0,44
48,453,29,189,170,111,59
48,453,29,510,52,55,-3
48,453,31,55,117,49,68
48,453,31,109,62,36,26
48,453,31,153,29,0,29
48,453,32,3,387,234,153
48,453,32,31,92,56,36
48,453,33,11,46,30,16
48,453,33,15,30,0,30
48,453,34,3,69,58,11
48,453,34,7,45,0,45
48,453,34,13,75,33,42
48,453,34,17,79,64,15
48,453,34,21,48,49,-1
48,453,34,23,107,71,36
48,453,34,25,47,0,47
48,453,34,27,91,37,54
48,453,34,29,29,0,29
48,453,34,31,31,0,31
48,453,34,35,42,47,-5
48,453,35,1,296,182,114
48,453,35,13,78,50,28
48,453,35,25,31,0,31
48,453,35,43,59,36,23
48,453,35,45,24,0,24
48,453,35,49,91,53,38
48,453,36,1,41,29,12
48,453,36,5,68,31,37
48,453,36,27,56,55,1
48,453,36,29,49,41,8
48,453,36,47,342,301,41
48,453,36,55,81,38,43
48,453,36,59,81,0,81
48,453,36,61,485,449,36
48,453,36,67,35,0,35
48,453,36,81,169,80,89
48,453,36,103,88,42,46
48,453,36,109,37,0,37
48,453,36,111,25,0,25
48,453,36,119,85,93,-8
48,453,37,21,42,31,11
48,453,37,51,50,49,1
48,453,37,63,114,51,63
48,453,37,67,55,50,5
48,453,37,81,47,56,-9
48,453,37,119,156,119,37
48,453,37,129,23,0,23
48,453,37,133,54,44,10
48,453,37,135,42,42,0
48,453,37,183,192,182,10
48,453,39,17,47,0,47
48,453,39,35,122,44,78
48,453,39,49,192,76,116
48,453,39,61,86,37,49
48,453,39,95,24,0,24
48,453,39,153,58,0,58
48,453,40,27,107,69,38
48,453,40,31,38,0,38
48,453,40,109,217,165,52
48,453,40,119,53,0,53
48,453,40,143,204,177,27
48,453,41,3,30,0,30
48,453,41,5,68,47,21
48,453,41,39,69,57,12
48,453,41,51,172,178,-6
48,453,41,67,224,108,116
48,453,42,3,111,90,21
48,453,42,17,35,0,35
48,453,42,27,40,23,17
48,453,42,29,57,0,57
48,453,42,77,46,0,46
48,453,42,91,42,26,16
48,453,42,101,122,79,43
48,453,44,7,53,37,16
48,453,45,19,52,33,19
48,453,45,45,50,38,12
48,453,45,79,46,44,2
48,453,46,99,0,33,-33
48,453,47,37,147,158,-11
48,453,47,65,0,24,-24
48,453,47,93,80,42,38
48,453,47,125,34,0,34
48,453,47,149,54,0,54
48,453,47,157,222,88,134
48,453,47,187,58,0,58
48,453,48,1,62,28,34
48,453,48,5,86,61,25
48,453,48,7,58,59,-1
48,453,48,13,60,39,21
48,453,48,15,25,48,-23
48,453,48,19,35,28,7
48,453,48,21,2264,2833,-569
48,453,48,25,52,31,21
48,453,48,27,1315,897,418
48,453,48,29,3614,3164,450
48,453,48,31,83,103,-20
48,453,48,37,34,0,34
48,453,48,39,321,245,76
48,453,48,41,690,439,251
48,453,48,43,42,0,42
48,453,48,49,117,70,47
48,453,48,51,0,44,-44
48,453,48,53,452,607,-155
48,453,48,55,616,926,-310
48,453,48,57,25,33,-8
48,453,48,61,581,422,159
48,453,48,71,23,0,23
48,453,48,73,40,0,40
48,453,48,85,1072,854,218
48,453,48,89,41,37,4
48,453,48,91,488,475,13
48,453,48,99,156,140,16
48,453,48,113,2800,2204,596
48,453,48,121,789,619,170
48,453,48,123,45,0,45
48,453,48,127,36,0,36
48,453,48,135,123,105,18
48,453,48,139,87,83,4
48,453,48,141,712,420,292
48,453,48,143,58,0,58
48,453,48,145,0,31,-31
48,453,48,149,95,122,-27
48,453,48,157,625,613,12
48,453,48,167,404,245,159
48,453,48,171,106,101,5
48,453,48,177,87,94,-7
48,453,48,181,81,52,29
48,453,48,183,98,72,26
48,453,48,185,31,0,31
48,453,48,187,349,319,30
48,453,48,199,38,46,-8
48,453,48,201,5244,4690,554
48,453,48,203,50,30,20
48,453,48,209,4592,7599,-3007
48,453,48,213,53,35,18
48,453,48,215,674,575,99
48,453,48,217,37,38,-1
48,453,48,221,31,48,-17
48,453,48,227,23,53,-30
48,453,48,231,57,30,27
48,453,48,241,27,0,27
48,453,48,245,381,208,173
48,453,48,249,55,43,12
48,453,48,251,69,79,-10
48,453,48,255,0,32,-32
48,453,48,257,54,36,18
48,453,48,259,96,91,5
48,453,48,265,123,113,10
48,453,48,273,91,56,35
48,453,48,281,69,36,33
48,453,48,285,56,51,5
48,453,48,287,158,174,-16
48,453,48,291,0,44,-44
48,453,48,299,123,176,-53
48,453,48,303,526,284,242
48,453,48,307,30,23,7
48,453,48,309,676,407,269
48,453,48,321,48,41,7
48,453,48,323,121,150,-29
48,453,48,325,59,40,19
48,453,48,329,182,142,40
48,453,48,331,150,128,22
48,453,48,339,540,458,82
48,453,48,347,113,63,50
48,453,48,349,47,37,10
48,453,48,353,0,34,-34
48,453,48,355,829,580,249
48,453,48,361,67,72,-5
48,453,48,367,53,59,-6
48,453,48,373,42,43,-1
48,453,48,375,152,45,107
48,453,48,381,121,58,63
48,453,48,397,92,56,36
48,453,48,401,0,28,-28
48,453,48,409,146,115,31
48,453,48,423,267,135,132
48,453,48,427,31,0,31
48,453,48,439,1576,1363,213
48,453,48,441,237,187,50
48,453,48,451,268,158,110
48,453,48,463,61,48,13
48,453,48,465,86,70,16
48,453,48,467,22,0,22
48,453,48,469,324,115,209
48,453,48,471,78,71,7
48,453,48,473,0,27,-27
48,453,48,477,97,76,21
48,453,48,479,310,190,120
48,453,48,481,26,52,-26
48,453,48,485,92,56,36
48,453,48,489,31,0,31
48,453,48,491,15285,22630,-7345
48,453,48,493,27,50,-23
48,453,48,499,22,0,22
48,453,48,507,38,33,5
48,453,49,11,38,0,38
48,453,49,35,174,91,83
48,453,49,49,112,56,56
48,453,50,7,65,32,33
48,453,51,13,149,96,53
48,453,51,59,273,206,67
48,453,51,87,54,27,27
48,453,51,107,47,39,8
48,453,51,121,29,0,29
48,453,51,153,79,35,44
48,453,51,510,66,36,30
48,453,51,710,50,0,50
48,453,51,760,54,38,16
48,453,51,810,94,0,94
48,453,53,11,40,27,13
48,453,53,33,551,561,-10
48,453,53,35,41,0,41
48,453,53,53,117,57,60
48,453,53,61,76,73,3
48,453,53,63,31,0,31
48,453,53,67,54,0,54
48,453,53,73,35,33,2
48,453,55,25,146,93,53
48,453,55,79,113,51,62
48,453,55,133,67,0,67
48,453,56,1,32,0,32
48,453,56,21,0,28,-28
48,455,48,5,135,138,-3
48,455,48,39,32,0,32
48,455,48,167,50,0,50
48,455,48,201,209,153,56
48,455,48,225,53,87,-34
48,455,48,339,102,105,-3
48,455,48,373,91,118,-27
48,455,48,407,0,26,-26
48,455,48,471,166,197,-31
48,457,48,5,74,40,34
48,457,48,167,52,0,52
48,457,48,199,274,214,60
48,457,48,201,137,122,15
48,457,48,241,146,87,59
48,457,48,245,187,120,67
48,457,48,339,0,41,-41
48,457,48,361,66,82,-16
48,457,48,373,65,52,13
48,459,48,63,68,63,5
48,459,48,67,40,45,-5
48,459,48,113,101,100,1
48,459,48,121,36,0,36
48,459,48,183,1349,1109,240
48,459,48,201,0,43,-43
48,459,48,203,179,197,-18
48,459,48,315,64,48,16
48,459,48,339,26,0,26
48,459,48,343,52,68,-16
48,459,48,401,79,101,-22
48,459,48,423,246,226,20
48,459,48,439,90,47,43
48,459,48,467,0,37,-37
48,459,48,499,134,169,-35
48,461,48,135,55,0,55
48,461,48,329,38,0,38
48,463,48,19,0,34,-34
48,463,48,29,206,359,-153
48,463,48,113,0,29,-29
48,463,48,127,0,38,-38
48,463,48,163,33,0,33
48,463,48,201,45,41,4
48,463,48,215,0,46,-46
48,463,48,323,83,62,21
48,463,48,325,54,97,-43
48,463,48,355,36,37,-1
48,463,48,385,38,34,4
48,463,48,453,48,61,-13
48,463,48,465,40,42,-2
48,463,48,491,0,45,-45
48,463,48,507,83,78,5
48,465,2,20,0,50,-50
48,465,4,13,32,87,-55
48,465,4,19,35,43,-8
48,465,5,119,0,36,-36
48,465,6,73,38,0,38
48,465,6,95,0,36,-36
48,465,8,41,142,0,142
48,465,10,1,0,26,-26
48,465,13,185,69,0,69
48,465,32,3,39,0,39
48,465,37,191,0,33,-33
48,465,45,19,0,24,-24
48,465,48,27,43,0,43
48,465,48,29,416,618,-202
48,465,48,113,46,76,-30
48,465,48,135,0,27,-27
48,465,48,141,57,68,-11
48,465,48,187,0,57,-57
48,465,48,201,99,112,-13
48,465,48,209,31,36,-5
48,465,48,215,0,51,-51
48,465,48,271,45,0,45
48,465,48,323,99,106,-7
48,465,48,355,0,87,-87
48,465,48,371,0,40,-40
48,465,48,383,0,55,-55
48,465,48,435,0,58,-58
48,465,48,439,108,177,-69
48,465,48,441,51,50,1
48,465,48,451,102,131,-29
48,465,48,453,70,86,-16
48,465,48,463,42,40,2
48,465,48,479,43,46,-3
48,465,48,491,0,37,-37
48,467,48,85,136,110,26
48,467,48,113,605,425,180
48,467,48,121,60,70,-10
48,467,48,139,83,53,30
48,467,48,183,0,44,-44
48,467,48,201,31,30,1
48,467,48,213,292,312,-20
48,467,48,231,137,119,18
48,467,48,257,603,453,150
48,467,48,379,45,71,-26
48,467,48,397,57,80,-23
48,467,48,423,504,558,-54
48,467,48,439,169,138,31
48,467,48,453,0,22,-22
48,467,48,459,37,0,37
48,467,48,499,170,201,-31
48,469,48,7,29,49,-20
48,469,48,13,0,27,-27
48,469,48,21,33,0,33
48,469,48,25,107,49,58
48,469,48,27,63,56,7
48,469,48,29,207,357,-150
48,469,48,39,141,116,25
48,469,48,41,44,62,-18
48,469,48,57,455,252,203
48,469,48,61,36,0,36
48,469,48,85,30,32,-2
48,469,48,91,0,44,-44
48,469,48,113,66,78,-12
48,469,48,121,37,0,37
48,469,48,123,350,295,55
48,469,48,149,30,0,30
48,469,48,157,65,172,-107
48,469,48,167,41,47,-6
48,469,48,175,270,288,-18
48,469,48,177,28,33,-5
48,469,48,187,47,47,0
48,469,48,201,357,599,-242
48,469,48,209,66,58,8
48,469,48,215,69,99,-30
48,469,48,239,212,218,-6
48,469,48,249,42,0,42
48,469,48,255,33,36,-3
48,469,48,273,34,0,34
48,469,48,285,139,99,40
48,469,48,309,0,34,-34
48,469,48,321,51,48,3
48,469,48,339,0,50,-50
48,469,48,355,212,226,-14
48,469,48,391,88,52,36
48,469,48,409,71,70,1
48,469,48,439,57,74,-17
48,469,48,453,115,324,-209
48,469,48,481,82,89,-7
48,469,48,491,78,133,-55
48,471,6,73,23,0,23
48,471,48,1,34,0,34
48,471,48,5,0,31,-31
48,471,48,27,38,31,7
48,471,48,29,51,45,6
48,471,48,39,100,91,9
48,471,48,41,136,149,-13
48,471,48,85,23,0,23
48,471,48,113,93,124,-31
48,471,48,121,0,40,-40
48,471,48,157,61,71,-10
48,471,48,167,84,53,31
48,471,48,185,80,64,16
48,471,48,201,820,879,-59
48,471,48,225,71,42,29
48,471,48,289,32,25,7
48,471,48,291,0,28,-28
48,471,48,309,0,30,-30
48,471,48,313,109,68,41
48,471,48,339,732,1076,-344
48,471,48,373,70,70,0
48,471,48,407,200,239,-39
48,471,48,423,0,22,-22
48,471,48,439,62,68,-6
48,471,48,453,71,78,-7
48,471,48,455,197,166,31
48,471,48,473,35,0,35
48,471,48,477,25,0,25
48,471,48,491,28,57,-29
48,473,48,15,123,171,-48
48,473,48,29,35,26,9
48,473,48,41,24,51,-27
48,473,48,85,0,26,-26
48,473,48,113,52,62,-10
48,473,48,157,251,211,40
48,473,48,167,36,0,36
48,473,48,185,44,57,-13
48,473,48,201,1725,1670,55
48,473,48,215,0,39,-39
48,473,48,245,28,0,28
48,473,48,339,249,248,1
48,473,48,439,35,0,35
48,473,48,453,27,0,27
48,473,48,471,0,35,-35
48,473,48,477,65,91,-26
48,475,48,135,210,229,-19
48,475,48,329,87,102,-15
48,475,48,371,60,0,60
48,475,48,389,75,41,34
48,475,48,495,34,38,-4
48,477,48,15,186,110,76
48,477,48,27,0,23,-23
48,477,48,29,0,28,-28
48,477,48,39,29,0,29
48,477,48,41,178,223,-45
48,477,48,51,67,66,1
48,477,48,113,0,31,-31
48,477,48,149,49,60,-11
48,477,48,157,74,52,22
48,477,48,167,35,0,35
48,477,48,185,59,73,-14
48,477,48,201,418,332,86
48,477,48,287,0,50,-50
48,477,48,339,51,45,6
48,477,48,453,76,97,-21
48,477,48,471,0,25,-25
48,477,48,473,91,65,26
48,477,48,491,0,43,-43
48,479,4,13,49,0,49
48,479,6,37,100,71,29
48,479,6,73,113,56,57
48,479,12,86,34,0,34
48,479,17,31,101,53,48
48,479,26,97,52,0,52
48,479,26,163,75,33,42
48,479,48,27,60,0,60
48,479,48,29,852,1705,-853
48,479,48,41,0,37,-37
48,479,48,61,144,141,3
48,479,48,91,40,0,40
48,479,48,113,416,369,47
48,479,48,121,47,46,1
48,479,48,127,36,0,36
48,479,48,141,87,162,-75
48,479,48,157,32,43,-11
48,479,48,167,0,34,-34
48,479,48,187,0,36,-36
48,479,48,201,537,531,6
48,479,48,209,31,83,-52
48,479,48,215,364,449,-85
48,479,48,247,46,43,3
48,479,48,273,42,44,-2
48,479,48,283,67,42,25
48,479,48,303,35,0,35
48,479,48,323,115,104,11
48,479,48,325,0,50,-50
48,479,48,329,0,44,-44
48,479,48,339,0,42,-42
48,479,48,355,172,223,-51
48,479,48,409,0,32,-32
48,479,48,427,52,51,1
48,479,48,439,128,127,1
48,479,48,453,190,310,-120
48,479,48,465,46,43,3
48,479,48,491,42,64,-22
48,479,48,505,133,163,-30
48,481,48,15,45,62,-17
48,481,48,29,0,51,-51
48,481,48,39,94,86,8
48,481,48,41,27,43,-16
48,481,48,89,74,94,-20
48,481,48,157,416,600,-184
48,481,48,201,417,396,21
48,481,48,239,47,51,-4
48,481,48,321,156,218,-62
48,481,48,339,0,31,-31
48,481,48,453,52,26,26
48,481,48,469,89,82,7
48,483,40,9,0,26,-26
48,483,48,179,0,39,-39
48,483,48,375,31,0,31
48,483,48,381,42,43,-1
48,485,2,20,38,59,-21
48,485,2,90,43,0,43
48,485,4,13,85,200,-115
48,485,4,19,43,95,-52
48,485,5,119,0,53,-53
48,485,6,37,81,29,52
48,485,6,53,25,0,25
48,485,6,71,29,0,29
48,485,6,73,71,46,25
48,485,6,95,0,70,-70
48,485,8,5,0,28,-28
48,485,8,41,89,83,6
48,485,12,5,0,67,-67
48,485,12,57,43,44,-1
48,485,12,91,55,140,-85
48,485,13,153,0,36,-36
48,485,13,185,0,36,-36
48,485,15,3,40,43,-3
48,485,16,39,0,30,-30
48,485,20,173,0,56,-56
48,485,22,15,35,73,-38
48,485,22,17,0,37,-37
48,485,28,47,0,84,-84
48,485,31,153,0,35,-35
48,485,32,3,54,127,-73
48,485,35,1,33,91,-58
48,485,35,9,41,0,41
48,485,35,35,0,27,-27
48,485,37,51,0,66,-66
48,485,37,133,32,0,32
48,485,37,191,0,40,-40
48,485,38,101,0,53,-53
48,485,39,113,0,34,-34
48,485,40,17,0,27,-27
48,485,40,19,30,0,30
48,485,40,27,36,68,-32
48,485,40,31,177,153,24
48,485,40,33,83,55,28
48,485,40,65,32,41,-9
48,485,40,67,35,29,6
48,485,40,109,110,151,-41
48,485,40,119,0,36,-36
48,485,40,137,37,0,37
48,485,40,141,68,0,68
48,485,40,143,44,53,-9
48,485,45,85,0,38,-38
48,485,46,93,0,22,-22
48,485,48,9,385,473,-88
48,485,48,23,71,33,38
48,485,48,27,86,175,-89
48,485,48,29,170,237,-67
48,485,48,41,0,25,-25
48,485,48,77,546,409,137
48,485,48,85,85,199,-114
48,485,48,97,0,37,-37
48,485,48,113,260,476,-216
48,485,48,121,199,297,-98
48,485,48,139,31,39,-8
48,485,48,141,51,0,51
48,485,48,181,33,54,-21
48,485,48,187,0,37,-37
48,485,48,197,26,0,26
48,485,48,201,135,192,-57
48,485,48,237,45,0,45
48,485,48,251,49,69,-20
48,485,48,303,94,113,-19
48,485,48,309,37,0,37
48,485,48,329,0,60,-60
48,485,48,337,100,76,24
48,485,48,355,0,36,-36
48,485,48,363,41,0,41
48,485,48,367,27,54,-27
48,485,48,375,31,0,31
48,485,48,381,0,69,-69
48,485,48,439,458,760,-302
48,485,48,441,87,126,-39
48,485,48,451,45,41,4
48,485,48,453,56,92,-36
48,485,48,487,203,129,74
48,485,48,491,0,55,-55
48,485,48,497,42,41,1
48,485,48,503,101,79,22
48,485,49,11,0,51,-51
48,485,51,59,37,0,37
48,485,51,810,28,0,28
48,485,53,53,0,80,-80
48,485,53,63,0,51,-51
48,487,40,65,33,0,33
48,487,48,113,0,43,-43
48,487,48,121,0,27,-27
48,487,48,155,40,31,9
48,487,48,197,60,46,14
48,487,48,303,0,31,-31
48,487,48,375,24,0,24
48,487,48,439,35,63,-28
48,487,48,485,129,203,-74
48,489,48,29,32,60,-28
48,489,48,61,333,398,-65
48,489,48,201,48,76,-28
48,489,48,215,166,238,-72
48,489,48,355,44,38,6
48,489,48,453,0,31,-31
48,491,1,73,36,0,36
48,491,2,20,46,0,46
48,491,4,5,35,0,35
48,491,4,13,533,274,259
48,491,4,19,108,0,108
48,491,4,21,41,29,12
48,491,5,7,50,36,14
48,491,5,119,33,0,33
48,491,6,1,146,34,112
48,491,6,13,72,0,72
48,491,6,17,38,0,38
48,491,6,19,35,0,35
48,491,6,29,57,0,57
48,491,6,37,940,201,739
48,491,6,53,34,0,34
48,491,6,59,505,122,383
48,491,6,61,35,0,35
48,491,6,65,293,66,227
48,491,6,67,126,78,48
48,491,6,71,271,78,193
48,491,6,73,510,173,337
48,491,6,75,0,35,-35
48,491,6,77,71,0,71
48,491,6,81,55,28,27
48,491,6,83,49,0,49
48,491,6,85,311,141,170
48,491,6,97,41,0,41
48,491,6,111,168,0,168
48,491,8,5,59,28,31
48,491,8,13,49,0,49
48,491,8,31,62,30,32
48,491,8,35,53,49,4
48,491,8,41,204,115,89
48,491,8,59,69,0,69
48,491,8,69,60,0,60
48,491,12,9,27,0,27
48,491,12,11,171,68,103
48,491,12,21,38,0,38
48,491,12,31,69,0,69
48,491,12,33,40,0,40
48,491,12,57,85,65,20
48,491,12,69,0,32,-32
48,491,12,71,38,0,38
48,491,12,86,144,41,103
48,491,12,95,106,37,69
48,491,12,97,39,0,39
48,491,12,99,106,0,106
48,491,12,103,63,46,17
48,491,12,105,34,0,34
48,491,12,117,62,0,62
48,491,13,67,37,43,-6
48,491,13,89,34,0,34
48,491,13,121,50,37,13
48,491,15,3,145,58,87
48,491,16,1,31,30,1
48,491,17,31,196,96,100
48,491,17,43,86,37,49
48,491,17,97,95,0,95
48,491,18,97,53,0,53
48,491,19,153,35,0,35
48,491,20,91,71,41,30
48,491,20,173,35,0,35
48,491,21,111,31,0,31
48,491,22,19,39,39,0
48,491,22,33,77,0,77
48,491,22,51,75,0,75
48,491,22,71,0,41,-41
48,491,22,73,30,0,30
48,491,22,103,32,0,32
48,491,24,21,33,0,33
48,491,24,31,55,0,55
48,491,24,33,39,0,39
48,491,25,17,78,43,35
48,491,25,21,42,0,42
48,491,25,27,35,0,35
48,491,26,49,38,0,38
48,491,26,77,31,0,31
48,491,26,99,54,0,54
48,491,26,125,89,0,89
48,491,26,161,33,0,33
48,491,26,163,51,0,51
48,491,27,53,79,60,19
48,491,27,123,24,0,24
48,491,29,77,30,0,30
48,491,29,95,56,32,24
48,491,29,183,40,0,40
48,491,29,189,56,30,26
48,491,31,55,43,0,43
48,491,31,153,30,0,30
48,491,32,3,347,123,224
48,491,32,31,72,30,42
48,491,34,23,31,0,31
48,491,34,27,34,0,34
48,491,35,1,159,44,115
48,491,35,13,38,0,38
48,491,35,43,44,0,44
48,491,35,49,30,0,30
48,491,36,47,33,32,1
48,491,36,55,36,0,36
48,491,36,59,26,0,26
48,491,36,61,0,25,-25
48,491,36,81,66,0,66
48,491,36,103,63,0,63
48,491,37,51,40,0,40
48,491,37,119,57,29,28
48,491,37,133,35,31,4
48,491,37,183,41,68,-27
48,491,39,35,27,0,27
48,491,39,49,62,0,62
48,491,40,27,46,33,13
48,491,40,109,83,69,14
48,491,40,143,99,58,41
48,491,41,5,28,0,28
48,491,41,51,40,32,8
48,491,41,67,88,0,88
48,491,47,37,46,50,-4
48,491,47,149,36,0,36
48,491,47,157,68,0,68
48,491,47,187,48,0,48
48,491,48,1,33,0,33
48,491,48,5,55,30,25
48,491,48,7,0,31,-31
48,491,48,15,28,0,28
48,491,48,19,30,0,30
48,491,48,21,588,490,98
48,491,48,27,1376,978,398
48,491,48,29,1183,936,247
48,491,48,31,26,0,26
48,491,48,39,156,91,65
48,491,48,41,334,238,96
48,491,48,49,70,35,35
48,491,48,51,0,30,-30
48,491,48,53,440,446,-6
48,491,48,55,121,125,-4
48,491,48,61,191,80,111
48,491,48,73,36,0,36
48,491,48,85,470,378,92
48,491,48,91,135,149,-14
48,491,48,99,201,110,91
48,491,48,113,791,567,224
48,491,48,121,403,314,89
48,491,48,135,81,52,29
48,491,48,139,43,33,10
48,491,48,141,326,117,209
48,491,48,143,40,28,12
48,491,48,149,49,51,-2
48,491,48,157,262,211,51
48,491,48,167,162,93,69
48,491,48,171,30,34,-4
48,491,48,181,48,0,48
48,491,48,183,50,0,50
48,491,48,187,102,133,-31
48,491,48,199,0,48,-48
48,491,48,201,1461,1263,198
48,491,48,209,687,700,-13
48,491,48,215,272,126,146
48,491,48,231,51,0,51
48,491,48,245,201,35,166
48,491,48,251,59,55,4
48,491,48,257,48,41,7
48,491,48,259,37,35,2
48,491,48,265,61,59,2
48,491,48,273,24,0,24
48,491,48,281,65,116,-51
48,491,48,287,85,88,-3
48,491,48,293,38,0,38
48,491,48,299,83,111,-28
48,491,48,303,228,173,55
48,491,48,309,380,243,137
48,491,48,323,52,0,52
48,491,48,329,120,81,39
48,491,48,331,298,267,31
48,491,48,339,224,209,15
48,491,48,347,47,0,47
48,491,48,349,30,0,30
48,491,48,355,338,228,110
48,491,48,361,61,0,61
48,491,48,367,35,0,35
48,491,48,373,38,0,38
48,491,48,375,29,0,29
48,491,48,381,69,0,69
48,491,48,397,37,55,-18
48,491,48,409,32,43,-11
48,491,48,423,118,77,41
48,491,48,439,721,578,143
48,491,48,441,130,82,48
48,491,48,451,175,93,82
48,491,48,453,22630,15285,7345
48,491,48,463,45,0,45
48,491,48,465,37,0,37
48,491,48,469,133,78,55
48,491,48,471,57,28,29
48,491,48,477,43,0,43
48,491,48,479,64,42,22
48,491,48,485,55,0,55
48,491,49,35,92,0,92
48,491,49,49,82,59,23
48,491,51,59,75,67,8
48,491,51,153,57,0,57
48,491,51,710,52,0,52
48,491,51,810,38,0,38
48,491,53,11,37,0,37
48,491,53,33,153,145,8
48,491,53,53,65,31,34
48,491,53,61,55,30,25
48,491,53,63,37,0,37
48,491,55,25,34,0,34
48,491,55,79,39,0,39
48,493,48,13,83,66,17
48,493,48,27,31,0,31
48,493,48,29,1954,1436,518
48,493,48,41,28,0,28
48,493,48,91,113,70,43
48,493,48,113,28,0,28
48,493,48,177,41,0,41
48,493,48,187,260,199,61
48,493,48,201,47,49,-2
48,493,48,209,27,26,1
48,493,48,255,95,61,34
48,493,48,325,0,27,-27
48,493,48,355,37,37,0
48,493,48,439,34,0,34
48,493,48,453,50,27,23
48,495,48,135,156,147,9
48,495,48,329,44,55,-11
48,495,48,475,38,34,4
48,497,4,13,37,0,37
48,497,48,85,51,52,-1
48,497,48,97,42,49,-7
48,497,48,113,188,153,35
48,497,48,121,478,594,-116
48,497,48,181,45,35,10
48,497,48,201,42,34,8
48,497,48,221,37,67,-30
48,497,48,237,70,57,13
48,497,48,251,60,106,-46
48,497,48,303,34,0,34
48,497,48,337,170,246,-76
48,497,48,363,35,46,-11
48,497,48,367,411,448,-37
48,497,48,439,1798,1479,319
48,497,48,441,43,0,43
48,497,48,485,41,42,-1
48,499,48,29,26,0,26
48,499,48,63,0,58,-58
48,499,48,73,43,0,43
48,499,48,85,105,91,14
48,499,48,113,340,216,124
48,499,48,121,78,68,10
48,499,48,159,92,84,8
48,499,48,183,103,152,-49
48,499,48,201,62,51,11
48,499,48,213,30,41,-11
48,499,48,223,163,218,-55
48,499,48,231,128,58,70
48,499,48,257,51,41,10
48,499,48,379,107,104,3
48,499,48,397,35,39,-4
48,499,48,423,432,524,-92
48,499,48,439,196,97,99
48,499,48,453,0,22,-22
48,499,48,459,169,134,35
48,499,48,467,201,170,31
48,501,35,25,56,51,5
48,501,48,165,60,61,-1
48,501,48,219,39,0,39
48,501,48,303,43,58,-15
48,501,48,329,0,76,-76
48,503,48,9,0,45,-45
48,503,48,113,34,26,8
48,503,48,121,66,48,18
48,503,48,237,81,89,-8
48,503,48,251,0,59,-59
48,503,48,363,53,48,5
48,503,48,367,31,55,-24
48,503,48,429,41,49,-8
48,503,48,439,80,94,-14
48,503,48,441,30,27,3
48,503,48,485,79,101,-22
48,505,48,201,31,33,-2
48,505,48,215,38,36,2
48,505,48,427,60,60,0
48,505,48,479,163,133,30
48,507,48,29,43,94,-51
48,507,48,127,87,105,-18
48,507,48,453,33,38,-5
48,507,48,463,78,83,-5
49,1,32,3,47,0,47
49,1,49,21,77,111,-34
49,1,49,35,31,0,31
49,1,49,49,37,0,37
49,1,49,53,54,50,4
49,3,4,13,44,38,6
49,3,16,5,44,0,44
49,3,16,71,57,44,13
49,3,32,3,75,32,43
49,3,49,5,621,682,-61
49,3,49,11,450,292,158
49,3,49,35,341,296,45
49,3,49,45,46,0,46
49,3,49,49,176,195,-19
49,3,49,53,45,53,-8
49,3,49,57,1152,768,384
49,5,4,13,182,158,24
49,5,4,15,47,0,47
49,5,4,19,0,35,-35
49,5,6,1,31,0,31
49,5,6,19,41,0,41
49,5,6,29,0,50,-50
49,5,6,37,212,61,151
49,5,6,59,69,0,69
49,5,6,65,75,0,75
49,5,6,67,41,0,41
49,5,6,71,69,0,69
49,5,6,73,56,81,-25
49,5,6,85,0,26,-26
49,5,16,1,94,97,-3
49,5,16,5,64,87,-23
49,5,16,7,38,43,-5
49,5,16,11,44,47,-3
49,5,16,19,111,134,-23
49,5,16,27,49,58,-9
49,5,16,31,33,0,33
49,5,16,41,245,298,-53
49,5,16,51,0,48,-48
49,5,16,65,95,64,31
49,5,16,71,39,0,39
49,5,16,83,44,70,-26
49,5,30,63,32,0,32
49,5,32,3,217,133,84
49,5,39,49,0,27,-27
49,5,41,67,0,29,-29
49,5,48,201,0,61,-61
49,5,48,215,37,0,37
49,5,49,3,682,621,61
49,5,49,7,65,33,32
49,5,49,11,622,704,-82
49,5,49,13,40,0,40
49,5,49,21,77,60,17
49,5,49,33,53,0,53
49,5,49,35,1200,1235,-35
49,5,49,39,71,38,33
49,5,49,41,0,43,-43
49,5,49,43,42,0,42
49,5,49,45,75,93,-18
49,5,49,47,72,85,-13
49,5,49,49,702,656,46
49,5,49,51,46,0,46
49,5,49,53,214,216,-2
49,5,49,57,472,537,-65
49,5,53,33,58,35,23
49,5,53,61,51,0,51
49,5,53,63,36,48,-12
49,5,56,23,53,54,-1
49,5,56,37,38,0,38
49,5,56,41,29,0,29
49,7,8,77,31,49,-18
49,7,32,3,58,0,58
49,7,49,5,33,65,-32
49,7,49,11,52,63,-11
49,7,49,15,150,186,-36
49,7,49,35,218,334,-116
49,7,49,47,41,60,-19
49,7,49,49,132,181,-49
49,7,49,53,73,54,19
49,7,49,57,0,29,-29
49,7,56,37,42,118,-76
49,11,2,20,93,83,10
49,11,2,90,62,38,24
49,11,4,5,49,0,49
49,11,4,13,627,512,115
49,11,4,15,48,0,48
49,11,4,19,79,115,-36
49,11,6,1,47,37,10
49,11,6,13,49,37,12
49,11,6,19,30,0,30
49,11,6,29,86,0,86
49,11,6,37,624,188,436
49,11,6,53,40,32,8
49,11,6,59,180,90,90
49,11,6,65,147,87,60
49,11,6,67,59,91,-32
49,11,6,71,166,78,88
49,11,6,73,178,140,38
49,11,6,77,0,55,-55
49,11,6,79,27,0,27
49,11,6,83,29,0,29
49,11,6,85,62,43,19
49,11,6,111,67,0,67
49,11,8,1,41,42,-1
49,11,8,5,101,59,42
49,11,8,31,40,0,40
49,11,8,35,64,57,7
49,11,8,41,110,104,6
49,11,8,59,0,31,-31
49,11,8,69,54,36,18
49,11,12,91,92,31,61
49,11,12,95,60,0,60
49,11,15,3,162,103,59
49,11,16,1,180,149,31
49,11,16,5,104,104,0
49,11,16,11,37,0,37
49,11,16,19,112,122,-10
49,11,16,27,53,0,53
49,11,16,39,39,43,-4
49,11,16,41,0,44,-44
49,11,16,65,69,74,-5
49,11,16,67,33,0,33
49,11,16,83,65,52,13
49,11,17,31,42,41,1
49,11,25,17,38,0,38
49,11,30,13,40,38,2
49,11,32,3,415,332,83
49,11,32,7,40,46,-6
49,11,32,31,48,0,48
49,11,35,1,49,36,13
49,11,35,9,129,0,129
49,11,35,45,33,0,33
49,11,36,61,0,28,-28
49,11,37,51,45,0,45
49,11,39,49,0,35,-35
49,11,39,57,0,65,-65
49,11,39,113,0,42,-42
49,11,40,109,28,0,28
49,11,41,39,28,0,28
49,11,41,51,25,53,-28
49,11,41,67,65,41,24
49,11,48,27,0,39,-39
49,11,48,29,68,146,-78
49,11,48,113,0,35,-35
49,11,48,201,69,33,36
49,11,48,439,47,71,-24
49,11,48,453,0,38,-38
49,11,48,485,51,0,51
49,11,49,3,292,450,-158
49,11,49,5,704,622,82
49,11,49,7,63,52,11
49,11,49,13,32,53,-21
49,11,49,21,105,60,45
49,11,49,27,30,0,30
49,11,49,29,184,279,-95
49,11,49,35,8482,5518,2964
49,11,49,37,0,29,-29
49,11,49,39,43,36,7
49,11,49,41,0,53,-53
49,11,49,43,87,94,-7
49,11,49,45,257,292,-35
49,11,49,47,59,76,-17
49,11,49,49,1283,1216,67
49,11,49,51,0,81,-81
49,11,49,53,399,369,30
49,11,49,57,6042,7573,-1531
49,11,51,59,47,49,-2
49,11,53,11,55,71,-16
49,11,53,33,124,114,10
49,11,53,53,169,64,105
49,11,53,61,69,0,69
49,11,53,63,57,66,-9
49,11,56,21,46,45,1
49,11,56,23,37,0,37
49,11,56,37,0,67,-67
49,11,56,41,42,74,-32
49,13,4,13,39,0,39
49,13,32,3,41,0,41
49,13,49,5,0,40,-40
49,13,49,11,53,32,21
49,13,49,35,249,187,62
49,13,49,45,71,0,71
49,13,49,47,267,286,-19
49,13,49,49,181,128,53
49,13,49,51,53,0,53
49,13,49,53,0,34,-34
49,13,49,57,57,0,57
49,15,49,7,186,150,36
49,15,49,35,99,93,6
49,15,49,49,79,111,-32
49,15,56,37,0,101,-101
49,17,32,3,46,0,46
49,17,49,21,61,67,-6
49,17,49,35,28,0,28
49,17,49,53,83,43,40
49,19,8,77,67,86,-19
49,19,49,35,120,85,35
49,19,49,37,50,63,-13
49,19,49,49,37,0,37
49,19,49,53,37,0,37
49,21,4,5,28,37,-9
49,21,4,13,80,57,23
49,21,4,15,31,0,31
49,21,4,25,0,38,-38
49,21,6,37,127,40,87
49,21,6,59,57,0,57
49,21,6,65,65,0,65
49,21,6,71,86,0,86
49,21,6,73,113,48,65
49,21,32,3,550,312,238
49,21,49,1,111,77,34
49,21,49,5,60,77,-17
49,21,49,11,60,105,-45
49,21,49,17,67,61,6
49,21,49,25,31,38,-7
49,21,49,27,61,98,-37
49,21,49,35,406,418,-12
49,21,49,39,68,53,15
49,21,49,41,80,90,-10
49,21,49,45,28,48,-20
49,21,49,47,0,42,-42
49,21,49,49,244,422,-178
49,21,49,53,677,798,-121
49,21,49,57,50,46,4
49,23,49,35,88,85,3
49,23,49,39,42,46,-4
49,23,49,49,575,275,300
49,23,49,53,0,46,-46
49,25,4,5,77,87,-10
49,25,32,3,66,33,33
49,25,49,21,38,31,7
49,25,49,35,39,0,39
49,25,49,53,63,97,-34
49,27,49,11,0,30,-30
49,27,49,21,98,61,37
49,27,49,35,109,118,-9
49,27,49,49,158,167,-9
49,27,49,53,61,98,-37
49,29,49,11,279,184,95
49,29,49,35,74,88,-14
49,29,49,43,60,0,60
49,29,49,57,246,216,30
49,33,49,5,0,53,-53
49,35,1,89,31,0,31
49,35,2,20,127,130,-3
49,35,2,90,52,0,52
49,35,4,1,58,57,1
49,35,4,3,49,34,15
49,35,4,5,142,92,50
49,35,4,13,1960,1498,462
49,35,4,15,115,128,-13
49,35,4,17,53,33,20
49,35,4,19,262,237,25
49,35,4,21,92,136,-44
49,35,4,25,58,48,10
49,35,4,27,71,45,26
49,35,5,7,0,53,-53
49,35,6,1,209,196,13
49,35,6,7,57,59,-2
49,35,6,13,169,187,-18
49,35,6,17,44,35,9
49,35,6,19,141,87,54
49,35,6,25,40,0,40
49,35,6,29,155,72,83
49,35,6,37,2421,933,1488
49,35,6,41,38,0,38
49,35,6,53,148,50,98
49,35,6,57,31,0,31
49,35,6,59,1134,427,707
49,35,6,61,80,58,22
49,35,6,65,688,245,443
49,35,6,67,283,184,99
49,35,6,71,745,223,522
49,35,6,73,884,680,204
49,35,6,75,117,173,-56
49,35,6,77,129,51,78
49,35,6,79,29,41,-12
49,35,6,81,120,135,-15
49,35,6,83,128,52,76
49,35,6,85,382,221,161
49,35,6,87,0,31,-31
49,35,6,89,21,26,-5
49,35,6,95,93,75,18
49,35,6,97,83,29,54
49,35,6,99,149,0,149
49,35,6,107,100,0,100
49,35,6,111,218,110,108
49,35,6,113,29,36,-7
49,35,8,1,139,100,39
49,35,8,5,290,197,93
49,35,8,13,118,96,22
49,35,8,14,29,0,29
49,35,8,31,223,164,59
49,35,8,35,121,146,-25
49,35,8,41,276,144,132
49,35,8,45,37,0,37
49,35,8,59,129,187,-58
49,35,8,67,46,38,8
49,35,8,69,76,96,-20
49,35,8,77,109,159,-50
49,35,8,83,0,40,-40
49,35,8,123,76,68,8
49,35,9,1,58,36,22
49,35,9,3,48,0,48
49,35,9,9,52,41,11
49,35,11,1,44,66,-22
49,35,12,1,37,58,-21
49,35,12,9,48,63,-15
49,35,12,11,128,59,69
49,35,12,31,31,57,-26
49,35,12,57,69,82,-13
49,35,12,69,0,33,-33
49,35,12,71,71,41,30
49,35,12,73,26,0,26
49,35,12,81,46,0,46
49,35,12,86,116,106,10
49,35,12,95,169,81,88
49,35,12,99,35,58,-23
49,35,12,103,67,51,16
49,35,12,105,37,0,37
49,35,12,117,40,37,3
49,35,12,127,37,0,37
49,35,13,51,28,0,28
49,35,13,67,79,34,45
49,35,13,89,49,28,21
49,35,13,121,57,57,0
49,35,13,135,77,66,11
49,35,15,1,60,55,5
49,35,15,3,347,317,30
49,35,15,7,35,0,35
49,35,15,9,38,65,-27
49,35,16,1,636,496,140
49,35,16,5,221,206,15
49,35,16,11,86,89,-3
49,35,16,13,44,28,16
49,35,16,19,287,305,-18
49,35,16,27,179,147,32
49,35,16,29,30,0,30
49,35,16,31,26,41,-15
49,35,16,41,72,41,31
49,35,16,43,42,0,42
49,35,16,51,54,78,-24
49,35,16,55,46,70,-24
49,35,16,57,36,41,-5
49,35,16,65,276,187,89
49,35,16,67,35,31,4
49,35,16,71,0,38,-38
49,35,16,81,0,31,-31
49,35,16,83,135,117,18
49,35,17,31,296,257,39
49,35,17,43,77,99,-22
49,35,17,89,40,0,40
49,35,17,97,35,40,-5
49,35,17,197,36,0,36
49,35,18,97,47,58,-11
49,35,18,105,0,40,-40
49,35,18,141,0,35,-35
49,35,19,153,54,78,-24
49,35,19,163,0,33,-33
49,35,20,91,72,62,10
49,35,20,173,53,0,53
49,35,21,67,0,34,-34
49,35,21,111,54,65,-11
49,35,22,33,34,0,34
49,35,22,51,29,0,29
49,35,22,71,0,40,-40
49,35,23,5,28,0,28
49,35,24,3,52,0,52
49,35,24,5,62,0,62
49,35,24,31,97,79,18
49,35,24,510,0,27,-27
49,35,25,9,41,27,14
49,35,25,13,33,0,33
49,35,25,17,115,118,-3
49,35,25,21,34,0,34
49,35,25,25,49,69,-20
49,35,25,27,52,0,52
49,35,26,65,33,41,-8
49,35,26,77,24,0,24
49,35,26,81,48,37,11
49,35,26,125,83,62,21
49,35,26,161,39,95,-56
49,35,26,163,76,41,35
49,35,27,37,48,55,-7
49,35,27,53,171,116,55
49,35,27,123,31,50,-19
49,35,29,47,0,38,-38
49,35,29,95,59,50,9
49,35,29,183,39,0,39
49,35,29,189,117,60,57
49,35,30,13,33,63,-30
49,35,30,29,22,45,-23
49,35,30,31,86,99,-13
49,35,30,49,0,31,-31
49,35,30,63,91,74,17
49,35,30,81,0,48,-48
49,35,30,111,84,57,27
49,35,31,55,133,103,30
49,35,31,109,41,0,41
49,35,32,3,1769,1324,445
49,35,32,7,205,151,54
49,35,32,13,58,0,58
49,35,32,31,307,161,146
49,35,33,11,35,52,-17
49,35,33,15,21,0,21
49,35,34,3,24,30,-6
49,35,34,29,31,0,31
49,35,35,1,223,188,35
49,35,35,13,48,0,48
49,35,35,31,40,0,40
49,35,35,43,26,0,26
49,35,35,45,90,113,-23
49,35,35,49,0,38,-38
49,35,36,5,0,33,-33
49,35,36,45,0,33,-33
49,35,36,47,36,73,-37
49,35,36,55,37,47,-10
49,35,36,61,108,189,-81
49,35,36,81,57,53,4
49,35,36,103,63,43,20
49,35,36,119,26,0,26
49,35,37,51,30,34,-4
49,35,37,63,0,40,-40
49,35,37,67,58,0,58
49,35,37,119,73,54,19
49,35,37,133,0,30,-30
49,35,37,135,39,0,39
49,35,37,183,56,122,-66
49,35,39,7,37,0,37
49,35,39,35,47,82,-35
49,35,39,49,108,122,-14
49,35,39,61,62,40,22
49,35,39,113,40,0,40
49,35,39,155,93,0,93
49,35,40,109,42,54,-12
49,35,40,143,61,69,-8
49,35,41,3,38,0,38
49,35,41,5,108,102,6
49,35,41,11,0,29,-29
49,35,41,17,60,63,-3
49,35,41,29,56,70,-14
49,35,41,39,107,101,6
49,35,41,41,0,24,-24
49,35,41,47,94,92,2
49,35,41,51,175,304,-129
49,35,41,59,32,36,-4
49,35,41,67,202,246,-44
49,35,42,3,78,88,-10
49,35,42,29,37,0,37
49,35,42,41,0,32,-32
49,35,42,45,30,0,30
49,35,42,91,36,41,-5
49,35,42,101,36,54,-18
49,35,46,99,28,0,28
49,35,46,103,0,29,-29
49,35,47,37,61,59,2
49,35,47,125,43,0,43
49,35,47,157,65,49,16
49,35,48,27,45,45,0
49,35,48,29,149,197,-48
49,35,48,85,108,115,-7
49,35,48,113,176,175,1
49,35,48,121,110,124,-14
49,35,48,141,123,66,57
49,35,48,157,33,52,-19
49,35,48,201,283,375,-92
49,35,48,339,39,73,-34
49,35,48,439,215,164,51
49,35,48,453,91,174,-83
49,35,48,491,0,92,-92
49,35,49,1,0,31,-31
49,35,49,3,296,341,-45
49,35,49,5,1235,1200,35
49,35,49,7,334,218,116
49,35,49,11,5518,8482,-2964
49,35,49,13,187,249,-62
49,35,49,15,93,99,-6
49,35,49,17,0,28,-28
49,35,49,19,85,120,-35
49,35,49,21,418,406,12
49,35,49,23,85,88,-3
49,35,49,25,0,39,-39
49,35,49,27,118,109,9
49,35,49,29,88,74,14
49,35,49,37,80,100,-20
49,35,49,39,241,410,-169
49,35,49,41,202,167,35
49,35,49,43,934,791,143
49,35,49,45,1478,3069,-1591
49,35,49,47,207,339,-132
49,35,49,49,7675,9575,-1900
49,35,49,51,390,387,3
49,35,49,53,1382,1531,-149
49,35,49,55,0,35,-35
49,35,49,57,1684,2016,-332
49,35,50,7,54,30,24
49,35,51,13,55,86,-31
49,35,51,59,155,151,4
49,35,51,87,38,53,-15
49,35,51,107,41,60,-19
49,35,51,153,68,41,27
49,35,51,510,35,37,-2
49,35,51,810,37,30,7
49,35,53,5,63,32,31
49,35,53,11,155,124,31
49,35,53,21,40,0,40
49,35,53,33,620,633,-13
49,35,53,35,67,44,23
49,35,53,53,235,216,19
49,35,53,57,0,32,-32
49,35,53,61,136,137,-1
49,35,53,63,172,149,23
49,35,53,67,49,57,-8
49,35,53,73,37,72,-35
49,35,53,77,46,37,9
49,35,55,25,55,81,-26
49,35,55,79,60,40,20
49,35,55,133,33,0,33
49,35,56,1,37,35,2
49,35,56,5,32,47,-15
49,35,56,7,32,0,32
49,35,56,13,29,40,-11
49,35,56,21,56,45,11
49,35,56,23,41,97,-56
49,35,56,25,46,44,2
49,35,56,35,32,44,-12
49,35,56,37,158,131,27
49,35,56,39,69,47,22
49,35,56,41,154,174,-20
49,37,4,1,0,98,-98
49,37,4,13,35,47,-12
49,37,4,17,59,36,23
49,37,8,83,45,50,-5
49,37,35,45,304,269,35
49,37,49,11,29,0,29
49,37,49,19,63,50,13
49,37,49,35,100,80,20
49,37,49,49,78,42,36
49,39,4,13,36,0,36
49,39,32,3,74,0,74
49,39,49,5,38,71,-33
49,39,49,11,36,43,-7
49,39,49,21,53,68,-15
49,39,49,23,46,42,4
49,39,49,35,410,241,169
49,39,49,41,121,105,16
49,39,49,49,480,499,-19
49,39,49,53,104,79,25
49,39,49,57,0,33,-33
49,41,32,3,109,30,79
49,41,49,5,43,0,43
49,41,49,11,53,0,53
49,41,49,21,90,80,10
49,41,49,35,167,202,-35
49,41,49,39,105,121,-16
49,41,49,49,161,207,-46
49,41,49,53,130,112,18
49,43,4,13,56,26,30
49,43,6,37,96,63,33
49,43,6,59,55,30,25
49,43,6,65,32,0,32
49,43,6,73,53,38,15
49,43,8,31,0,22,-22
49,43,17,31,28,0,28
49,43,32,3,108,48,60
49,43,49,5,0,42,-42
49,43,49,11,94,87,7
49,43,49,29,0,60,-60
49,43,49,35,791,934,-143
49,43,49,49,112,114,-2
49,43,49,51,383,555,-172
49,43,49,53,0,53,-53
49,43,49,57,34,61,-27
49,43,53,33,30,35,-5
49,45,4,13,74,47,27
49,45,6,37,50,0,50
49,45,6,59,43,0,43
49,45,6,71,48,0,48
49,45,6,73,40,0,40
49,45,32,3,55,88,-33
49,45,32,7,172,186,-14
49,45,49,3,0,46,-46
49,45,49,5,93,75,18
49,45,49,11,292,257,35
49,45,49,13,0,71,-71
49,45,49,21,48,28,20
49,45,49,35,3069,1478,1591
49,45,49,47,0,56,-56
49,45,49,49,260,311,-51
49,45,49,53,88,94,-6
49,45,49,57,103,87,16
49,47,4,13,32,0,32
49,47,8,77,51,131,-80
49,47,8,103,0,28,-28
49,47,32,3,64,43,21
49,47,49,5,85,72,13
49,47,49,7,60,41,19
49,47,49,11,76,59,17
49,47,49,13,286,267,19
49,47,49,21,42,0,42
49,47,49,35,339,207,132
49,47,49,45,56,0,56
49,47,49,49,202,128,74
49,47,49,53,0,61,-61
49,47,49,57,67,65,2
49,47,56,37,76,43,33
49,49,2,20,79,54,25
49,49,4,3,35,40,-5
49,49,4,5,77,86,-9
49,49,4,13,1283,1214,69
49,49,4,15,39,0,39
49,49,4,17,73,36,37
49,49,4,19,193,167,26
49,49,4,21,59,138,-79
49,49,4,25,53,0,53
49,49,5,7,0,49,-49
49,49,6,1,169,148,21
49,49,6,7,50,0,50
49,49,6,13,135,127,8
49,49,6,17,26,0,26
49,49,6,19,121,48,73
49,49,6,29,125,98,27
49,49,6,37,1206,461,745
49,49,6,53,106,82,24
49,49,6,59,519,300,219
49,49,6,61,99,51,48
49,49,6,65,438,205,233
49,49,6,67,213,133,80
49,49,6,71,333,156,177
49,49,6,73,383,285,98
49,49,6,75,0,69,-69
49,49,6,77,48,0,48
49,49,6,79,32,0,32
49,49,6,81,60,61,-1
49,49,6,83,56,0,56
49,49,6,85,223,181,42
49,49,6,89,33,0,33
49,49,6,95,56,38,18
49,49,6,97,42,0,42
49,49,6,99,71,32,39
49,49,6,107,57,30,27
49,49,6,111,174,78,96
49,49,8,1,48,28,20
49,49,8,5,98,111,-13
49,49,8,13,34,29,5
49,49,8,14,33,0,33
49,49,8,31,40,59,-19
49,49,8,35,145,105,40
49,49,8,41,201,105,96
49,49,8,45,45,0,45
49,49,8,59,89,56,33
49,49,8,69,57,53,4
49,49,8,77,76,86,-10
49,49,8,123,64,0,64
49,49,9,1,26,0,26
49,49,9,9,0,43,-43
49,49,11,1,0,31,-31
49,49,12,11,0,38,-38
49,49,12,71,50,0,50
49,49,12,86,52,0,52
49,49,12,95,38,42,-4
49,49,13,67,43,39,4
49,49,13,121,0,35,-35
49,49,13,135,40,0,40
49,49,15,1,0,40,-40
49,49,15,3,293,161,132
49,49,16,1,527,344,183
49,49,16,5,106,158,-52
49,49,16,11,35,43,-8
49,49,16,19,219,242,-23
49,49,16,27,120,132,-12
49,49,16,31,56,0,56
49,49,16,41,0,95,-95
49,49,16,51,44,85,-41
49,49,16,65,364,195,169
49,49,16,83,64,64,0
49,49,17,31,81,106,-25
49,49,17,43,35,47,-12
49,49,18,105,0,40,-40
49,49,19,103,0,37,-37
49,49,19,153,0,34,-34
49,49,20,91,41,0,41
49,49,20,173,32,49,-17
49,49,24,31,51,63,-12
49,49,25,17,58,136,-78
49,49,26,161,0,54,-54
49,49,27,53,37,72,-35
49,49,29,1,0,53,-53
49,49,29,95,40,34,6
49,49,29,183,34,0,34
49,49,29,189,49,59,-10
49,49,30,29,0,28,-28
49,49,31,55,59,55,4
49,49,32,3,984,758,226
49,49,32,7,63,54,9
49,49,32,31,140,42,98
49,49,34,31,40,0,40
49,49,35,1,75,67,8
49,49,35,13,29,0,29
49,49,35,45,59,35,24
49,49,36,29,0,49,-49
49,49,36,47,0,41,-41
49,49,36,61,36,108,-72
49,49,36,81,0,38,-38
49,49,37,63,0,41,-41
49,49,37,119,0,36,-36
49,49,37,183,32,81,-49
49,49,39,35,0,85,-85
49,49,39,49,46,130,-84
49,49,40,109,31,53,-22
49,49,40,143,33,0,33
49,49,41,5,77,69,8
49,49,41,29,35,44,-9
49,49,41,39,68,83,-15
49,49,41,47,47,56,-9
49,49,41,51,67,83,-16
49,49,41,67,167,159,8
49,49,42,3,0,42,-42
49,49,42,91,34,0,34
49,49,47,93,39,0,39
49,49,47,157,51,56,-5
49,49,48,29,103,128,-25
49,49,48,39,0,39,-39
49,49,48,85,121,124,-3
49,49,48,113,73,87,-14
49,49,48,121,0,88,-88
49,49,48,141,60,44,16
49,49,48,157,0,48,-48
49,49,48,201,127,288,-161
49,49,48,303,0,39,-39
49,49,48,339,45,84,-39
49,49,48,439,113,139,-26
49,49,48,453,56,112,-56
49,49,48,491,59,82,-23
49,49,49,1,0,37,-37
49,49,49,3,195,176,19
49,49,49,5,656,702,-46
49,49,49,7,181,132,49
49,49,49,11,1216,1283,-67
49,49,49,13,128,181,-53
49,49,49,15,111,79,32
49,49,49,19,0,37,-37
49,49,49,21,422,244,178
49,49,49,23,275,575,-300
49,49,49,27,167,158,9
49,49,49,35,9575,7675,1900
49,49,49,37,42,78,-36
49,49,49,39,499,480,19
49,49,49,41,207,161,46
49,49,49,43,114,112,2
49,49,49,45,311,260,51
49,49,49,47,128,202,-74
49,49,49,51,349,264,85
49,49,49,53,996,939,57
49,49,49,57,419,591,-172
49,49,51,13,0,72,-72
49,49,51,59,147,121,26
49,49,51,107,54,49,5
49,49,51,153,91,54,37
49,49,51,510,0,40,-40
49,49,53,5,76,113,-37
49,49,53,11,115,97,18
49,49,53,25,33,0,33
49,49,53,33,305,385,-80
49,49,53,35,50,35,15
49,49,53,53,115,104,11
49,49,53,61,99,111,-12
49,49,53,63,107,113,-6
49,49,53,67,38,31,7
49,49,53,73,28,0,28
49,49,53,77,49,0,49
49,49,55,25,0,54,-54
49,49,55,79,0,44,-44
49,49,56,23,25,66,-41
49,49,56,25,33,0,33
49,49,56,37,57,84,-27
49,49,56,41,61,61,0
49,51,4,13,62,35,27
49,51,6,37,65,0,65
49,51,6,59,31,0,31
49,51,6,71,35,0,35
49,51,32,3,36,0,36
49,51,49,5,0,46,-46
49,51,49,11,81,0,81
49,51,49,13,0,53,-53
49,51,49,35,387,390,-3
49,51,49,43,555,383,172
49,51,49,49,264,349,-85
49,51,49,53,32,41,-9
49,51,49,57,38,31,7
49,53,4,5,92,114,-22
49,53,4,13,294,237,57
49,53,4,15,246,304,-58
49,53,4,17,35,54,-19
49,53,4,19,61,38,23
49,53,4,21,0,33,-33
49,53,4,25,0,32,-32
49,53,6,29,47,0,47
49,53,6,37,378,139,239
49,53,6,59,178,83,95
49,53,6,65,181,88,93
49,53,6,71,198,82,116
49,53,6,73,168,62,106
49,53,6,79,25,30,-5
49,53,6,95,39,0,39
49,53,6,111,42,26,16
49,53,8,5,35,0,35
49,53,8,41,0,38,-38
49,53,8,59,27,0,27
49,53,8,77,33,49,-16
49,53,15,3,62,70,-8
49,53,16,1,74,65,9
49,53,16,5,31,51,-20
49,53,16,19,37,80,-43
49,53,16,65,43,0,43
49,53,30,13,0,39,-39
49,53,32,3,1129,977,152
49,53,32,17,0,39,-39
49,53,32,31,0,36,-36
49,53,41,67,29,0,29
49,53,49,1,50,54,-4
49,53,49,3,53,45,8
49,53,49,5,216,214,2
49,53,49,7,54,73,-19
49,53,49,11,369,399,-30
49,53,49,13,34,0,34
49,53,49,17,43,83,-40
49,53,49,19,0,37,-37
49,53,49,21,798,677,121
49,53,49,23,46,0,46
49,53,49,25,97,63,34
49,53,49,27,98,61,37
49,53,49,35,1531,1382,149
49,53,49,39,79,104,-25
49,53,49,41,112,130,-18
49,53,49,43,53,0,53
49,53,49,45,94,88,6
49,53,49,47,61,0,61
49,53,49,49,939,996,-57
49,53,49,51,41,32,9
49,53,49,57,243,245,-2
49,53,53,11,38,0,38
49,53,53,33,46,48,-2
49,53,53,61,63,0,63
49,53,56,41,32,0,32
49,55,49,35,35,0,35
49,57,4,13,399,205,194
49,57,4,15,40,0,40
49,57,4,19,60,76,-16
49,57,6,1,31,0,31
49,57,6,19,33,0,33
49,57,6,29,64,0,64
49,57,6,37,403,135,268
49,57,6,59,116,56,60
49,57,6,65,152,74,78
49,57,6,67,83,44,39
49,57,6,71,140,48,92
49,57,6,73,165,77,88
49,57,6,77,53,0,53
49,57,6,83,61,0,61
49,57,6,85,0,41,-41
49,57,6,99,40,0,40
49,57,6,111,62,0,62
49,57,8,5,71,0,71
49,57,8,41,55,55,0
49,57,8,77,0,31,-31
49,57,15,3,68,0,68
49,57,16,1,78,60,18
49,57,16,5,62,82,-20
49,57,16,11,0,36,-36
49,57,16,19,49,43,6
49,57,16,27,54,46,8
49,57,16,65,49,0,49
49,57,16,71,0,46,-46
49,57,16,83,30,0,30
49,57,32,3,332,160,172
49,57,32,31,67,0,67
49,57,35,1,32,39,-7
49,57,35,9,39,0,39
49,57,41,51,64,0,64
49,57,41,67,27,22,5
49,57,48,27,0,34,-34
49,57,48,29,28,57,-29
49,57,48,113,33,0,33
49,57,48,201,35,49,-14
49,57,48,439,0,47,-47
49,57,48,451,30,0,30
49,57,49,3,768,1152,-384
49,57,49,5,537,472,65
49,57,49,7,29,0,29
49,57,49,11,7573,6042,1531
49,57,49,13,0,57,-57
49,57,49,21,46,50,-4
49,57,49,29,216,246,-30
49,57,49,35,2016,1684,332
49,57,49,39,33,0,33
49,57,49,43,61,34,27
49,57,49,45,87,103,-16
49,57,49,47,65,67,-2
49,57,49,49,591,419,172
49,57,49,51,31,38,-7
49,57,49,53,245,243,2
49,57,53,33,41,55,-14
49,57,53,53,57,61,-4
49,57,53,61,39,40,-1
49,57,56,23,23,0,23
49,57,56,37,48,35,13
49,57,56,39,37,0,37
49,57,56,41,56,56,0
50,1,9,1,23,0,23
50,1,25,17,27,37,-10
50,1,25,25,0,32,-32
50,1,36,31,55,56,-1
50,1,36,47,0,24,-24
50,1,36,61,0,30,-30
50,1,50,7,529,616,-87
50,1,50,11,53,41,12
50,1,50,17,36,0,36
50,1,50,21,243,224,19
50,1,50,23,109,95,14
50,1,50,27,40,29,11
50,3,9,1,30,0,30
50,3,9,9,40,0,40
50,3,25,3,143,181,-38
50,3,25,17,22,36,-14
50,3,36,1,0,48,-48
50,3,36,61,31,23,8
50,3,36,83,169,178,-9
50,3,36,91,0,39,-39
50,3,36,115,86,99,-13
50,3,36,119,37,0,37
50,3,50,7,48,101,-53
50,3,50,21,119,152,-33
50,3,50,25,127,103,24
50,3,50,27,31,38,-7
50,5,33,9,118,176,-58
50,5,33,15,27,0,27
50,5,50,7,75,162,-87
50,5,50,9,140,173,-33
50,5,50,11,0,35,-35
50,5,50,15,118,125,-7
50,5,50,17,101,106,-5
50,5,50,19,181,185,-4
50,5,50,23,167,169,-2
50,5,50,27,44,0,44
50,7,4,13,34,100,-66
50,7,4,19,33,0,33
50,7,6,1,0,35,-35
50,7,6,37,54,52,2
50,7,6,59,0,39,-39
50,7,6,73,62,64,-2
50,7,6,75,29,56,-27
50,7,6,85,30,73,-43
50,7,8,5,0,33,-33
50,7,8,13,48,47,1
50,7,8,31,26,56,-30
50,7,8,69,0,27,-27
50,7,9,1,50,64,-14
50,7,9,3,108,60,48
50,7,9,5,29,0,29
50,7,9,7,0,35,-35
50,7,9,9,40,41,-1
50,7,9,11,37,22,15
50,7,11,1,38,81,-43
50,7,12,9,0,33,-33
50,7,12,11,0,30,-30
50,7,12,21,0,28,-28
50,7,12,31,0,40,-40
50,7,12,57,23,33,-10
50,7,12,71,36,33,3
50,7,12,86,38,29,9
50,7,12,95,0,33,-33
50,7,12,99,0,34,-34
50,7,12,103,25,43,-18
50,7,12,115,0,42,-42
50,7,13,135,0,26,-26
50,7,17,31,89,80,9
50,7,23,5,94,139,-45
50,7,23,31,23,36,-13
50,7,24,5,23,0,23
50,7,24,31,55,54,1
50,7,24,510,33,0,33
50,7,25,1,54,57,-3
50,7,25,3,25,0,25
50,7,25,5,48,20,28
50,7,25,9,83,99,-16
50,7,25,13,32,0,32
50,7,25,15,30,42,-12
50,7,25,17,238,238,0
50,7,25,21,77,79,-2
50,7,25,23,60,25,35
50,7,25,25,119,176,-57
50,7,25,27,70,41,29
50,7,27,53,26,27,-1
50,7,32,3,0,42,-42
50,7,33,3,28,0,28
50,7,33,5,33,46,-13
50,7,33,7,26,0,26
50,7,33,9,75,100,-25
50,7,33,11,100,73,27
50,7,33,13,74,55,19
50,7,33,15,71,64,7
50,7,33,17,34,24,10
50,7,33,19,31,0,31
50,7,34,3,32,0,32
50,7,36,1,60,43,17
50,7,36,19,82,107,-25
50,7,36,27,26,38,-12
50,7,36,29,34,0,34
50,7,36,31,32,38,-6
50,7,36,47,64,109,-45
50,7,36,55,60,0,60
50,7,36,59,38,0,38
50,7,36,61,87,92,-5
50,7,36,67,58,0,58
50,7,36,81,37,44,-7
50,7,36,89,39,31,8
50,7,36,91,47,0,47
50,7,36,103,53,28,25
50,7,36,109,0,24,-24
50,7,36,113,33,0,33
50,7,36,119,61,38,23
50,7,37,21,0,30,-30
50,7,37,63,0,34,-34
50,7,37,119,31,52,-21
50,7,37,183,30,80,-50
50,7,41,51,0,89,-89
50,7,42,3,25,44,-19
50,7,42,17,0,28,-28
50,7,42,101,0,26,-26
50,7,44,7,38,52,-14
50,7,45,19,0,28,-28
50,7,45,91,0,46,-46
50,7,48,453,32,65,-33
50,7,49,35,30,54,-24
50,7,50,1,616,529,87
50,7,50,5,162,75,87
50,7,50,11,984,1102,-118
50,7,50,13,241,382,-141
50,7,50,15,371,373,-2
50,7,50,17,111,54,57
50,7,50,19,163,83,80
50,7,50,21,230,180,50
50,7,50,23,695,560,135
50,7,50,25,146,80,66
50,7,50,27,192,139,53
50,7,51,13,0,27,-27
50,7,51,59,27,42,-15
50,7,53,33,67,91,-24
50,7,56,39,0,21,-21
50,9,33,7,124,88,36
50,9,33,9,0,50,-50
50,9,50,5,173,140,33
50,9,50,19,56,58,-2
50,11,23,5,0,25,-25
50,11,36,19,38,62,-24
50,11,50,1,41,53,-12
50,11,50,5,35,0,35
50,11,50,7,1102,984,118
50,11,50,13,115,156,-41
50,11,50,15,156,120,36
50,11,50,19,81,42,39
50,11,50,21,38,30,8
50,11,50,23,52,64,-12
50,13,36,19,0,43,-43
50,13,50,7,382,241,141
50,13,50,11,156,115,41
50,13,50,23,26,0,26
50,15,25,9,26,0,26
50,15,25,17,0,26,-26
50,15,50,5,125,118,7
50,15,50,7,373,371,2
50,15,50,11,120,156,-36
50,15,50,17,29,0,29
50,15,50,19,109,93,16
50,15,50,21,21,0,21
50,15,50,23,204,197,7
50,17,25,17,33,26,7
50,17,33,9,295,282,13
50,17,33,19,29,33,-4
50,17,50,1,0,36,-36
50,17,50,5,106,101,5
50,17,50,7,54,111,-57
50,17,50,15,0,29,-29
50,17,50,19,0,31,-31
50,17,50,21,27,35,-8
50,17,50,23,520,494,26
50,17,50,27,398,396,2
50,19,50,5,185,181,4
50,19,50,7,83,163,-80
50,19,50,9,58,56,2
50,19,50,11,42,81,-39
50,19,50,15,93,109,-16
50,19,50,17,31,0,31
50,19,50,21,0,31,-31
50,19,50,23,55,99,-44
50,19,50,27,32,25,7
50,21,9,1,0,30,-30
50,21,9,3,33,0,33
50,21,12,127,25,0,25
50,21,23,5,0,39,-39
50,21,25,1,0,37,-37
50,21,25,9,0,22,-22
50,21,25,17,33,56,-23
50,21,25,19,0,23,-23
50,21,25,21,0,29,-29
50,21,25,27,0,25,-25
50,21,33,9,0,27,-27
50,21,33,11,35,38,-3
50,21,33,19,0,25,-25
50,21,36,1,27,0,27
50,21,36,61,24,22,2
50,21,36,91,0,39,-39
50,21,36,113,27,38,-11
50,21,36,115,137,211,-74
50,21,50,1,224,243,-19
50,21,50,3,152,119,33
50,21,50,7,180,230,-50
50,21,50,11,30,38,-8
50,21,50,15,0,21,-21
50,21,50,17,35,27,8
50,21,50,19,31,0,31
50,21,50,23,54,62,-8
50,21,50,25,80,69,11
50,21,50,27,195,175,20
50,23,4,13,25,0,25
50,23,6,73,27,0,27
50,23,9,3,24,0,24
50,23,17,31,0,24,-24
50,23,23,5,0,30,-30
50,23,25,9,33,35,-2
50,23,25,17,73,47,26
50,23,25,25,24,42,-18
50,23,25,27,25,0,25
50,23,33,9,57,33,24
50,23,33,15,0,24,-24
50,23,36,61,0,31,-31
50,23,50,1,95,109,-14
50,23,50,5,169,167,2
50,23,50,7,560,695,-135
50,23,50,11,64,52,12
50,23,50,13,0,26,-26
50,23,50,15,197,204,-7
50,23,50,17,494,520,-26
50,23,50,19,99,55,44
50,23,50,21,62,54,8
50,23,50,27,98,82,16
50,23,53,33,0,20,-20
50,25,9,1,45,0,45
50,25,9,3,49,36,13
50,25,9,9,39,30,9
50,25,11,1,0,20,-20
50,25,12,103,24,0,24
50,25,17,31,41,0,41
50,25,23,5,40,25,15
50,25,25,3,0,22,-22
50,25,25,11,96,93,3
50,25,25,13,37,37,0
50,25,25,15,46,61,-15
50,25,25,17,63,70,-7
50,25,25,25,31,39,-8
50,25,25,27,32,0,32
50,25,33,5,382,449,-67
50,25,33,9,26,37,-11
50,25,33,11,38,47,-9
50,25,33,13,0,30,-30
50,25,33,19,57,56,1
50,25,36,47,31,30,1
50,25,36,61,37,34,3
50,25,36,119,24,0,24
50,25,50,3,103,127,-24
50,25,50,7,80,146,-66
50,25,50,21,69,80,-11
50,25,50,27,266,275,-9
50,27,6,73,25,0,25
50,27,9,3,45,27,18
50,27,9,9,34,21,13
50,27,11,1,20,24,-4
50,27,23,5,20,28,-8
50,27,23,31,0,26,-26
50,27,25,9,26,27,-1
50,27,25,15,28,24,4
50,27,25,17,47,88,-41
50,27,25,25,42,82,-40
50,27,25,27,30,0,30
50,27,33,5,75,91,-16
50,27,33,9,530,590,-60
50,27,33,11,30,52,-22
50,27,33,13,29,55,-26
50,27,33,15,0,37,-37
50,27,33,19,339,329,10
50,27,36,47,0,23,-23
50,27,36,61,45,45,0
50,27,36,103,32,0,32
50,27,44,7,27,0,27
50,27,50,1,29,40,-11
50,27,50,3,38,31,7
50,27,50,5,0,44,-44
50,27,50,7,139,192,-53
50,27,50,17,396,398,-2
50,27,50,19,25,32,-7
50,27,50,21,175,195,-20
50,27,50,23,82,98,-16
50,27,50,25,275,266,9
51,1,10,1,35,0,35
51,1,10,5,52,51,1
51,1,24,3,31,0,31
51,1,24,39,49,48,1
51,1,24,45,99,113,-14
51,1,24,47,109,106,3
51,1,51,131,183,227,-44
51,1,51,550,0,43,-43
51,1,51,700,0,34,-34
51,1,51,710,59,53,6
51,1,51,760,0,20,-20
51,1,51,810,64,97,-33
51,3,4,13,55,0,55
51,3,6,37,88,66,22
51,3,6,59,33,0,33
51,3,6,73,67,49,18
51,3,6,75,0,40,-40
51,3,6,85,0,49,-49
51,3,8,41,40,0,40
51,3,9,1,39,0,39
51,3,11,1,86,74,12
51,3,12,57,27,0,27
51,3,12,86,29,0,29
51,3,13,121,32,22,10
51,3,17,31,74,51,23
51,3,24,3,59,0,59
51,3,24,5,42,0,42
51,3,24,31,106,61,45
51,3,24,33,32,0,32
51,3,24,510,29,33,-4
51,3,25,17,46,50,-4
51,3,25,25,0,25,-25
51,3,26,125,49,0,49
51,3,27,53,43,28,15
51,3,29,189,36,0,36
51,3,31,55,33,0,33
51,3,32,3,34,0,34
51,3,34,25,28,0,28
51,3,36,47,0,20,-20
51,3,36,59,26,0,26
51,3,36,61,79,104,-25
51,3,36,81,29,0,29
51,3,36,103,39,0,39
51,3,37,21,0,27,-27
51,3,37,63,0,36,-36
51,3,37,67,32,23,9
51,3,37,81,29,28,1
51,3,37,119,30,74,-44
51,3,37,135,0,35,-35
51,3,37,183,42,62,-20
51,3,39,49,0,27,-27
51,3,42,3,72,46,26
51,3,42,101,0,43,-43
51,3,45,19,34,29,5
51,3,48,113,0,44,-44
51,3,48,201,0,39,-39
51,3,51,9,0,25,-25
51,3,51,13,129,101,28
51,3,51,15,106,164,-58
51,3,51,19,29,32,-3
51,3,51,29,131,146,-15
51,3,51,41,90,97,-7
51,3,51,47,41,0,41
51,3,51,59,315,204,111
51,3,51,61,37,0,37
51,3,51,65,477,560,-83
51,3,51,75,30,38,-8
51,3,51,79,426,488,-62
51,3,51,87,144,193,-49
51,3,51,107,52,51,1
51,3,51,109,254,319,-65
51,3,51,113,85,0,85
51,3,51,121,47,60,-13
51,3,51,125,167,196,-29
51,3,51,137,134,171,-37
51,3,51,153,103,55,48
51,3,51,165,41,32,9
51,3,51,177,0,48,-48
51,3,51,510,50,55,-5
51,3,51,540,1878,1780,98
51,3,51,550,36,32,4
51,3,51,650,29,0,29
51,3,51,660,76,38,38
51,3,51,680,52,53,-1
51,3,51,700,36,32,4
51,3,51,710,52,29,23
51,3,51,760,125,129,-4
51,3,51,770,0,37,-37
51,3,51,790,55,43,12
51,3,51,810,76,52,24
51,3,51,820,122,249,-127
51,3,53,33,35,47,-12
51,5,51,17,36,41,-5
51,5,51,23,59,63,-4
51,5,51,161,0,27,-27
51,5,51,580,114,142,-28
51,5,51,770,57,43,14
51,5,54,25,36,33,3
51,7,51,41,458,251,207
51,7,51,87,56,31,25
51,7,51,135,83,129,-46
51,7,51,145,92,48,44
51,7,51,147,60,68,-8
51,7,51,760,59,78,-19
51,9,51,3,25,0,25
51,9,51,11,49,73,-24
51,9,51,19,156,101,55
51,9,51,31,228,256,-28
51,9,51,87,0,27,-27
51,9,51,125,138,125,13
51,9,51,680,710,576,134
51,11,51,9,73,49,24
51,11,51,19,62,0,62
51,11,51,29,33,0,33
51,11,51,31,234,136,98
51,11,51,37,0,31,-31
51,11,51,147,43,40,3
51,11,51,680,209,156,53
51,13,1,73,32,28,4
51,13,1,89,36,55,-19
51,13,4,13,157,129,28
51,13,4,19,54,62,-8
51,13,6,1,72,75,-3
51,13,6,13,38,32,6
51,13,6,37,339,401,-62
51,13,6,41,0,25,-25
51,13,6,53,50,68,-18
51,13,6,59,134,114,20
51,13,6,65,25,31,-6
51,13,6,67,36,39,-3
51,13,6,71,28,0,28
51,13,6,73,283,333,-50
51,13,6,75,70,230,-160
51,13,6,81,34,77,-43
51,13,6,85,75,97,-22
51,13,8,5,59,36,23
51,13,8,13,32,57,-25
51,13,8,31,85,160,-75
51,13,8,41,88,58,30
51,13,8,59,0,39,-39
51,13,8,69,0,31,-31
51,13,9,1,116,65,51
51,13,9,3,82,34,48
51,13,9,9,75,53,22
51,13,10,1,27,0,27
51,13,10,3,78,59,19
51,13,10,5,23,38,-15
51,13,11,1,3792,4012,-220
51,13,12,1,33,0,33
51,13,12,9,57,37,20
51,13,12,11,124,94,30
51,13,12,31,63,63,0
51,13,12,33,39,30,9
51,13,12,57,134,83,51
51,13,12,71,28,0,28
51,13,12,73,46,0,46
51,13,12,86,183,131,52
51,13,12,91,30,0,30
51,13,12,95,74,68,6
51,13,12,99,64,71,-7
51,13,12,103,65,24,41
51,13,12,115,29,31,-2
51,13,12,117,32,0,32
51,13,13,67,58,53,5
51,13,13,89,84,84,0
51,13,13,121,134,117,17
51,13,13,135,37,0,37
51,13,15,3,143,117,26
51,13,16,1,23,0,23
51,13,17,19,0,26,-26
51,13,17,31,359,425,-66
51,13,17,43,55,27,28
51,13,17,97,39,0,39
51,13,18,97,44,29,15
51,13,20,91,29,24,5
51,13,21,111,25,23,2
51,13,22,33,20,25,-5
51,13,22,51,20,24,-4
51,13,22,71,0,23,-23
51,13,23,5,34,0,34
51,13,23,31,25,0,25
51,13,24,3,219,257,-38
51,13,24,5,197,105,92
51,13,24,9,40,25,15
51,13,24,17,108,55,53
51,13,24,21,81,50,31
51,13,24,25,34,0,34
51,13,24,27,199,102,97
51,13,24,31,1617,1375,242
51,13,24,33,828,784,44
51,13,24,37,52,28,24
51,13,24,510,203,192,11
51,13,25,5,25,0,25
51,13,25,9,52,0,52
51,13,25,13,26,0,26
51,13,25,17,261,240,21
51,13,25,21,97,85,12
51,13,25,23,40,0,40
51,13,25,25,207,146,61
51,13,25,27,41,0,41
51,13,26,65,24,0,24
51,13,26,81,35,0,35
51,13,26,99,40,0,40
51,13,26,125,114,28,86
51,13,26,161,76,51,25
51,13,26,163,87,27,60
51,13,27,53,70,73,-3
51,13,27,123,29,38,-9
51,13,29,95,39,0,39
51,13,29,189,73,30,43
51,13,29,510,0,28,-28
51,13,31,55,27,30,-3
51,13,32,3,89,101,-12
51,13,32,31,0,25,-25
51,13,33,11,41,41,0
51,13,33,15,32,0,32
51,13,34,3,99,47,52
51,13,34,5,42,0,42
51,13,34,7,41,0,41
51,13,34,13,47,27,20
51,13,34,15,27,0,27
51,13,34,17,94,116,-22
51,13,34,21,70,33,37
51,13,34,23,78,38,40
51,13,34,25,58,35,23
51,13,34,27,81,58,23
51,13,34,29,32,0,32
51,13,34,35,42,24,18
51,13,34,39,38,0,38
51,13,35,1,54,38,16
51,13,35,49,0,36,-36
51,13,36,1,27,0,27
51,13,36,5,40,0,40
51,13,36,29,64,44,20
51,13,36,47,105,132,-27
51,13,36,55,104,0,104
51,13,36,59,100,64,36
51,13,36,61,329,609,-280
51,13,36,65,30,0,30
51,13,36,67,95,26,69
51,13,36,81,117,73,44
51,13,36,87,31,0,31
51,13,36,103,93,34,59
51,13,36,109,26,0,26
51,13,36,119,86,54,32
51,13,37,19,0,27,-27
51,13,37,51,46,31,15
51,13,37,63,57,82,-25
51,13,37,67,35,30,5
51,13,37,81,47,27,20
51,13,37,119,109,201,-92
51,13,37,129,39,0,39
51,13,37,133,40,35,5
51,13,37,135,43,36,7
51,13,37,183,115,178,-63
51,13,39,17,24,0,24
51,13,39,35,106,48,58
51,13,39,49,94,81,13
51,13,39,57,27,0,27
51,13,39,61,50,35,15
51,13,39,99,20,0,20
51,13,39,113,24,0,24
51,13,39,153,46,0,46
51,13,40,143,25,0,25
51,13,41,51,41,67,-26
51,13,41,67,26,22,4
51,13,42,3,236,118,118
51,13,42,11,28,0,28
51,13,42,17,88,0,88
51,13,42,27,52,0,52
51,13,42,29,93,70,23
51,13,42,41,54,39,15
51,13,42,43,27,0,27
51,13,42,45,73,30,43
51,13,42,49,32,0,32
51,13,42,69,28,0,28
51,13,42,71,43,0,43
51,13,42,77,46,0,46
51,13,42,79,23,0,23
51,13,42,91,142,89,53
51,13,42,95,38,0,38
51,13,42,101,137,160,-23
51,13,42,125,24,0,24
51,13,42,129,41,0,41
51,13,42,133,44,0,44
51,13,44,5,50,30,20
51,13,44,7,35,28,7
51,13,45,13,0,25,-25
51,13,45,19,49,93,-44
51,13,45,45,20,0,20
51,13,45,79,20,38,-18
51,13,47,37,56,49,7
51,13,47,93,29,0,29
51,13,47,157,45,35,10
51,13,48,29,103,86,17
51,13,48,41,37,0,37
51,13,48,61,0,32,-32
51,13,48,85,45,29,16
51,13,48,113,96,142,-46
51,13,48,141,0,30,-30
51,13,48,201,179,163,16
51,13,48,439,68,55,13
51,13,48,453,96,149,-53
51,13,49,35,86,55,31
51,13,49,49,72,0,72
51,13,50,7,27,0,27
51,13,51,3,101,129,-28
51,13,51,41,103,68,35
51,13,51,47,0,29,-29
51,13,51,59,7857,9110,-1253
51,13,51,61,63,42,21
51,13,51,69,0,29,-29
51,13,51,87,128,114,14
51,13,51,95,39,37,2
51,13,51,107,810,1095,-285
51,13,51,121,61,45,16
51,13,51,137,0,33,-33
51,13,51,153,1301,1185,116
51,13,51,161,30,26,4
51,13,51,165,26,0,26
51,13,51,171,0,24,-24
51,13,51,177,50,57,-7
51,13,51,179,157,133,24
51,13,51,187,0,30,-30
51,13,51,199,30,0,30
51,13,51,510,2854,4125,-1271
51,13,51,540,94,98,-4
51,13,51,550,50,0,50
51,13,51,600,143,226,-83
51,13,51,610,162,254,-92
51,13,51,630,50,29,21
51,13,51,650,55,0,55
51,13,51,660,55,0,55
51,13,51,683,116,97,19
51,13,51,685,51,48,3
51,13,51,700,39,0,39
51,13,51,710,104,63,41
51,13,51,760,143,147,-4
51,13,51,810,176,135,41
51,13,51,830,30,0,30
51,13,53,33,96,183,-87
51,13,53,53,30,28,2
51,13,54,61,31,0,31
51,13,55,25,42,21,21
51,13,55,79,47,0,47
51,15,51,3,164,106,58
51,15,51,41,27,39,-12
51,15,51,59,43,42,1
51,15,51,87,37,43,-6
51,15,51,121,33,35,-2
51,15,51,125,45,49,-4
51,15,51,163,173,126,47
51,15,51,165,481,483,-2
51,15,51,660,279,175,104
51,15,51,770,0,35,-35
51,15,51,790,781,829,-48
51,15,51,820,770,766,4
51,17,12,86,0,22,-22
51,17,51,5,41,36,5
51,19,37,81,0,33,-33
51,19,51,3,32,29,3
51,19,51,9,101,156,-55
51,19,51,11,0,62,-62
51,19,51,23,191,188,3
51,19,51,31,508,624,-116
51,19,51,41,30,36,-6
51,19,51,59,62,37,25
51,19,51,67,158,219,-61
51,19,51,87,35,30,5
51,19,51,107,30,0,30
51,19,51,121,60,68,-8
51,19,51,143,28,52,-24
51,19,51,153,32,0,32
51,19,51,161,444,460,-16
51,19,51,163,0,24,-24
51,19,51,515,203,199,4
51,19,51,550,30,0,30
51,19,51,680,983,822,161
51,19,51,760,0,24,-24
51,19,51,770,538,545,-7
51,19,51,775,73,63,10
51,21,51,185,36,34,2
51,21,51,197,91,68,23
51,21,54,55,48,0,48
51,23,37,119,0,34,-34
51,23,51,5,63,59,4
51,23,51,19,188,191,-3
51,23,51,59,31,0,31
51,23,51,67,60,60,0
51,23,51,121,46,58,-12
51,23,51,161,616,410,206
51,23,51,163,29,32,-3
51,23,51,770,745,594,151
51,23,51,775,117,104,13
51,25,37,83,0,41,-41
51,25,51,41,57,63,-6
51,25,51,53,49,54,-5
51,25,51,81,43,70,-27
51,25,51,87,0,52,-52
51,25,51,111,71,32,39
51,25,51,117,212,258,-46
51,25,51,595,38,60,-22
51,25,51,730,0,42,-42
51,27,21,195,41,46,-5
51,27,47,163,0,30,-30
51,27,51,51,51,80,-29
51,27,51,167,78,176,-98
51,27,51,185,198,347,-149
51,27,51,191,35,89,-54
51,27,54,47,37,46,-9
51,29,51,3,146,131,15
51,29,51,11,0,33,-33
51,29,51,41,26,0,26
51,29,51,49,65,48,17
51,29,51,65,36,39,-3
51,29,51,147,87,98,-11
51,29,51,540,44,59,-15
51,31,51,9,256,228,28
51,31,51,11,136,234,-98
51,31,51,19,624,508,116
51,31,51,37,45,0,45
51,31,51,41,35,0,35
51,31,51,83,84,57,27
51,31,51,87,26,0,26
51,31,51,121,32,0,32
51,31,51,143,269,374,-105
51,31,51,161,29,26,3
51,31,51,515,41,0,41
51,31,51,680,1205,1029,176
51,31,51,700,0,22,-22
51,31,51,760,26,35,-9
51,33,24,33,38,0,38
51,33,51,41,90,48,42
51,33,51,47,35,0,35
51,33,51,59,76,43,33
51,33,51,85,204,204,0
51,33,51,87,179,188,-9
51,33,51,99,131,68,63
51,33,51,101,32,0,32
51,33,51,109,0,46,-46
51,33,51,137,27,48,-21
51,33,51,153,222,114,108
51,33,51,177,874,577,297
51,33,51,179,393,229,164
51,33,51,193,43,0,43
51,33,51,630,207,180,27
51,33,51,760,37,68,-31
51,35,37,67,0,31,-31
51,35,37,171,190,237,-47
51,35,51,63,40,37,3
51,35,51,77,149,140,9
51,35,51,121,27,38,-11
51,35,51,141,28,32,-4
51,35,51,155,68,51,17
51,35,51,197,97,98,-1
51,35,51,640,140,177,-37
51,36,51,41,49,25,24
51,36,51,85,29,35,-6
51,36,51,87,189,170,19
51,36,51,95,51,26,25
51,36,51,127,81,55,26
51,36,51,760,38,52,-14
51,37,51,11,31,0,31
51,37,51,31,0,45,-45
51,37,51,83,55,94,-39
51,37,51,111,37,0,37
51,37,51,117,59,89,-30
51,37,51,147,96,82,14
51,37,51,680,32,27,5
51,41,1,89,0,28,-28
51,41,4,13,58,87,-29
51,41,6,37,110,80,30
51,41,6,59,46,34,12
51,41,6,65,35,29,6
51,41,6,73,89,86,3
51,41,6,75,0,23,-23
51,41,8,35,0,45,-45
51,41,8,41,51,0,51
51,41,9,1,49,0,49
51,41,9,3,50,0,50
51,41,9,9,27,0,27
51,41,10,3,66,44,22
51,41,11,1,53,72,-19
51,41,12,9,30,28,2
51,41,12,11,80,56,24
51,41,12,31,67,44,23
51,41,12,57,70,79,-9
51,41,12,86,79,0,79
51,41,12,95,48,57,-9
51,41,12,99,75,44,31
51,41,12,101,30,46,-16
51,41,12,103,40,51,-11
51,41,12,105,0,37,-37
51,41,12,115,23,0,23
51,41,12,117,0,36,-36
51,41,12,127,40,0,40
51,41,13,67,60,55,5
51,41,13,89,32,37,-5
51,41,13,121,62,74,-12
51,41,13,135,61,60,1
51,41,13,245,0,38,-38
51,41,15,3,56,46,10
51,41,17,31,64,34,30
51,41,17,97,45,0,45
51,41,24,3,83,50,33
51,41,24,5,77,82,-5
51,41,24,25,68,0,68
51,41,24,27,0,57,-57
51,41,24,31,110,81,29
51,41,24,33,164,76,88
51,41,24,510,24,43,-19
51,41,25,17,35,39,-4
51,41,26,125,54,0,54
51,41,26,163,38,0,38
51,41,29,189,0,48,-48
51,41,32,3,0,60,-60
51,41,34,3,64,0,64
51,41,34,5,51,0,51
51,41,34,7,33,0,33
51,41,34,13,66,0,66
51,41,34,17,29,0,29
51,41,34,23,42,0,42
51,41,34,29,46,0,46
51,41,36,5,70,0,70
51,41,36,29,48,0,48
51,41,36,45,53,30,23
51,41,36,47,138,60,78
51,41,36,55,34,0,34
51,41,36,59,90,0,90
51,41,36,61,67,60,7
51,41,36,67,44,0,44
51,41,36,81,110,34,76
51,41,36,91,0,29,-29
51,41,36,103,101,0,101
51,41,36,119,36,0,36
51,41,37,19,0,29,-29
51,41,37,25,90,47,43
51,41,37,51,82,77,5
51,41,37,55,25,27,-2
51,41,37,63,41,50,-9
51,41,37,67,40,31,9
51,41,37,81,74,83,-9
51,41,37,119,137,229,-92
51,41,37,129,29,49,-20
51,41,37,133,35,45,-10
51,41,37,147,0,26,-26
51,41,37,179,0,49,-49
51,41,37,183,134,264,-130
51,41,39,35,0,33,-33
51,41,39,49,51,0,51
51,41,39,113,54,0,54
51,41,40,143,32,0,32
51,41,42,3,66,40,26
51,41,42,29,36,54,-18
51,41,42,41,39,0,39
51,41,42,45,40,0,40
51,41,42,91,42,48,-6
51,41,42,101,61,31,30
51,41,42,133,0,38,-38
51,41,45,19,35,39,-4
51,41,45,45,45,49,-4
51,41,45,51,0,50,-50
51,41,45,63,37,0,37
51,41,45,79,41,45,-4
51,41,45,91,32,0,32
51,41,47,125,55,33,22
51,41,47,157,0,51,-51
51,41,48,27,83,69,14
51,41,48,29,30,50,-20
51,41,48,85,43,61,-18
51,41,48,113,67,30,37
51,41,48,121,0,39,-39
51,41,48,201,64,97,-33
51,41,48,439,34,50,-16
51,41,51,3,97,90,7
51,41,51,7,251,458,-207
51,41,51,13,68,103,-35
51,41,51,15,39,27,12
51,41,51,19,36,30,6
51,41,51,25,63,57,6
51,41,51,29,0,26,-26
51,41,51,31,0,35,-35
51,41,51,33,48,90,-42
51,41,51,36,25,49,-24
51,41,51,49,60,99,-39
51,41,51,53,419,569,-150
51,41,51,57,0,39,-39
51,41,51,59,355,230,125
51,41,51,73,37,41,-4
51,41,51,75,116,212,-96
51,41,51,83,34,0,34
51,41,51,85,463,468,-5
51,41,51,87,4148,3143,1005
51,41,51,93,0,30,-30
51,41,51,95,87,136,-49
51,41,51,101,55,76,-21
51,41,51,107,93,76,17
51,41,51,109,42,86,-44
51,41,51,111,0,30,-30
51,41,51,117,73,55,18
51,41,51,119,0,47,-47
51,41,51,121,81,66,15
51,41,51,127,47,146,-99
51,41,51,135,126,137,-11
51,41,51,143,36,31,5
51,41,51,145,550,868,-318
51,41,51,147,88,100,-12
51,41,51,149,508,599,-91
51,41,51,153,185,131,54
51,41,51,161,72,53,19
51,41,51,165,0,28,-28
51,41,51,175,27,0,27
51,41,51,177,99,92,7
51,41,51,179,79,63,16
51,41,51,183,55,118,-63
51,41,51,199,41,32,9
51,41,51,510,59,60,-1
51,41,51,540,40,35,5
51,41,51,550,139,82,57
51,41,51,570,718,619,99
51,41,51,590,30,31,-1
51,41,51,595,34,0,34
51,41,51,650,74,61,13
51,41,51,660,0,26,-26
51,41,51,670,674,561,113
51,41,51,680,65,68,-3
51,41,51,700,149,140,9
51,41,51,710,148,81,67
51,41,51,730,691,672,19
51,41,51,740,42,48,-6
51,41,51,760,5745,4646,1099
51,41,51,770,72,49,23
51,41,51,800,52,52,0
51,41,51,810,328,260,68
51,41,53,33,0,43,-43
51,41,53,53,39,37,2
51,43,51,59,106,45,61
51,43,51,61,29,0,29
51,43,51,69,220,280,-60
51,43,51,107,329,185,144
51,43,51,153,41,0,41
51,43,51,840,84,121,-37
51,43,54,3,33,32,1
51,43,54,37,49,65,-16
51,45,51,121,24,0,24
51,45,51,161,71,78,-7
51,45,51,770,26,49,-23
51,45,51,775,0,50,-50
51,47,24,31,38,0,38
51,47,24,33,39,0,39
51,47,51,3,0,41,-41
51,47,51,13,29,0,29
51,47,51,33,0,35,-35
51,47,51,59,362,214,148
51,47,51,61,747,475,272
51,47,51,79,0,31,-31
51,47,51,87,0,31,-31
51,47,51,107,64,86,-22
51,47,51,109,0,49,-49
51,47,51,113,179,262,-83
51,47,51,137,219,266,-47
51,47,51,153,461,471,-10
51,47,51,157,145,69,76
51,47,51,171,0,42,-42
51,47,51,177,101,108,-7
51,47,51,179,92,68,24
51,47,51,187,0,48,-48
51,47,51,630,24,32,-8
51,47,51,683,176,97,79
51,47,51,685,44,32,12
51,49,51,29,48,65,-17
51,49,51,41,99,60,39
51,49,51,87,56,43,13
51,49,51,145,114,67,47
51,49,51,147,47,94,-47
51,49,51,760,41,40,1
51,51,51,27,80,51,29
51,51,51,167,35,57,-22
51,51,51,191,0,34,-34
51,51,51,195,179,119,60
51,53,51,25,54,49,5
51,53,51,41,569,419,150
51,53,51,87,48,83,-35
51,53,51,135,49,56,-7
51,53,51,149,250,142,108
51,53,51,183,49,39,10
51,53,51,570,220,180,40
51,53,51,670,180,86,94
51,53,51,730,330,248,82
51,53,51,760,54,78,-24
51,57,51,41,39,0,39
51,57,51,85,0,56,-56
51,57,51,87,89,55,34
51,57,51,97,66,32,34
51,57,51,101,40,40,0
51,57,51,159,103,80,23
51,57,51,177,47,33,14
51,57,51,179,41,0,41
51,57,51,193,58,43,15
51,57,51,760,28,0,28
51,59,1,1,141,0,141
51,59,1,45,38,0,38
51,59,1,73,56,59,-3
51,59,1,83,0,51,-51
51,59,1,89,131,263,-132
51,59,1,97,47,0,47
51,59,1,101,217,71,146
51,59,1,117,35,0,35
51,59,2,20,140,67,73
51,59,2,90,57,32,25
51,59,4,3,132,66,66
51,59,4,13,431,493,-62
51,59,4,19,115,161,-46
51,59,4,27,43,0,43
51,59,5,7,0,34,-34
51,59,5,119,74,56,18
51,59,6,1,175,211,-36
51,59,6,13,75,130,-55
51,59,6,19,28,27,1
51,59,6,29,47,0,47
51,59,6,37,898,866,32
51,59,6,41,37,57,-20
51,59,6,53,266,103,163
51,59,6,59,340,367,-27
51,59,6,61,36,0,36
51,59,6,65,134,116,18
51,59,6,67,109,106,3
51,59,6,71,148,112,36
51,59,6,73,948,896,52
51,59,6,75,71,201,-130
51,59,6,79,30,0,30
51,59,6,81,69,129,-60
51,59,6,83,73,66,7
51,59,6,85,282,405,-123
51,59,6,95,73,46,27
51,59,6,97,36,0,36
51,59,6,111,118,109,9
51,59,8,1,35,48,-13
51,59,8,5,114,137,-23
51,59,8,13,64,92,-28
51,59,8,31,133,168,-35
51,59,8,35,87,115,-28
51,59,8,41,343,414,-71
51,59,8,59,45,86,-41
51,59,8,69,33,65,-32
51,59,9,1,136,176,-40
51,59,9,3,118,129,-11
51,59,9,5,0,21,-21
51,59,9,7,35,0,35
51,59,9,9,108,88,20
51,59,9,11,72,60,12
51,59,9,13,21,0,21
51,59,10,1,45,47,-2
51,59,10,3,173,119,54
51,59,10,5,51,193,-142
51,59,11,1,2860,2857,3
51,59,12,1,73,62,11
51,59,12,5,60,39,21
51,59,12,9,212,186,26
51,59,12,11,394,375,19
51,59,12,15,0,35,-35
51,59,12,19,54,46,8
51,59,12,21,63,79,-16
51,59,12,31,247,238,9
51,59,12,33,70,95,-25
51,59,12,57,332,454,-122
51,59,12,61,0,28,-28
51,59,12,69,0,84,-84
51,59,12,71,84,126,-42
51,59,12,73,84,44,40
51,59,12,81,56,114,-58
51,59,12,83,0,33,-33
51,59,12,85,0,34,-34
51,59,12,86,456,442,14
51,59,12,87,54,0,54
51,59,12,91,122,112,10
51,59,12,95,386,243,143
51,59,12,97,56,64,-8
51,59,12,99,194,225,-31
51,59,12,101,58,107,-49
51,59,12,103,174,194,-20
51,59,12,105,63,61,2
51,59,12,109,44,107,-63
51,59,12,111,0,40,-40
51,59,12,113,51,58,-7
51,59,12,115,65,113,-48
51,59,12,117,115,83,32
51,59,12,119,0,70,-70
51,59,12,127,66,72,-6
51,59,13,51,61,61,0
51,59,13,57,0,46,-46
51,59,13,59,32,0,32
51,59,13,63,31,46,-15
51,59,13,67,203,234,-31
51,59,13,73,108,0,108
51,59,13,89,178,203,-25
51,59,13,97,0,53,-53
51,59,13,113,49,34,15
51,59,13,117,0,37,-37
51,59,13,121,329,306,23
51,59,13,127,36,0,36
51,59,13,135,163,201,-38
51,59,13,151,55,48,7
51,59,13,153,75,0,75
51,59,13,179,64,42,22
51,59,13,185,47,0,47
51,59,13,215,52,67,-15
51,59,13,245,97,56,41
51,59,15,3,763,560,203
51,59,16,1,53,54,-1
51,59,17,19,63,35,28
51,59,17,31,531,487,44
51,59,17,43,120,137,-17
51,59,17,97,111,68,43
51,59,17,161,33,0,33
51,59,17,163,152,133,19
51,59,17,197,50,32,18
51,59,18,57,36,92,-56
51,59,18,97,97,79,18
51,59,18,105,70,32,38
51,59,18,141,36,34,2
51,59,18,157,40,27,13
51,59,19,113,0,36,-36
51,59,19,153,33,0,33
51,59,19,163,0,26,-26
51,59,20,61,45,38,7
51,59,20,91,165,83,82
51,59,20,103,147,120,27
51,59,20,161,38,31,7
51,59,20,173,51,49,2
51,59,21,47,92,0,92
51,59,21,67,60,53,7
51,59,21,93,0,51,-51
51,59,21,111,104,108,-4
51,59,22,15,57,0,57
51,59,22,33,68,0,68
51,59,22,51,55,61,-6
51,59,22,71,64,83,-19
51,59,22,103,54,42,12
51,59,22,115,73,48,25
51,59,23,5,68,54,14
51,59,23,31,0,29,-29
51,59,24,3,662,774,-112
51,59,24,5,473,368,105
51,59,24,9,74,138,-64
51,59,24,13,52,42,10
51,59,24,15,0,33,-33
51,59,24,17,397,306,91
51,59,24,21,264,235,29
51,59,24,25,71,83,-12
51,59,24,27,497,476,21
51,59,24,31,3926,3036,890
51,59,24,33,3033,2543,490
51,59,24,35,41,0,41
51,59,24,37,91,98,-7
51,59,24,41,27,32,-5
51,59,24,43,50,83,-33
51,59,24,45,41,39,2
51,59,24,47,0,37,-37
51,59,24,510,254,309,-55
51,59,25,1,0,41,-41
51,59,25,5,37,25,12
51,59,25,9,109,81,28
51,59,25,13,27,29,-2
51,59,25,15,25,0,25
51,59,25,17,476,435,41
51,59,25,21,162,142,20
51,59,25,23,46,0,46
51,59,25,25,147,180,-33
51,59,25,27,116,81,35
51,59,26,49,26,0,26
51,59,26,65,61,51,10
51,59,26,81,26,38,-12
51,59,26,93,27,0,27
51,59,26,99,115,58,57
51,59,26,125,243,116,127
51,59,26,161,93,52,41
51,59,26,163,171,89,82
51,59,27,3,31,0,31
51,59,27,37,32,0,32
51,59,27,53,205,182,23
51,59,27,123,59,44,15
51,59,27,163,33,53,-20
51,59,28,47,0,54,-54
51,59,29,47,0,31,-31
51,59,29,95,58,65,-7
51,59,29,169,55,52,3
51,59,29,183,55,34,21
51,59,29,189,164,108,56
51,59,29,510,48,25,23
51,59,31,55,85,66,19
51,59,31,109,39,0,39
51,59,31,153,88,82,6
51,59,32,3,307,395,-88
51,59,32,31,0,35,-35
51,59,33,11,80,82,-2
51,59,33,15,67,48,19
51,59,33,17,25,0,25
51,59,34,1,34,43,-9
51,59,34,3,174,186,-12
51,59,34,5,144,92,52
51,59,34,7,79,55,24
51,59,34,9,0,25,-25
51,59,34,13,98,73,25
51,59,34,15,39,0,39
51,59,34,17,172,200,-28
51,59,34,21,77,78,-1
51,59,34,23,268,304,-36
51,59,34,25,138,46,92
51,59,34,27,127,82,45
51,59,34,29,58,28,30
51,59,34,31,38,26,12
51,59,34,35,88,53,35
51,59,34,37,31,0,31
51,59,34,39,72,64,8
51,59,35,1,166,132,34
51,59,35,13,43,42,1
51,59,35,28,29,0,29
51,59,35,43,0,61,-61
51,59,35,49,32,40,-8
51,59,36,1,68,45,23
51,59,36,5,132,146,-14
51,59,36,7,45,0,45
51,59,36,15,22,0,22
51,59,36,27,46,24,22
51,59,36,29,153,95,58
51,59,36,45,201,61,140
51,59,36,47,249,346,-97
51,59,36,55,184,83,101
51,59,36,59,200,117,83
51,59,36,61,347,702,-355
51,59,36,63,44,0,44
51,59,36,65,32,0,32
51,59,36,67,144,106,38
51,59,36,71,131,32,99
51,59,36,75,26,0,26
51,59,36,81,349,251,98
51,59,36,85,53,37,16
51,59,36,87,41,0,41
51,59,36,91,37,32,5
51,59,36,103,154,102,52
51,59,36,109,48,28,20
51,59,36,111,32,0,32
51,59,36,119,122,109,13
51,59,37,1,0,50,-50
51,59,37,19,0,165,-165
51,59,37,21,36,77,-41
51,59,37,25,0,53,-53
51,59,37,31,0,28,-28
51,59,37,37,0,56,-56
51,59,37,49,58,55,3
51,59,37,51,393,266,127
51,59,37,55,24,74,-50
51,59,37,61,0,34,-34
51,59,37,63,124,239,-115
51,59,37,67,76,93,-17
51,59,37,71,0,37,-37
51,59,37,81,113,118,-5
51,59,37,85,37,47,-10
51,59,37,101,0,40,-40
51,59,37,119,285,631,-346
51,59,37,125,29,60,-31
51,59,37,129,72,144,-72
51,59,37,133,206,152,54
51,59,37,135,49,63,-14
51,59,37,141,0,28,-28
51,59,37,147,38,55,-17
51,59,37,179,0,90,-90
51,59,37,183,348,886,-538
51,59,37,191,33,28,5
51,59,38,101,36,0,36
51,59,39,17,0,39,-39
51,59,39,35,191,132,59
51,59,39,41,47,41,6
51,59,39,49,240,204,36
51,59,39,57,129,64,65
51,59,39,61,87,66,21
51,59,39,93,0,41,-41
51,59,39,95,38,22,16
51,59,39,113,152,50,102
51,59,39,153,39,50,-11
51,59,40,27,32,0,32
51,59,40,31,123,48,75
51,59,40,109,117,104,13
51,59,40,143,79,57,22
51,59,41,5,0,38,-38
51,59,41,39,29,41,-12
51,59,41,51,86,72,14
51,59,41,67,55,40,15
51,59,42,1,0,37,-37
51,59,42,3,397,337,60
51,59,42,7,40,36,4
51,59,42,11,61,50,11
51,59,42,13,32,0,32
51,59,42,17,142,108,34
51,59,42,19,48,26,22
51,59,42,21,67,0,67
51,59,42,27,120,68,52
51,59,42,29,122,164,-42
51,59,42,41,164,149,15
51,59,42,43,77,69,8
51,59,42,45,134,80,54
51,59,42,49,63,28,35
51,59,42,55,36,44,-8
51,59,42,63,27,0,27
51,59,42,69,21,23,-2
51,59,42,71,63,130,-67
51,59,42,77,74,55,19
51,59,42,79,55,0,55
51,59,42,91,212,185,27
51,59,42,95,47,30,17
51,59,42,101,267,236,31
51,59,42,107,24,0,24
51,59,42,129,84,35,49
51,59,42,133,82,87,-5
51,59,44,5,166,75,91
51,59,44,7,79,49,30
51,59,45,3,0,29,-29
51,59,45,13,45,125,-80
51,59,45,15,0,66,-66
51,59,45,19,103,197,-94
51,59,45,35,46,64,-18
51,59,45,43,0,26,-26
51,59,45,45,52,109,-57
51,59,45,51,80,196,-116
51,59,45,63,32,40,-8
51,59,45,77,21,0,21
51,59,45,79,135,138,-3
51,59,45,85,43,39,4
51,59,45,91,41,74,-33
51,59,47,37,109,136,-27
51,59,47,65,0,31,-31
51,59,47,93,72,81,-9
51,59,47,125,273,67,206
51,59,47,149,0,31,-31
51,59,47,157,134,75,59
51,59,47,179,0,26,-26
51,59,47,187,0,57,-57
51,59,48,27,303,190,113
51,59,48,29,426,486,-60
51,59,48,41,76,0,76
51,59,48,61,42,64,-22
51,59,48,85,216,228,-12
51,59,48,99,49,0,49
51,59,48,113,309,336,-27
51,59,48,121,93,139,-46
51,59,48,141,112,173,-61
51,59,48,157,73,98,-25
51,59,48,187,58,0,58
51,59,48,201,435,599,-164
51,59,48,215,0,43,-43
51,59,48,339,52,87,-35
51,59,48,355,62,40,22
51,59,48,439,260,247,13
51,59,48,453,206,273,-67
51,59,48,485,0,37,-37
51,59,48,491,67,75,-8
51,59,49,11,49,47,2
51,59,49,35,151,155,-4
51,59,49,49,121,147,-26
51,59,50,7,42,27,15
51,59,51,3,204,315,-111
51,59,51,13,9110,7857,1253
51,59,51,15,42,43,-1
51,59,51,19,37,62,-25
51,59,51,23,0,31,-31
51,59,51,33,43,76,-33
51,59,51,41,230,355,-125
51,59,51,43,45,106,-61
51,59,51,47,214,362,-148
51,59,51,61,386,724,-338
51,59,51,65,28,68,-40
51,59,51,67,0,50,-50
51,59,51,69,199,378,-179
51,59,51,79,0,62,-62
51,59,51,85,77,91,-14
51,59,51,87,520,552,-32
51,59,51,93,29,30,-1
51,59,51,95,134,220,-86
51,59,51,99,46,60,-14
51,59,51,103,0,36,-36
51,59,51,107,6652,13879,-7227
51,59,51,109,28,57,-29
51,59,51,121,284,217,67
51,59,51,125,0,52,-52
51,59,51,133,0,66,-66
51,59,51,137,68,167,-99
51,59,51,139,0,28,-28
51,59,51,149,39,0,39
51,59,51,153,10404,11671,-1267
51,59,51,157,0,34,-34
51,59,51,161,62,55,7
51,59,51,165,62,67,-5
51,59,51,171,70,184,-114
51,59,51,177,385,640,-255
51,59,51,179,987,1260,-273
51,59,51,187,140,375,-235
51,59,51,191,0,28,-28
51,59,51,193,30,71,-41
51,59,51,199,204,123,81
51,59,51,510,8911,6870,2041
51,59,51,540,124,154,-30
51,59,51,550,207,140,67
51,59,51,590,23,0,23
51,59,51,600,1880,1978,-98
51,59,51,610,553,458,95
51,59,51,630,122,148,-26
51,59,51,650,177,112,65
51,59,51,660,125,90,35
51,59,51,680,74,70,4
51,59,51,683,1067,786,281
51,59,51,685,516,460,56
51,59,51,700,252,188,64
51,59,51,710,360,204,156
51,59,51,730,26,24,2
51,59,51,735,34,0,34
51,59,51,740,44,58,-14
51,59,51,750,36,24,12
51,59,51,760,309,498,-189
51,59,51,770,35,61,-26
51,59,51,790,0,32,-32
51,59,51,800,51,75,-24
51,59,51,810,669,588,81
51,59,51,830,29,48,-19
51,59,51,840,72,125,-53
51,59,53,11,36,30,6
51,59,53,29,37,38,-1
51,59,53,33,347,433,-86
51,59,53,35,65,84,-19
51,59,53,53,231,183,48
51,59,53,61,86,65,21
51,59,53,63,0,52,-52
51,59,53,67,79,49,30
51,59,54,3,83,233,-150
51,59,54,11,38,0,38
51,59,54,27,0,42,-42
51,59,54,37,119,212,-93
51,59,54,39,34,42,-8
51,59,54,61,58,54,4
51,59,54,81,24,0,24
51,59,54,107,23,0,23
51,59,55,25,81,71,10
51,59,55,79,93,48,45
51,59,56,21,32,0,32
51,61,4,13,0,43,-43
51,61,6,37,38,0,38
51,61,11,1,0,39,-39
51,61,24,3,46,0,46
51,61,24,31,60,34,26
51,61,24,33,35,0,35
51,61,45,51,0,29,-29
51,61,51,3,0,37,-37
51,61,51,13,42,63,-21
51,61,51,43,0,29,-29
51,61,51,47,475,747,-272
51,61,51,59,724,386,338
51,61,51,69,48,96,-48
51,61,51,87,0,51,-51
51,61,51,107,313,270,43
51,61,51,113,24,0,24
51,61,51,137,54,72,-18
51,61,51,139,0,34,-34
51,61,51,153,1400,790,610
51,61,51,157,96,97,-1
51,61,51,171,0,36,-36
51,61,51,177,70,96,-26
51,61,51,179,218,174,44
51,61,51,187,148,224,-76
51,61,51,510,40,29,11
51,61,51,600,26,0,26
51,61,51,630,47,0,47
51,61,51,683,279,159,120
51,61,51,685,83,51,32
51,61,51,760,0,32,-32
51,63,51,35,37,40,-3
51,63,51,121,257,218,39
51,63,51,155,47,47,0
51,63,51,161,74,62,12
51,63,51,750,39,0,39
51,63,51,770,64,75,-11
51,65,36,103,34,0,34
51,65,51,3,560,477,83
51,65,51,29,39,36,3
51,65,51,59,68,28,40
51,65,51,79,49,37,12
51,65,51,87,41,38,3
51,65,51,109,124,76,48
51,65,51,125,34,0,34
51,65,51,137,49,0,49
51,65,51,153,38,0,38
51,65,51,540,201,181,20
51,65,51,820,0,31,-31
51,67,37,81,29,29,0
51,67,37,157,44,0,44
51,67,37,183,0,27,-27
51,67,51,19,219,158,61
51,67,51,23,60,60,0
51,67,51,59,50,0,50
51,67,51,89,246,295,-49
51,67,51,121,67,51,16
51,67,51,141,0,28,-28
51,67,51,143,67,60,7
51,67,51,161,391,363,28
51,67,51,690,0,35,-35
51,67,51,770,489,532,-43
51,67,51,775,78,82,-4
51,69,11,1,29,0,29
51,69,24,5,34,0,34
51,69,24,17,40,0,40
51,69,24,21,76,26,50
51,69,24,31,29,0,29
51,69,24,33,37,0,37
51,69,24,43,50,32,18
51,69,37,119,0,31,-31
51,69,51,13,29,0,29
51,69,51,43,280,220,60
51,69,51,59,378,199,179
51,69,51,61,96,48,48
51,69,51,107,524,409,115
51,69,51,121,0,26,-26
51,69,51,139,26,0,26
51,69,51,153,270,89,181
51,69,51,165,0,35,-35
51,69,51,171,426,414,12
51,69,51,187,484,300,184
51,69,51,660,37,43,-6
51,69,51,683,50,0,50
51,69,51,810,46,38,8
51,69,51,840,1937,1619,318
51,69,54,3,391,511,-120
51,69,54,27,190,224,-34
51,69,54,31,37,55,-18
51,69,54,37,104,95,9
51,69,54,65,45,64,-19
51,71,51,121,314,218,96
51,71,51,155,71,79,-8
51,71,51,750,0,26,-26
51,71,51,770,0,28,-28
51,71,54,55,33,64,-31
51,71,54,63,60,81,-21
51,73,51,41,41,37,4
51,73,51,87,0,40,-40
51,73,51,95,124,114,10
51,73,51,97,33,49,-16
51,73,51,101,50,45,5
51,73,51,103,26,0,26
51,73,51,115,134,191,-57
51,73,51,119,122,118,4
51,73,51,199,350,233,117
51,73,51,650,223,166,57
51,73,51,700,667,356,311
51,73,51,710,41,21,20
51,73,51,735,33,0,33
51,73,51,760,0,41,-41
51,73,51,810,50,36,14
51,73,51,830,34,0,34
51,75,51,3,38,30,8
51,75,51,41,212,116,96
51,75,51,85,118,76,42
51,75,51,87,785,486,299
51,75,51,109,95,58,37
51,75,51,760,167,149,18
51,77,37,5,55,69,-14
51,77,37,9,38,29,9
51,77,51,35,140,149,-9
51,77,51,173,0,52,-52
51,77,51,197,0,43,-43
51,77,51,640,86,100,-14
51,79,51,3,488,426,62
51,79,51,47,31,0,31
51,79,51,59,62,0,62
51,79,51,65,37,49,-12
51,79,51,87,0,26,-26
51,79,51,109,29,65,-36
51,79,51,113,75,54,21
51,79,51,137,67,92,-25
51,79,51,540,127,112,15
51,79,51,820,0,39,-39
51,81,51,25,70,43,27
51,81,51,183,0,37,-37
51,81,51,595,51,64,-13
51,83,37,63,0,28,-28
51,83,37,145,71,94,-23
51,83,51,31,57,84,-27
51,83,51,37,94,55,39
51,83,51,41,0,34,-34
51,83,51,87,26,58,-32
51,83,51,117,113,38,75
51,83,51,143,112,102,10
51,83,51,590,71,122,-51
51,83,51,680,0,37,-37
51,83,51,760,0,30,-30
51,85,36,103,27,0,27
51,85,37,119,0,35,-35
51,85,51,33,204,204,0
51,85,51,36,35,29,6
51,85,51,41,468,463,5
51,85,51,57,56,0,56
51,85,51,59,91,77,14
51,85,51,75,76,118,-42
51,85,51,87,2820,2313,507
51,85,51,95,48,0,48
51,85,51,97,0,37,-37
51,85,51,101,248,370,-122
51,85,51,109,165,150,15
51,85,51,127,86,125,-39
51,85,51,145,32,41,-9
51,85,51,153,0,38,-38
51,85,51,177,124,70,54
51,85,51,179,42,0,42
51,85,51,550,34,0,34
51,85,51,700,57,0,57
51,85,51,710,49,28,21
51,85,51,760,645,621,24
51,85,51,810,61,52,9
51,87,1,73,0,31,-31
51,87,4,13,126,70,56
51,87,6,1,0,55,-55
51,87,6,37,114,99,15
51,87,6,59,48,38,10
51,87,6,73,68,46,22
51,87,6,75,0,22,-22
51,87,6,85,33,57,-24
51,87,8,31,0,29,-29
51,87,8,41,49,0,49
51,87,9,1,70,82,-12
51,87,9,3,61,34,27
51,87,9,9,49,37,12
51,87,10,3,63,61,2
51,87,11,1,73,112,-39
51,87,12,11,47,57,-10
51,87,12,31,47,61,-14
51,87,12,57,82,57,25
51,87,12,71,27,39,-12
51,87,12,81,29,0,29
51,87,12,86,73,42,31
51,87,12,95,69,67,2
51,87,12,99,63,49,14
51,87,12,103,62,0,62
51,87,12,115,0,32,-32
51,87,12,117,0,36,-36
51,87,13,51,31,0,31
51,87,13,67,70,56,14
51,87,13,89,70,77,-7
51,87,13,121,116,116,0
51,87,13,135,65,58,7
51,87,15,3,0,25,-25
51,87,17,31,133,121,12
51,87,17,43,50,39,11
51,87,18,97,0,26,-26
51,87,19,163,0,56,-56
51,87,20,91,0,45,-45
51,87,21,111,0,36,-36
51,87,24,3,63,68,-5
51,87,24,5,87,110,-23
51,87,24,21,0,31,-31
51,87,24,27,51,35,16
51,87,24,31,142,156,-14
51,87,24,33,156,91,65
51,87,24,510,47,53,-6
51,87,25,17,50,70,-20
51,87,25,21,0,33,-33
51,87,26,125,66,0,66
51,87,26,163,61,24,37
51,87,27,53,53,38,15
51,87,29,189,29,64,-35
51,87,32,3,37,44,-7
51,87,34,3,48,28,20
51,87,34,13,54,37,17
51,87,34,17,36,32,4
51,87,34,23,99,98,1
51,87,34,35,34,0,34
51,87,34,39,36,0,36
51,87,36,5,99,67,32
51,87,36,29,40,0,40
51,87,36,47,244,62,182
51,87,36,55,31,0,31
51,87,36,59,41,0,41
51,87,36,61,74,90,-16
51,87,36,67,24,0,24
51,87,36,81,138,78,60
51,87,36,103,71,39,32
51,87,36,119,85,0,85
51,87,37,25,34,0,34
51,87,37,51,45,50,-5
51,87,37,55,0,41,-41
51,87,37,63,0,62,-62
51,87,37,67,40,49,-9
51,87,37,81,45,111,-66
51,87,37,119,150,253,-103
51,87,37,129,0,27,-27
51,87,37,133,43,0,43
51,87,37,147,31,0,31
51,87,37,183,145,260,-115
51,87,39,35,53,67,-14
51,87,39,49,45,74,-29
51,87,39,61,30,0,30
51,87,39,113,32,0,32
51,87,42,3,90,68,22
51,87,42,11,26,0,26
51,87,42,27,36,0,36
51,87,42,29,48,35,13
51,87,42,45,0,44,-44
51,87,42,91,58,32,26
51,87,42,101,55,47,8
51,87,45,19,44,36,8
51,87,45,45,0,29,-29
51,87,45,51,33,51,-18
51,87,45,91,0,49,-49
51,87,47,37,44,51,-7
51,87,47,93,28,0,28
51,87,47,157,31,47,-16
51,87,48,29,42,62,-20
51,87,48,85,52,77,-25
51,87,48,113,71,96,-25
51,87,48,121,0,62,-62
51,87,48,201,106,150,-44
51,87,48,439,43,73,-30
51,87,48,453,27,54,-27
51,87,49,35,53,38,15
51,87,51,3,193,144,49
51,87,51,7,31,56,-25
51,87,51,9,27,0,27
51,87,51,13,114,128,-14
51,87,51,15,43,37,6
51,87,51,19,30,35,-5
51,87,51,25,52,0,52
51,87,51,31,0,26,-26
51,87,51,33,188,179,9
51,87,51,36,170,189,-19
51,87,51,41,3143,4148,-1005
51,87,51,47,31,0,31
51,87,51,49,43,56,-13
51,87,51,53,83,48,35
51,87,51,57,55,89,-34
51,87,51,59,552,520,32
51,87,51,61,51,0,51
51,87,51,65,38,41,-3
51,87,51,73,40,0,40
51,87,51,75,486,785,-299
51,87,51,79,26,0,26
51,87,51,83,58,26,32
51,87,51,85,2313,2820,-507
51,87,51,93,28,0,28
51,87,51,95,134,94,40
51,87,51,97,62,57,5
51,87,51,101,178,308,-130
51,87,51,103,34,28,6
51,87,51,107,135,129,6
51,87,51,109,256,290,-34
51,87,51,117,29,55,-26
51,87,51,119,58,53,5
51,87,51,121,128,60,68
51,87,51,127,269,419,-150
51,87,51,133,30,36,-6
51,87,51,135,31,44,-13
51,87,51,137,37,36,1
51,87,51,143,34,0,34
51,87,51,145,132,251,-119
51,87,51,147,54,39,15
51,87,51,149,89,75,14
51,87,51,153,269,175,94
51,87,51,159,31,0,31
51,87,51,161,86,50,36
51,87,51,165,31,33,-2
51,87,51,177,166,129,37
51,87,51,179,132,87,45
51,87,51,199,66,42,24
51,87,51,510,62,65,-3
51,87,51,540,82,66,16
51,87,51,550,107,98,9
51,87,51,570,114,59,55
51,87,51,590,37,0,37
51,87,51,630,59,28,31
51,87,51,650,124,70,54
51,87,51,660,40,0,40
51,87,51,670,133,140,-7
51,87,51,680,72,45,27
51,87,51,683,34,0,34
51,87,51,700,211,183,28
51,87,51,710,184,80,104
51,87,51,730,146,137,9
51,87,51,740,60,46,14
51,87,51,760,7683,6431,1252
51,87,51,770,53,76,-23
51,87,51,800,33,25,8
51,87,51,810,298,274,24
51,87,51,830,43,0,43
51,87,53,33,28,74,-46
51,87,54,39,28,0,28
51,89,37,67,0,53,-53
51,89,37,81,88,103,-15
51,89,37,157,169,286,-117
51,89,51,67,295,246,49
51,89,51,121,0,27,-27
51,89,51,141,240,188,52
51,89,51,143,105,158,-53
51,89,51,161,31,51,-20
51,89,51,590,76,55,21
51,89,51,690,570,625,-55
51,89,51,770,30,54,-24
51,93,51,41,30,0,30
51,93,51,59,30,29,1
51,93,51,87,0,28,-28
51,93,51,95,0,32,-32
51,93,51,175,82,135,-53
51,93,51,181,51,87,-36
51,93,51,199,131,42,89
51,93,51,550,183,102,81
51,93,51,620,36,53,-17
51,93,51,650,365,221,144
51,93,51,700,520,370,150
51,93,51,710,74,100,-26
51,93,51,735,38,0,38
51,93,51,740,209,136,73
51,93,51,800,478,434,44
51,93,51,810,183,122,61
51,95,4,13,34,0,34
51,95,6,37,37,31,6
51,95,6,73,49,34,15
51,95,11,1,0,33,-33
51,95,12,11,32,0,32
51,95,12,95,40,0,40
51,95,15,3,44,0,44
51,95,24,31,35,44,-9
51,95,34,3,32,0,32
51,95,34,27,39,0,39
51,95,36,59,47,0,47
51,95,36,61,0,22,-22
51,95,36,103,32,0,32
51,95,37,119,0,44,-44
51,95,37,183,57,32,25
51,95,51,13,37,39,-2
51,95,51,36,26,51,-25
51,95,51,41,136,87,49
51,95,51,59,220,134,86
51,95,51,73,114,124,-10
51,95,51,85,0,48,-48
51,95,51,87,94,134,-40
51,95,51,93,32,0,32
51,95,51,97,0,37,-37
51,95,51,101,53,110,-57
51,95,51,107,52,29,23
51,95,51,127,126,277,-151
51,95,51,153,48,27,21
51,95,51,181,50,27,23
51,95,51,199,619,378,241
51,95,51,510,40,0,40
51,95,51,550,98,33,65
51,95,51,650,365,195,170
51,95,51,700,1017,633,384
51,95,51,710,83,69,14
51,95,51,735,43,0,43
51,95,51,740,35,0,35
51,95,51,760,83,126,-43
51,95,51,800,45,0,45
51,95,51,810,192,138,54
51,95,51,830,484,352,132
51,97,51,57,32,66,-34
51,97,51,73,49,33,16
51,97,51,85,37,0,37
51,97,51,87,57,62,-5
51,97,51,95,37,0,37
51,97,51,101,108,106,2
51,99,6,73,60,140,-80
51,99,15,3,52,54,-2
51,99,17,97,74,0,74
51,99,24,9,45,0,45
51,99,24,17,389,91,298
51,99,24,33,105,52,53
51,99,24,37,31,0,31
51,99,51,33,68,131,-63
51,99,51,59,60,46,14
51,99,51,153,93,50,43
51,99,51,177,334,251,83
51,99,51,179,313,223,90
51,99,51,193,170,256,-86
51,99,51,510,46,0,46
51,99,51,630,136,162,-26
51,99,51,810,57,72,-15
51,101,51,33,0,32,-32
51,101,51,41,76,55,21
51,101,51,57,40,40,0
51,101,51,73,45,50,-5
51,101,51,85,370,248,122
51,101,51,87,308,178,130
51,101,51,95,110,53,57
51,101,51,97,106,108,-2
51,101,51,127,39,53,-14
51,101,51,700,36,29,7
51,101,51,760,44,53,-9
51,103,51,59,36,0,36
51,103,51,73,0,26,-26
51,103,51,87,28,34,-6
51,103,51,119,0,37,-37
51,103,51,133,122,110,12
51,103,51,159,29,0,29
51,103,51,700,0,28,-28
51,105,21,13,58,74,-16
51,105,21,95,0,34,-34
51,105,47,25,67,85,-18
51,105,47,73,0,32,-32
51,105,47,163,43,47,-4
51,105,47,179,0,34,-34
51,105,51,169,46,70,-24
51,105,51,195,219,163,56
51,107,1,89,0,59,-59
51,107,4,13,213,154,59
51,107,4,19,38,43,-5
51,107,6,1,53,49,4
51,107,6,13,0,34,-34
51,107,6,37,193,214,-21
51,107,6,53,45,0,45
51,107,6,59,128,79,49
51,107,6,67,33,0,33
51,107,6,71,31,36,-5
51,107,6,73,177,172,5
51,107,6,75,0,36,-36
51,107,6,83,32,0,32
51,107,6,85,72,94,-22
51,107,8,5,49,36,13
51,107,8,13,0,42,-42
51,107,8,31,26,37,-11
51,107,8,35,43,76,-33
51,107,8,41,114,80,34
51,107,8,59,0,42,-42
51,107,9,1,78,36,42
51,107,9,3,44,36,8
51,107,9,9,30,32,-2
51,107,10,3,49,29,20
51,107,10,5,32,61,-29
51,107,11,1,545,434,111
51,107,12,9,69,53,16
51,107,12,11,164,124,40
51,107,12,21,0,29,-29
51,107,12,31,43,57,-14
51,107,12,33,0,30,-30
51,107,12,57,131,101,30
51,107,12,71,43,44,-1
51,107,12,81,0,37,-37
51,107,12,86,125,121,4
51,107,12,91,43,0,43
51,107,12,95,130,111,19
51,107,12,99,114,89,25
51,107,12,101,0,35,-35
51,107,12,103,44,58,-14
51,107,12,117,62,0,62
51,107,12,127,37,0,37
51,107,13,57,0,37,-37
51,107,13,67,66,88,-22
51,107,13,89,78,28,50
51,107,13,121,91,113,-22
51,107,13,135,70,99,-29
51,107,15,3,121,75,46
51,107,17,31,118,150,-32
51,107,17,43,47,49,-2
51,107,18,57,0,44,-44
51,107,20,91,92,44,48
51,107,21,111,0,38,-38
51,107,24,3,258,149,109
51,107,24,5,167,61,106
51,107,24,13,43,0,43
51,107,24,17,94,40,54
51,107,24,21,300,178,122
51,107,24,25,43,0,43
51,107,24,27,182,109,73
51,107,24,31,1230,512,718
51,107,24,33,562,252,310
51,107,24,43,79,31,48
51,107,24,510,77,47,30
51,107,25,17,98,66,32
51,107,25,21,43,45,-2
51,107,25,25,27,40,-13
51,107,25,27,23,39,-16
51,107,26,99,32,0,32
51,107,26,125,74,0,74
51,107,26,163,70,0,70
51,107,27,53,0,33,-33
51,107,29,95,32,0,32
51,107,29,189,62,27,35
51,107,32,3,106,101,5
51,107,33,11,29,0,29
51,107,34,3,60,44,16
51,107,34,5,59,0,59
51,107,34,13,35,0,35
51,107,34,17,44,39,5
51,107,34,21,35,0,35
51,107,34,23,59,61,-2
51,107,34,25,30,0,30
51,107,34,27,49,52,-3
51,107,34,35,37,0,37
51,107,35,1,30,0,30
51,107,36,5,45,0,45
51,107,36,29,57,0,57
51,107,36,47,46,78,-32
51,107,36,55,83,0,83
51,107,36,59,85,39,46
51,107,36,61,81,58,23
51,107,36,67,44,0,44
51,107,36,71,0,38,-38
51,107,36,81,125,48,77
51,107,36,103,84,45,39
51,107,36,119,31,0,31
51,107,37,19,0,37,-37
51,107,37,49,0,34,-34
51,107,37,63,0,46,-46
51,107,37,67,32,0,32
51,107,37,81,39,43,-4
51,107,37,119,117,160,-43
51,107,37,129,0,56,-56
51,107,37,133,56,39,17
51,107,37,179,0,66,-66
51,107,37,183,146,286,-140
51,107,39,35,53,0,53
51,107,39,49,78,63,15
51,107,39,113,43,0,43
51,107,39,153,24,0,24
51,107,41,51,0,27,-27
51,107,42,3,72,91,-19
51,107,42,17,0,46,-46
51,107,42,29,65,93,-28
51,107,42,43,26,0,26
51,107,42,45,42,0,42
51,107,42,71,38,0,38
51,107,42,77,32,0,32
51,107,42,91,71,44,27
51,107,42,101,45,44,1
51,107,42,129,25,0,25
51,107,42,133,38,41,-3
51,107,45,13,0,41,-41
51,107,45,19,0,60,-60
51,107,45,51,0,40,-40
51,107,45,79,47,0,47
51,107,45,91,0,39,-39
51,107,47,37,44,28,16
51,107,47,93,36,0,36
51,107,47,157,49,0,49
51,107,47,187,0,38,-38
51,107,48,29,74,121,-47
51,107,48,61,44,0,44
51,107,48,85,75,93,-18
51,107,48,113,79,129,-50
51,107,48,121,61,65,-4
51,107,48,157,0,47,-47
51,107,48,201,110,168,-58
51,107,48,439,52,129,-77
51,107,48,453,39,47,-8
51,107,49,35,60,41,19
51,107,49,49,49,54,-5
51,107,51,3,51,52,-1
51,107,51,13,1095,810,285
51,107,51,19,0,30,-30
51,107,51,41,76,93,-17
51,107,51,43,185,329,-144
51,107,51,47,86,64,22
51,107,51,59,13879,6652,7227
51,107,51,61,270,313,-43
51,107,51,69,409,524,-115
51,107,51,87,129,135,-6
51,107,51,95,29,52,-23
51,107,51,109,0,40,-40
51,107,51,121,69,52,17
51,107,51,137,38,37,1
51,107,51,153,1705,1234,471
51,107,51,171,42,36,6
51,107,51,177,79,92,-13
51,107,51,179,134,140,-6
51,107,51,187,108,137,-29
51,107,51,199,41,64,-23
51,107,51,510,679,312,367
51,107,51,540,0,31,-31
51,107,51,550,66,48,18
51,107,51,600,227,151,76
51,107,51,610,108,115,-7
51,107,51,630,41,0,41
51,107,51,650,59,0,59
51,107,51,660,39,35,4
51,107,51,680,40,0,40
51,107,51,683,284,178,106
51,107,51,685,90,76,14
51,107,51,700,87,22,65
51,107,51,710,42,36,6
51,107,51,750,28,0,28
51,107,51,760,48,104,-56
51,107,51,810,142,135,7
51,107,51,840,107,144,-37
51,107,53,33,64,77,-13
51,107,53,53,49,36,13
51,107,53,61,39,0,39
51,107,54,3,180,279,-99
51,107,54,37,304,574,-270
51,107,55,25,28,0,28
51,109,51,3,319,254,65
51,109,51,33,46,0,46
51,109,51,41,86,42,44
51,109,51,47,49,0,49
51,109,51,59,57,28,29
51,109,51,65,76,124,-48
51,109,51,75,58,95,-37
51,109,51,79,65,29,36
51,109,51,85,150,165,-15
51,109,51,87,290,256,34
51,109,51,107,40,0,40
51,109,51,113,42,0,42
51,109,51,137,143,104,39
51,109,51,153,87,53,34
51,109,51,177,205,156,49
51,109,51,179,79,48,31
51,109,51,540,154,65,89
51,109,51,760,66,73,-7
51,111,51,25,32,71,-39
51,111,51,37,0,37,-37
51,111,51,41,30,0,30
51,111,51,117,77,111,-34
51,111,51,135,102,88,14
51,111,51,147,23,62,-39
51,111,51,760,28,49,-21
51,113,51,3,0,85,-85
51,113,51,47,262,179,83
51,113,51,61,0,24,-24
51,113,51,79,54,75,-21
51,113,51,109,0,42,-42
51,113,51,137,89,188,-99
51,115,51,73,191,134,57
51,115,51,119,0,52,-52
51,115,51,700,57,35,22
51,117,24,33,25,0,25
51,117,37,77,46,0,46
51,117,37,181,25,50,-25
51,117,37,183,46,52,-6
51,117,37,185,31,57,-26
51,117,51,25,258,212,46
51,117,51,37,89,59,30
51,117,51,41,55,73,-18
51,117,51,83,38,113,-75
51,117,51,87,55,29,26
51,117,51,111,111,77,34
51,117,51,760,63,48,15
51,117,51,810,40,0,40
51,119,51,41,47,0,47
51,119,51,73,118,122,-4
51,119,51,87,53,58,-5
51,119,51,103,37,0,37
51,119,51,115,52,0,52
51,119,51,700,45,31,14
51,119,51,760,29,0,29
51,121,4,13,30,28,2
51,121,6,1,0,28,-28
51,121,6,37,0,47,-47
51,121,6,73,0,32,-32
51,121,11,1,30,0,30
51,121,12,95,0,23,-23
51,121,17,31,0,43,-43
51,121,18,157,30,0,30
51,121,24,3,0,25,-25
51,121,24,27,0,32,-32
51,121,24,31,47,64,-17
51,121,24,33,27,0,27
51,121,25,17,0,32,-32
51,121,37,67,34,30,4
51,121,37,81,37,40,-3
51,121,37,119,43,92,-49
51,121,37,183,28,88,-60
51,121,42,3,0,39,-39
51,121,42,101,0,24,-24
51,121,45,19,0,30,-30
51,121,47,93,33,34,-1
51,121,47,163,0,33,-33
51,121,48,201,0,49,-49
51,121,48,453,0,29,-29
51,121,51,3,60,47,13
51,121,51,13,45,61,-16
51,121,51,15,35,33,2
51,121,51,19,68,60,8
51,121,51,23,58,46,12
51,121,51,31,0,32,-32
51,121,51,35,38,27,11
51,121,51,41,66,81,-15
51,121,51,45,0,24,-24
51,121,51,59,217,284,-67
51,121,51,63,218,257,-39
51,121,51,67,51,67,-16
51,121,51,69,26,0,26
51,121,51,71,218,314,-96
51,121,51,87,60,128,-68
51,121,51,89,27,0,27
51,121,51,107,52,69,-17
51,121,51,153,71,69,2
51,121,51,155,538,527,11
51,121,51,161,291,295,-4
51,121,51,165,37,0,37
51,121,51,173,31,0,31
51,121,51,179,40,0,40
51,121,51,185,48,0,48
51,121,51,191,28,0,28
51,121,51,197,70,42,28
51,121,51,199,28,0,28
51,121,51,510,0,35,-35
51,121,51,550,43,42,1
51,121,51,660,0,27,-27
51,121,51,680,37,0,37
51,121,51,700,25,33,-8
51,121,51,710,46,28,18
51,121,51,750,436,418,18
51,121,51,760,52,74,-22
51,121,51,770,221,246,-25
51,121,51,775,155,144,11
51,121,51,790,29,0,29
51,121,51,810,64,61,3
51,121,53,33,0,30,-30
51,121,54,55,44,32,12
51,125,51,3,196,167,29
51,125,51,9,125,138,-13
51,125,51,15,49,45,4
51,125,51,59,52,0,52
51,125,51,65,0,34,-34
51,125,51,540,103,54,49
51,125,51,820,56,65,-9
51,127,51,36,55,81,-26
51,127,51,41,146,47,99
51,127,51,85,125,86,39
51,127,51,87,419,269,150
51,127,51,95,277,126,151
51,127,51,101,53,39,14
51,127,51,199,43,0,43
51,127,51,700,108,57,51
51,127,51,760,52,85,-33
51,127,51,830,28,0,28
51,131,51,1,227,183,44
51,131,51,710,28,31,-3
51,131,51,810,60,73,-13
51,133,51,59,66,0,66
51,133,51,87,36,30,6
51,133,51,103,110,122,-12
51,133,51,153,33,0,33
51,133,51,159,89,94,-5
51,133,51,193,75,55,20
51,133,51,760,0,29,-29
51,135,51,7,129,83,46
51,135,51,41,137,126,11
51,135,51,53,56,49,7
51,135,51,87,44,31,13
51,135,51,111,88,102,-14
51,135,51,147,115,85,30
51,135,51,760,42,37,5
51,137,24,33,46,0,46
51,137,51,3,171,134,37
51,137,51,13,33,0,33
51,137,51,33,48,27,21
51,137,51,47,266,219,47
51,137,51,59,167,68,99
51,137,51,61,72,54,18
51,137,51,65,0,49,-49
51,137,51,79,92,67,25
51,137,51,87,36,37,-1
51,137,51,107,37,38,-1
51,137,51,109,104,143,-39
51,137,51,113,188,89,99
51,137,51,153,185,122,63
51,137,51,177,607,353,254
51,137,51,179,225,124,101
51,137,51,540,77,69,8
51,137,51,630,146,78,68
51,137,51,760,29,0,29
51,139,51,59,28,0,28
51,139,51,61,34,0,34
51,139,51,69,0,26,-26
51,139,51,153,31,0,31
51,139,51,165,283,257,26
51,139,51,171,70,71,-1
51,139,51,187,128,76,52
51,139,51,660,65,69,-4
51,141,37,171,128,104,24
51,141,51,35,32,28,4
51,141,51,67,28,0,28
51,141,51,89,188,240,-52
51,141,51,690,0,28,-28
51,143,37,1,0,39,-39
51,143,37,33,103,117,-14
51,143,37,81,49,86,-37
51,143,37,157,90,86,4
51,143,45,51,0,30,-30
51,143,51,19,52,28,24
51,143,51,31,374,269,105
51,143,51,41,31,36,-5
51,143,51,67,60,67,-7
51,143,51,83,102,112,-10
51,143,51,87,0,34,-34
51,143,51,89,158,105,53
51,143,51,161,0,26,-26
51,143,51,590,1273,1183,90
51,143,51,680,76,93,-17
51,143,51,690,51,40,11
51,143,51,760,0,27,-27
51,143,51,770,39,0,39
51,143,51,810,32,35,-3
51,145,51,7,48,92,-44
51,145,51,41,868,550,318
51,145,51,49,67,114,-47
51,145,51,85,41,32,9
51,145,51,87,251,132,119
51,145,51,760,128,92,36
51,147,51,7,68,60,8
51,147,51,11,40,43,-3
51,147,51,29,98,87,11
51,147,51,37,82,96,-14
51,147,51,41,100,88,12
51,147,51,49,94,47,47
51,147,51,87,39,54,-15
51,147,51,111,62,23,39
51,147,51,135,85,115,-30
51,147,51,760,35,54,-19
51,149,8,41,64,49,15
51,149,15,3,46,51,-5
51,149,21,47,56,0,56
51,149,36,45,72,0,72
51,149,37,51,83,134,-51
51,149,47,125,55,119,-64
51,149,48,27,75,100,-25
51,149,48,29,0,38,-38
51,149,51,41,599,508,91
51,149,51,53,142,250,-108
51,149,51,59,0,39,-39
51,149,51,87,75,89,-14
51,149,51,181,39,0,39
51,149,51,183,83,110,-27
51,149,51,570,269,239,30
51,149,51,670,509,422,87
51,149,51,700,43,32,11
51,149,51,710,0,26,-26
51,149,51,730,565,319,246
51,149,51,760,98,78,20
51,149,53,53,44,0,44
51,153,1,1,56,0,56
51,153,1,73,41,0,41
51,153,1,89,58,182,-124
51,153,1,101,88,44,44
51,153,2,20,0,42,-42
51,153,4,3,39,31,8
51,153,4,13,85,134,-49
51,153,4,19,64,37,27
51,153,4,27,78,37,41
51,153,6,1,46,0,46
51,153,6,29,39,0,39
51,153,6,37,285,219,66
51,153,6,53,131,62,69
51,153,6,59,141,86,55
51,153,6,65,103,79,24
51,153,6,67,29,0,29
51,153,6,71,170,179,-9
51,153,6,73,736,614,122
51,153,6,85,45,60,-15
51,153,6,95,47,0,47
51,153,6,111,39,0,39
51,153,8,5,33,0,33
51,153,8,35,0,50,-50
51,153,8,41,150,155,-5
51,153,9,1,0,39,-39
51,153,9,3,29,0,29
51,153,9,9,43,27,16
51,153,9,11,48,0,48
51,153,10,3,52,30,22
51,153,10,5,0,34,-34
51,153,11,1,596,437,159
51,153,12,5,35,0,35
51,153,12,9,82,29,53
51,153,12,11,138,98,40
51,153,12,19,0,30,-30
51,153,12,31,122,77,45
51,153,12,33,69,58,11
51,153,12,35,0,24,-24
51,153,12,57,130,190,-60
51,153,12,69,25,34,-9
51,153,12,71,52,52,0
51,153,12,73,26,0,26
51,153,12,81,37,0,37
51,153,12,86,113,100,13
51,153,12,91,61,63,-2
51,153,12,95,138,116,22
51,153,12,97,0,43,-43
51,153,12,99,71,83,-12
51,153,12,101,0,50,-50
51,153,12,103,34,60,-26
51,153,12,105,39,49,-10
51,153,12,109,0,37,-37
51,153,12,113,0,43,-43
51,153,12,117,37,63,-26
51,153,12,127,48,38,10
51,153,13,51,42,0,42
51,153,13,63,0,49,-49
51,153,13,67,56,49,7
51,153,13,89,55,67,-12
51,153,13,121,78,106,-28
51,153,13,135,103,122,-19
51,153,13,151,35,0,35
51,153,13,153,43,0,43
51,153,13,215,41,0,41
51,153,13,245,41,0,41
51,153,15,3,370,227,143
51,153,16,1,149,111,38
51,153,17,31,122,89,33
51,153,17,97,25,33,-8
51,153,17,163,61,82,-21
51,153,18,57,0,58,-58
51,153,18,97,37,74,-37
51,153,20,91,36,46,-10
51,153,20,103,111,75,36
51,153,21,111,0,50,-50
51,153,22,103,0,47,-47
51,153,24,3,281,233,48
51,153,24,5,162,136,26
51,153,24,9,39,0,39
51,153,24,17,140,153,-13
51,153,24,21,73,86,-13
51,153,24,25,64,58,6
51,153,24,27,105,93,12
51,153,24,31,686,745,-59
51,153,24,33,1148,1124,24
51,153,24,37,50,30,20
51,153,24,45,0,24,-24
51,153,24,510,70,86,-16
51,153,25,17,79,69,10
51,153,25,25,30,44,-14
51,153,25,27,53,39,14
51,153,26,49,40,0,40
51,153,26,99,37,0,37
51,153,26,125,52,37,15
51,153,26,163,78,0,78
51,153,27,53,0,29,-29
51,153,28,47,0,32,-32
51,153,29,95,38,0,38
51,153,29,189,0,40,-40
51,153,31,55,39,0,39
51,153,31,153,36,0,36
51,153,32,3,71,135,-64
51,153,33,11,37,0,37
51,153,34,3,50,0,50
51,153,34,5,48,47,1
51,153,34,7,37,0,37
51,153,34,13,39,37,2
51,153,34,17,29,33,-4
51,153,34,23,60,47,13
51,153,34,25,70,37,33
51,153,34,27,42,0,42
51,153,34,31,35,0,35
51,153,34,35,30,0,30
51,153,35,1,39,0,39
51,153,36,5,183,138,45
51,153,36,29,83,25,58
51,153,36,45,55,0,55
51,153,36,47,112,94,18
51,153,36,55,70,0,70
51,153,36,59,64,55,9
51,153,36,61,103,70,33
51,153,36,67,33,28,5
51,153,36,71,44,0,44
51,153,36,81,158,107,51
51,153,36,103,81,50,31
51,153,36,119,54,46,8
51,153,37,19,0,48,-48
51,153,37,25,0,42,-42
51,153,37,35,0,40,-40
51,153,37,49,102,110,-8
51,153,37,51,154,147,7
51,153,37,63,0,43,-43
51,153,37,67,26,50,-24
51,153,37,81,52,72,-20
51,153,37,85,0,38,-38
51,153,37,101,0,47,-47
51,153,37,119,90,223,-133
51,153,37,129,32,34,-2
51,153,37,133,625,466,159
51,153,37,179,0,34,-34
51,153,37,183,133,357,-224
51,153,39,35,57,31,26
51,153,39,49,91,82,9
51,153,39,57,0,48,-48
51,153,39,113,64,0,64
51,153,39,153,32,0,32
51,153,40,31,44,0,44
51,153,40,109,0,42,-42
51,153,41,67,24,0,24
51,153,42,3,97,167,-70
51,153,42,29,31,39,-8
51,153,42,41,89,0,89
51,153,42,43,36,22,14
51,153,42,45,26,0,26
51,153,42,71,0,32,-32
51,153,42,91,50,56,-6
51,153,42,101,72,68,4
51,153,42,129,31,33,-2
51,153,42,133,0,40,-40
51,153,44,5,68,43,25
51,153,44,7,55,38,17
51,153,45,13,140,89,51
51,153,45,15,0,44,-44
51,153,45,19,54,53,1
51,153,45,35,0,40,-40
51,153,45,45,0,35,-35
51,153,45,51,55,157,-102
51,153,45,79,80,68,12
51,153,45,91,0,48,-48
51,153,47,37,55,44,11
51,153,47,93,0,29,-29
51,153,47,125,160,0,160
51,153,47,149,0,28,-28
51,153,47,157,66,38,28
51,153,48,27,68,79,-11
51,153,48,29,171,126,45
51,153,48,61,0,44,-44
51,153,48,85,34,71,-37
51,153,48,113,71,159,-88
51,153,48,121,35,79,-44
51,153,48,141,73,46,27
51,153,48,157,0,32,-32
51,153,48,201,140,383,-243
51,153,48,215,0,39,-39
51,153,48,339,0,44,-44
51,153,48,355,0,31,-31
51,153,48,439,80,117,-37
51,153,48,453,35,79,-44
51,153,48,491,0,57,-57
51,153,49,35,41,68,-27
51,153,49,49,54,91,-37
51,153,51,3,55,103,-48
51,153,51,13,1185,1301,-116
51,153,51,19,0,32,-32
51,153,51,33,114,222,-108
51,153,51,41,131,185,-54
51,153,51,43,0,41,-41
51,153,51,47,471,461,10
51,153,51,59,11671,10404,1267
51,153,51,61,790,1400,-610
51,153,51,65,0,38,-38
51,153,51,69,89,270,-181
51,153,51,85,38,0,38
51,153,51,87,175,269,-94
51,153,51,95,27,48,-21
51,153,51,99,50,93,-43
51,153,51,107,1234,1705,-471
51,153,51,109,53,87,-34
51,153,51,121,69,71,-2
51,153,51,133,0,33,-33
51,153,51,137,122,185,-63
51,153,51,139,0,31,-31
51,153,51,157,0,32,-32
51,153,51,161,0,37,-37
51,153,51,165,0,27,-27
51,153,51,171,74,115,-41
51,153,51,177,804,1025,-221
51,153,51,179,2094,3065,-971
51,153,51,187,192,306,-114
51,153,51,193,28,0,28
51,153,51,199,43,41,2
51,153,51,510,1664,1706,-42
51,153,51,540,0,33,-33
51,153,51,550,113,125,-12
51,153,51,600,282,248,34
51,153,51,630,199,232,-33
51,153,51,650,116,81,35
51,153,51,660,33,77,-44
51,153,51,680,0,54,-54
51,153,51,683,2999,2815,184
51,153,51,685,933,867,66
51,153,51,700,191,89,102
51,153,51,710,130,109,21
51,153,51,740,40,0,40
51,153,51,760,99,186,-87
51,153,51,800,39,39,0
51,153,51,810,303,279,24
51,153,51,840,62,56,6
51,153,53,33,65,73,-8
51,153,53,53,76,70,6
51,153,54,3,86,125,-39
51,153,54,37,41,67,-26
51,153,54,39,0,29,-29
51,155,51,35,51,68,-17
51,155,51,63,47,47,0
51,155,51,71,79,71,8
51,155,51,121,527,538,-11
51,155,51,161,0,28,-28
51,155,51,185,46,30,16
51,155,51,197,154,171,-17
51,155,51,750,262,248,14
51,155,51,770,52,42,10
51,155,54,55,26,0,26
51,157,51,47,69,145,-76
51,157,51,59,34,0,34
51,157,51,61,97,96,1
51,157,51,153,32,0,32
51,157,51,187,63,75,-12
51,159,51,57,80,103,-23
51,159,51,87,0,31,-31
51,159,51,103,0,29,-29
51,159,51,133,94,89,5
51,159,51,193,101,76,25
51,161,6,73,0,27,-27
51,161,12,57,26,0,26
51,161,26,163,0,38,-38
51,161,37,67,38,0,38
51,161,37,81,43,42,1
51,161,37,119,43,83,-40
51,161,37,183,43,63,-20
51,161,45,51,0,32,-32
51,161,51,5,27,0,27
51,161,51,13,26,30,-4
51,161,51,19,460,444,16
51,161,51,23,410,616,-206
51,161,51,31,26,29,-3
51,161,51,41,53,72,-19
51,161,51,45,78,71,7
51,161,51,59,55,62,-7
51,161,51,63,62,74,-12
51,161,51,67,363,391,-28
51,161,51,87,50,86,-36
51,161,51,89,51,31,20
51,161,51,121,295,291,4
51,161,51,143,26,0,26
51,161,51,153,37,0,37
51,161,51,155,28,0,28
51,161,51,185,39,0,39
51,161,51,515,35,0,35
51,161,51,550,49,0,49
51,161,51,660,0,26,-26
51,161,51,680,44,48,-4
51,161,51,700,39,0,39
51,161,51,750,41,0,41
51,161,51,760,33,52,-19
51,161,51,770,3243,2968,275
51,161,51,775,504,607,-103
51,161,51,810,75,35,40
51,161,54,55,28,0,28
51,163,51,15,126,173,-47
51,163,51,19,24,0,24
51,163,51,23,32,29,3
51,163,51,530,252,213,39
51,163,51,678,62,113,-51
51,163,51,770,0,30,-30
51,163,51,790,81,47,34
51,163,51,820,0,31,-31
51,165,51,3,32,41,-9
51,165,51,13,0,26,-26
51,165,51,15,483,481,2
51,165,51,41,28,0,28
51,165,51,59,67,62,5
51,165,51,69,35,0,35
51,165,51,87,33,31,2
51,165,51,121,0,37,-37
51,165,51,139,257,283,-26
51,165,51,153,27,0,27
51,165,51,171,323,280,43
51,165,51,660,1360,1137,223
51,165,51,760,0,29,-29
51,165,51,790,112,117,-5
51,165,51,820,37,45,-8
51,165,54,71,32,34,-2
51,167,47,163,47,71,-24
51,167,47,179,23,0,23
51,167,51,27,176,78,98
51,167,51,51,57,35,22
51,167,51,169,0,45,-45
51,167,51,185,179,157,22
51,167,51,191,159,215,-56
51,167,51,195,144,153,-9
51,167,51,520,41,27,14
51,169,47,73,101,129,-28
51,169,47,163,363,397,-34
51,169,47,179,0,44,-44
51,169,51,105,70,46,24
51,169,51,167,45,0,45
51,169,51,191,52,71,-19
51,169,51,195,62,73,-11
51,171,51,13,24,0,24
51,171,51,47,42,0,42
51,171,51,59,184,70,114
51,171,51,61,36,0,36
51,171,51,69,414,426,-12
51,171,51,107,36,42,-6
51,171,51,139,71,70,1
51,171,51,153,115,74,41
51,171,51,165,280,323,-43
51,171,51,187,399,316,83
51,171,51,660,56,81,-25
51,171,51,683,31,0,31
51,171,51,840,124,104,20
51,171,54,3,58,51,7
51,171,54,27,0,36,-36
51,173,47,163,40,62,-22
51,173,51,77,52,0,52
51,173,51,121,0,31,-31
51,173,51,185,58,34,24
51,173,51,191,269,340,-71
51,173,51,197,166,173,-7
51,173,51,520,0,29,-29
51,175,37,91,32,34,-2
51,175,51,41,0,27,-27
51,175,51,93,135,82,53
51,175,51,183,35,51,-16
51,175,51,550,86,44,42
51,175,51,595,0,39,-39
51,175,51,620,258,173,85
51,175,51,700,35,0,35
51,175,51,710,36,0,36
51,175,51,740,33,0,33
51,175,51,800,132,106,26
51,175,51,810,77,69,8
51,177,1,89,0,63,-63
51,177,4,13,37,34,3
51,177,6,37,26,40,-14
51,177,6,71,39,39,0
51,177,6,73,174,108,66
51,177,8,41,0,26,-26
51,177,11,1,68,32,36
51,177,12,9,0,34,-34
51,177,12,11,38,0,38
51,177,12,33,0,35,-35
51,177,12,95,33,0,33
51,177,12,103,0,25,-25
51,177,15,3,47,48,-1
51,177,24,3,49,44,5
51,177,24,17,34,0,34
51,177,24,31,78,57,21
51,177,24,33,128,75,53
51,177,24,510,0,20,-20
51,177,36,5,34,0,34
51,177,36,59,38,0,38
51,177,37,49,0,41,-41
51,177,37,51,0,41,-41
51,177,37,119,0,51,-51
51,177,37,133,169,154,15
51,177,37,183,27,57,-30
51,177,45,51,0,48,-48
51,177,48,29,0,46,-46
51,177,48,201,0,42,-42
51,177,51,3,48,0,48
51,177,51,13,57,50,7
51,177,51,33,577,874,-297
51,177,51,41,92,99,-7
51,177,51,47,108,101,7
51,177,51,57,33,47,-14
51,177,51,59,640,385,255
51,177,51,61,96,70,26
51,177,51,85,70,124,-54
51,177,51,87,129,166,-37
51,177,51,99,251,334,-83
51,177,51,107,92,79,13
51,177,51,109,156,205,-49
51,177,51,137,353,607,-254
51,177,51,153,1025,804,221
51,177,51,179,2225,1677,548
51,177,51,193,130,79,51
51,177,51,510,92,84,8
51,177,51,550,37,26,11
51,177,51,600,27,0,27
51,177,51,630,1828,1625,203
51,177,51,650,0,32,-32
51,177,51,660,22,0,22
51,177,51,683,39,50,-11
51,177,51,700,30,29,1
51,177,51,710,67,46,21
51,177,51,760,64,106,-42
51,177,51,810,106,72,34
51,179,1,89,0,54,-54
51,179,4,3,42,0,42
51,179,4,13,32,52,-20
51,179,4,19,43,37,6
51,179,4,27,0,47,-47
51,179,6,37,77,53,24
51,179,6,53,133,0,133
51,179,6,59,56,0,56
51,179,6,71,94,116,-22
51,179,6,73,457,344,113
51,179,8,41,0,69,-69
51,179,11,1,72,66,6
51,179,12,9,41,0,41
51,179,12,11,65,40,25
51,179,12,31,58,32,26
51,179,12,33,0,71,-71
51,179,12,57,54,74,-20
51,179,12,86,35,0,35
51,179,12,95,31,27,4
51,179,12,103,0,34,-34
51,179,12,113,0,99,-99
51,179,15,3,229,129,100
51,179,17,31,0,37,-37
51,179,24,3,131,56,75
51,179,24,5,33,0,33
51,179,24,17,50,26,24
51,179,24,31,113,99,14
51,179,24,33,201,104,97
51,179,26,163,39,0,39
51,179,32,3,0,54,-54
51,179,34,5,49,0,49
51,179,36,5,30,0,30
51,179,36,47,37,0,37
51,179,37,49,84,101,-17
51,179,37,51,74,32,42
51,179,37,119,0,83,-83
51,179,37,133,508,455,53
51,179,37,183,50,38,12
51,179,39,35,33,0,33
51,179,42,101,27,0,27
51,179,45,13,0,32,-32
51,179,45,19,37,0,37
51,179,45,51,0,36,-36
51,179,45,79,0,37,-37
51,179,47,125,44,0,44
51,179,48,29,33,73,-40
51,179,48,85,0,39,-39
51,179,48,201,66,72,-6
51,179,48,439,0,51,-51
51,179,51,13,133,157,-24
51,179,51,33,229,393,-164
51,179,51,41,63,79,-16
51,179,51,47,68,92,-24
51,179,51,57,0,41,-41
51,179,51,59,1260,987,273
51,179,51,61,174,218,-44
51,179,51,85,0,42,-42
51,179,51,87,87,132,-45
51,179,51,99,223,313,-90
51,179,51,107,140,134,6
51,179,51,109,48,79,-31
51,179,51,121,0,40,-40
51,179,51,137,124,225,-101
51,179,51,153,3065,2094,971
51,179,51,177,1677,2225,-548
51,179,51,187,0,57,-57
51,179,51,193,64,80,-16
51,179,51,510,207,143,64
51,179,51,550,70,59,11
51,179,51,600,0,29,-29
51,179,51,630,739,870,-131
51,179,51,683,62,58,4
51,179,51,685,0,42,-42
51,179,51,700,74,46,28
51,179,51,710,49,42,7
51,179,51,760,74,93,-19
51,179,51,810,92,101,-9
51,181,51,93,87,51,36
51,181,51,95,27,50,-23
51,181,51,149,0,39,-39
51,181,51,183,52,33,19
51,181,51,650,41,0,41
51,181,51,670,0,29,-29
51,181,51,700,47,58,-11
51,183,51,41,118,55,63
51,183,51,53,39,49,-10
51,183,51,81,37,0,37
51,183,51,149,110,83,27
51,183,51,175,51,35,16
51,183,51,181,33,52,-19
51,183,51,570,0,31,-31
51,183,51,595,31,47,-16
51,183,51,670,44,40,4
51,183,51,730,81,124,-43
51,185,51,21,34,36,-2
51,185,51,27,347,198,149
51,185,51,121,0,48,-48
51,185,51,155,30,46,-16
51,185,51,161,0,39,-39
51,185,51,167,157,179,-22
51,185,51,173,34,58,-24
51,185,51,191,75,101,-26
51,185,51,520,0,36,-36
51,185,54,47,105,69,36
51,185,54,55,457,367,90
51,187,24,31,40,0,40
51,187,24,33,44,0,44
51,187,51,13,30,0,30
51,187,51,47,48,0,48
51,187,51,59,375,140,235
51,187,51,61,224,148,76
51,187,51,69,300,484,-184
51,187,51,107,137,108,29
51,187,51,139,76,128,-52
51,187,51,153,306,192,114
51,187,51,157,75,63,12
51,187,51,171,316,399,-83
51,187,51,179,57,0,57
51,187,51,660,25,0,25
51,187,51,683,71,0,71
51,187,51,810,0,24,-24
51,187,51,840,124,120,4
51,187,54,3,0,32,-32
51,187,54,37,27,0,27
51,191,47,91,35,45,-10
51,191,47,163,481,558,-77
51,191,47,179,72,101,-29
51,191,51,27,89,35,54
51,191,51,51,34,0,34
51,191,51,59,28,0,28
51,191,51,121,0,28,-28
51,191,51,167,215,159,56
51,191,51,169,71,52,19
51,191,51,173,340,269,71
51,191,51,185,101,75,26
51,191,51,195,49,0,49
51,191,51,197,45,46,-1
51,191,51,520,472,493,-21
51,193,24,17,148,30,118
51,193,24,33,63,0,63
51,193,51,33,0,43,-43
51,193,51,57,43,58,-15
51,193,51,59,71,30,41
51,193,51,99,256,170,86
51,193,51,133,55,75,-20
51,193,51,153,0,28,-28
51,193,51,159,76,101,-25
51,193,51,177,79,130,-51
51,193,51,179,80,64,16
51,193,51,630,0,33,-33
51,195,21,133,58,48,10
51,195,47,73,33,0,33
51,195,47,163,68,123,-55
51,195,47,179,30,46,-16
51,195,51,51,119,179,-60
51,195,51,105,163,219,-56
51,195,51,167,153,144,9
51,195,51,169,73,62,11
51,195,51,191,0,49,-49
51,195,51,720,228,257,-29
51,197,51,21,68,91,-23
51,197,51,35,98,97,1
51,197,51,77,43,0,43
51,197,51,121,42,70,-28
51,197,51,155,171,154,17
51,197,51,173,173,166,7
51,197,51,191,46,45,1
51,197,51,750,0,28,-28
51,199,1,101,0,58,-58
51,199,2,20,0,96,-96
51,199,4,13,34,46,-12
51,199,6,37,55,0,55
51,199,6,73,55,54,1
51,199,8,41,0,73,-73
51,199,12,9,38,0,38
51,199,12,31,0,30,-30
51,199,12,57,0,48,-48
51,199,12,91,0,51,-51
51,199,13,153,44,0,44
51,199,15,3,100,69,31
51,199,24,3,38,0,38
51,199,32,3,0,71,-71
51,199,36,61,0,25,-25
51,199,37,51,34,43,-9
51,199,37,133,0,46,-46
51,199,37,183,27,30,-3
51,199,40,109,0,44,-44
51,199,45,19,29,30,-1
51,199,47,125,40,0,40
51,199,48,27,33,0,33
51,199,48,29,68,82,-14
51,199,51,13,0,30,-30
51,199,51,41,32,41,-9
51,199,51,59,123,204,-81
51,199,51,73,233,350,-117
51,199,51,87,42,66,-24
51,199,51,93,42,131,-89
51,199,51,95,378,619,-241
51,199,51,107,64,41,23
51,199,51,121,0,28,-28
51,199,51,127,0,43,-43
51,199,51,153,41,43,-2
51,199,51,550,86,42,44
51,199,51,650,1204,908,296
51,199,51,700,2202,1820,382
51,199,51,710,115,115,0
51,199,51,735,143,186,-43
51,199,51,740,57,30,27
51,199,51,760,38,65,-27
51,199,51,800,0,56,-56
51,199,51,810,194,116,78
51,199,51,830,65,54,11
51,510,1,89,0,37,-37
51,510,1,101,46,0,46
51,510,4,13,84,67,17
51,510,6,1,33,61,-28
51,510,6,13,0,27,-27
51,510,6,37,230,197,33
51,510,6,53,51,0,51
51,510,6,59,53,46,7
51,510,6,65,23,0,23
51,510,6,67,42,30,12
51,510,6,71,24,0,24
51,510,6,73,179,171,8
51,510,6,75,43,58,-15
51,510,6,85,44,42,2
51,510,8,5,29,0,29
51,510,8,13,20,44,-24
51,510,8,31,51,53,-2
51,510,8,41,54,29,25
51,510,8,59,0,33,-33
51,510,9,1,38,0,38
51,510,9,3,38,0,38
51,510,9,9,45,0,45
51,510,10,3,55,31,24
51,510,10,5,0,67,-67
51,510,11,1,1752,1547,205
51,510,12,1,34,0,34
51,510,12,9,26,26,0
51,510,12,11,88,96,-8
51,510,12,31,54,54,0
51,510,12,57,57,54,3
51,510,12,71,30,28,2
51,510,12,73,22,24,-2
51,510,12,86,112,90,22
51,510,12,95,66,52,14
51,510,12,99,59,65,-6
51,510,12,103,0,32,-32
51,510,12,117,38,0,38
51,510,13,67,61,0,61
51,510,13,89,56,64,-8
51,510,13,121,78,82,-4
51,510,13,135,35,0,35
51,510,15,3,116,81,35
51,510,17,31,162,203,-41
51,510,17,43,30,28,2
51,510,18,97,29,0,29
51,510,20,91,34,0,34
51,510,21,111,31,29,2
51,510,22,71,36,0,36
51,510,23,5,37,0,37
51,510,24,3,167,217,-50
51,510,24,5,84,49,35
51,510,24,9,59,30,29
51,510,24,17,136,151,-15
51,510,24,21,32,80,-48
51,510,24,25,22,0,22
51,510,24,27,57,84,-27
51,510,24,31,822,782,40
51,510,24,33,1178,1038,140
51,510,24,37,45,32,13
51,510,24,510,110,94,16
51,510,25,9,25,0,25
51,510,25,17,138,93,45
51,510,25,21,55,26,29
51,510,25,25,76,37,39
51,510,25,27,32,0,32
51,510,26,65,25,0,25
51,510,26,81,22,0,22
51,510,26,125,58,27,31
51,510,26,161,45,23,22
51,510,26,163,64,0,64
51,510,27,53,39,51,-12
51,510,27,123,39,26,13
51,510,29,95,24,0,24
51,510,29,189,52,0,52
51,510,32,3,59,50,9
51,510,33,11,26,0,26
51,510,34,3,37,30,7
51,510,34,13,0,34,-34
51,510,34,17,52,42,10
51,510,34,21,33,32,1
51,510,34,23,51,0,51
51,510,34,25,31,34,-3
51,510,34,27,33,0,33
51,510,36,1,34,0,34
51,510,36,5,78,0,78
51,510,36,29,55,0,55
51,510,36,47,110,106,4
51,510,36,55,67,0,67
51,510,36,59,23,33,-10
51,510,36,61,148,174,-26
51,510,36,67,49,27,22
51,510,36,81,101,48,53
51,510,36,103,31,0,31
51,510,36,119,44,23,21
51,510,37,51,53,30,23
51,510,37,63,27,52,-25
51,510,37,81,50,0,50
51,510,37,119,64,141,-77
51,510,37,129,0,29,-29
51,510,37,133,44,0,44
51,510,37,135,24,22,2
51,510,37,183,82,109,-27
51,510,39,35,65,36,29
51,510,39,49,61,60,1
51,510,39,57,30,0,30
51,510,39,61,45,27,18
51,510,39,113,28,0,28
51,510,39,153,29,0,29
51,510,40,109,27,0,27
51,510,41,51,0,40,-40
51,510,42,3,113,109,4
51,510,42,17,56,0,56
51,510,42,21,21,0,21
51,510,42,27,27,0,27
51,510,42,29,22,28,-6
51,510,42,43,27,27,0
51,510,42,45,33,0,33
51,510,42,49,21,0,21
51,510,42,71,27,0,27
51,510,42,91,58,48,10
51,510,42,101,101,59,42
51,510,42,133,25,0,25
51,510,44,5,37,0,37
51,510,44,7,40,0,40
51,510,45,19,21,34,-13
51,510,45,79,0,24,-24
51,510,47,37,34,0,34
51,510,47,157,41,42,-1
51,510,48,27,30,0,30
51,510,48,29,85,66,19
51,510,48,85,23,28,-5
51,510,48,113,87,85,2
51,510,48,201,106,112,-6
51,510,48,439,44,48,-4
51,510,48,453,36,66,-30
51,510,49,35,37,35,2
51,510,49,49,40,0,40
51,510,51,3,55,50,5
51,510,51,13,4125,2854,1271
51,510,51,41,60,59,1
51,510,51,59,6870,8911,-2041
51,510,51,61,29,40,-11
51,510,51,87,65,62,3
51,510,51,95,0,40,-40
51,510,51,99,0,46,-46
51,510,51,107,312,679,-367
51,510,51,121,35,0,35
51,510,51,153,1706,1664,42
51,510,51,177,84,92,-8
51,510,51,179,143,207,-64
51,510,51,540,33,35,-2
51,510,51,550,52,40,12
51,510,51,600,98,124,-26
51,510,51,610,59,86,-27
51,510,51,630,25,29,-4
51,510,51,650,46,26,20
51,510,51,683,78,69,9
51,510,51,685,0,24,-24
51,510,51,700,42,29,13
51,510,51,710,106,56,50
51,510,51,760,92,88,4
51,510,51,810,139,93,46
51,510,53,33,88,91,-3
51,510,53,53,31,36,-5
51,510,55,79,28,0,28
51,515,51,19,199,203,-4
51,515,51,31,0,41,-41
51,515,51,161,0,35,-35
51,515,51,680,57,68,-11
51,515,51,770,34,51,-17
51,520,47,163,632,644,-12
51,520,47,179,67,59,8
51,520,51,167,27,41,-14
51,520,51,173,29,0,29
51,520,51,185,36,0,36
51,520,51,191,493,472,21
51,530,51,163,213,252,-39
51,530,51,678,63,31,32
51,540,6,1,25,0,25
51,540,6,37,24,68,-44
51,540,6,85,0,34,-34
51,540,11,1,55,141,-86
51,540,13,121,24,29,-5
51,540,17,31,41,64,-23
51,540,24,31,35,37,-2
51,540,24,510,0,32,-32
51,540,25,17,34,37,-3
51,540,25,25,0,25,-25
51,540,27,53,0,27,-27
51,540,36,47,28,32,-4
51,540,36,61,39,172,-133
51,540,37,63,0,48,-48
51,540,37,119,0,43,-43
51,540,37,183,0,30,-30
51,540,41,51,0,29,-29
51,540,42,3,33,0,33
51,540,42,101,0,22,-22
51,540,51,3,1780,1878,-98
51,540,51,13,98,94,4
51,540,51,29,59,44,15
51,540,51,41,35,40,-5
51,540,51,59,154,124,30
51,540,51,65,181,201,-20
51,540,51,79,112,127,-15
51,540,51,87,66,82,-16
51,540,51,107,31,0,31
51,540,51,109,65,154,-89
51,540,51,125,54,103,-49
51,540,51,137,69,77,-8
51,540,51,153,33,0,33
51,540,51,510,35,33,2
51,540,51,660,39,24,15
51,540,51,680,24,32,-8
51,540,51,700,0,37,-37
51,540,51,710,0,27,-27
51,540,51,760,72,144,-72
51,540,51,790,31,34,-3
51,540,51,810,60,40,20
51,540,51,820,49,106,-57
51,540,53,33,33,35,-2
51,550,1,97,0,30,-30
51,550,4,13,46,104,-58
51,550,6,31,0,40,-40
51,550,6,37,42,76,-34
51,550,6,53,64,58,6
51,550,6,59,0,29,-29
51,550,6,65,0,32,-32
51,550,6,71,38,0,38
51,550,6,73,293,301,-8
51,550,6,111,46,0,46
51,550,9,11,91,101,-10
51,550,11,1,0,36,-36
51,550,12,9,29,48,-19
51,550,12,11,62,45,17
51,550,12,19,50,100,-50
51,550,12,31,203,159,44
51,550,12,33,121,66,55
51,550,12,57,67,92,-25
51,550,12,71,0,31,-31
51,550,12,86,34,45,-11
51,550,12,95,0,48,-48
51,550,12,99,34,0,34
51,550,12,103,42,28,14
51,550,12,113,41,52,-11
51,550,12,127,30,0,30
51,550,13,39,0,102,-102
51,550,13,51,0,36,-36
51,550,13,67,32,39,-7
51,550,13,89,32,41,-9
51,550,13,97,0,32,-32
51,550,13,121,32,54,-22
51,550,13,135,35,69,-34
51,550,15,3,218,158,60
51,550,17,31,30,50,-20
51,550,17,97,69,81,-12
51,550,23,5,0,28,-28
51,550,24,3,120,100,20
51,550,24,5,40,34,6
51,550,24,31,59,94,-35
51,550,24,33,93,100,-7
51,550,24,37,49,64,-15
51,550,26,125,0,52,-52
51,550,26,163,31,138,-107
51,550,28,47,0,31,-31
51,550,32,3,37,41,-4
51,550,34,7,29,0,29
51,550,34,13,0,28,-28
51,550,36,1,23,0,23
51,550,36,5,63,59,4
51,550,36,47,63,39,24
51,550,36,61,37,32,5
51,550,36,81,64,29,35
51,550,36,91,37,0,37
51,550,36,103,43,42,1
51,550,37,15,0,35,-35
51,550,37,29,31,129,-98
51,550,37,41,0,29,-29
51,550,37,49,59,0,59
51,550,37,51,62,84,-22
51,550,37,53,145,291,-146
51,550,37,55,55,78,-23
51,550,37,67,0,25,-25
51,550,37,73,55,79,-24
51,550,37,81,44,79,-35
51,550,37,119,60,111,-51
51,550,37,129,0,37,-37
51,550,37,133,133,129,4
51,550,37,139,153,240,-87
51,550,37,143,0,66,-66
51,550,37,147,0,60,-60
51,550,37,183,87,141,-54
51,550,39,35,56,0,56
51,550,39,49,26,36,-10
51,550,42,3,60,44,16
51,550,42,101,34,35,-1
51,550,44,5,97,63,34
51,550,45,13,0,54,-54
51,550,45,15,75,48,27
51,550,45,19,63,63,0
51,550,45,35,0,49,-49
51,550,45,45,0,32,-32
51,550,45,79,0,55,-55
51,550,47,157,83,60,23
51,550,48,29,50,70,-20
51,550,48,113,51,42,9
51,550,48,201,25,83,-58
51,550,48,355,0,48,-48
51,550,48,439,0,53,-53
51,550,51,1,43,0,43
51,550,51,3,32,36,-4
51,550,51,13,0,50,-50
51,550,51,19,0,30,-30
51,550,51,41,82,139,-57
51,550,51,59,140,207,-67
51,550,51,85,0,34,-34
51,550,51,87,98,107,-9
51,550,51,93,102,183,-81
51,550,51,95,33,98,-65
51,550,51,107,48,66,-18
51,550,51,121,42,43,-1
51,550,51,153,125,113,12
51,550,51,161,0,49,-49
51,550,51,175,44,86,-42
51,550,51,177,26,37,-11
51,550,51,179,59,70,-11
51,550,51,199,42,86,-44
51,550,51,510,40,52,-12
51,550,51,620,0,37,-37
51,550,51,650,428,327,101
51,550,51,680,0,27,-27
51,550,51,700,428,416,12
51,550,51,710,3609,2814,795
51,550,51,740,3172,2674,498
51,550,51,760,83,115,-32
51,550,51,770,32,0,32
51,550,51,800,927,1296,-369
51,550,51,810,6512,4889,1623
51,550,53,33,23,0,23
51,550,53,35,60,115,-55
51,550,53,53,0,41,-41
51,570,51,41,619,718,-99
51,570,51,53,180,220,-40
51,570,51,87,59,114,-55
51,570,51,149,239,269,-30
51,570,51,183,31,0,31
51,570,51,670,190,187,3
51,570,51,730,243,215,28
51,570,51,760,78,134,-56
51,580,51,5,142,114,28
51,580,51,770,0,39,-39
51,590,37,33,188,209,-21
51,590,37,63,0,37,-37
51,590,37,81,57,198,-141
51,590,37,119,0,45,-45
51,590,37,157,72,109,-37
51,590,37,183,32,43,-11
51,590,51,41,31,30,1
51,590,51,59,0,23,-23
51,590,51,83,122,71,51
51,590,51,87,0,37,-37
51,590,51,89,55,76,-21
51,590,51,143,1183,1273,-90
51,590,51,690,0,45,-45
51,590,51,760,42,30,12
51,590,51,770,0,31,-31
51,595,37,83,30,0,30
51,595,51,25,60,38,22
51,595,51,41,0,34,-34
51,595,51,81,64,51,13
51,595,51,175,39,0,39
51,595,51,183,47,31,16
51,600,6,37,0,25,-25
51,600,11,1,63,87,-24
51,600,17,31,29,0,29
51,600,24,31,85,87,-2
51,600,24,33,51,0,51
51,600,51,13,226,143,83
51,600,51,59,1978,1880,98
51,600,51,61,0,26,-26
51,600,51,107,151,227,-76
51,600,51,153,248,282,-34
51,600,51,177,0,27,-27
51,600,51,179,29,0,29
51,600,51,510,124,98,26
51,600,51,683,52,0,52
51,600,51,685,26,29,-3
51,610,11,1,78,66,12
51,610,24,31,48,0,48
51,610,51,13,254,162,92
51,610,51,59,458,553,-95
51,610,51,107,115,108,7
51,610,51,510,86,59,27
51,620,51,93,53,36,17
51,620,51,175,173,258,-85
51,620,51,550,37,0,37
51,620,51,700,0,40,-40
51,620,51,710,48,26,22
51,620,51,740,32,0,32
51,620,51,800,104,110,-6
51,620,51,810,38,0,38
51,630,6,73,42,37,5
51,630,11,1,27,35,-8
51,630,24,33,61,32,29
51,630,36,29,26,0,26
51,630,37,133,44,0,44
51,630,51,13,29,50,-21
51,630,51,33,180,207,-27
51,630,51,47,32,24,8
51,630,51,59,148,122,26
51,630,51,61,0,47,-47
51,630,51,87,28,59,-31
51,630,51,99,162,136,26
51,630,51,107,0,41,-41
51,630,51,137,78,146,-68
51,630,51,153,232,199,33
51,630,51,177,1625,1828,-203
51,630,51,179,870,739,131
51,630,51,193,33,0,33
51,630,51,510,29,25,4
51,630,51,760,26,48,-22
51,630,51,810,0,42,-42
51,640,51,35,177,140,37
51,640,51,77,100,86,14
51,650,1,73,0,34,-34
51,650,1,97,29,0,29
51,650,2,20,33,56,-23
51,650,4,13,33,70,-37
51,650,4,19,0,58,-58
51,650,6,37,58,85,-27
51,650,6,73,132,163,-31
51,650,8,41,56,48,8
51,650,9,11,57,35,22
51,650,10,1,31,0,31
51,650,11,1,41,43,-2
51,650,12,5,0,56,-56
51,650,12,11,32,0,32
51,650,12,19,0,39,-39
51,650,12,31,191,127,64
51,650,12,33,45,71,-26
51,650,12,57,35,55,-20
51,650,12,86,25,54,-29
51,650,12,91,51,42,9
51,650,12,95,26,43,-17
51,650,12,103,0,34,-34
51,650,13,63,0,33,-33
51,650,13,67,30,68,-38
51,650,13,89,33,58,-25
51,650,13,121,29,84,-55
51,650,13,135,0,42,-42
51,650,13,153,39,0,39
51,650,13,245,0,46,-46
51,650,15,3,128,116,12
51,650,17,31,68,59,9
51,650,17,97,59,0,59
51,650,17,163,0,43,-43
51,650,22,15,34,0,34
51,650,24,3,45,71,-26
51,650,24,5,30,49,-19
51,650,24,17,0,32,-32
51,650,24,31,41,58,-17
51,650,24,33,79,158,-79
51,650,24,37,41,70,-29
51,650,24,510,49,0,49
51,650,26,163,44,0,44
51,650,28,47,0,38,-38
51,650,28,59,27,0,27
51,650,32,3,61,61,0
51,650,34,5,28,27,1
51,650,34,13,44,43,1
51,650,36,5,50,36,14
51,650,36,29,31,0,31
51,650,36,45,37,0,37
51,650,36,47,106,57,49
51,650,36,81,32,34,-2
51,650,36,91,36,0,36
51,650,36,103,52,0,52
51,650,37,51,71,79,-8
51,650,37,63,0,42,-42
51,650,37,67,0,27,-27
51,650,37,81,42,35,7
51,650,37,119,42,165,-123
51,650,37,133,58,47,11
51,650,37,147,0,39,-39
51,650,37,183,50,105,-55
51,650,37,191,0,34,-34
51,650,39,35,47,29,18
51,650,39,49,25,29,-4
51,650,39,113,0,35,-35
51,650,40,109,53,0,53
51,650,42,3,28,0,28
51,650,42,101,28,32,-4
51,650,45,15,111,44,67
51,650,45,19,56,28,28
51,650,45,79,68,50,18
51,650,47,157,0,32,-32
51,650,48,27,50,38,12
51,650,48,29,70,98,-28
51,650,48,113,29,98,-69
51,650,48,141,33,0,33
51,650,48,201,86,121,-35
51,650,48,439,32,40,-8
51,650,48,451,25,0,25
51,650,51,3,0,29,-29
51,650,51,13,0,55,-55
51,650,51,41,61,74,-13
51,650,51,59,112,177,-65
51,650,51,73,166,223,-57
51,650,51,87,70,124,-54
51,650,51,93,221,365,-144
51,650,51,95,195,365,-170
51,650,51,107,0,59,-59
51,650,51,153,81,116,-35
51,650,51,177,32,0,32
51,650,51,181,0,41,-41
51,650,51,199,908,1204,-296
51,650,51,510,26,46,-20
51,650,51,550,327,428,-101
51,650,51,700,5612,5797,-185
51,650,51,710,1084,949,135
51,650,51,735,129,219,-90
51,650,51,740,269,277,-8
51,650,51,760,73,90,-17
51,650,51,770,28,34,-6
51,650,51,800,190,266,-76
51,650,51,810,869,825,44
51,650,51,830,46,57,-11
51,650,53,33,0,25,-25
51,650,53,53,0,42,-42
51,660,11,1,0,29,-29
51,660,36,5,31,0,31
51,660,36,61,58,0,58
51,660,37,119,0,48,-48
51,660,42,71,29,0,29
51,660,51,3,38,76,-38
51,660,51,13,0,55,-55
51,660,51,15,175,279,-104
51,660,51,41,26,0,26
51,660,51,59,90,125,-35
51,660,51,69,43,37,6
51,660,51,87,0,40,-40
51,660,51,107,35,39,-4
51,660,51,121,27,0,27
51,660,51,139,69,65,4
51,660,51,153,77,33,44
51,660,51,161,26,0,26
51,660,51,165,1137,1360,-223
51,660,51,171,81,56,25
51,660,51,177,0,22,-22
51,660,51,187,0,25,-25
51,660,51,540,24,39,-15
51,660,51,760,0,38,-38
51,660,51,770,26,0,26
51,660,51,790,66,99,-33
51,660,51,810,40,0,40
51,660,51,820,0,46,-46
51,670,48,27,33,35,-2
51,670,51,41,561,674,-113
51,670,51,53,86,180,-94
51,670,51,87,140,133,7
51,670,51,149,422,509,-87
51,670,51,181,29,0,29
51,670,51,183,40,44,-4
51,670,51,570,187,190,-3
51,670,51,730,454,328,126
51,670,51,760,126,114,12
51,670,51,810,0,29,-29
51,678,51,163,113,62,51
51,678,51,530,31,63,-32
51,680,6,37,26,0,26
51,680,12,95,0,27,-27
51,680,12,103,32,0,32
51,680,24,31,28,0,28
51,680,24,33,31,0,31
51,680,37,81,48,51,-3
51,680,37,119,0,46,-46
51,680,37,183,29,71,-42
51,680,51,3,53,52,1
51,680,51,9,576,710,-134
51,680,51,11,156,209,-53
51,680,51,19,822,983,-161
51,680,51,31,1029,1205,-176
51,680,51,37,27,32,-5
51,680,51,41,68,65,3
51,680,51,59,70,74,-4
51,680,51,83,37,0,37
51,680,51,87,45,72,-27
51,680,51,107,0,40,-40
51,680,51,121,0,37,-37
51,680,51,143,93,76,17
51,680,51,153,54,0,54
51,680,51,161,48,44,4
51,680,51,515,68,57,11
51,680,51,540,32,24,8
51,680,51,550,27,0,27
51,680,51,700,0,37,-37
51,680,51,710,0,28,-28
51,680,51,760,43,54,-11
51,680,51,770,58,50,8
51,680,51,810,38,41,-3
51,683,11,1,0,23,-23
51,683,24,31,44,103,-59
51,683,24,33,57,127,-70
51,683,37,119,0,44,-44
51,683,37,183,0,45,-45
51,683,48,201,0,45,-45
51,683,51,13,97,116,-19
51,683,51,47,97,176,-79
51,683,51,59,786,1067,-281
51,683,51,61,159,279,-120
51,683,51,69,0,50,-50
51,683,51,87,0,34,-34
51,683,51,107,178,284,-106
51,683,51,153,2815,2999,-184
51,683,51,171,0,31,-31
51,683,51,177,50,39,11
51,683,51,179,58,62,-4
51,683,51,187,0,71,-71
51,683,51,510,69,78,-9
51,683,51,600,0,52,-52
51,683,51,685,469,408,61
51,683,54,3,0,27,-27
51,685,24,31,0,52,-52
51,685,24,33,42,55,-13
51,685,48,201,0,44,-44
51,685,51,13,48,51,-3
51,685,51,47,32,44,-12
51,685,51,59,460,516,-56
51,685,51,61,51,83,-32
51,685,51,107,76,90,-14
51,685,51,153,867,933,-66
51,685,51,179,42,0,42
51,685,51,510,24,0,24
51,685,51,600,29,26,3
51,685,51,683,408,469,-61
51,690,37,81,0,48,-48
51,690,37,119,0,39,-39
51,690,37,157,0,47,-47
51,690,51,67,35,0,35
51,690,51,89,625,570,55
51,690,51,141,28,0,28
51,690,51,143,40,51,-11
51,690,51,590,45,0,45
51,690,51,770,0,37,-37
51,700,1,73,26,37,-11
51,700,1,89,0,30,-30
51,700,2,20,54,64,-10
51,700,2,90,57,48,9
51,700,4,13,64,94,-30
51,700,4,19,59,0,59
51,700,6,37,99,109,-10
51,700,6,67,0,28,-28
51,700,6,71,46,69,-23
51,700,6,73,148,191,-43
51,700,8,41,74,84,-10
51,700,9,1,32,0,32
51,700,9,3,36,0,36
51,700,9,11,39,0,39
51,700,10,3,0,34,-34
51,700,11,1,0,48,-48
51,700,12,5,54,40,14
51,700,12,9,37,40,-3
51,700,12,11,63,56,7
51,700,12,19,30,34,-4
51,700,12,31,207,152,55
51,700,12,33,57,40,17
51,700,12,57,59,79,-20
51,700,12,86,51,54,-3
51,700,12,91,52,40,12
51,700,12,95,69,80,-11
51,700,12,99,40,0,40
51,700,12,101,27,0,27
51,700,12,103,34,48,-14
51,700,12,105,25,0,25
51,700,12,127,36,0,36
51,700,13,39,0,31,-31
51,700,13,51,53,68,-15
51,700,13,63,34,62,-28
51,700,13,67,32,36,-4
51,700,13,89,39,89,-50
51,700,13,121,53,87,-34
51,700,13,135,0,72,-72
51,700,13,153,38,41,-3
51,700,13,179,33,0,33
51,700,13,245,30,75,-45
51,700,15,3,165,152,13
51,700,17,31,73,68,5
51,700,17,97,34,38,-4
51,700,17,163,0,99,-99
51,700,18,89,28,0,28
51,700,20,61,0,42,-42
51,700,21,47,95,75,20
51,700,21,93,0,47,-47
51,700,22,115,37,0,37
51,700,24,3,44,65,-21
51,700,24,5,49,44,5
51,700,24,17,0,36,-36
51,700,24,25,36,0,36
51,700,24,31,28,80,-52
51,700,24,33,117,109,8
51,700,24,37,23,40,-17
51,700,24,510,49,46,3
51,700,25,17,0,39,-39
51,700,26,163,50,0,50
51,700,28,47,0,40,-40
51,700,29,169,0,36,-36
51,700,32,3,74,58,16
51,700,36,5,72,49,23
51,700,36,29,0,35,-35
51,700,36,45,131,45,86
51,700,36,47,123,104,19
51,700,36,61,37,32,5
51,700,36,67,24,0,24
51,700,36,81,83,70,13
51,700,36,91,30,37,-7
51,700,36,103,52,39,13
51,700,36,119,26,0,26
51,700,37,49,0,33,-33
51,700,37,51,176,187,-11
51,700,37,63,50,45,5
51,700,37,81,32,68,-36
51,700,37,91,24,33,-9
51,700,37,119,31,173,-142
51,700,37,133,40,93,-53
51,700,37,147,0,31,-31
51,700,37,183,59,154,-95
51,700,37,191,0,34,-34
51,700,39,35,0,37,-37
51,700,39,49,50,47,3
51,700,39,113,28,0,28
51,700,40,31,44,48,-4
51,700,40,109,0,34,-34
51,700,42,3,44,0,44
51,700,42,101,61,36,25
51,700,42,133,0,52,-52
51,700,45,15,102,97,5
51,700,45,19,69,46,23
51,700,45,35,0,48,-48
51,700,45,45,0,34,-34
51,700,45,51,0,36,-36
51,700,45,79,69,92,-23
51,700,45,91,0,29,-29
51,700,47,37,0,42,-42
51,700,47,93,0,31,-31
51,700,47,125,118,124,-6
51,700,47,157,0,35,-35
51,700,48,27,182,154,28
51,700,48,29,142,147,-5
51,700,48,99,60,0,60
51,700,48,113,40,0,40
51,700,48,121,0,26,-26
51,700,48,141,65,67,-2
51,700,48,201,82,166,-84
51,700,48,439,32,67,-35
51,700,51,1,34,0,34
51,700,51,3,32,36,-4
51,700,51,13,0,39,-39
51,700,51,31,22,0,22
51,700,51,41,140,149,-9
51,700,51,59,188,252,-64
51,700,51,73,356,667,-311
51,700,51,85,0,57,-57
51,700,51,87,183,211,-28
51,700,51,93,370,520,-150
51,700,51,95,633,1017,-384
51,700,51,101,29,36,-7
51,700,51,103,28,0,28
51,700,51,107,22,87,-65
51,700,51,115,35,57,-22
51,700,51,119,31,45,-14
51,700,51,121,33,25,8
51,700,51,127,57,108,-51
51,700,51,149,32,43,-11
51,700,51,153,89,191,-102
51,700,51,161,0,39,-39
51,700,51,175,0,35,-35
51,700,51,177,29,30,-1
51,700,51,179,46,74,-28
51,700,51,181,58,47,11
51,700,51,199,1820,2202,-382
51,700,51,510,29,42,-13
51,700,51,540,37,0,37
51,700,51,550,416,428,-12
51,700,51,620,40,0,40
51,700,51,650,5797,5612,185
51,700,51,680,37,0,37
51,700,51,710,844,905,-61
51,700,51,730,43,26,17
51,700,51,735,224,262,-38
51,700,51,740,361,322,39
51,700,51,760,84,150,-66
51,700,51,800,246,393,-147
51,700,51,810,776,744,32
51,700,51,830,161,146,15
51,700,53,33,0,38,-38
51,700,53,35,0,55,-55
51,700,53,53,113,122,-9
51,700,54,39,32,0,32
51,710,4,13,71,133,-62
51,710,5,119,0,23,-23
51,710,6,1,29,0,29
51,710,6,37,103,142,-39
51,710,6,53,39,34,5
51,710,6,59,45,41,4
51,710,6,65,0,45,-45
51,710,6,67,28,39,-11
51,710,6,71,46,73,-27
51,710,6,73,430,531,-101
51,710,6,85,0,34,-34
51,710,6,111,68,97,-29
51,710,8,5,0,28,-28
51,710,8,41,35,52,-17
51,710,9,1,0,36,-36
51,710,9,3,28,0,28
51,710,9,9,28,0,28
51,710,9,11,141,118,23
51,710,10,3,27,74,-47
51,710,11,1,112,106,6
51,710,12,5,0,31,-31
51,710,12,9,54,60,-6
51,710,12,11,63,91,-28
51,710,12,19,53,117,-64
51,710,12,31,531,372,159
51,710,12,33,266,154,112
51,710,12,57,76,110,-34
51,710,12,71,0,32,-32
51,710,12,73,28,0,28
51,710,12,83,0,39,-39
51,710,12,86,79,83,-4
51,710,12,87,42,42,0
51,710,12,91,25,0,25
51,710,12,95,76,50,26
51,710,12,99,57,54,3
51,710,12,103,49,37,12
51,710,12,105,0,44,-44
51,710,12,109,0,31,-31
51,710,12,113,74,82,-8
51,710,12,117,0,32,-32
51,710,12,127,0,34,-34
51,710,13,39,65,139,-74
51,710,13,51,0,59,-59
51,710,13,63,27,50,-23
51,710,13,67,34,60,-26
51,710,13,89,56,87,-31
51,710,13,121,50,137,-87
51,710,13,135,38,79,-41
51,710,13,151,0,35,-35
51,710,13,245,0,42,-42
51,710,15,3,246,220,26
51,710,17,31,127,178,-51
51,710,17,97,171,188,-17
51,710,18,97,0,49,-49
51,710,21,111,26,41,-15
51,710,22,71,0,46,-46
51,710,23,5,53,58,-5
51,710,24,3,156,138,18
51,710,24,5,62,99,-37
51,710,24,25,0,34,-34
51,710,24,27,0,35,-35
51,710,24,31,90,135,-45
51,710,24,33,103,150,-47
51,710,24,37,121,118,3
51,710,24,45,0,36,-36
51,710,24,510,63,66,-3
51,710,25,5,22,0,22
51,710,25,17,45,45,0
51,710,25,25,32,29,3
51,710,26,49,27,0,27
51,710,26,125,31,44,-13
51,710,26,161,29,0,29
51,710,26,163,77,103,-26
51,710,27,53,36,0,36
51,710,28,47,64,80,-16
51,710,28,59,70,43,27
51,710,29,189,0,51,-51
51,710,32,3,32,75,-43
51,710,34,3,0,32,-32
51,710,34,5,0,33,-33
51,710,34,7,32,34,-2
51,710,34,13,58,52,6
51,710,34,17,0,37,-37
51,710,34,23,33,39,-6
51,710,34,25,23,33,-10
51,710,34,29,0,31,-31
51,710,34,31,0,32,-32
51,710,36,5,129,68,61
51,710,36,29,29,48,-19
51,710,36,47,166,141,25
51,710,36,55,0,26,-26
51,710,36,59,41,50,-9
51,710,36,61,72,56,16
51,710,36,67,39,0,39
51,710,36,71,24,0,24
51,710,36,81,126,92,34
51,710,36,85,28,31,-3
51,710,36,91,46,0,46
51,710,36,103,43,65,-22
51,710,36,119,0,47,-47
51,710,37,49,43,52,-9
51,710,37,51,99,88,11
51,710,37,53,53,56,-3
51,710,37,55,0,24,-24
51,710,37,63,0,33,-33
51,710,37,67,35,29,6
51,710,37,71,0,38,-38
51,710,37,73,29,43,-14
51,710,37,81,58,96,-38
51,710,37,91,0,32,-32
51,710,37,101,0,34,-34
51,710,37,119,76,207,-131
51,710,37,129,40,32,8
51,710,37,133,125,175,-50
51,710,37,139,49,122,-73
51,710,37,147,33,38,-5
51,710,37,183,84,181,-97
51,710,39,35,85,100,-15
51,710,39,49,62,52,10
51,710,39,61,51,35,16
51,710,39,153,28,0,28
51,710,40,109,44,65,-21
51,710,40,143,0,36,-36
51,710,42,3,72,51,21
51,710,42,17,34,0,34
51,710,42,49,26,0,26
51,710,42,91,28,41,-13
51,710,42,101,107,160,-53
51,710,44,5,63,94,-31
51,710,45,13,49,49,0
51,710,45,15,173,91,82
51,710,45,19,112,91,21
51,710,45,35,29,0,29
51,710,45,45,0,39,-39
51,710,45,63,0,40,-40
51,710,45,79,38,43,-5
51,710,45,91,0,34,-34
51,710,47,65,0,35,-35
51,710,47,93,40,38,2
51,710,47,125,41,0,41
51,710,47,157,74,70,4
51,710,48,27,0,55,-55
51,710,48,29,69,144,-75
51,710,48,113,79,124,-45
51,710,48,141,39,72,-33
51,710,48,201,134,206,-72
51,710,48,273,33,0,33
51,710,48,355,74,80,-6
51,710,48,409,32,43,-11
51,710,48,439,64,108,-44
51,710,48,453,0,50,-50
51,710,48,491,0,52,-52
51,710,51,1,53,59,-6
51,710,51,3,29,52,-23
51,710,51,13,63,104,-41
51,710,51,41,81,148,-67
51,710,51,59,204,360,-156
51,710,51,73,21,41,-20
51,710,51,85,28,49,-21
51,710,51,87,80,184,-104
51,710,51,93,100,74,26
51,710,51,95,69,83,-14
51,710,51,107,36,42,-6
51,710,51,121,28,46,-18
51,710,51,131,31,28,3
51,710,51,149,26,0,26
51,710,51,153,109,130,-21
51,710,51,175,0,36,-36
51,710,51,177,46,67,-21
51,710,51,179,42,49,-7
51,710,51,199,115,115,0
51,710,51,510,56,106,-50
51,710,51,540,27,0,27
51,710,51,550,2814,3609,-795
51,710,51,620,26,48,-22
51,710,51,650,949,1084,-135
51,710,51,680,28,0,28
51,710,51,700,905,844,61
51,710,51,730,25,38,-13
51,710,51,740,1718,1539,179
51,710,51,760,122,176,-54
51,710,51,770,22,28,-6
51,710,51,800,448,611,-163
51,710,51,810,8001,9254,-1253
51,710,53,29,44,45,-1
51,710,53,33,56,69,-13
51,710,53,35,36,103,-67
51,710,53,53,37,66,-29
51,710,55,79,0,34,-34
51,720,51,195,257,228,29
51,730,8,41,0,29,-29
51,730,24,33,35,38,-3
51,730,36,47,32,29,3
51,730,37,51,43,47,-4
51,730,48,27,33,51,-18
51,730,51,25,42,0,42
51,730,51,41,672,691,-19
51,730,51,53,248,330,-82
51,730,51,59,24,26,-2
51,730,51,87,137,146,-9
51,730,51,149,319,565,-246
51,730,51,183,124,81,43
51,730,51,570,215,243,-28
51,730,51,670,328,454,-126
51,730,51,700,26,43,-17
51,730,51,710,38,25,13
51,730,51,760,187,230,-43
51,730,51,810,24,0,24
51,730,53,53,0,34,-34
51,735,51,59,0,34,-34
51,735,51,73,0,33,-33
51,735,51,93,0,38,-38
51,735,51,95,0,43,-43
51,735,51,199,186,143,43
51,735,51,650,219,129,90
51,735,51,700,262,224,38
51,735,51,810,23,0,23
51,740,4,13,29,0,29
51,740,6,37,34,33,1
51,740,6,73,91,156,-65
51,740,9,11,67,46,21
51,740,11,1,25,29,-4
51,740,12,31,108,84,24
51,740,12,33,48,59,-11
51,740,12,86,24,32,-8
51,740,13,39,0,42,-42
51,740,13,63,0,32,-32
51,740,13,67,0,26,-26
51,740,15,3,35,73,-38
51,740,17,31,0,34,-34
51,740,17,97,23,0,23
51,740,24,31,47,76,-29
51,740,24,33,55,70,-15
51,740,24,510,0,29,-29
51,740,26,163,42,32,10
51,740,36,47,48,36,12
51,740,36,61,0,29,-29
51,740,37,51,0,52,-52
51,740,37,53,26,0,26
51,740,37,55,0,37,-37
51,740,37,73,34,56,-22
51,740,37,91,0,36,-36
51,740,37,119,0,45,-45
51,740,37,133,67,89,-22
51,740,37,139,41,95,-54
51,740,37,183,0,55,-55
51,740,42,3,0,29,-29
51,740,42,101,0,30,-30
51,740,45,15,51,36,15
51,740,45,19,35,0,35
51,740,48,27,0,34,-34
51,740,48,113,0,29,-29
51,740,48,201,56,45,11
51,740,51,41,48,42,6
51,740,51,59,58,44,14
51,740,51,87,46,60,-14
51,740,51,93,136,209,-73
51,740,51,95,0,35,-35
51,740,51,153,0,40,-40
51,740,51,175,0,33,-33
51,740,51,199,30,57,-27
51,740,51,550,2674,3172,-498
51,740,51,620,0,32,-32
51,740,51,650,277,269,8
51,740,51,700,322,361,-39
51,740,51,710,1539,1718,-179
51,740,51,760,52,50,2
51,740,51,800,1054,1490,-436
51,740,51,810,1425,1304,121
51,740,53,35,0,31,-31
51,750,37,119,0,28,-28
51,750,51,59,24,36,-12
51,750,51,63,0,39,-39
51,750,51,71,26,0,26
51,750,51,107,0,28,-28
51,750,51,121,418,436,-18
51,750,51,155,248,262,-14
51,750,51,161,0,41,-41
51,750,51,197,28,0,28
51,750,51,770,0,58,-58
51,760,1,73,22,0,22
51,760,4,13,61,45,16
51,760,6,1,25,0,25
51,760,6,37,105,65,40
51,760,6,59,46,0,46
51,760,6,67,27,0,27
51,760,6,73,60,65,-5
51,760,6,75,28,40,-12
51,760,8,31,0,36,-36
51,760,9,1,44,36,8
51,760,9,3,34,0,34
51,760,9,9,25,0,25
51,760,10,3,35,0,35
51,760,11,1,106,144,-38
51,760,12,1,25,0,25
51,760,12,11,46,26,20
51,760,12,31,25,0,25
51,760,12,57,0,41,-41
51,760,12,86,34,38,-4
51,760,12,95,31,40,-9
51,760,12,99,31,21,10
51,760,12,103,28,23,5
51,760,13,51,29,0,29
51,760,13,67,28,44,-16
51,760,13,89,53,41,12
51,760,13,121,50,94,-44
51,760,13,135,34,43,-9
51,760,17,31,92,144,-52
51,760,18,97,29,0,29
51,760,21,111,27,0,27
51,760,22,33,0,25,-25
51,760,24,3,38,39,-1
51,760,24,5,40,42,-2
51,760,24,31,75,71,4
51,760,24,33,96,112,-16
51,760,24,510,153,73,80
51,760,25,17,34,51,-17
51,760,25,25,0,31,-31
51,760,26,163,49,0,49
51,760,34,3,31,0,31
51,760,34,13,121,45,76
51,760,34,17,23,0,23
51,760,34,23,26,0,26
51,760,36,5,76,35,41
51,760,36,29,23,0,23
51,760,36,47,189,152,37
51,760,36,55,33,0,33
51,760,36,59,25,0,25
51,760,36,61,117,135,-18
51,760,36,67,0,23,-23
51,760,36,81,62,54,8
51,760,36,103,40,0,40
51,760,36,119,56,0,56
51,760,37,51,27,0,27
51,760,37,63,60,44,16
51,760,37,67,32,0,32
51,760,37,81,24,43,-19
51,760,37,119,95,152,-57
51,760,37,129,32,23,9
51,760,37,135,34,0,34
51,760,37,147,24,0,24
51,760,37,183,101,118,-17
51,760,39,35,28,34,-6
51,760,39,49,43,36,7
51,760,41,51,0,33,-33
51,760,42,3,56,36,20
51,760,42,91,34,30,4
51,760,42,101,64,75,-11
51,760,45,19,44,33,11
51,760,45,79,0,22,-22
51,760,47,93,25,0,25
51,760,48,29,0,31,-31
51,760,48,113,30,51,-21
51,760,48,201,0,48,-48
51,760,48,453,38,54,-16
51,760,51,1,20,0,20
51,760,51,3,129,125,4
51,760,51,7,78,59,19
51,760,51,13,147,143,4
51,760,51,19,24,0,24
51,760,51,31,35,26,9
51,760,51,33,68,37,31
51,760,51,36,52,38,14
51,760,51,41,4646,5745,-1099
51,760,51,49,40,41,-1
51,760,51,53,78,54,24
51,760,51,57,0,28,-28
51,760,51,59,498,309,189
51,760,51,61,32,0,32
51,760,51,73,41,0,41
51,760,51,75,149,167,-18
51,760,51,83,30,0,30
51,760,51,85,621,645,-24
51,760,51,87,6431,7683,-1252
51,760,51,95,126,83,43
51,760,51,101,53,44,9
51,760,51,107,104,48,56
51,760,51,109,73,66,7
51,760,51,111,49,28,21
51,760,51,117,48,63,-15
51,760,51,119,0,29,-29
51,760,51,121,74,52,22
51,760,51,127,85,52,33
51,760,51,133,29,0,29
51,760,51,135,37,42,-5
51,760,51,137,0,29,-29
51,760,51,143,27,0,27
51,760,51,145,92,128,-36
51,760,51,147,54,35,19
51,760,51,149,78,98,-20
51,760,51,153,186,99,87
51,760,51,161,52,33,19
51,760,51,165,29,0,29
51,760,51,177,106,64,42
51,760,51,179,93,74,19
51,760,51,199,65,38,27
51,760,51,510,88,92,-4
51,760,51,540,144,72,72
51,760,51,550,115,83,32
51,760,51,570,134,78,56
51,760,51,590,30,42,-12
51,760,51,630,48,26,22
51,760,51,650,90,73,17
51,760,51,660,38,0,38
51,760,51,670,114,126,-12
51,760,51,680,54,43,11
51,760,51,700,150,84,66
51,760,51,710,176,122,54
51,760,51,730,230,187,43
51,760,51,740,50,52,-2
51,760,51,770,69,57,12
51,760,51,800,29,34,-5
51,760,51,810,218,163,55
51,760,51,830,25,0,25
51,760,53,33,25,71,-46
51,770,12,57,57,0,57
51,770,12,86,34,0,34
51,770,13,121,0,24,-24
51,770,36,5,34,0,34
51,770,36,47,34,26,8
51,770,37,67,36,0,36
51,770,37,81,0,110,-110
51,770,37,119,56,100,-44
51,770,37,183,29,55,-26
51,770,45,51,0,35,-35
51,770,51,3,37,0,37
51,770,51,5,43,57,-14
51,770,51,15,35,0,35
51,770,51,19,545,538,7
51,770,51,23,594,745,-151
51,770,51,41,49,72,-23
51,770,51,45,49,26,23
51,770,51,59,61,35,26
51,770,51,63,75,64,11
51,770,51,67,532,489,43
51,770,51,71,28,0,28
51,770,51,87,76,53,23
51,770,51,89,54,30,24
51,770,51,121,246,221,25
51,770,51,143,0,39,-39
51,770,51,155,42,52,-10
51,770,51,161,2968,3243,-275
51,770,51,163,30,0,30
51,770,51,515,51,34,17
51,770,51,550,0,32,-32
51,770,51,580,39,0,39
51,770,51,590,31,0,31
51,770,51,650,34,28,6
51,770,51,660,0,26,-26
51,770,51,680,50,58,-8
51,770,51,690,37,0,37
51,770,51,710,28,22,6
51,770,51,750,58,0,58
51,770,51,760,57,69,-12
51,770,51,775,811,950,-139
51,770,51,810,81,36,45
51,770,53,33,0,40,-40
51,775,51,19,63,73,-10
51,775,51,23,104,117,-13
51,775,51,45,50,0,50
51,775,51,67,82,78,4
51,775,51,121,144,155,-11
51,775,51,161,607,504,103
51,775,51,770,950,811,139
51,790,51,3,43,55,-12
51,790,51,15,829,781,48
51,790,51,59,32,0,32
51,790,51,121,0,29,-29
51,790,51,163,47,81,-34
51,790,51,165,117,112,5
51,790,51,540,34,31,3
51,790,51,660,99,66,33
51,790,51,820,302,245,57
51,800,6,73,73,83,-10
51,800,9,11,0,43,-43
51,800,12,19,0,50,-50
51,800,12,31,62,63,-1
51,800,12,33,0,49,-49
51,800,12,113,51,0,51
51,800,13,67,0,38,-38
51,800,13,121,0,28,-28
51,800,15,3,81,34,47
51,800,24,3,37,0,37
51,800,24,31,61,0,61
51,800,24,33,42,43,-1
51,800,26,163,0,39,-39
51,800,37,73,99,176,-77
51,800,37,119,0,32,-32
51,800,37,133,0,46,-46
51,800,37,139,0,64,-64
51,800,37,143,0,30,-30
51,800,37,183,0,59,-59
51,800,45,15,42,38,4
51,800,51,41,52,52,0
51,800,51,59,75,51,24
51,800,51,87,25,33,-8
51,800,51,93,434,478,-44
51,800,51,95,0,45,-45
51,800,51,153,39,39,0
51,800,51,175,106,132,-26
51,800,51,199,56,0,56
51,800,51,550,1296,927,369
51,800,51,620,110,104,6
51,800,51,650,266,190,76
51,800,51,700,393,246,147
51,800,51,710,611,448,163
51,800,51,740,1490,1054,436
51,800,51,760,34,29,5
51,800,51,810,1153,597,556
51,810,1,73,32,46,-14
51,810,1,89,25,73,-48
51,810,1,97,0,60,-60
51,810,1,101,34,37,-3
51,810,2,20,25,34,-9
51,810,4,3,0,34,-34
51,810,4,13,173,225,-52
51,810,4,19,60,60,0
51,810,6,1,36,49,-13
51,810,6,13,0,34,-34
51,810,6,29,56,88,-32
51,810,6,31,144,181,-37
51,810,6,37,235,264,-29
51,810,6,53,78,186,-108
51,810,6,59,86,112,-26
51,810,6,65,108,132,-24
51,810,6,67,34,46,-12
51,810,6,71,68,144,-76
51,810,6,73,1119,1061,58
51,810,6,77,0,42,-42
51,810,6,85,55,68,-13
51,810,6,111,130,142,-12
51,810,8,5,39,36,3
51,810,8,13,0,29,-29
51,810,8,31,0,38,-38
51,810,8,35,0,29,-29
51,810,8,41,61,129,-68
51,810,8,59,0,36,-36
51,810,9,1,58,27,31
51,810,9,3,55,32,23
51,810,9,9,48,54,-6
51,810,9,11,214,138,76
51,810,10,1,31,54,-23
51,810,10,3,68,58,10
51,810,11,1,129,95,34
51,810,12,5,67,106,-39
51,810,12,9,57,116,-59
51,810,12,11,158,134,24
51,810,12,19,216,265,-49
51,810,12,21,25,33,-8
51,810,12,31,938,552,386
51,810,12,33,523,312,211
51,810,12,53,0,31,-31
51,810,12,57,140,299,-159
51,810,12,69,45,58,-13
51,810,12,71,49,62,-13
51,810,12,81,0,33,-33
51,810,12,83,0,33,-33
51,810,12,86,146,123,23
51,810,12,87,89,90,-1
51,810,12,89,0,34,-34
51,810,12,91,54,74,-20
51,810,12,95,142,168,-26
51,810,12,97,37,39,-2
51,810,12,99,113,115,-2
51,810,12,101,0,62,-62
51,810,12,103,90,111,-21
51,810,12,105,44,81,-37
51,810,12,109,36,56,-20
51,810,12,111,0,43,-43
51,810,12,113,105,115,-10
51,810,12,115,32,48,-16
51,810,12,117,49,86,-37
51,810,12,127,45,74,-29
51,810,13,39,108,160,-52
51,810,13,51,46,47,-1
51,810,13,57,41,48,-7
51,810,13,63,0,49,-49
51,810,13,67,72,150,-78
51,810,13,73,43,46,-3
51,810,13,89,28,90,-62
51,810,13,97,0,50,-50
51,810,13,121,78,142,-64
51,810,13,135,77,146,-69
51,810,13,151,0,47,-47
51,810,13,215,41,31,10
51,810,13,223,0,50,-50
51,810,13,245,0,62,-62
51,810,15,3,515,498,17
51,810,16,1,0,41,-41
51,810,17,31,170,192,-22
51,810,17,43,31,47,-16
51,810,17,97,285,166,119
51,810,17,111,27,0,27
51,810,17,143,33,0,33
51,810,17,163,39,46,-7
51,810,17,197,39,0,39
51,810,18,3,33,0,33
51,810,18,89,0,34,-34
51,810,18,97,62,59,3
51,810,18,141,0,22,-22
51,810,20,91,0,39,-39
51,810,20,173,0,40,-40
51,810,21,47,33,0,33
51,810,21,67,0,32,-32
51,810,21,111,55,77,-22
51,810,22,33,22,32,-10
51,810,22,51,43,28,15
51,810,22,71,39,34,5
51,810,22,103,0,28,-28
51,810,23,5,107,78,29
51,810,23,19,25,0,25
51,810,23,23,0,48,-48
51,810,23,31,31,29,2
51,810,24,3,248,276,-28
51,810,24,5,147,98,49
51,810,24,9,43,58,-15
51,810,24,17,56,53,3
51,810,24,21,47,55,-8
51,810,24,25,59,36,23
51,810,24,27,54,84,-30
51,810,24,31,154,203,-49
51,810,24,33,154,247,-93
51,810,24,37,279,287,-8
51,810,24,45,33,0,33
51,810,24,510,56,43,13
51,810,25,1,27,0,27
51,810,25,9,34,37,-3
51,810,25,13,43,30,13
51,810,25,17,71,77,-6
51,810,25,21,46,26,20
51,810,25,23,24,0,24
51,810,25,25,33,29,4
51,810,25,27,39,39,0
51,810,26,49,33,31,2
51,810,26,65,37,0,37
51,810,26,81,39,31,8
51,810,26,99,50,40,10
51,810,26,125,56,82,-26
51,810,26,161,0,50,-50
51,810,26,163,162,193,-31
51,810,27,37,31,27,4
51,810,27,53,40,62,-22
51,810,28,47,122,97,25
51,810,28,59,69,90,-21
51,810,28,75,95,0,95
51,810,29,47,0,35,-35
51,810,29,95,0,36,-36
51,810,29,189,49,53,-4
51,810,31,55,0,41,-41
51,810,31,153,0,53,-53
51,810,32,1,51,57,-6
51,810,32,3,93,173,-80
51,810,33,11,43,21,22
51,810,33,15,31,0,31
51,810,34,3,47,38,9
51,810,34,5,80,50,30
51,810,34,7,33,70,-37
51,810,34,13,95,39,56
51,810,34,15,0,44,-44
51,810,34,17,62,41,21
51,810,34,21,32,0,32
51,810,34,23,56,32,24
51,810,34,25,46,48,-2
51,810,34,27,0,37,-37
51,810,34,29,51,47,4
51,810,34,31,0,38,-38
51,810,34,39,63,33,30
51,810,35,1,22,36,-14
51,810,36,1,37,0,37
51,810,36,5,122,130,-8
51,810,36,7,30,0,30
51,810,36,27,24,0,24
51,810,36,29,53,73,-20
51,810,36,45,0,37,-37
51,810,36,47,149,160,-11
51,810,36,55,72,55,17
51,810,36,59,106,88,18
51,810,36,61,91,116,-25
51,810,36,65,0,38,-38
51,810,36,67,47,35,12
51,810,36,71,59,0,59
51,810,36,81,211,152,59
51,810,36,85,34,0,34
51,810,36,91,64,53,11
51,810,36,103,145,86,59
51,810,36,111,25,0,25
51,810,36,119,48,42,6
51,810,37,21,0,65,-65
51,810,37,25,0,40,-40
51,810,37,29,40,152,-112
51,810,37,31,35,42,-7
51,810,37,41,0,27,-27
51,810,37,49,95,114,-19
51,810,37,51,130,217,-87
51,810,37,53,199,444,-245
51,810,37,55,65,91,-26
51,810,37,57,0,33,-33
51,810,37,63,52,44,8
51,810,37,67,50,72,-22
51,810,37,69,33,0,33
51,810,37,71,0,50,-50
51,810,37,73,30,123,-93
51,810,37,81,95,97,-2
51,810,37,83,0,34,-34
51,810,37,101,0,31,-31
51,810,37,119,141,326,-185
51,810,37,127,0,31,-31
51,810,37,129,54,49,5
51,810,37,133,306,305,1
51,810,37,135,0,32,-32
51,810,37,139,92,318,-226
51,810,37,143,0,56,-56
51,810,37,147,78,74,4
51,810,37,179,0,76,-76
51,810,37,183,160,388,-228
51,810,37,191,30,32,-2
51,810,37,195,0,37,-37
51,810,39,35,89,73,16
51,810,39,49,89,100,-11
51,810,39,61,44,54,-10
51,810,39,85,41,0,41
51,810,39,93,0,29,-29
51,810,39,95,0,33,-33
51,810,39,113,68,32,36
51,810,39,133,27,0,27
51,810,39,151,0,49,-49
51,810,39,153,40,41,-1
51,810,40,27,0,49,-49
51,810,40,31,31,52,-21
51,810,40,109,54,61,-7
51,810,40,143,30,71,-41
51,810,41,51,0,26,-26
51,810,42,3,112,78,34
51,810,42,11,35,0,35
51,810,42,17,75,59,16
51,810,42,21,27,0,27
51,810,42,29,28,67,-39
51,810,42,41,55,51,4
51,810,42,43,51,50,1
51,810,42,45,45,45,0
51,810,42,49,43,41,2
51,810,42,71,29,38,-9
51,810,42,77,43,27,16
51,810,42,79,31,0,31
51,810,42,91,81,68,13
51,810,42,95,35,31,4
51,810,42,101,167,127,40
51,810,42,133,66,0,66
51,810,44,5,199,172,27
51,810,44,7,47,58,-11
51,810,45,13,116,191,-75
51,810,45,15,222,190,32
51,810,45,19,94,123,-29
51,810,45,35,51,140,-89
51,810,45,45,52,85,-33
51,810,45,51,47,44,3
51,810,45,63,0,56,-56
51,810,45,79,44,55,-11
51,810,45,83,0,29,-29
51,810,45,91,0,47,-47
51,810,47,37,45,85,-40
51,810,47,65,0,37,-37
51,810,47,93,24,41,-17
51,810,47,125,46,78,-32
51,810,47,149,0,41,-41
51,810,47,157,139,193,-54
51,810,47,179,0,39,-39
51,810,48,27,76,95,-19
51,810,48,29,154,247,-93
51,810,48,39,0,36,-36
51,810,48,61,0,31,-31
51,810,48,85,28,75,-47
51,810,48,113,61,132,-71
51,810,48,121,0,37,-37
51,810,48,141,50,75,-25
51,810,48,157,31,59,-28
51,810,48,201,169,300,-131
51,810,48,273,101,0,101
51,810,48,355,122,89,33
51,810,48,409,109,47,62
51,810,48,439,153,184,-31
51,810,48,453,0,94,-94
51,810,48,485,0,28,-28
51,810,48,491,0,38,-38
51,810,49,35,30,37,-7
51,810,51,1,97,64,33
51,810,51,3,52,76,-24
51,810,51,13,135,176,-41
51,810,51,41,260,328,-68
51,810,51,59,588,669,-81
51,810,51,69,38,46,-8
51,810,51,73,36,50,-14
51,810,51,85,52,61,-9
51,810,51,87,274,298,-24
51,810,51,93,122,183,-61
51,810,51,95,138,192,-54
51,810,51,99,72,57,15
51,810,51,107,135,142,-7
51,810,51,117,0,40,-40
51,810,51,121,61,64,-3
51,810,51,131,73,60,13
51,810,51,143,35,32,3
51,810,51,153,279,303,-24
51,810,51,161,35,75,-40
51,810,51,175,69,77,-8
51,810,51,177,72,106,-34
51,810,51,179,101,92,9
51,810,51,187,24,0,24
51,810,51,199,116,194,-78
51,810,51,510,93,139,-46
51,810,51,540,40,60,-20
51,810,51,550,4889,6512,-1623
51,810,51,620,0,38,-38
51,810,51,630,42,0,42
51,810,51,650,825,869,-44
51,810,51,660,0,40,-40
51,810,51,670,29,0,29
51,810,51,680,41,38,3
51,810,51,700,744,776,-32
51,810,51,710,9254,8001,1253
51,810,51,730,0,24,-24
51,810,51,735,0,23,-23
51,810,51,740,1304,1425,-121
51,810,51,760,163,218,-55
51,810,51,770,36,81,-45
51,810,51,800,597,1153,-556
51,810,51,830,25,37,-12
51,810,51,840,26,0,26
51,810,53,29,127,155,-28
51,810,53,33,69,158,-89
51,810,53,35,118,132,-14
51,810,53,53,54,72,-18
51,810,53,57,48,32,16
51,810,53,61,51,101,-50
51,810,54,3,50,31,19
51,810,54,81,0,27,-27
51,810,55,59,60,74,-14
51,820,51,3,249,122,127
51,820,51,15,766,770,-4
51,820,51,65,31,0,31
51,820,51,79,39,0,39
51,820,51,125,65,56,9
51,820,51,163,31,0,31
51,820,51,165,45,37,8
51,820,51,540,106,49,57
51,820,51,660,46,0,46
51,820,51,790,245,302,-57
51,830,36,61,0,20,-20
51,830,51,13,0,30,-30
51,830,51,59,48,29,19
51,830,51,73,0,34,-34
51,830,51,87,0,43,-43
51,830,51,95,352,484,-132
51,830,51,127,0,28,-28
51,830,51,199,54,65,-11
51,830,51,650,57,46,11
51,830,51,700,146,161,-15
51,830,51,760,0,25,-25
51,830,51,810,37,25,12
51,840,24,31,28,0,28
51,840,24,43,29,24,5
51,840,51,43,121,84,37
51,840,51,59,125,72,53
51,840,51,69,1619,1937,-318
51,840,51,107,144,107,37
51,840,51,153,56,62,-6
51,840,51,171,104,124,-20
51,840,51,187,120,124,-4
51,840,51,810,0,26,-26
51,840,54,3,140,261,-121
51,840,54,27,75,61,14
51,840,54,37,34,39,-5
51,840,54,65,42,0,42
53,1,53,5,47,136,-89
53,1,53,21,102,162,-60
53,1,53,25,321,264,57
53,1,53,33,53,32,21
53,1,53,61,28,34,-6
53,1,53,63,78,143,-65
53,3,16,1,29,69,-40
53,3,16,35,34,0,34
53,3,16,49,40,0,40
53,3,16,55,37,42,-5
53,3,16,57,86,60,26
53,3,16,69,998,726,272
53,3,53,33,59,49,10
53,3,53,63,145,136,9
53,3,53,75,85,94,-9
53,5,2,20,59,51,8
53,5,4,13,191,170,21
53,5,4,21,0,36,-36
53,5,6,1,34,0,34
53,5,6,29,26,0,26
53,5,6,37,214,107,107
53,5,6,59,94,0,94
53,5,6,65,73,41,32
53,5,6,67,56,0,56
53,5,6,71,66,0,66
53,5,6,73,98,63,35
53,5,6,81,34,0,34
53,5,6,85,28,32,-4
53,5,6,111,47,0,47
53,5,8,5,27,0,27
53,5,15,3,41,0,41
53,5,16,1,119,93,26
53,5,16,19,84,52,32
53,5,16,27,70,48,22
53,5,16,55,88,60,28
53,5,16,57,69,41,28
53,5,16,65,31,30,1
53,5,16,83,40,0,40
53,5,17,31,0,35,-35
53,5,30,29,0,39,-39
53,5,32,3,224,110,114
53,5,35,1,59,0,59
53,5,41,5,54,29,25
53,5,41,17,53,35,18
53,5,41,29,32,0,32
53,5,41,39,62,36,26
53,5,41,47,93,80,13
53,5,41,49,67,0,67
53,5,41,51,109,129,-20
53,5,41,59,388,214,174
53,5,41,61,38,0,38
53,5,41,67,88,63,25
53,5,45,45,0,55,-55
53,5,48,201,44,0,44
53,5,49,35,32,63,-31
53,5,49,49,113,76,37
53,5,53,1,136,47,89
53,5,53,7,94,45,49
53,5,53,9,36,0,36
53,5,53,11,232,173,59
53,5,53,15,46,0,46
53,5,53,17,74,27,47
53,5,53,21,3300,3668,-368
53,5,53,25,349,196,153
53,5,53,27,63,0,63
53,5,53,29,45,0,45
53,5,53,33,711,657,54
53,5,53,35,163,69,94
53,5,53,37,87,54,33
53,5,53,39,78,0,78
53,5,53,41,63,0,63
53,5,53,45,0,30,-30
53,5,53,47,0,35,-35
53,5,53,53,329,162,167
53,5,53,57,76,43,33
53,5,53,61,381,237,144
53,5,53,63,536,568,-32
53,5,53,65,0,31,-31
53,5,53,67,138,80,58
53,5,53,71,416,298,118
53,5,53,73,57,76,-19
53,5,53,75,125,125,0
53,5,53,77,1288,879,409
53,7,2,20,26,0,26
53,7,4,13,103,48,55
53,7,4,19,0,28,-28
53,7,6,37,76,45,31
53,7,6,65,42,0,42
53,7,6,73,47,32,15
53,7,16,1,0,44,-44
53,7,41,5,26,0,26
53,7,41,51,0,28,-28
53,7,53,5,45,94,-49
53,7,53,9,26,0,26
53,7,53,11,46,50,-4
53,7,53,17,1812,1965,-153
53,7,53,21,40,43,-3
53,7,53,25,159,239,-80
53,7,53,27,0,30,-30
53,7,53,33,535,467,68
53,7,53,35,35,30,5
53,7,53,37,73,87,-14
53,7,53,47,187,135,52
53,7,53,53,139,138,1
53,7,53,57,49,57,-8
53,7,53,61,358,231,127
53,7,53,63,128,178,-50
53,7,53,67,75,52,23
53,7,53,73,66,117,-51
53,7,53,75,25,26,-1
53,7,53,77,132,102,30
53,9,2,20,32,0,32
53,9,4,13,73,61,12
53,9,4,19,0,32,-32
53,9,6,37,96,38,58
53,9,6,59,67,36,31
53,9,6,65,48,0,48
53,9,6,67,31,0,31
53,9,6,73,87,42,45
53,9,6,85,33,0,33
53,9,15,3,37,25,12
53,9,32,3,43,28,15
53,9,32,31,25,0,25
53,9,41,39,35,0,35
53,9,41,47,0,28,-28
53,9,41,51,0,50,-50
53,9,41,67,32,0,32
53,9,53,5,0,36,-36
53,9,53,7,0,26,-26
53,9,53,11,67,58,9
53,9,53,15,39,0,39
53,9,53,27,76,101,-25
53,9,53,29,0,34,-34
53,9,53,31,195,167,28
53,9,53,33,547,405,142
53,9,53,35,230,222,8
53,9,53,41,31,34,-3
53,9,53,45,46,33,13
53,9,53,53,245,194,51
53,9,53,57,45,41,4
53,9,53,61,218,191,27
53,9,53,63,66,80,-14
53,9,53,67,72,84,-12
53,9,53,73,70,130,-60
53,9,53,75,32,0,32
53,9,53,77,0,39,-39
53,11,2,20,144,91,53
53,11,2,90,0,22,-22
53,11,2,170,60,0,60
53,11,4,13,504,491,13
53,11,4,15,41,33,8
53,11,4,19,65,89,-24
53,11,4,21,0,77,-77
53,11,4,25,0,28,-28
53,11,4,27,0,31,-31
53,11,6,1,193,50,143
53,11,6,13,118,41,77
53,11,6,19,59,40,19
53,11,6,23,49,0,49
53,11,6,29,54,0,54
53,11,6,37,664,225,439
53,11,6,53,38,0,38
53,11,6,59,223,109,114
53,11,6,61,85,58,27
53,11,6,65,197,155,42
53,11,6,67,192,116,76
53,11,6,71,222,83,139
53,11,6,73,444,247,197
53,11,6,75,34,0,34
53,11,6,77,50,0,50
53,11,6,79,0,27,-27
53,11,6,81,122,34,88
53,11,6,83,31,25,6
53,11,6,85,283,89,194
53,11,6,87,33,0,33
53,11,6,89,30,0,30
53,11,6,95,59,28,31
53,11,6,97,65,0,65
53,11,6,99,63,0,63
53,11,6,107,39,0,39
53,11,6,111,75,28,47
53,11,6,113,36,0,36
53,11,8,1,0,32,-32
53,11,8,5,94,42,52
53,11,8,13,28,25,3
53,11,8,31,44,31,13
53,11,8,35,56,0,56
53,11,8,41,85,56,29
53,11,8,59,32,0,32
53,11,8,69,30,0,30
53,11,12,11,0,30,-30
53,11,12,31,33,30,3
53,11,12,57,0,39,-39
53,11,12,95,38,28,10
53,11,12,103,26,0,26
53,11,12,115,65,0,65
53,11,13,67,27,33,-6
53,11,15,1,50,47,3
53,11,15,3,223,131,92
53,11,15,9,45,27,18
53,11,16,1,165,189,-24
53,11,16,17,0,43,-43
53,11,16,27,38,53,-15
53,11,16,55,86,92,-6
53,11,16,57,47,0,47
53,11,17,31,53,35,18
53,11,20,91,45,0,45
53,11,26,125,53,0,53
53,11,26,161,29,0,29
53,11,26,163,31,0,31
53,11,27,53,28,0,28
53,11,30,13,0,38,-38
53,11,30,29,40,66,-26
53,11,30,31,26,60,-34
53,11,30,49,27,0,27
53,11,30,63,26,54,-28
53,11,30,111,0,28,-28
53,11,32,3,325,223,102
53,11,32,31,118,76,42
53,11,35,1,65,34,31
53,11,36,61,28,0,28
53,11,37,119,0,44,-44
53,11,39,49,0,32,-32
53,11,40,143,32,0,32
53,11,41,3,118,85,33
53,11,41,5,1505,1208,297
53,11,41,7,68,88,-20
53,11,41,9,177,150,27
53,11,41,11,65,36,29
53,11,41,17,143,216,-73
53,11,41,19,69,58,11
53,11,41,27,48,40,8
53,11,41,29,182,108,74
53,11,41,33,39,0,39
53,11,41,35,101,39,62
53,11,41,39,293,238,55
53,11,41,41,64,75,-11
53,11,41,43,83,69,14
53,11,41,47,383,317,66
53,11,41,51,4976,3642,1334
53,11,41,53,54,72,-18
53,11,41,57,56,47,9
53,11,41,59,75,54,21
53,11,41,61,27,0,27
53,11,41,65,99,45,54
53,11,41,67,1982,1351,631
53,11,41,71,93,125,-32
53,11,48,27,0,31,-31
53,11,48,29,53,67,-14
53,11,48,85,47,38,9
53,11,48,113,26,76,-50
53,11,48,141,34,0,34
53,11,48,201,104,112,-8
53,11,48,339,0,47,-47
53,11,48,439,74,89,-15
53,11,48,453,27,40,-13
53,11,48,491,0,37,-37
53,11,49,11,71,55,16
53,11,49,35,124,155,-31
53,11,49,49,97,115,-18
53,11,49,53,0,38,-38
53,11,51,59,30,36,-6
53,11,53,5,173,232,-59
53,11,53,7,50,46,4
53,11,53,9,58,67,-9
53,11,53,15,1482,1769,-287
53,11,53,21,43,93,-50
53,11,53,25,50,69,-19
53,11,53,27,76,76,0
53,11,53,29,46,78,-32
53,11,53,31,35,0,35
53,11,53,33,1210,1221,-11
53,11,53,35,177,150,27
53,11,53,37,79,40,39
53,11,53,39,125,185,-60
53,11,53,41,128,149,-21
53,11,53,45,46,93,-47
53,11,53,47,34,0,34
53,11,53,49,126,159,-33
53,11,53,53,600,630,-30
53,11,53,57,71,74,-3
53,11,53,59,247,210,37
53,11,53,61,371,413,-42
53,11,53,63,435,420,15
53,11,53,65,35,40,-5
53,11,53,67,248,429,-181
53,11,53,69,0,35,-35
53,11,53,71,79,66,13
53,11,53,73,168,173,-5
53,11,53,75,103,89,14
53,11,53,77,215,177,38
53,13,53,71,97,84,13
53,15,4,13,73,65,8
53,15,6,37,68,0,68
53,15,6,59,53,0,53
53,15,6,65,43,0,43
53,15,6,67,38,0,38
53,15,6,71,46,0,46
53,15,6,73,70,29,41
53,15,32,3,43,37,6
53,15,32,31,0,27,-27
53,15,41,5,104,92,12
53,15,41,7,91,62,29
53,15,41,9,305,258,47
53,15,41,17,36,26,10
53,15,41,39,69,61,8
53,15,41,47,71,42,29
53,15,41,51,293,245,48
53,15,41,67,159,128,31
53,15,53,5,0,46,-46
53,15,53,9,0,39,-39
53,15,53,11,1769,1482,287
53,15,53,27,100,59,41
53,15,53,29,0,27,-27
53,15,53,33,289,264,25
53,15,53,35,37,25,12
53,15,53,37,0,27,-27
53,15,53,41,390,389,1
53,15,53,45,0,36,-36
53,15,53,49,88,64,24
53,15,53,53,150,167,-17
53,15,53,61,114,113,1
53,15,53,63,60,58,2
53,15,53,67,143,139,4
53,15,53,69,105,94,11
53,15,53,73,44,62,-18
53,15,53,77,40,72,-32
53,17,4,13,48,0,48
53,17,6,37,46,0,46
53,17,32,3,49,0,49
53,17,53,5,27,74,-47
53,17,53,7,1965,1812,153
53,17,53,25,142,182,-40
53,17,53,33,208,168,40
53,17,53,37,30,28,2
53,17,53,47,108,116,-8
53,17,53,53,76,77,-1
53,17,53,61,121,107,14
53,17,53,63,86,134,-48
53,17,53,67,35,0,35
53,17,53,73,0,26,-26
53,17,53,77,71,43,28
53,19,53,33,80,28,52
53,19,53,47,0,39,-39
53,19,53,61,0,49,-49
53,19,53,63,101,91,10
53,19,53,65,96,85,11
53,21,4,13,51,52,-1
53,21,6,37,105,58,47
53,21,6,59,64,35,29
53,21,6,65,75,0,75
53,21,6,67,43,0,43
53,21,6,71,75,0,75
53,21,6,73,62,0,62
53,21,16,1,0,31,-31
53,21,16,55,0,24,-24
53,21,32,3,110,38,72
53,21,41,51,47,25,22
53,21,41,59,110,68,42
53,21,41,67,57,30,27
53,21,48,201,0,39,-39
53,21,49,35,0,40,-40
53,21,53,1,162,102,60
53,21,53,5,3668,3300,368
53,21,53,7,43,40,3
53,21,53,11,93,43,50
53,21,53,25,204,136,68
53,21,53,33,207,202,5
53,21,53,53,124,47,77
53,21,53,61,159,89,70
53,21,53,63,181,164,17
53,21,53,67,42,0,42
53,21,53,71,319,175,144
53,21,53,77,372,160,212
53,23,16,69,0,30,-30
53,25,4,13,72,71,1
53,25,6,37,108,0,108
53,25,6,59,39,0,39
53,25,6,67,41,0,41
53,25,6,71,46,0,46
53,25,6,73,40,0,40
53,25,16,1,0,36,-36
53,25,16,55,41,35,6
53,25,32,3,59,31,28
53,25,41,51,29,0,29
53,25,41,59,37,43,-6
53,25,41,67,30,0,30
53,25,48,215,0,47,-47
53,25,49,49,0,33,-33
53,25,53,1,264,321,-57
53,25,53,5,196,349,-153
53,25,53,7,239,159,80
53,25,53,11,69,50,19
53,25,53,17,182,142,40
53,25,53,21,136,204,-68
53,25,53,27,0,34,-34
53,25,53,29,34,0,34
53,25,53,33,494,273,221
53,25,53,35,42,34,8
53,25,53,37,113,121,-8
53,25,53,41,46,34,12
53,25,53,43,58,74,-16
53,25,53,45,38,0,38
53,25,53,47,121,72,49
53,25,53,53,247,158,89
53,25,53,57,61,37,24
53,25,53,61,426,149,277
53,25,53,63,382,501,-119
53,25,53,67,52,63,-11
53,25,53,71,50,40,10
53,25,53,73,73,37,36
53,25,53,75,57,51,6
53,25,53,77,257,213,44
53,27,4,13,49,48,1
53,27,4,19,28,0,28
53,27,6,37,29,0,29
53,27,32,3,35,0,35
53,27,41,5,33,0,33
53,27,41,51,35,46,-11
53,27,41,67,29,33,-4
53,27,53,5,0,63,-63
53,27,53,7,30,0,30
53,27,53,9,101,76,25
53,27,53,11,76,76,0
53,27,53,15,59,100,-41
53,27,53,25,34,0,34
53,27,53,33,413,332,81
53,27,53,35,71,58,13
53,27,53,37,0,33,-33
53,27,53,41,133,152,-19
53,27,53,45,234,200,34
53,27,53,49,146,112,34
53,27,53,53,438,294,144
53,27,53,57,36,0,36
53,27,53,61,189,125,64
53,27,53,63,61,100,-39
53,27,53,67,711,941,-230
53,27,53,73,39,58,-19
53,27,53,75,0,45,-45
53,27,53,77,0,75,-75
53,29,2,20,32,0,32
53,29,4,13,98,144,-46
53,29,4,19,0,57,-57
53,29,6,1,29,0,29
53,29,6,29,94,58,36
53,29,6,31,129,121,8
53,29,6,37,116,106,10
53,29,6,59,68,34,34
53,29,6,65,69,42,27
53,29,6,67,0,29,-29
53,29,6,71,51,38,13
53,29,6,73,462,412,50
53,29,6,85,28,0,28
53,29,6,111,126,116,10
53,29,8,41,0,30,-30
53,29,12,19,137,44,93
53,29,12,31,231,90,141
53,29,12,33,216,103,113
53,29,12,57,0,38,-38
53,29,15,3,209,150,59
53,29,16,1,0,31,-31
53,29,17,31,35,35,0
53,29,24,37,70,98,-28
53,29,28,47,0,44,-44
53,29,32,1,64,62,2
53,29,32,3,50,75,-25
53,29,37,49,0,59,-59
53,29,40,109,34,52,-18
53,29,41,5,0,36,-36
53,29,41,51,36,67,-31
53,29,41,67,0,27,-27
53,29,47,157,0,35,-35
53,29,48,29,41,54,-13
53,29,48,113,0,31,-31
53,29,48,201,0,62,-62
53,29,48,355,0,68,-68
53,29,48,439,32,55,-23
53,29,51,59,38,37,1
53,29,51,710,45,44,1
53,29,51,810,155,127,28
53,29,53,5,0,45,-45
53,29,53,9,34,0,34
53,29,53,11,78,46,32
53,29,53,15,27,0,27
53,29,53,25,0,34,-34
53,29,53,33,874,672,202
53,29,53,35,97,143,-46
53,29,53,53,123,149,-26
53,29,53,57,482,643,-161
53,29,53,61,1406,1424,-18
53,29,53,63,45,81,-36
53,29,53,67,0,57,-57
53,29,53,73,183,315,-132
53,31,6,37,54,0,54
53,31,6,59,34,0,34
53,31,6,73,49,26,23
53,31,41,51,37,39,-2
53,31,53,9,167,195,-28
53,31,53,11,0,35,-35
53,31,53,33,359,211,148
53,31,53,35,320,292,28
53,31,53,45,28,43,-15
53,31,53,53,96,88,8
53,31,53,61,89,90,-1
53,31,53,67,43,39,4
53,31,53,73,38,48,-10
53,31,53,77,33,0,33
53,33,1,3,32,0,32
53,33,1,73,43,54,-11
53,33,1,89,51,93,-42
53,33,1,97,0,25,-25
53,33,2,13,39,25,14
53,33,2,16,134,35,99
53,33,2,20,655,401,254
53,33,2,90,108,72,36
53,33,2,110,77,67,10
53,33,2,122,76,53,23
53,33,2,130,67,57,10
53,33,2,150,0,35,-35
53,33,2,170,87,64,23
53,33,2,280,23,0,23
53,33,4,3,48,30,18
53,33,4,5,107,60,47
53,33,4,13,2222,2324,-102
53,33,4,15,70,74,-4
53,33,4,19,563,583,-20
53,33,4,21,72,177,-105
53,33,4,25,89,108,-19
53,33,4,27,64,108,-44
53,33,5,7,44,0,44
53,33,5,119,59,43,16
53,33,5,143,39,0,39
53,33,6,1,966,839,127
53,33,6,7,81,37,44
53,33,6,13,641,468,173
53,33,6,17,102,34,68
53,33,6,19,198,148,50
53,33,6,23,113,47,66
53,33,6,25,0,34,-34
53,33,6,29,189,110,79
53,33,6,31,35,0,35
53,33,6,37,3700,2610,1090
53,33,6,39,40,0,40
53,33,6,41,163,147,16
53,33,6,45,31,0,31
53,33,6,47,60,38,22
53,33,6,53,169,110,59
53,33,6,55,72,0,72
53,33,6,57,50,34,16
53,33,6,59,1529,975,554
53,33,6,61,235,135,100
53,33,6,65,629,497,132
53,33,6,67,774,471,303
53,33,6,71,564,311,253
53,33,6,73,2064,1621,443
53,33,6,75,953,1120,-167
53,33,6,77,223,103,120
53,33,6,79,123,113,10
53,33,6,81,502,460,42
53,33,6,83,214,164,50
53,33,6,85,1270,1249,21
53,33,6,87,131,90,41
53,33,6,89,79,88,-9
53,33,6,93,26,0,26
53,33,6,95,124,128,-4
53,33,6,97,214,173,41
53,33,6,99,111,98,13
53,33,6,101,47,0,47
53,33,6,107,87,71,16
53,33,6,111,397,249,148
53,33,6,113,107,93,14
53,33,8,1,124,111,13
53,33,8,5,202,206,-4
53,33,8,13,304,242,62
53,33,8,14,41,56,-15
53,33,8,31,487,366,121
53,33,8,35,219,184,35
53,33,8,37,0,29,-29
53,33,8,41,263,232,31
53,33,8,59,186,146,40
53,33,8,69,186,110,76
53,33,8,77,38,39,-1
53,33,8,101,0,36,-36
53,33,8,107,0,34,-34
53,33,8,123,66,43,23
53,33,9,1,188,138,50
53,33,9,3,119,94,25
53,33,9,5,28,0,28
53,33,9,9,147,82,65
53,33,9,11,74,48,26
53,33,10,3,99,48,51
53,33,11,1,410,329,81
53,33,12,1,84,27,57
53,33,12,5,41,0,41
53,33,12,9,87,57,30
53,33,12,11,248,177,71
53,33,12,19,28,0,28
53,33,12,21,51,26,25
53,33,12,31,152,131,21
53,33,12,33,49,84,-35
53,33,12,57,263,146,117
53,33,12,71,123,89,34
53,33,12,73,47,0,47
53,33,12,81,55,36,19
53,33,12,86,326,204,122
53,33,12,87,25,0,25
53,33,12,91,36,0,36
53,33,12,95,277,217,60
53,33,12,97,0,29,-29
53,33,12,99,157,116,41
53,33,12,101,51,78,-27
53,33,12,103,193,151,42
53,33,12,105,54,44,10
53,33,12,109,0,39,-39
53,33,12,115,66,0,66
53,33,12,117,77,28,49
53,33,12,127,61,28,33
53,33,13,51,30,52,-22
53,33,13,57,30,41,-11
53,33,13,59,31,0,31
53,33,13,63,58,0,58
53,33,13,67,189,163,26
53,33,13,89,308,165,143
53,33,13,117,43,0,43
53,33,13,121,363,260,103
53,33,13,135,167,103,64
53,33,15,1,189,206,-17
53,33,15,3,1157,871,286
53,33,15,7,59,56,3
53,33,15,9,165,189,-24
53,33,16,1,557,631,-74
53,33,16,5,47,63,-16
53,33,16,13,73,59,14
53,33,16,17,72,82,-10
53,33,16,19,67,65,2
53,33,16,27,117,143,-26
53,33,16,55,229,315,-86
53,33,16,57,167,58,109
53,33,16,65,57,74,-17
53,33,16,69,78,23,55
53,33,16,83,63,47,16
53,33,17,19,108,44,64
53,33,17,31,1390,1082,308
53,33,17,43,273,153,120
53,33,17,77,32,0,32
53,33,17,89,72,41,31
53,33,17,97,176,87,89
53,33,17,111,44,0,44
53,33,17,113,56,0,56
53,33,17,119,27,0,27
53,33,17,143,29,0,29
53,33,17,161,80,0,80
53,33,17,163,0,34,-34
53,33,17,167,23,0,23
53,33,17,197,60,50,10
53,33,17,201,47,41,6
53,33,18,3,62,0,62
53,33,18,57,36,64,-28
53,33,18,89,28,0,28
53,33,18,97,160,117,43
53,33,18,105,90,56,34
53,33,18,141,40,30,10
53,33,18,157,60,0,60
53,33,18,163,25,0,25
53,33,19,103,62,50,12
53,33,19,113,47,26,21
53,33,19,153,87,63,24
53,33,19,163,48,212,-164
53,33,19,169,41,0,41
53,33,20,45,69,0,69
53,33,20,91,198,99,99
53,33,20,111,50,0,50
53,33,20,161,26,0,26
53,33,20,173,133,115,18
53,33,21,15,27,0,27
53,33,21,67,90,36,54
53,33,21,111,78,64,14
53,33,21,117,30,29,1
53,33,22,17,0,24,-24
53,33,22,33,71,29,42
53,33,22,51,52,41,11
53,33,22,55,0,37,-37
53,33,22,71,95,78,17
53,33,23,5,81,79,2
53,33,23,19,27,0,27
53,33,23,31,31,0,31
53,33,24,3,100,76,24
53,33,24,5,131,56,75
53,33,24,27,67,53,14
53,33,24,31,320,221,99
53,33,24,33,98,52,46
53,33,24,510,159,95,64
53,33,25,1,48,38,10
53,33,25,5,38,0,38
53,33,25,9,80,99,-19
53,33,25,13,40,39,1
53,33,25,15,50,40,10
53,33,25,17,692,437,255
53,33,25,21,182,98,84
53,33,25,23,0,32,-32
53,33,25,25,360,335,25
53,33,25,27,116,57,59
53,33,26,21,47,0,47
53,33,26,49,38,0,38
53,33,26,55,32,25,7
53,33,26,65,108,34,74
53,33,26,77,63,0,63
53,33,26,81,128,58,70
53,33,26,93,39,0,39
53,33,26,99,116,0,116
53,33,26,103,26,0,26
53,33,26,121,31,0,31
53,33,26,125,401,118,283
53,33,26,139,0,28,-28
53,33,26,161,298,118,180
53,33,26,163,255,68,187
53,33,27,3,69,32,37
53,33,27,13,25,0,25
53,33,27,37,132,85,47
53,33,27,53,679,404,275
53,33,27,109,93,34,59
53,33,27,111,25,0,25
53,33,27,123,187,126,61
53,33,27,137,54,27,27
53,33,27,139,42,0,42
53,33,27,145,34,0,34
53,33,27,163,63,35,28
53,33,29,19,59,33,26
53,33,29,47,0,48,-48
53,33,29,77,37,0,37
53,33,29,95,172,84,88
53,33,29,165,40,0,40
53,33,29,183,65,41,24
53,33,29,189,339,195,144
53,33,29,510,148,91,57
53,33,30,13,64,76,-12
53,33,30,29,136,193,-57
53,33,30,31,183,144,39
53,33,30,47,0,35,-35
53,33,30,49,87,91,-4
53,33,30,53,0,27,-27
53,33,30,63,256,219,37
53,33,30,81,60,64,-4
53,33,30,93,25,35,-10
53,33,30,111,128,145,-17
53,33,31,55,220,109,111
53,33,31,109,53,47,6
53,33,31,153,50,32,18
53,33,32,3,1327,1059,268
53,33,32,5,24,0,24
53,33,32,31,361,259,102
53,33,32,510,60,0,60
53,33,33,5,21,0,21
53,33,33,9,41,36,5
53,33,33,11,63,46,17
53,33,33,13,26,0,26
53,33,33,15,48,53,-5
53,33,34,1,26,0,26
53,33,34,3,130,63,67
53,33,34,7,53,42,11
53,33,34,13,60,35,25
53,33,34,15,34,0,34
53,33,34,17,128,139,-11
53,33,34,19,40,0,40
53,33,34,21,101,78,23
53,33,34,23,189,104,85
53,33,34,25,29,0,29
53,33,34,27,94,49,45
53,33,34,31,28,0,28
53,33,34,35,54,29,25
53,33,34,39,29,0,29
53,33,35,1,288,241,47
53,33,35,13,54,46,8
53,33,35,28,28,0,28
53,33,35,43,46,62,-16
53,33,35,45,38,0,38
53,33,35,49,69,70,-1
53,33,36,1,44,25,19
53,33,36,5,89,91,-2
53,33,36,7,34,0,34
53,33,36,27,42,0,42
53,33,36,29,118,50,68
53,33,36,45,51,31,20
53,33,36,47,375,507,-132
53,33,36,55,124,76,48
53,33,36,59,102,42,60
53,33,36,61,753,851,-98
53,33,36,67,73,40,33
53,33,36,71,0,35,-35
53,33,36,81,267,189,78
53,33,36,83,33,0,33
53,33,36,87,40,0,40
53,33,36,91,0,30,-30
53,33,36,103,142,92,50
53,33,36,109,95,52,43
53,33,36,119,121,84,37
53,33,37,21,54,81,-27
53,33,37,51,73,62,11
53,33,37,63,119,99,20
53,33,37,67,38,56,-18
53,33,37,81,104,28,76
53,33,37,119,219,182,37
53,33,37,133,58,64,-6
53,33,37,135,88,60,28
53,33,37,183,245,162,83
53,33,38,15,22,0,22
53,33,38,17,71,29,42
53,33,38,35,35,0,35
53,33,38,101,0,23,-23
53,33,39,17,47,0,47
53,33,39,35,242,110,132
53,33,39,41,32,0,32
53,33,39,49,336,196,140
53,33,39,57,28,0,28
53,33,39,61,213,81,132
53,33,39,93,29,0,29
53,33,39,95,60,21,39
53,33,39,113,94,36,58
53,33,39,153,51,0,51
53,33,39,165,42,0,42
53,33,40,27,77,30,47
53,33,40,109,128,105,23
53,33,40,119,25,0,25
53,33,40,143,162,75,87
53,33,41,3,212,124,88
53,33,41,5,447,480,-33
53,33,41,7,69,78,-9
53,33,41,9,43,61,-18
53,33,41,11,54,55,-1
53,33,41,17,212,260,-48
53,33,41,19,62,60,2
53,33,41,27,0,23,-23
53,33,41,29,194,141,53
53,33,41,33,65,47,18
53,33,41,35,46,0,46
53,33,41,39,598,334,264
53,33,41,41,45,40,5
53,33,41,43,65,93,-28
53,33,41,47,317,233,84
53,33,41,51,1544,1736,-192
53,33,41,53,65,89,-24
53,33,41,57,26,39,-13
53,33,41,59,95,54,41
53,33,41,61,33,0,33
53,33,41,65,37,0,37
53,33,41,67,1101,850,251
53,33,41,71,66,69,-3
53,33,42,3,268,160,108
53,33,42,17,67,36,31
53,33,42,27,31,43,-12
53,33,42,29,89,86,3
53,33,42,43,41,0,41
53,33,42,45,106,36,70
53,33,42,49,33,0,33
53,33,42,71,38,48,-10
53,33,42,77,44,0,44
53,33,42,91,122,96,26
53,33,42,95,36,0,36
53,33,42,101,322,226,96
53,33,42,129,29,0,29
53,33,42,133,30,0,30
53,33,44,5,30,0,30
53,33,44,7,108,63,45
53,33,44,9,23,0,23
53,33,45,15,37,35,2
53,33,45,19,71,73,-2
53,33,45,45,51,41,10
53,33,45,79,28,55,-27
53,33,46,99,44,49,-5
53,33,46,103,40,41,-1
53,33,47,37,231,134,97
53,33,47,65,30,0,30
53,33,47,93,65,42,23
53,33,47,125,58,0,58
53,33,47,157,134,131,3
53,33,47,187,0,69,-69
53,33,48,27,96,80,16
53,33,48,29,297,284,13
53,33,48,39,39,33,6
53,33,48,41,44,0,44
53,33,48,85,299,303,-4
53,33,48,113,598,467,131
53,33,48,121,255,197,58
53,33,48,141,133,99,34
53,33,48,157,76,133,-57
53,33,48,167,51,64,-13
53,33,48,201,733,619,114
53,33,48,215,38,0,38
53,33,48,309,33,0,33
53,33,48,339,61,115,-54
53,33,48,355,34,48,-14
53,33,48,375,43,0,43
53,33,48,381,28,0,28
53,33,48,439,422,281,141
53,33,48,453,561,551,10
53,33,48,491,145,153,-8
53,33,49,5,35,58,-23
53,33,49,11,114,124,-10
53,33,49,35,633,620,13
53,33,49,43,35,30,5
53,33,49,49,385,305,80
53,33,49,53,48,46,2
53,33,49,57,55,41,14
53,33,50,7,91,67,24
53,33,50,23,20,0,20
53,33,51,3,47,35,12
53,33,51,13,183,96,87
53,33,51,41,43,0,43
53,33,51,59,433,347,86
53,33,51,87,74,28,46
53,33,51,107,77,64,13
53,33,51,121,30,0,30
53,33,51,153,73,65,8
53,33,51,510,91,88,3
53,33,51,540,35,33,2
53,33,51,550,0,23,-23
53,33,51,650,25,0,25
53,33,51,700,38,0,38
53,33,51,710,69,56,13
53,33,51,760,71,25,46
53,33,51,770,40,0,40
53,33,51,810,158,69,89
53,33,53,1,32,53,-21
53,33,53,3,49,59,-10
53,33,53,5,657,711,-54
53,33,53,7,467,535,-68
53,33,53,9,405,547,-142
53,33,53,11,1221,1210,11
53,33,53,15,264,289,-25
53,33,53,17,168,208,-40
53,33,53,19,28,80,-52
53,33,53,21,202,207,-5
53,33,53,25,273,494,-221
53,33,53,27,332,413,-81
53,33,53,29,672,874,-202
53,33,53,31,211,359,-148
53,33,53,35,2579,2547,32
53,33,53,37,686,821,-135
53,33,53,39,30,60,-30
53,33,53,41,330,429,-99
53,33,53,43,38,52,-14
53,33,53,45,339,458,-119
53,33,53,47,149,279,-130
53,33,53,49,88,125,-37
53,33,53,51,0,57,-57
53,33,53,53,14827,20097,-5270
53,33,53,55,168,192,-24
53,33,53,57,602,828,-226
53,33,53,61,18015,23134,-5119
53,33,53,63,2158,1876,282
53,33,53,65,87,138,-51
53,33,53,67,1991,2412,-421
53,33,53,71,175,262,-87
53,33,53,73,1866,1837,29
53,33,53,75,560,412,148
53,33,53,77,1107,834,273
53,33,55,9,36,0,36
53,33,55,25,272,161,111
53,33,55,73,20,0,20
53,33,55,79,182,88,94
53,33,55,87,0,24,-24
53,33,55,105,26,0,26
53,33,55,133,82,64,18
53,33,55,139,25,28,-3
53,33,56,1,37,0,37
53,33,56,21,34,0,34
53,33,56,25,0,30,-30
53,33,56,39,49,36,13
53,35,2,20,58,25,33
53,35,2,110,0,35,-35
53,35,4,13,252,262,-10
53,35,4,15,35,0,35
53,35,4,19,52,62,-10
53,35,4,27,40,26,14
53,35,6,1,58,64,-6
53,35,6,13,93,36,57
53,35,6,19,28,0,28
53,35,6,29,58,50,8
53,35,6,31,63,51,12
53,35,6,37,268,163,105
53,35,6,53,74,92,-18
53,35,6,59,180,101,79
53,35,6,61,0,36,-36
53,35,6,65,112,130,-18
53,35,6,67,81,47,34
53,35,6,71,105,133,-28
53,35,6,73,877,797,80
53,35,6,75,35,27,8
53,35,6,77,52,31,21
53,35,6,79,0,30,-30
53,35,6,81,34,24,10
53,35,6,85,88,68,20
53,35,6,95,41,42,-1
53,35,6,97,39,38,1
53,35,6,99,56,0,56
53,35,6,111,148,96,52
53,35,8,1,0,45,-45
53,35,8,5,34,0,34
53,35,8,13,0,27,-27
53,35,8,31,30,0,30
53,35,8,41,63,68,-5
53,35,8,59,0,34,-34
53,35,9,11,618,251,367
53,35,11,1,0,32,-32
53,35,12,5,31,0,31
53,35,12,9,45,77,-32
53,35,12,11,28,0,28
53,35,12,31,147,70,77
53,35,12,33,48,56,-8
53,35,13,39,193,170,23
53,35,15,1,27,49,-22
53,35,15,3,579,444,135
53,35,16,1,49,55,-6
53,35,16,27,0,42,-42
53,35,16,55,39,59,-20
53,35,17,31,63,70,-7
53,35,17,97,83,57,26
53,35,24,3,25,46,-21
53,35,24,31,45,38,7
53,35,26,163,33,0,33
53,35,29,189,28,28,0
53,35,31,55,0,29,-29
53,35,32,1,42,0,42
53,35,32,3,169,159,10
53,35,32,31,47,52,-5
53,35,35,1,40,30,10
53,35,36,47,0,39,-39
53,35,36,61,0,23,-23
53,35,36,91,97,69,28
53,35,37,133,39,77,-38
53,35,39,49,37,0,37
53,35,41,5,26,40,-14
53,35,41,11,0,34,-34
53,35,41,17,28,65,-37
53,35,41,29,30,0,30
53,35,41,39,47,48,-1
53,35,41,47,60,33,27
53,35,41,51,106,121,-15
53,35,41,67,80,93,-13
53,35,42,3,29,0,29
53,35,44,5,0,50,-50
53,35,45,15,285,105,180
53,35,45,19,104,50,54
53,35,45,35,47,56,-9
53,35,47,157,38,52,-14
53,35,48,27,0,28,-28
53,35,48,29,55,85,-30
53,35,48,113,40,0,40
53,35,48,141,28,54,-26
53,35,48,201,66,138,-72
53,35,48,355,50,0,50
53,35,48,439,45,68,-23
53,35,48,453,0,41,-41
53,35,49,35,44,67,-23
53,35,49,49,35,50,-15
53,35,51,59,84,65,19
53,35,51,550,115,60,55
53,35,51,700,55,0,55
53,35,51,710,103,36,67
53,35,51,740,31,0,31
53,35,51,810,132,118,14
53,35,53,5,69,163,-94
53,35,53,7,30,35,-5
53,35,53,9,222,230,-8
53,35,53,11,150,177,-27
53,35,53,15,25,37,-12
53,35,53,25,34,42,-8
53,35,53,27,58,71,-13
53,35,53,29,143,97,46
53,35,53,31,292,320,-28
53,35,53,33,2547,2579,-32
53,35,53,37,28,86,-58
53,35,53,41,46,48,-2
53,35,53,45,741,1313,-572
53,35,53,47,28,34,-6
53,35,53,53,1946,2030,-84
53,35,53,57,58,74,-16
53,35,53,61,793,860,-67
53,35,53,63,150,219,-69
53,35,53,67,239,259,-20
53,35,53,71,0,47,-47
53,35,53,73,162,252,-90
53,35,53,75,50,71,-21
53,35,53,77,47,93,-46
53,37,4,13,0,35,-35
53,37,6,73,0,43,-43
53,37,32,3,0,36,-36
53,37,41,51,37,0,37
53,37,53,5,54,87,-33
53,37,53,7,87,73,14
53,37,53,11,40,79,-39
53,37,53,15,27,0,27
53,37,53,17,28,30,-2
53,37,53,25,121,113,8
53,37,53,27,33,0,33
53,37,53,33,821,686,135
53,37,53,35,86,28,58
53,37,53,41,26,0,26
53,37,53,45,43,0,43
53,37,53,53,288,253,35
53,37,53,57,34,0,34
53,37,53,61,254,211,43
53,37,53,63,55,141,-86
53,37,53,67,66,89,-23
53,37,53,73,36,53,-17
53,37,53,77,341,292,49
53,39,6,37,33,0,33
53,39,41,5,49,0,49
53,39,41,17,21,31,-10
53,39,41,27,135,87,48
53,39,41,51,102,61,41
53,39,41,65,172,144,28
53,39,41,67,46,0,46
53,39,53,5,0,78,-78
53,39,53,11,185,125,60
53,39,53,33,60,30,30
53,39,53,53,30,0,30
53,39,53,59,67,90,-23
53,39,53,61,35,0,35
53,39,53,63,49,0,49
53,39,53,77,58,100,-42
53,41,4,13,26,59,-33
53,41,4,21,0,40,-40
53,41,6,37,38,39,-1
53,41,6,59,38,0,38
53,41,6,65,39,33,6
53,41,6,73,37,25,12
53,41,15,3,25,0,25
53,41,32,3,48,0,48
53,41,41,5,41,0,41
53,41,41,51,63,68,-5
53,41,41,67,63,0,63
53,41,53,5,0,63,-63
53,41,53,9,34,31,3
53,41,53,11,149,128,21
53,41,53,15,389,390,-1
53,41,53,25,34,46,-12
53,41,53,27,152,133,19
53,41,53,33,429,330,99
53,41,53,35,48,46,2
53,41,53,37,0,26,-26
53,41,53,45,77,60,17
53,41,53,49,75,40,35
53,41,53,53,624,390,234
53,41,53,57,54,0,54
53,41,53,61,143,76,67
53,41,53,63,68,76,-8
53,41,53,67,1113,1371,-258
53,41,53,73,28,39,-11
53,41,53,77,74,59,15
53,43,53,25,74,58,16
53,43,53,33,52,38,14
53,43,53,61,27,0,27
53,43,53,63,316,368,-52
53,45,4,13,54,52,2
53,45,4,19,0,29,-29
53,45,6,37,25,0,25
53,45,6,73,66,51,15
53,45,15,3,26,0,26
53,45,41,5,0,29,-29
53,45,41,51,23,26,-3
53,45,53,5,30,0,30
53,45,53,9,33,46,-13
53,45,53,11,93,46,47
53,45,53,15,36,0,36
53,45,53,25,0,38,-38
53,45,53,27,200,234,-34
53,45,53,31,43,28,15
53,45,53,33,458,339,119
53,45,53,35,1313,741,572
53,45,53,37,0,43,-43
53,45,53,41,60,77,-17
53,45,53,49,29,0,29
53,45,53,53,571,443,128
53,45,53,61,108,66,42
53,45,53,63,39,58,-19
53,45,53,67,1010,1072,-62
53,45,53,73,0,33,-33
53,45,53,77,0,29,-29
53,47,6,73,51,0,51
53,47,41,51,0,26,-26
53,47,53,5,35,0,35
53,47,53,7,135,187,-52
53,47,53,11,0,34,-34
53,47,53,17,116,108,8
53,47,53,19,39,0,39
53,47,53,25,72,121,-49
53,47,53,33,279,149,130
53,47,53,35,34,28,6
53,47,53,53,97,63,34
53,47,53,57,57,54,3
53,47,53,61,284,132,152
53,47,53,63,221,292,-71
53,47,53,67,0,34,-34
53,47,53,73,74,43,31
53,47,53,77,58,37,21
53,49,41,5,28,0,28
53,49,41,7,71,88,-17
53,49,41,51,87,43,44
53,49,53,11,159,126,33
53,49,53,15,64,88,-24
53,49,53,27,112,146,-34
53,49,53,33,125,88,37
53,49,53,41,40,75,-35
53,49,53,45,0,29,-29
53,49,53,53,69,47,22
53,49,53,61,34,52,-18
53,49,53,63,23,28,-5
53,49,53,67,44,94,-50
53,49,53,69,29,34,-5
53,51,16,17,118,119,-1
53,51,16,55,57,29,28
53,51,53,33,57,0,57
53,51,53,63,370,366,4
53,51,53,65,28,72,-44
53,53,1,31,0,36,-36
53,53,1,45,52,57,-5
53,53,1,73,57,0,57
53,53,1,89,26,54,-28
53,53,1,97,32,0,32
53,53,1,113,0,50,-50
53,53,2,20,312,273,39
53,53,2,90,292,97,195
53,53,2,110,40,27,13
53,53,2,122,22,0,22
53,53,2,170,42,61,-19
53,53,4,3,160,165,-5
53,53,4,5,50,0,50
53,53,4,13,740,1004,-264
53,53,4,15,46,38,8
53,53,4,19,219,255,-36
53,53,4,21,62,93,-31
53,53,4,25,44,54,-10
53,53,4,27,81,120,-39
53,53,5,119,60,53,7
53,53,6,1,218,144,74
53,53,6,7,37,48,-11
53,53,6,13,130,73,57
53,53,6,19,162,92,70
53,53,6,23,39,0,39
53,53,6,29,143,100,43
53,53,6,31,34,0,34
53,53,6,37,1094,609,485
53,53,6,41,23,0,23
53,53,6,53,121,103,18
53,53,6,59,388,235,153
53,53,6,61,74,73,1
53,53,6,65,378,288,90
53,53,6,67,299,246,53
53,53,6,71,586,368,218
53,53,6,73,731,524,207
53,53,6,75,61,38,23
53,53,6,77,154,82,72
53,53,6,79,57,29,28
53,53,6,81,96,47,49
53,53,6,83,66,66,0
53,53,6,85,263,162,101
53,53,6,87,0,25,-25
53,53,6,89,46,55,-9
53,53,6,95,112,133,-21
53,53,6,97,77,41,36
53,53,6,99,94,72,22
53,53,6,101,30,0,30
53,53,6,107,53,31,22
53,53,6,111,122,92,30
53,53,6,113,24,0,24
53,53,6,115,44,41,3
53,53,8,1,44,42,2
53,53,8,5,132,73,59
53,53,8,13,46,37,9
53,53,8,31,48,83,-35
53,53,8,35,43,41,2
53,53,8,41,357,314,43
53,53,8,59,84,62,22
53,53,8,69,43,29,14
53,53,8,77,28,0,28
53,53,9,3,36,0,36
53,53,9,9,0,35,-35
53,53,9,11,38,0,38
53,53,10,1,0,118,-118
53,53,11,1,39,49,-10
53,53,12,5,0,40,-40
53,53,12,9,55,57,-2
53,53,12,11,57,84,-27
53,53,12,19,0,37,-37
53,53,12,31,115,104,11
53,53,12,33,65,38,27
53,53,12,57,102,128,-26
53,53,12,71,30,43,-13
53,53,12,83,27,0,27
53,53,12,86,110,76,34
53,53,12,91,99,60,39
53,53,12,95,81,104,-23
53,53,12,97,34,31,3
53,53,12,99,54,47,7
53,53,12,101,34,35,-1
53,53,12,103,111,41,70
53,53,12,105,44,44,0
53,53,12,113,50,0,50
53,53,12,115,46,0,46
53,53,12,117,57,0,57
53,53,12,127,42,0,42
53,53,13,51,74,52,22
53,53,13,53,106,92,14
53,53,13,63,49,34,15
53,53,13,67,50,59,-9
53,53,13,73,39,56,-17
53,53,13,89,62,37,25
53,53,13,121,95,69,26
53,53,13,135,88,70,18
53,53,13,151,0,47,-47
53,53,13,179,127,103,24
53,53,13,185,37,0,37
53,53,13,215,221,157,64
53,53,13,245,159,145,14
53,53,15,1,66,66,0
53,53,15,3,759,738,21
53,53,15,9,57,93,-36
53,53,16,1,137,170,-33
53,53,16,13,0,30,-30
53,53,16,17,38,0,38
53,53,16,19,0,65,-65
53,53,16,27,94,105,-11
53,53,16,39,29,0,29
53,53,16,55,125,119,6
53,53,16,57,38,25,13
53,53,16,65,0,48,-48
53,53,16,69,30,0,30
53,53,17,31,185,169,16
53,53,17,43,40,0,40
53,53,17,89,40,0,40
53,53,17,97,0,57,-57
53,53,17,163,44,43,1
53,53,18,89,32,0,32
53,53,18,97,82,58,24
53,53,19,113,34,0,34
53,53,19,153,31,0,31
53,53,20,61,99,133,-34
53,53,20,91,37,41,-4
53,53,20,103,141,146,-5
53,53,20,161,50,86,-36
53,53,20,173,41,67,-26
53,53,21,47,225,113,112
53,53,21,67,34,0,34
53,53,21,93,126,130,-4
53,53,21,111,38,36,2
53,53,21,163,79,0,79
53,53,22,71,0,33,-33
53,53,22,115,144,87,57
53,53,23,5,33,0,33
53,53,24,3,71,68,3
53,53,24,5,36,30,6
53,53,24,25,44,52,-8
53,53,24,27,31,0,31
53,53,24,31,82,114,-32
53,53,24,33,52,51,1
53,53,25,9,26,35,-9
53,53,25,13,28,0,28
53,53,25,17,57,33,24
53,53,25,21,0,24,-24
53,53,25,25,41,0,41
53,53,26,65,37,0,37
53,53,26,75,28,0,28
53,53,26,81,38,0,38
53,53,26,99,51,0,51
53,53,26,125,56,48,8
53,53,26,161,35,0,35
53,53,26,163,125,60,65
53,53,27,37,38,0,38
53,53,27,53,90,48,42
53,53,27,109,25,0,25
53,53,27,123,38,0,38
53,53,28,47,33,52,-19
53,53,28,87,27,0,27
53,53,29,47,28,0,28
53,53,29,77,0,26,-26
53,53,29,95,53,31,22
53,53,29,169,103,187,-84
53,53,29,183,35,0,35
53,53,29,189,97,47,50
53,53,30,13,48,36,12
53,53,30,29,71,79,-8
53,53,30,31,32,36,-4
53,53,30,49,30,59,-29
53,53,30,63,67,69,-2
53,53,30,81,42,36,6
53,53,30,111,51,71,-20
53,53,31,55,45,40,5
53,53,31,109,47,0,47
53,53,31,153,0,36,-36
53,53,32,3,549,528,21
53,53,32,31,144,107,37
53,53,33,15,31,0,31
53,53,34,5,0,66,-66
53,53,34,7,43,0,43
53,53,34,13,0,27,-27
53,53,35,1,98,133,-35
53,53,35,13,48,0,48
53,53,36,5,55,46,9
53,53,36,29,48,59,-11
53,53,36,45,217,99,118
53,53,36,47,93,60,33
53,53,36,55,61,0,61
53,53,36,61,45,81,-36
53,53,36,71,74,34,40
53,53,36,81,58,38,20
53,53,36,103,35,37,-2
53,53,37,51,608,400,208
53,53,37,85,81,59,22
53,53,37,93,32,52,-20
53,53,37,119,61,62,-1
53,53,37,125,0,46,-46
53,53,37,133,42,55,-13
53,53,37,183,0,70,-70
53,53,39,17,32,0,32
53,53,39,35,57,31,26
53,53,39,49,77,54,23
53,53,39,61,51,0,51
53,53,39,113,44,0,44
53,53,40,31,688,150,538
53,53,40,47,27,0,27
53,53,40,65,36,59,-23
53,53,40,109,123,104,19
53,53,40,143,65,44,21
53,53,41,3,45,34,11
53,53,41,5,182,190,-8
53,53,41,7,32,39,-7
53,53,41,9,0,28,-28
53,53,41,11,42,0,42
53,53,41,17,103,126,-23
53,53,41,19,54,46,8
53,53,41,29,94,65,29
53,53,41,33,0,45,-45
53,53,41,35,33,0,33
53,53,41,39,201,196,5
53,53,41,41,33,0,33
53,53,41,43,84,78,6
53,53,41,47,200,133,67
53,53,41,51,418,366,52
53,53,41,53,52,58,-6
53,53,41,59,49,39,10
53,53,41,65,28,0,28
53,53,41,67,335,316,19
53,53,41,71,54,72,-18
53,53,42,3,52,69,-17
53,53,42,9,0,40,-40
53,53,42,41,36,0,36
53,53,42,43,47,0,47
53,53,42,71,34,0,34
53,53,42,101,50,49,1
53,53,42,133,34,0,34
53,53,44,7,0,32,-32
53,53,45,15,0,34,-34
53,53,45,19,38,35,3
53,53,45,45,44,0,44
53,53,45,79,137,109,28
53,53,45,91,0,44,-44
53,53,46,103,0,38,-38
53,53,47,37,62,49,13
53,53,47,65,31,0,31
53,53,47,93,65,45,20
53,53,47,125,381,197,184
53,53,47,157,73,47,26
53,53,48,27,495,378,117
53,53,48,29,540,551,-11
53,53,48,85,44,64,-20
53,53,48,99,111,84,27
53,53,48,113,192,160,32
53,53,48,121,59,49,10
53,53,48,141,303,327,-24
53,53,48,157,0,41,-41
53,53,48,187,37,63,-26
53,53,48,201,273,241,32
53,53,48,215,33,0,33
53,53,48,303,35,0,35
53,53,48,339,30,0,30
53,53,48,355,0,41,-41
53,53,48,439,212,247,-35
53,53,48,451,30,0,30
53,53,48,453,57,117,-60
53,53,48,485,80,0,80
53,53,48,491,31,65,-34
53,53,49,11,64,169,-105
53,53,49,35,216,235,-19
53,53,49,49,104,115,-11
53,53,49,57,61,57,4
53,53,51,13,28,30,-2
53,53,51,41,37,39,-2
53,53,51,59,183,231,-48
53,53,51,107,36,49,-13
53,53,51,149,0,44,-44
53,53,51,153,70,76,-6
53,53,51,510,36,31,5
53,53,51,550,41,0,41
53,53,51,650,42,0,42
53,53,51,700,122,113,9
53,53,51,710,66,37,29
53,53,51,730,34,0,34
53,53,51,810,72,54,18
53,53,53,5,162,329,-167
53,53,53,7,138,139,-1
53,53,53,9,194,245,-51
53,53,53,11,630,600,30
53,53,53,15,167,150,17
53,53,53,17,77,76,1
53,53,53,21,47,124,-77
53,53,53,25,158,247,-89
53,53,53,27,294,438,-144
53,53,53,29,149,123,26
53,53,53,31,88,96,-8
53,53,53,33,20097,14827,5270
53,53,53,35,2030,1946,84
53,53,53,37,253,288,-35
53,53,53,39,0,30,-30
53,53,53,41,390,624,-234
53,53,53,45,443,571,-128
53,53,53,47,63,97,-34
53,53,53,49,47,69,-22
53,53,53,55,30,0,30
53,53,53,57,160,212,-52
53,53,53,61,1693,1405,288
53,53,53,63,761,834,-73
53,53,53,65,58,98,-40
53,53,53,67,3759,5131,-1372
53,53,53,71,76,87,-11
53,53,53,73,412,408,4
53,53,53,75,170,155,15
53,53,53,77,383,377,6
53,53,55,9,43,0,43
53,53,55,25,34,0,34
53,53,55,79,33,0,33
53,55,53,33,192,168,24
53,55,53,53,0,30,-30
53,55,53,57,70,88,-18
53,55,53,61,33,70,-37
53,55,53,73,82,106,-24
53,57,4,13,89,86,3
53,57,4,19,24,49,-25
53,57,4,21,0,27,-27
53,57,4,25,0,35,-35
53,57,6,19,33,0,33
53,57,6,29,42,0,42
53,57,6,37,128,72,56
53,57,6,59,63,47,16
53,57,6,65,59,50,9
53,57,6,71,32,0,32
53,57,6,73,137,78,59
53,57,6,111,32,0,32
53,57,12,31,32,0,32
53,57,12,33,51,0,51
53,57,15,3,0,21,-21
53,57,16,1,0,45,-45
53,57,16,55,24,43,-19
53,57,32,3,58,40,18
53,57,32,31,31,0,31
53,57,41,29,30,0,30
53,57,41,39,33,0,33
53,57,41,47,33,0,33
53,57,41,51,57,52,5
53,57,41,67,0,27,-27
53,57,48,29,33,0,33
53,57,48,201,45,32,13
53,57,49,35,32,0,32
53,57,51,810,32,48,-16
53,57,53,5,43,76,-33
53,57,53,7,57,49,8
53,57,53,9,41,45,-4
53,57,53,11,74,71,3
53,57,53,25,37,61,-24
53,57,53,27,0,36,-36
53,57,53,29,643,482,161
53,57,53,33,828,602,226
53,57,53,35,74,58,16
53,57,53,37,0,34,-34
53,57,53,41,0,54,-54
53,57,53,47,54,57,-3
53,57,53,53,212,160,52
53,57,53,55,88,70,18
53,57,53,61,2091,1247,844
53,57,53,63,121,94,27
53,57,53,67,80,61,19
53,57,53,71,0,30,-30
53,57,53,73,1062,1276,-214
53,57,53,75,0,34,-34
53,57,53,77,120,58,62
53,59,41,5,34,23,11
53,59,41,27,44,29,15
53,59,41,51,66,45,21
53,59,53,11,210,247,-37
53,59,53,39,90,67,23
53,61,1,89,0,62,-62
53,61,2,20,171,115,56
53,61,2,90,39,31,8
53,61,2,110,40,0,40
53,61,2,130,0,27,-27
53,61,2,170,60,37,23
53,61,4,3,0,39,-39
53,61,4,5,32,0,32
53,61,4,13,843,906,-63
53,61,4,15,64,49,15
53,61,4,19,139,227,-88
53,61,4,21,88,117,-29
53,61,4,25,46,60,-14
53,61,4,27,30,71,-41
53,61,6,1,170,119,51
53,61,6,7,20,30,-10
53,61,6,13,128,89,39
53,61,6,19,122,59,63
53,61,6,29,135,79,56
53,61,6,31,41,0,41
53,61,6,37,891,564,327
53,61,6,53,45,62,-17
53,61,6,59,459,331,128
53,61,6,61,44,74,-30
53,61,6,65,348,212,136
53,61,6,67,238,118,120
53,61,6,71,284,147,137
53,61,6,73,811,680,131
53,61,6,75,51,56,-5
53,61,6,77,112,56,56
53,61,6,79,53,28,25
53,61,6,81,78,54,24
53,61,6,83,101,73,28
53,61,6,85,181,184,-3
53,61,6,87,47,0,47
53,61,6,89,58,36,22
53,61,6,95,80,70,10
53,61,6,97,51,50,1
53,61,6,99,33,44,-11
53,61,6,107,39,0,39
53,61,6,111,119,120,-1
53,61,8,1,44,52,-8
53,61,8,5,109,97,12
53,61,8,13,35,50,-15
53,61,8,31,37,47,-10
53,61,8,35,53,50,3
53,61,8,41,124,109,15
53,61,8,59,56,56,0
53,61,8,69,27,30,-3
53,61,9,1,35,0,35
53,61,9,9,44,0,44
53,61,11,1,28,21,7
53,61,12,1,27,0,27
53,61,12,9,24,41,-17
53,61,12,11,52,30,22
53,61,12,31,117,55,62
53,61,12,33,52,48,4
53,61,12,57,48,48,0
53,61,12,86,78,39,39
53,61,12,95,60,48,12
53,61,12,99,28,0,28
53,61,12,103,68,56,12
53,61,12,115,53,0,53
53,61,12,117,40,21,19
53,61,12,127,35,0,35
53,61,13,51,47,32,15
53,61,13,67,52,0,52
53,61,13,121,55,65,-10
53,61,13,135,0,57,-57
53,61,15,1,55,48,7
53,61,15,3,419,339,80
53,61,15,9,34,75,-41
53,61,16,1,137,230,-93
53,61,16,17,0,69,-69
53,61,16,19,29,0,29
53,61,16,27,90,75,15
53,61,16,55,155,154,1
53,61,16,57,26,54,-28
53,61,16,65,44,0,44
53,61,17,31,199,102,97
53,61,17,43,54,27,27
53,61,17,97,91,68,23
53,61,17,119,43,0,43
53,61,18,97,36,36,0
53,61,20,91,51,45,6
53,61,20,173,141,63,78
53,61,22,51,0,25,-25
53,61,24,31,36,51,-15
53,61,25,17,53,70,-17
53,61,25,25,36,0,36
53,61,26,49,28,0,28
53,61,26,77,25,0,25
53,61,26,99,72,0,72
53,61,26,125,152,44,108
53,61,26,163,106,0,106
53,61,27,53,66,55,11
53,61,29,189,82,31,51
53,61,30,13,31,54,-23
53,61,30,29,60,99,-39
53,61,30,31,69,44,25
53,61,30,49,0,43,-43
53,61,30,63,64,49,15
53,61,30,111,44,36,8
53,61,31,55,45,38,7
53,61,31,109,35,0,35
53,61,32,3,427,438,-11
53,61,32,31,99,91,8
53,61,34,17,32,0,32
53,61,34,23,36,0,36
53,61,35,1,84,93,-9
53,61,36,29,23,0,23
53,61,36,47,0,26,-26
53,61,36,61,29,51,-22
53,61,36,67,29,0,29
53,61,36,81,67,0,67
53,61,36,103,42,0,42
53,61,37,51,43,29,14
53,61,37,81,49,0,49
53,61,37,119,42,0,42
53,61,37,133,33,30,3
53,61,37,183,34,62,-28
53,61,39,35,41,32,9
53,61,39,49,71,41,30
53,61,40,109,43,41,2
53,61,40,143,42,45,-3
53,61,41,3,60,36,24
53,61,41,5,143,135,8
53,61,41,9,35,0,35
53,61,41,17,79,79,0
53,61,41,19,0,38,-38
53,61,41,29,83,66,17
53,61,41,33,0,34,-34
53,61,41,39,120,164,-44
53,61,41,41,28,0,28
53,61,41,43,41,53,-12
53,61,41,47,130,89,41
53,61,41,51,263,250,13
53,61,41,59,27,31,-4
53,61,41,61,32,0,32
53,61,41,67,361,259,102
53,61,41,71,0,56,-56
53,61,42,3,42,0,42
53,61,42,17,33,0,33
53,61,42,91,25,0,25
53,61,42,101,31,0,31
53,61,44,5,40,54,-14
53,61,45,15,67,0,67
53,61,45,19,29,36,-7
53,61,45,45,26,47,-21
53,61,45,83,0,36,-36
53,61,46,103,23,0,23
53,61,47,37,0,51,-51
53,61,47,93,39,0,39
53,61,47,157,41,36,5
53,61,48,27,43,32,11
53,61,48,29,135,170,-35
53,61,48,85,51,108,-57
53,61,48,113,106,99,7
53,61,48,121,66,97,-31
53,61,48,141,61,0,61
53,61,48,157,0,80,-80
53,61,48,201,167,221,-54
53,61,48,339,32,34,-2
53,61,48,355,25,55,-30
53,61,48,409,38,0,38
53,61,48,439,140,99,41
53,61,48,453,73,76,-3
53,61,48,491,30,55,-25
53,61,49,5,0,51,-51
53,61,49,11,0,69,-69
53,61,49,35,137,136,1
53,61,49,49,111,99,12
53,61,49,53,0,63,-63
53,61,49,57,40,39,1
53,61,51,59,65,86,-21
53,61,51,107,0,39,-39
53,61,51,810,101,51,50
53,61,53,1,34,28,6
53,61,53,5,237,381,-144
53,61,53,7,231,358,-127
53,61,53,9,191,218,-27
53,61,53,11,413,371,42
53,61,53,15,113,114,-1
53,61,53,17,107,121,-14
53,61,53,19,49,0,49
53,61,53,21,89,159,-70
53,61,53,25,149,426,-277
53,61,53,27,125,189,-64
53,61,53,29,1424,1406,18
53,61,53,31,90,89,1
53,61,53,33,23134,18015,5119
53,61,53,35,860,793,67
53,61,53,37,211,254,-43
53,61,53,39,0,35,-35
53,61,53,41,76,143,-67
53,61,53,43,0,27,-27
53,61,53,45,66,108,-42
53,61,53,47,132,284,-152
53,61,53,49,52,34,18
53,61,53,53,1405,1693,-288
53,61,53,55,70,33,37
53,61,53,57,1247,2091,-844
53,61,53,63,613,1005,-392
53,61,53,65,65,160,-95
53,61,53,67,343,521,-178
53,61,53,71,71,67,4
53,61,53,73,1006,1219,-213
53,61,53,75,136,158,-22
53,61,53,77,451,392,59
53,61,55,25,40,0,40
53,61,55,79,51,0,51
53,63,2,20,247,144,103
53,63,2,90,117,52,65
53,63,2,122,28,0,28
53,63,2,170,68,45,23
53,63,4,13,478,503,-25
53,63,4,15,88,31,57
53,63,4,17,33,0,33
53,63,4,19,135,148,-13
53,63,4,21,52,52,0
53,63,4,25,33,48,-15
53,63,4,27,45,79,-34
53,63,5,119,0,37,-37
53,63,6,1,71,72,-1
53,63,6,13,135,24,111
53,63,6,19,75,53,22
53,63,6,23,35,0,35
53,63,6,29,99,51,48
53,63,6,37,523,223,300
53,63,6,53,0,42,-42
53,63,6,59,216,126,90
53,63,6,61,36,54,-18
53,63,6,65,153,104,49
53,63,6,67,155,107,48
53,63,6,71,186,135,51
53,63,6,73,398,262,136
53,63,6,75,53,44,9
53,63,6,77,0,34,-34
53,63,6,79,30,0,30
53,63,6,81,0,29,-29
53,63,6,83,50,47,3
53,63,6,85,137,70,67
53,63,6,87,28,0,28
53,63,6,89,27,42,-15
53,63,6,95,69,36,33
53,63,6,97,65,36,29
53,63,6,99,52,24,28
53,63,6,107,33,0,33
53,63,6,111,122,35,87
53,63,8,5,45,74,-29
53,63,8,31,40,55,-15
53,63,8,35,39,45,-6
53,63,8,41,110,164,-54
53,63,8,59,47,42,5
53,63,8,69,62,32,30
53,63,11,1,0,25,-25
53,63,12,11,43,0,43
53,63,12,31,0,31,-31
53,63,12,33,0,30,-30
53,63,12,57,37,42,-5
53,63,12,91,44,0,44
53,63,12,95,0,23,-23
53,63,12,103,27,42,-15
53,63,12,113,0,42,-42
53,63,15,1,64,39,25
53,63,15,3,201,183,18
53,63,15,9,29,33,-4
53,63,16,1,230,312,-82
53,63,16,5,43,38,5
53,63,16,9,48,63,-15
53,63,16,17,228,242,-14
53,63,16,19,50,53,-3
53,63,16,21,35,28,7
53,63,16,27,65,57,8
53,63,16,39,49,0,49
53,63,16,49,28,0,28
53,63,16,55,1593,1590,3
53,63,16,57,178,136,42
53,63,16,65,38,48,-10
53,63,16,69,178,60,118
53,63,16,79,61,61,0
53,63,17,31,62,31,31
53,63,17,163,41,0,41
53,63,18,97,37,0,37
53,63,20,173,38,29,9
53,63,24,31,0,30,-30
53,63,26,163,34,0,34
53,63,27,53,37,34,3
53,63,30,13,115,62,53
53,63,30,29,132,121,11
53,63,30,31,55,93,-38
53,63,30,47,42,34,8
53,63,30,49,38,62,-24
53,63,30,53,27,34,-7
53,63,30,63,211,191,20
53,63,30,81,58,42,16
53,63,30,93,34,0,34
53,63,30,111,117,97,20
53,63,31,55,66,0,66
53,63,31,153,45,0,45
53,63,32,3,362,298,64
53,63,32,7,0,39,-39
53,63,32,31,140,60,80
53,63,35,1,74,52,22
53,63,36,45,34,0,34
53,63,36,47,0,23,-23
53,63,36,61,20,28,-8
53,63,37,51,0,36,-36
53,63,38,101,33,0,33
53,63,40,109,0,28,-28
53,63,41,3,33,36,-3
53,63,41,5,129,112,17
53,63,41,7,38,32,6
53,63,41,11,28,0,28
53,63,41,17,79,52,27
53,63,41,19,40,35,5
53,63,41,29,50,25,25
53,63,41,35,53,0,53
53,63,41,39,148,104,44
53,63,41,41,0,25,-25
53,63,41,43,35,41,-6
53,63,41,47,76,118,-42
53,63,41,51,217,316,-99
53,63,41,59,82,44,38
53,63,41,61,52,0,52
53,63,41,67,267,240,27
53,63,41,71,38,34,4
53,63,48,27,43,38,5
53,63,48,29,93,100,-7
53,63,48,99,42,0,42
53,63,48,113,38,47,-9
53,63,48,121,0,51,-51
53,63,48,141,44,37,7
53,63,48,201,56,118,-62
53,63,48,439,66,52,14
53,63,48,453,0,31,-31
53,63,48,485,51,0,51
53,63,48,491,0,37,-37
53,63,49,5,48,36,12
53,63,49,11,66,57,9
53,63,49,35,149,172,-23
53,63,49,49,113,107,6
53,63,51,59,52,0,52
53,63,53,1,143,78,65
53,63,53,3,136,145,-9
53,63,53,5,568,536,32
53,63,53,7,178,128,50
53,63,53,9,80,66,14
53,63,53,11,420,435,-15
53,63,53,15,58,60,-2
53,63,53,17,134,86,48
53,63,53,19,91,101,-10
53,63,53,21,164,181,-17
53,63,53,25,501,382,119
53,63,53,27,100,61,39
53,63,53,29,81,45,36
53,63,53,33,1876,2158,-282
53,63,53,35,219,150,69
53,63,53,37,141,55,86
53,63,53,39,0,49,-49
53,63,53,41,76,68,8
53,63,53,43,368,316,52
53,63,53,45,58,39,19
53,63,53,47,292,221,71
53,63,53,49,28,23,5
53,63,53,51,366,370,-4
53,63,53,53,834,761,73
53,63,53,57,94,121,-27
53,63,53,61,1005,613,392
53,63,53,65,1561,1246,315
53,63,53,67,261,254,7
53,63,53,71,197,215,-18
53,63,53,73,259,226,33
53,63,53,75,668,506,162
53,63,53,77,431,310,121
53,63,56,21,45,0,45
53,63,56,25,0,27,-27
53,65,4,13,0,36,-36
53,65,6,65,34,0,34
53,65,6,73,42,0,42
53,65,16,17,0,40,-40
53,65,16,55,53,33,20
53,65,32,3,29,0,29
53,65,41,59,38,0,38
53,65,53,5,31,0,31
53,65,53,11,40,35,5
53,65,53,19,85,96,-11
53,65,53,33,138,87,51
53,65,53,51,72,28,44
53,65,53,53,98,58,40
53,65,53,61,160,65,95
53,65,53,63,1246,1561,-315
53,65,53,73,39,0,39
53,65,53,75,26,38,-12
53,65,53,77,28,0,28
53,67,1,89,41,0,41
53,67,2,20,141,55,86
53,67,2,90,103,40,63
53,67,4,3,59,43,16
53,67,4,13,284,279,5
53,67,4,15,39,31,8
53,67,4,19,62,43,19
53,67,4,21,0,46,-46
53,67,4,25,0,37,-37
53,67,4,27,44,28,16
53,67,6,1,60,46,14
53,67,6,13,42,0,42
53,67,6,19,32,0,32
53,67,6,29,40,0,40
53,67,6,37,297,130,167
53,67,6,53,44,55,-11
53,67,6,59,147,66,81
53,67,6,61,33,0,33
53,67,6,65,96,73,23
53,67,6,67,126,111,15
53,67,6,71,140,61,79
53,67,6,73,247,130,117
53,67,6,75,33,33,0
53,67,6,77,52,25,27
53,67,6,79,0,26,-26
53,67,6,85,68,51,17
53,67,6,95,49,0,49
53,67,6,97,22,23,-1
53,67,6,111,46,37,9
53,67,8,5,35,0,35
53,67,8,13,56,0,56
53,67,8,41,136,96,40
53,67,8,69,33,0,33
53,67,12,11,41,0,41
53,67,12,86,35,0,35
53,67,12,95,25,0,25
53,67,13,179,43,0,43
53,67,13,215,119,51,68
53,67,13,245,40,0,40
53,67,15,1,0,40,-40
53,67,15,3,269,190,79
53,67,15,9,43,30,13
53,67,16,1,70,82,-12
53,67,16,27,45,0,45
53,67,16,55,52,52,0
53,67,17,31,35,37,-2
53,67,17,43,29,0,29
53,67,18,97,34,0,34
53,67,20,91,31,0,31
53,67,20,103,123,51,72
53,67,21,47,77,0,77
53,67,21,93,62,0,62
53,67,21,163,47,0,47
53,67,22,115,49,0,49
53,67,24,31,44,0,44
53,67,27,53,44,0,44
53,67,29,169,58,43,15
53,67,30,63,24,36,-12
53,67,30,111,24,0,24
53,67,31,55,37,0,37
53,67,32,3,167,151,16
53,67,32,31,55,0,55
53,67,35,1,31,0,31
53,67,36,45,104,35,69
53,67,36,71,25,0,25
53,67,37,51,272,103,169
53,67,39,49,42,0,42
53,67,40,31,200,0,200
53,67,40,109,37,0,37
53,67,41,3,29,0,29
53,67,41,5,62,102,-40
53,67,41,7,40,0,40
53,67,41,17,47,46,1
53,67,41,29,53,38,15
53,67,41,39,116,72,44
53,67,41,43,24,0,24
53,67,41,47,116,71,45
53,67,41,51,179,313,-134
53,67,41,53,0,36,-36
53,67,41,67,162,104,58
53,67,41,71,0,25,-25
53,67,47,125,161,0,161
53,67,48,27,137,94,43
53,67,48,29,144,96,48
53,67,48,85,0,34,-34
53,67,48,113,29,50,-21
53,67,48,141,96,44,52
53,67,48,201,47,33,14
53,67,48,439,35,0,35
53,67,48,453,0,54,-54
53,67,49,35,57,49,8
53,67,49,49,31,38,-7
53,67,51,59,49,79,-30
53,67,53,5,80,138,-58
53,67,53,7,52,75,-23
53,67,53,9,84,72,12
53,67,53,11,429,248,181
53,67,53,15,139,143,-4
53,67,53,17,0,35,-35
53,67,53,21,0,42,-42
53,67,53,25,63,52,11
53,67,53,27,941,711,230
53,67,53,29,57,0,57
53,67,53,31,39,43,-4
53,67,53,33,2412,1991,421
53,67,53,35,259,239,20
53,67,53,37,89,66,23
53,67,53,41,1371,1113,258
53,67,53,45,1072,1010,62
53,67,53,47,34,0,34
53,67,53,49,94,44,50
53,67,53,53,5131,3759,1372
53,67,53,57,61,80,-19
53,67,53,61,521,343,178
53,67,53,63,254,261,-7
53,67,53,71,50,41,9
53,67,53,73,251,209,42
53,67,53,75,106,43,63
53,67,53,77,180,197,-17
53,69,53,11,35,0,35
53,69,53,15,94,105,-11
53,69,53,49,34,29,5
53,71,4,13,37,0,37
53,71,6,37,41,47,-6
53,71,6,65,39,0,39
53,71,6,71,0,29,-29
53,71,16,1,27,0,27
53,71,16,57,30,0,30
53,71,41,5,26,41,-15
53,71,41,17,30,0,30
53,71,41,47,38,0,38
53,71,41,51,93,56,37
53,71,41,59,541,410,131
53,71,41,61,27,0,27
53,71,41,67,23,41,-18
53,71,53,5,298,416,-118
53,71,53,11,66,79,-13
53,71,53,13,84,97,-13
53,71,53,21,175,319,-144
53,71,53,25,40,50,-10
53,71,53,33,262,175,87
53,71,53,35,47,0,47
53,71,53,53,87,76,11
53,71,53,57,30,0,30
53,71,53,61,67,71,-4
53,71,53,63,215,197,18
53,71,53,67,41,50,-9
53,71,53,73,0,35,-35
53,71,53,75,53,41,12
53,71,53,77,86,66,20
53,73,2,20,89,46,43
53,73,2,110,32,23,9
53,73,4,13,163,171,-8
53,73,4,19,111,73,38
53,73,4,25,46,0,46
53,73,6,1,41,38,3
53,73,6,13,55,0,55
53,73,6,19,47,0,47
53,73,6,23,28,0,28
53,73,6,29,56,0,56
53,73,6,37,257,152,105
53,73,6,59,157,86,71
53,73,6,65,86,57,29
53,73,6,67,63,42,21
53,73,6,71,59,48,11
53,73,6,73,248,173,75
53,73,6,75,27,41,-14
53,73,6,81,56,0,56
53,73,6,85,89,25,64
53,73,6,97,30,29,1
53,73,6,111,42,0,42
53,73,8,13,29,45,-16
53,73,8,41,30,24,6
53,73,12,86,29,0,29
53,73,15,1,44,26,18
53,73,15,3,46,40,6
53,73,16,1,68,49,19
53,73,16,55,33,46,-13
53,73,16,57,21,0,21
53,73,17,31,49,32,17
53,73,27,53,33,0,33
53,73,30,13,0,42,-42
53,73,30,29,25,0,25
53,73,30,31,52,26,26
53,73,30,63,27,25,2
53,73,32,3,118,91,27
53,73,32,31,0,26,-26
53,73,35,1,33,0,33
53,73,36,61,0,22,-22
53,73,37,119,25,0,25
53,73,41,5,58,61,-3
53,73,41,7,29,0,29
53,73,41,17,48,0,48
53,73,41,29,27,0,27
53,73,41,39,67,57,10
53,73,41,43,0,29,-29
53,73,41,47,0,37,-37
53,73,41,51,118,199,-81
53,73,41,67,82,86,-4
53,73,48,29,0,38,-38
53,73,48,201,55,36,19
53,73,48,453,33,35,-2
53,73,49,35,72,37,35
53,73,49,49,0,28,-28
53,73,53,5,76,57,19
53,73,53,7,117,66,51
53,73,53,9,130,70,60
53,73,53,11,173,168,5
53,73,53,15,62,44,18
53,73,53,17,26,0,26
53,73,53,25,37,73,-36
53,73,53,27,58,39,19
53,73,53,29,315,183,132
53,73,53,31,48,38,10
53,73,53,33,1837,1866,-29
53,73,53,35,252,162,90
53,73,53,37,53,36,17
53,73,53,41,39,28,11
53,73,53,45,33,0,33
53,73,53,47,43,74,-31
53,73,53,53,408,412,-4
53,73,53,55,106,82,24
53,73,53,57,1276,1062,214
53,73,53,61,1219,1006,213
53,73,53,63,226,259,-33
53,73,53,65,0,39,-39
53,73,53,67,209,251,-42
53,73,53,71,35,0,35
53,73,53,75,76,50,26
53,73,53,77,126,144,-18
53,75,4,13,0,50,-50
53,75,4,19,0,31,-31
53,75,6,37,26,61,-35
53,75,6,59,29,0,29
53,75,6,73,42,0,42
53,75,6,85,0,26,-26
53,75,15,3,25,0,25
53,75,16,1,40,45,-5
53,75,16,55,39,55,-16
53,75,16,57,306,255,51
53,75,16,69,63,56,7
53,75,41,51,26,34,-8
53,75,41,67,0,40,-40
53,75,53,3,94,85,9
53,75,53,5,125,125,0
53,75,53,7,26,25,1
53,75,53,9,0,32,-32
53,75,53,11,89,103,-14
53,75,53,25,51,57,-6
53,75,53,27,45,0,45
53,75,53,33,412,560,-148
53,75,53,35,71,50,21
53,75,53,53,155,170,-15
53,75,53,57,34,0,34
53,75,53,61,158,136,22
53,75,53,63,506,668,-162
53,75,53,65,38,26,12
53,75,53,67,43,106,-63
53,75,53,71,41,53,-12
53,75,53,73,50,76,-26
53,75,53,77,78,64,14
53,77,2,20,43,0,43
53,77,4,13,128,162,-34
53,77,4,27,30,36,-6
53,77,6,13,0,30,-30
53,77,6,19,75,55,20
53,77,6,29,58,39,19
53,77,6,37,252,164,88
53,77,6,53,0,37,-37
53,77,6,59,47,50,-3
53,77,6,65,119,48,71
53,77,6,67,34,40,-6
53,77,6,71,117,65,52
53,77,6,73,109,97,12
53,77,6,77,53,0,53
53,77,6,85,48,34,14
53,77,6,99,53,0,53
53,77,6,107,0,71,-71
53,77,6,111,28,0,28
53,77,8,41,30,27,3
53,77,15,3,35,0,35
53,77,16,1,42,50,-8
53,77,16,27,62,42,20
53,77,16,55,25,53,-28
53,77,32,3,111,92,19
53,77,32,31,43,31,12
53,77,36,45,59,0,59
53,77,41,5,33,69,-36
53,77,41,17,0,49,-49
53,77,41,35,41,0,41
53,77,41,39,28,38,-10
53,77,41,47,65,44,21
53,77,41,51,113,136,-23
53,77,41,59,64,60,4
53,77,41,67,75,107,-32
53,77,48,29,32,0,32
53,77,48,215,0,48,-48
53,77,49,35,37,46,-9
53,77,49,49,0,49,-49
53,77,53,5,879,1288,-409
53,77,53,7,102,132,-30
53,77,53,9,39,0,39
53,77,53,11,177,215,-38
53,77,53,15,72,40,32
53,77,53,17,43,71,-28
53,77,53,21,160,372,-212
53,77,53,25,213,257,-44
53,77,53,27,75,0,75
53,77,53,31,0,33,-33
53,77,53,33,834,1107,-273
53,77,53,35,93,47,46
53,77,53,37,292,341,-49
53,77,53,39,100,58,42
53,77,53,41,59,74,-15
53,77,53,45,29,0,29
53,77,53,47,37,58,-21
53,77,53,53,377,383,-6
53,77,53,57,58,120,-62
53,77,53,61,392,451,-59
53,77,53,63,310,431,-121
53,77,53,65,0,28,-28
53,77,53,67,197,180,17
53,77,53,71,66,86,-20
53,77,53,73,144,126,18
53,77,53,75,64,78,-14
54,1,54,33,62,100,-38
54,1,54,49,29,33,-4
54,1,54,61,33,30,3
54,1,54,83,229,183,46
54,1,54,91,75,36,39
54,1,54,97,95,83,12
54,3,6,37,31,0,31
54,3,11,1,72,0,72
54,3,24,1,53,42,11
54,3,24,3,105,40,65
54,3,24,5,139,39,100
54,3,24,13,56,0,56
54,3,24,17,52,0,52
54,3,24,21,505,191,314
54,3,24,25,32,0,32
54,3,24,27,48,0,48
54,3,24,31,384,154,230
54,3,24,33,209,75,134
54,3,24,43,1033,639,394
54,3,24,510,53,25,28
54,3,42,3,35,0,35
54,3,42,55,130,139,-9
54,3,45,51,0,38,-38
54,3,51,43,32,33,-1
54,3,51,59,233,83,150
54,3,51,69,511,391,120
54,3,51,107,279,180,99
54,3,51,153,125,86,39
54,3,51,171,51,58,-7
54,3,51,187,32,0,32
54,3,51,683,27,0,27
54,3,51,810,31,50,-19
54,3,51,840,261,140,121
54,3,54,11,38,25,13
54,3,54,27,86,81,5
54,3,54,31,29,0,29
54,3,54,33,37,61,-24
54,3,54,37,1423,938,485
54,3,54,39,33,28,5
54,3,54,49,26,0,26
54,3,54,57,35,59,-24
54,3,54,61,86,90,-4
54,3,54,65,222,200,22
54,3,54,77,36,0,36
54,3,54,83,0,35,-35
54,5,54,11,0,23,-23
54,5,54,39,223,413,-190
54,5,54,43,72,85,-13
54,5,54,45,117,126,-9
54,5,54,59,40,0,40
54,5,54,79,38,48,-10
54,5,54,81,64,95,-31
54,7,54,15,27,45,-18
54,7,54,21,92,71,21
54,7,54,39,28,55,-27
54,7,54,41,0,45,-45
54,7,54,67,36,27,9
54,9,39,13,30,31,-1
54,9,39,81,139,160,-21
54,9,42,3,82,55,27
54,9,42,125,96,47,49
54,9,54,29,234,351,-117
54,9,54,69,82,85,-3
54,11,21,19,120,155,-35
54,11,21,67,0,48,-48
54,11,21,89,33,0,33
54,11,37,119,0,29,-29
54,11,37,183,0,28,-28
54,11,39,49,68,91,-23
54,11,39,53,32,60,-28
54,11,39,61,0,35,-35
54,11,39,87,709,765,-56
54,11,39,145,39,29,10
54,11,45,51,0,42,-42
54,11,51,59,0,38,-38
54,11,54,3,25,38,-13
54,11,54,5,23,0,23
54,11,54,19,47,0,47
54,11,54,25,0,31,-31
54,11,54,35,36,53,-17
54,11,54,39,437,395,42
54,11,54,43,181,197,-16
54,11,54,45,77,62,15
54,11,54,53,98,133,-35
54,11,54,55,33,0,33
54,11,54,59,78,30,48
54,11,54,61,28,79,-51
54,11,54,79,506,488,18
54,11,54,81,48,45,3
54,11,54,99,826,814,12
54,11,54,107,46,54,-8
54,13,54,21,61,0,61
54,13,54,87,35,60,-25
54,13,54,107,0,31,-31
54,15,54,7,45,27,18
54,15,54,19,32,0,32
54,15,54,39,86,153,-67
54,15,54,67,26,37,-11
54,15,54,87,0,31,-31
54,17,54,33,117,114,3
54,17,54,85,0,50,-50
54,19,54,11,0,47,-47
54,19,54,15,0,32,-32
54,19,54,25,70,77,-7
54,19,54,39,257,316,-59
54,19,54,55,36,43,-7
54,19,54,61,0,34,-34
54,19,54,67,120,151,-31
54,19,54,79,46,50,-4
54,19,54,81,611,529,82
54,19,54,89,42,0,42
54,19,54,109,30,0,30
54,21,54,7,71,92,-21
54,21,54,13,0,61,-61
54,21,54,41,36,61,-25
54,23,54,31,144,155,-11
54,23,54,57,67,68,-1
54,23,54,71,72,57,15
54,25,51,5,33,36,-3
54,25,54,11,31,0,31
54,25,54,19,77,70,7
54,25,54,39,29,70,-41
54,25,54,55,27,35,-8
54,25,54,61,32,0,32
54,25,54,63,105,148,-43
54,25,54,67,44,0,44
54,25,54,75,40,35,5
54,25,54,81,68,92,-24
54,25,54,89,76,46,30
54,27,24,1,0,56,-56
54,27,24,3,26,0,26
54,27,51,59,42,0,42
54,27,51,69,224,190,34
54,27,51,171,36,0,36
54,27,51,840,61,75,-14
54,27,54,3,81,86,-5
54,27,54,31,92,69,23
54,27,54,37,26,0,26
54,27,54,57,114,168,-54
54,27,54,61,0,28,-28
54,27,54,65,39,31,8
54,29,39,13,0,33,-33
54,29,39,29,230,261,-31
54,29,39,81,268,214,54
54,29,42,3,160,141,19
54,29,42,7,106,67,39
54,29,42,125,81,78,3
54,29,54,9,351,234,117
54,29,54,61,0,41,-41
54,29,54,69,24,0,24
54,31,51,69,55,37,18
54,31,54,3,0,29,-29
54,31,54,23,155,144,11
54,31,54,27,69,92,-23
54,31,54,57,26,48,-22
54,31,54,71,0,28,-28
54,33,39,49,0,35,-35
54,33,42,3,0,30,-30
54,33,54,1,100,62,38
54,33,54,3,61,37,24
54,33,54,17,114,117,-3
54,33,54,39,102,80,22
54,33,54,41,159,130,29
54,33,54,49,561,462,99
54,33,54,61,200,263,-63
54,33,54,77,29,0,29
54,33,54,81,37,0,37
54,33,54,83,69,40,29
54,33,54,85,32,0,32
54,33,54,91,232,217,15
54,33,54,97,110,61,49
54,33,54,103,24,0,24
54,33,54,107,59,71,-12
54,35,54,11,53,36,17
54,35,54,39,288,292,-4
54,35,54,53,45,80,-35
54,35,54,61,0,35,-35
54,35,54,79,47,54,-7
54,35,54,87,128,63,65
54,35,54,107,136,196,-60
54,37,11,1,47,25,22
54,37,24,3,116,0,116
54,37,24,5,63,33,30
54,37,24,13,50,0,50
54,37,24,21,406,165,241
54,37,24,27,79,0,79
54,37,24,31,306,51,255
54,37,24,33,66,31,35
54,37,24,43,111,134,-23
54,37,51,43,65,49,16
54,37,51,59,212,119,93
54,37,51,69,95,104,-9
54,37,51,107,574,304,270
54,37,51,153,67,41,26
54,37,51,187,0,27,-27
54,37,51,840,39,34,5
54,37,54,3,938,1423,-485
54,37,54,27,0,26,-26
54,37,54,61,0,53,-53
54,37,54,65,34,42,-8
54,39,6,37,24,36,-12
54,39,11,1,0,38,-38
54,39,12,9,25,0,25
54,39,12,11,27,0,27
54,39,12,71,0,33,-33
54,39,12,83,28,0,28
54,39,12,95,40,29,11
54,39,12,99,26,0,26
54,39,12,103,40,0,40
54,39,12,127,0,29,-29
54,39,21,67,55,33,22
54,39,21,111,0,42,-42
54,39,24,5,25,0,25
54,39,24,31,29,0,29
54,39,26,163,33,0,33
54,39,32,3,0,28,-28
54,39,37,67,0,31,-31
54,39,37,81,30,33,-3
54,39,37,119,62,92,-30
54,39,37,183,0,56,-56
54,39,39,35,54,38,16
54,39,39,49,92,111,-19
54,39,39,61,0,41,-41
54,39,39,87,41,50,-9
54,39,42,3,41,78,-37
54,39,45,19,0,29,-29
54,39,45,45,0,35,-35
54,39,45,51,36,86,-50
54,39,47,37,0,33,-33
54,39,48,201,31,37,-6
54,39,51,59,42,34,8
54,39,51,87,0,28,-28
54,39,51,153,29,0,29
54,39,51,700,0,32,-32
54,39,54,3,28,33,-5
54,39,54,5,413,223,190
54,39,54,7,55,28,27
54,39,54,11,395,437,-42
54,39,54,15,153,86,67
54,39,54,19,316,257,59
54,39,54,25,70,29,41
54,39,54,33,80,102,-22
54,39,54,35,292,288,4
54,39,54,43,251,248,3
54,39,54,45,126,98,28
54,39,54,49,61,40,21
54,39,54,51,21,0,21
54,39,54,53,44,82,-38
54,39,54,55,75,53,22
54,39,54,59,40,0,40
54,39,54,61,238,188,50
54,39,54,67,72,73,-1
54,39,54,69,0,25,-25
54,39,54,79,1581,1752,-171
54,39,54,81,162,196,-34
54,39,54,83,35,0,35
54,39,54,87,206,132,74
54,39,54,99,41,40,1
54,39,54,107,142,136,6
54,39,54,109,38,0,38
54,41,54,7,45,0,45
54,41,54,21,61,36,25
54,41,54,33,130,159,-29
54,41,54,61,39,0,39
54,41,54,97,133,117,16
54,43,54,5,85,72,13
54,43,54,11,197,181,16
54,43,54,39,248,251,-3
54,43,54,45,113,78,35
54,43,54,79,80,90,-10
54,43,54,99,51,51,0
54,45,39,49,28,0,28
54,45,54,5,126,117,9
54,45,54,11,62,77,-15
54,45,54,39,98,126,-28
54,45,54,43,78,113,-35
54,45,54,59,179,107,72
54,45,54,109,0,37,-37
54,47,37,97,41,0,41
54,47,51,27,46,37,9
54,47,51,185,69,105,-36
54,47,54,55,172,339,-167
54,47,54,109,52,52,0
54,49,42,3,34,48,-14
54,49,45,51,0,24,-24
54,49,54,1,33,29,4
54,49,54,3,0,26,-26
54,49,54,33,462,561,-99
54,49,54,39,40,61,-21
54,49,54,61,507,508,-1
54,49,54,77,75,52,23
54,49,54,83,0,42,-42
54,49,54,91,150,185,-35
54,49,54,97,45,32,13
54,49,54,103,60,0,60
54,49,54,107,31,30,1
54,51,39,13,140,276,-136
54,51,39,81,0,34,-34
54,51,42,3,0,50,-50
54,51,42,125,0,35,-35
54,51,54,39,0,21,-21
54,51,54,61,52,65,-13
54,51,54,69,478,451,27
54,51,54,103,69,88,-19
54,53,39,49,46,0,46
54,53,39,53,185,147,38
54,53,39,105,98,91,7
54,53,54,11,133,98,35
54,53,54,35,80,45,35
54,53,54,39,82,44,38
54,53,54,79,77,140,-63
54,53,54,107,41,0,41
54,55,37,81,0,36,-36
54,55,37,97,30,0,30
54,55,37,119,0,37,-37
54,55,45,51,0,29,-29
54,55,51,21,0,48,-48
54,55,51,71,64,33,31
54,55,51,121,32,44,-12
54,55,51,155,0,26,-26
54,55,51,161,0,28,-28
54,55,51,185,367,457,-90
54,55,54,11,0,33,-33
54,55,54,19,43,36,7
54,55,54,25,35,27,8
54,55,54,39,53,75,-22
54,55,54,47,339,172,167
54,55,54,61,24,34,-10
54,55,54,63,67,88,-21
54,55,54,81,169,116,53
54,55,54,89,113,83,30
54,55,54,109,63,40,23
54,57,24,1,546,418,128
54,57,24,23,49,35,14
54,57,54,3,59,35,24
54,57,54,23,68,67,1
54,57,54,27,168,114,54
54,57,54,31,48,26,22
54,57,54,61,28,64,-36
54,59,21,159,51,53,-2
54,59,21,195,181,258,-77
54,59,39,49,67,0,67
54,59,54,5,0,40,-40
54,59,54,11,30,78,-48
54,59,54,39,0,40,-40
54,59,54,45,107,179,-72
54,59,54,99,46,63,-17
54,59,54,109,36,48,-12
54,61,6,37,0,31,-31
54,61,6,85,0,24,-24
54,61,13,89,0,27,-27
54,61,17,31,0,49,-49
54,61,24,1,29,0,29
54,61,24,3,0,29,-29
54,61,24,5,0,30,-30
54,61,24,23,42,0,42
54,61,24,31,22,79,-57
54,61,32,3,32,0,32
54,61,36,81,0,30,-30
54,61,37,119,27,43,-16
54,61,37,183,0,46,-46
54,61,39,49,46,32,14
54,61,42,3,112,207,-95
54,61,42,19,33,0,33
54,61,42,51,135,117,18
54,61,42,59,126,154,-28
54,61,42,101,23,0,23
54,61,42,125,68,55,13
54,61,42,129,36,36,0
54,61,45,51,0,28,-28
54,61,48,201,0,37,-37
54,61,51,13,0,31,-31
54,61,51,59,54,58,-4
54,61,54,1,30,33,-3
54,61,54,3,90,86,4
54,61,54,11,79,28,51
54,61,54,19,34,0,34
54,61,54,25,0,32,-32
54,61,54,27,28,0,28
54,61,54,29,41,0,41
54,61,54,33,263,200,63
54,61,54,35,35,0,35
54,61,54,37,53,0,53
54,61,54,39,188,238,-50
54,61,54,41,0,39,-39
54,61,54,49,508,507,1
54,61,54,51,65,52,13
54,61,54,55,34,24,10
54,61,54,57,64,28,36
54,61,54,67,36,0,36
54,61,54,69,49,42,7
54,61,54,77,452,424,28
54,61,54,79,31,47,-16
54,61,54,81,42,23,19
54,61,54,83,65,47,18
54,61,54,91,94,88,6
54,61,54,97,42,0,42
54,61,54,103,22,0,22
54,61,54,107,127,82,45
54,63,51,71,81,60,21
54,63,54,25,148,105,43
54,63,54,55,88,67,21
54,63,54,89,80,0,80
54,65,24,3,30,0,30
54,65,24,21,35,0,35
54,65,24,27,45,0,45
54,65,24,31,30,0,30
54,65,24,43,144,117,27
54,65,42,57,41,0,41
54,65,51,69,64,45,19
54,65,51,840,0,42,-42
54,65,54,3,200,222,-22
54,65,54,27,31,39,-8
54,65,54,37,42,34,8
54,67,54,7,27,36,-9
54,67,54,15,37,26,11
54,67,54,19,151,120,31
54,67,54,25,0,44,-44
54,67,54,39,73,72,1
54,67,54,61,0,36,-36
54,67,54,81,0,50,-50
54,67,54,101,124,72,52
54,69,39,13,505,517,-12
54,69,39,49,58,37,21
54,69,39,81,38,90,-52
54,69,42,3,42,90,-48
54,69,42,125,61,90,-29
54,69,54,9,85,82,3
54,69,54,29,0,24,-24
54,69,54,39,25,0,25
54,69,54,51,451,478,-27
54,69,54,61,42,49,-7
54,69,54,103,34,0,34
54,69,54,107,24,0,24
54,71,51,165,34,32,2
54,71,54,23,57,72,-15
54,71,54,31,28,0,28
54,73,39,167,46,40,6
54,73,54,85,40,30,10
54,73,54,107,98,156,-58
54,75,24,33,0,48,-48
54,75,54,25,35,40,-5
54,75,54,83,44,54,-10
54,77,24,23,104,75,29
54,77,42,51,44,31,13
54,77,54,3,0,36,-36
54,77,54,33,0,29,-29
54,77,54,49,52,75,-23
54,77,54,61,424,452,-28
54,77,54,91,0,66,-66
54,77,54,93,0,36,-36
54,79,21,111,0,25,-25
54,79,39,49,0,42,-42
54,79,39,87,36,0,36
54,79,54,5,48,38,10
54,79,54,11,488,506,-18
54,79,54,19,50,46,4
54,79,54,35,54,47,7
54,79,54,39,1752,1581,171
54,79,54,43,90,80,10
54,79,54,53,140,77,63
54,79,54,61,47,31,16
54,79,54,81,36,0,36
54,79,54,99,27,23,4
54,81,37,119,0,29,-29
54,81,39,49,0,28,-28
54,81,51,59,0,24,-24
54,81,51,810,27,0,27
54,81,54,5,95,64,31
54,81,54,11,45,48,-3
54,81,54,19,529,611,-82
54,81,54,25,92,68,24
54,81,54,33,0,37,-37
54,81,54,39,196,162,34
54,81,54,55,116,169,-53
54,81,54,61,23,42,-19
54,81,54,67,50,0,50
54,81,54,79,0,36,-36
54,81,54,89,128,96,32
54,81,54,107,28,0,28
54,81,54,109,282,186,96
54,83,54,1,183,229,-46
54,83,54,3,35,0,35
54,83,54,33,40,69,-29
54,83,54,39,0,35,-35
54,83,54,49,42,0,42
54,83,54,61,47,65,-18
54,83,54,75,54,44,10
54,83,54,93,92,116,-24
54,83,54,97,70,98,-28
54,85,39,167,24,0,24
54,85,54,17,50,0,50
54,85,54,33,0,32,-32
54,85,54,73,30,40,-10
54,85,54,107,123,194,-71
54,87,54,13,60,35,25
54,87,54,15,31,0,31
54,87,54,35,63,128,-65
54,87,54,39,132,206,-74
54,87,54,107,31,45,-14
54,89,54,19,0,42,-42
54,89,54,25,46,76,-30
54,89,54,55,83,113,-30
54,89,54,63,0,80,-80
54,89,54,81,96,128,-32
54,91,54,1,36,75,-39
54,91,54,33,217,232,-15
54,91,54,49,185,150,35
54,91,54,61,88,94,-6
54,91,54,77,66,0,66
54,93,54,77,36,0,36
54,93,54,83,116,92,24
54,95,39,167,0,30,-30
54,95,54,103,173,228,-55
54,95,54,107,34,0,34
54,97,54,1,83,95,-12
54,97,54,33,61,110,-49
54,97,54,41,117,133,-16
54,97,54,49,32,45,-13
54,97,54,61,0,42,-42
54,97,54,83,98,70,28
54,97,54,101,31,0,31
54,99,21,19,116,117,-1
54,99,21,127,79,99,-20
54,99,39,49,31,27,4
54,99,39,87,176,186,-10
54,99,54,11,814,826,-12
54,99,54,39,40,41,-1
54,99,54,43,51,51,0
54,99,54,59,63,46,17
54,99,54,79,23,27,-4
54,101,54,67,72,124,-52
54,101,54,97,0,31,-31
54,103,39,111,52,49,3
54,103,54,33,0,24,-24
54,103,54,49,0,60,-60
54,103,54,51,88,69,19
54,103,54,61,0,22,-22
54,103,54,69,0,34,-34
54,103,54,95,228,173,55
54,103,54,107,0,43,-43
54,105,54,107,102,167,-65
54,107,37,119,0,28,-28
54,107,37,133,0,39,-39
54,107,39,9,85,68,17
54,107,39,49,65,97,-32
54,107,39,105,33,0,33
54,107,39,151,0,40,-40
54,107,39,167,788,714,74
54,107,45,51,0,23,-23
54,107,51,59,0,23,-23
54,107,54,11,54,46,8
54,107,54,13,31,0,31
54,107,54,33,71,59,12
54,107,54,35,196,136,60
54,107,54,39,136,142,-6
54,107,54,49,30,31,-1
54,107,54,53,0,41,-41
54,107,54,61,82,127,-45
54,107,54,69,0,24,-24
54,107,54,73,156,98,58
54,107,54,81,0,28,-28
54,107,54,85,194,123,71
54,107,54,87,45,31,14
54,107,54,95,0,34,-34
54,107,54,103,43,0,43
54,107,54,105,167,102,65
54,109,54,19,0,30,-30
54,109,54,39,0,38,-38
54,109,54,45,37,0,37
54,109,54,47,52,52,0
54,109,54,55,40,63,-23
54,109,54,59,48,36,12
54,109,54,81,186,282,-96
55,1,17,31,65,26,39
55,1,55,21,110,106,4
55,1,55,25,99,68,31
55,1,55,57,60,73,-13
55,1,55,59,28,0,28
55,1,55,77,69,95,-26
55,1,55,79,90,47,43
55,1,55,97,51,39,12
55,1,55,101,27,0,27
55,1,55,105,35,43,-8
55,1,55,111,110,186,-76
55,1,55,133,77,26,51
55,1,55,137,0,33,-33
55,1,55,141,89,207,-118
55,3,27,53,0,29,-29
55,3,27,137,0,32,-32
55,3,55,7,227,132,95
55,3,55,25,27,38,-11
55,3,55,31,28,40,-12
55,3,55,35,0,36,-36
55,3,55,99,39,71,-32
55,3,55,113,0,32,-32
55,5,27,3,0,27,-27
55,5,27,37,32,37,-5
55,5,27,53,73,170,-97
55,5,27,123,45,57,-12
55,5,27,163,0,26,-26
55,5,55,13,48,0,48
55,5,55,17,165,187,-22
55,5,55,25,55,50,5
55,5,55,31,0,39,-39
55,5,55,33,131,85,46
55,5,55,35,157,257,-100
55,5,55,63,0,30,-30
55,5,55,79,41,0,41
55,5,55,93,42,0,42
55,5,55,95,272,230,42
55,5,55,107,125,90,35
55,5,55,109,106,107,-1
55,5,55,113,79,62,17
55,5,55,129,218,200,18
55,7,27,137,0,32,-32
55,7,55,3,132,227,-95
55,7,55,25,0,24,-24
55,7,55,31,114,104,10
55,7,55,35,0,36,-36
55,7,55,113,34,26,8
55,9,4,13,108,138,-30
55,9,6,37,49,41,8
55,9,6,59,31,0,31
55,9,6,73,99,59,40
55,9,8,41,0,33,-33
55,9,12,21,0,32,-32
55,9,12,33,30,0,30
55,9,12,57,30,0,30
55,9,12,71,0,23,-23
55,9,12,95,34,25,9
55,9,15,3,0,28,-28
55,9,17,31,239,303,-64
55,9,17,43,30,46,-16
55,9,17,97,73,52,21
55,9,17,197,28,58,-30
55,9,18,97,33,0,33
55,9,26,41,69,54,15
55,9,26,43,92,61,31
55,9,26,61,34,35,-1
55,9,26,71,29,0,29
55,9,26,103,84,68,16
55,9,26,109,93,47,46
55,9,26,125,0,33,-33
55,9,27,37,37,62,-25
55,9,27,53,144,181,-37
55,9,27,109,0,32,-32
55,9,27,123,52,75,-23
55,9,27,163,29,0,29
55,9,32,3,57,61,-4
55,9,36,61,0,25,-25
55,9,48,29,0,28,-28
55,9,48,113,0,45,-45
55,9,53,33,0,36,-36
55,9,53,53,0,43,-43
55,9,55,15,192,186,6
55,9,55,17,35,37,-2
55,9,55,21,31,0,31
55,9,55,25,299,511,-212
55,9,55,27,80,29,51
55,9,55,29,235,243,-8
55,9,55,33,0,34,-34
55,9,55,35,94,50,44
55,9,55,37,51,0,51
55,9,55,39,100,65,35
55,9,55,41,39,46,-7
55,9,55,47,22,21,1
55,9,55,55,41,31,10
55,9,55,59,95,43,52
55,9,55,61,548,468,80
55,9,55,63,77,55,22
55,9,55,67,44,40,4
55,9,55,69,38,25,13
55,9,55,71,471,474,-3
55,9,55,73,192,155,37
55,9,55,75,443,342,101
55,9,55,78,42,0,42
55,9,55,79,587,673,-86
55,9,55,83,999,1049,-50
55,9,55,85,83,66,17
55,9,55,87,1470,1560,-90
55,9,55,89,76,62,14
55,9,55,95,24,0,24
55,9,55,97,92,132,-40
55,9,55,101,36,79,-43
55,9,55,105,31,32,-1
55,9,55,109,0,29,-29
55,9,55,115,411,434,-23
55,9,55,117,214,151,63
55,9,55,125,41,0,41
55,9,55,127,27,0,27
55,9,55,131,68,91,-23
55,9,55,133,172,209,-37
55,9,55,135,111,102,9
55,9,55,139,390,467,-77
55,9,55,141,81,34,47
55,11,27,157,33,45,-12
55,11,27,169,108,107,1
55,11,55,17,35,44,-9
55,11,55,35,97,135,-38
55,11,55,63,0,27,-27
55,11,55,91,45,56,-11
55,11,55,121,109,159,-50
55,13,27,25,42,0,42
55,13,27,53,55,52,3
55,13,27,115,43,33,10
55,13,27,123,58,38,20
55,13,27,163,40,0,40
55,13,55,5,0,48,-48
55,13,55,31,29,0,29
55,13,55,35,0,34,-34
55,13,55,95,136,128,8
55,13,55,109,0,59,-59
55,13,55,129,54,50,4
55,15,27,53,0,23,-23
55,15,55,9,186,192,-6
55,15,55,25,42,86,-44
55,15,55,27,26,0,26
55,15,55,39,70,163,-93
55,15,55,71,319,204,115
55,15,55,79,72,104,-32
55,15,55,87,1372,1162,210
55,15,55,89,0,26,-26
55,15,55,117,145,56,89
55,15,55,133,45,33,12
55,15,55,135,69,63,6
55,15,55,139,591,694,-103
55,17,27,37,0,35,-35
55,17,27,53,65,91,-26
55,17,27,123,53,29,24
55,17,55,5,187,165,22
55,17,55,9,37,35,2
55,17,55,11,44,35,9
55,17,55,19,153,93,60
55,17,55,25,108,76,32
55,17,55,33,220,290,-70
55,17,55,35,1536,1348,188
55,17,55,53,0,33,-33
55,17,55,63,39,54,-15
55,17,55,73,76,45,31
55,17,55,79,42,38,4
55,17,55,93,24,0,24
55,17,55,107,125,129,-4
55,17,55,109,72,95,-23
55,17,55,119,84,57,27
55,17,55,121,43,58,-15
55,17,55,139,29,29,0
55,17,55,141,49,25,24
55,19,27,53,0,24,-24
55,19,55,17,93,153,-60
55,19,55,25,28,40,-12
55,19,55,35,114,139,-25
55,19,55,53,70,79,-9
55,19,55,63,0,44,-44
55,19,55,73,324,275,49
55,19,55,79,0,32,-32
55,19,55,97,0,37,-37
55,19,55,119,187,189,-2
55,19,55,121,0,41,-41
55,19,55,141,217,300,-83
55,21,4,13,0,42,-42
55,21,17,31,63,53,10
55,21,55,1,106,110,-4
55,21,55,9,0,31,-31
55,21,55,25,1560,1421,139
55,21,55,27,312,359,-47
55,21,55,39,51,48,3
55,21,55,43,32,0,32
55,21,55,45,0,35,-35
55,21,55,47,57,50,7
55,21,55,55,79,79,0
55,21,55,57,66,64,2
55,21,55,63,49,65,-16
55,21,55,77,256,274,-18
55,21,55,79,73,68,5
55,21,55,81,0,39,-39
55,21,55,97,0,33,-33
55,21,55,101,0,34,-34
55,21,55,105,69,74,-5
55,21,55,111,479,533,-54
55,21,55,127,0,25,-25
55,21,55,133,41,50,-9
55,21,55,137,0,28,-28
55,21,55,139,41,54,-13
55,21,55,141,0,28,-28
55,23,19,43,126,96,30
55,23,55,25,70,59,11
55,23,55,43,227,209,18
55,23,55,63,50,105,-55
55,23,55,103,36,31,5
55,23,55,123,93,91,2
55,25,2,20,0,36,-36
55,25,2,90,23,0,23
55,25,4,13,266,289,-23
55,25,4,19,102,100,2
55,25,4,25,28,0,28
55,25,6,1,90,113,-23
55,25,6,13,0,29,-29
55,25,6,37,283,305,-22
55,25,6,59,99,93,6
55,25,6,65,49,47,2
55,25,6,67,39,50,-11
55,25,6,71,29,35,-6
55,25,6,73,168,216,-48
55,25,6,75,101,86,15
55,25,6,81,31,66,-35
55,25,6,83,34,0,34
55,25,6,85,74,155,-81
55,25,6,97,32,0,32
55,25,8,5,30,41,-11
55,25,8,13,42,91,-49
55,25,8,31,57,113,-56
55,25,8,35,0,30,-30
55,25,8,41,56,58,-2
55,25,8,59,0,45,-45
55,25,8,69,48,48,0
55,25,9,1,42,0,42
55,25,9,3,48,45,3
55,25,9,9,26,60,-34
55,25,10,3,0,25,-25
55,25,11,1,64,153,-89
55,25,12,1,27,27,0
55,25,12,11,56,57,-1
55,25,12,21,27,34,-7
55,25,12,31,38,45,-7
55,25,12,57,29,81,-52
55,25,12,71,50,45,5
55,25,12,73,0,28,-28
55,25,12,81,0,33,-33
55,25,12,86,49,38,11
55,25,12,95,57,72,-15
55,25,12,99,27,32,-5
55,25,12,101,27,0,27
55,25,12,103,45,57,-12
55,25,12,105,0,41,-41
55,25,12,115,0,41,-41
55,25,13,67,0,50,-50
55,25,13,89,0,27,-27
55,25,13,121,27,70,-43
55,25,13,135,39,30,9
55,25,15,3,56,53,3
55,25,16,1,0,35,-35
55,25,17,19,81,46,35
55,25,17,31,1442,1581,-139
55,25,17,37,54,0,54
55,25,17,43,254,249,5
55,25,17,85,23,0,23
55,25,17,89,116,74,42
55,25,17,97,214,144,70
55,25,17,111,99,58,41
55,25,17,113,56,35,21
55,25,17,119,30,0,30
55,25,17,141,38,0,38
55,25,17,143,46,35,11
55,25,17,167,31,0,31
55,25,17,177,77,30,47
55,25,17,197,74,48,26
55,25,17,201,255,128,127
55,25,18,3,41,0,41
55,25,18,57,53,65,-12
55,25,18,89,55,38,17
55,25,18,97,102,54,48
55,25,18,105,36,0,36
55,25,18,141,48,25,23
55,25,18,157,62,30,32
55,25,19,13,36,0,36
55,25,19,61,124,71,53
55,25,19,103,106,74,32
55,25,19,113,71,54,17
55,25,19,153,71,55,16
55,25,19,163,50,54,-4
55,25,19,169,34,37,-3
55,25,20,45,25,0,25
55,25,20,91,57,63,-6
55,25,20,173,0,34,-34
55,25,21,67,29,35,-6
55,25,21,111,23,0,23
55,25,22,33,0,31,-31
55,25,22,71,0,35,-35
55,25,23,5,35,0,35
55,25,24,3,0,25,-25
55,25,24,31,58,90,-32
55,25,24,33,40,26,14
55,25,24,510,33,35,-2
55,25,25,9,0,33,-33
55,25,25,17,123,121,2
55,25,25,21,0,34,-34
55,25,25,25,44,58,-14
55,25,26,65,52,37,15
55,25,26,77,39,0,39
55,25,26,81,67,46,21
55,25,26,93,39,0,39
55,25,26,99,23,25,-2
55,25,26,103,42,0,42
55,25,26,125,139,85,54
55,25,26,161,103,76,27
55,25,26,163,64,59,5
55,25,27,3,78,29,49
55,25,27,37,116,109,7
55,25,27,53,481,726,-245
55,25,27,55,25,0,25
55,25,27,109,99,98,1
55,25,27,123,204,335,-131
55,25,27,131,29,0,29
55,25,27,137,64,50,14
55,25,27,145,64,0,64
55,25,27,163,38,99,-61
55,25,27,169,39,28,11
55,25,29,19,26,37,-11
55,25,29,95,38,37,1
55,25,29,189,90,112,-22
55,25,29,510,55,46,9
55,25,30,31,25,23,2
55,25,31,55,46,63,-17
55,25,31,109,42,0,42
55,25,32,3,101,135,-34
55,25,33,11,0,27,-27
55,25,34,17,0,35,-35
55,25,34,23,46,55,-9
55,25,35,1,58,48,10
55,25,36,5,0,27,-27
55,25,36,29,39,0,39
55,25,36,47,69,122,-53
55,25,36,55,36,0,36
55,25,36,59,0,37,-37
55,25,36,61,120,189,-69
55,25,36,81,34,59,-25
55,25,36,103,28,0,28
55,25,36,109,33,0,33
55,25,36,119,36,0,36
55,25,37,63,37,52,-15
55,25,37,119,27,56,-29
55,25,37,135,0,34,-34
55,25,37,183,49,60,-11
55,25,38,17,32,0,32
55,25,39,35,78,57,21
55,25,39,49,103,64,39
55,25,39,61,45,37,8
55,25,39,153,44,35,9
55,25,40,143,0,28,-28
55,25,41,5,33,0,33
55,25,41,39,40,42,-2
55,25,41,51,97,137,-40
55,25,41,67,40,72,-32
55,25,42,3,73,35,38
55,25,42,27,33,0,33
55,25,42,91,45,30,15
55,25,42,101,45,79,-34
55,25,44,7,34,0,34
55,25,45,19,22,29,-7
55,25,46,99,41,0,41
55,25,47,37,39,68,-29
55,25,47,93,0,35,-35
55,25,47,157,32,43,-11
55,25,48,29,39,44,-5
55,25,48,85,0,62,-62
55,25,48,113,50,81,-31
55,25,48,141,33,0,33
55,25,48,201,82,148,-66
55,25,48,439,39,52,-13
55,25,48,453,93,146,-53
55,25,48,491,0,34,-34
55,25,49,35,81,55,26
55,25,49,49,54,0,54
55,25,51,13,21,42,-21
55,25,51,59,71,81,-10
55,25,51,107,0,28,-28
55,25,53,33,161,272,-111
55,25,53,53,0,34,-34
55,25,53,61,0,40,-40
55,25,55,1,68,99,-31
55,25,55,3,38,27,11
55,25,55,5,50,55,-5
55,25,55,7,24,0,24
55,25,55,9,511,299,212
55,25,55,15,86,42,44
55,25,55,17,76,108,-32
55,25,55,19,40,28,12
55,25,55,21,1421,1560,-139
55,25,55,23,59,70,-11
55,25,55,27,432,478,-46
55,25,55,29,52,74,-22
55,25,55,31,38,26,12
55,25,55,33,64,42,22
55,25,55,35,238,204,34
55,25,55,39,273,126,147
55,25,55,43,401,268,133
55,25,55,45,643,740,-97
55,25,55,47,56,33,23
55,25,55,49,558,599,-41
55,25,55,53,40,39,1
55,25,55,55,933,1041,-108
55,25,55,57,117,113,4
55,25,55,59,180,141,39
55,25,55,63,434,339,95
55,25,55,65,150,187,-37
55,25,55,67,38,0,38
55,25,55,69,50,45,5
55,25,55,71,141,73,68
55,25,55,73,318,237,81
55,25,55,75,47,0,47
55,25,55,77,119,138,-19
55,25,55,79,1541,1600,-59
55,25,55,81,187,198,-11
55,25,55,83,21,0,21
55,25,55,85,133,55,78
55,25,55,87,399,276,123
55,25,55,89,160,135,25
55,25,55,93,42,32,10
55,25,55,95,0,24,-24
55,25,55,97,261,152,109
55,25,55,99,21,42,-21
55,25,55,101,253,127,126
55,25,55,103,155,134,21
55,25,55,105,1474,1582,-108
55,25,55,109,66,52,14
55,25,55,111,900,954,-54
55,25,55,115,54,44,10
55,25,55,117,196,133,63
55,25,55,119,29,0,29
55,25,55,121,63,186,-123
55,25,55,123,59,85,-26
55,25,55,125,60,63,-3
55,25,55,127,348,191,157
55,25,55,129,34,0,34
55,25,55,131,287,125,162
55,25,55,133,855,753,102
55,25,55,135,84,61,23
55,25,55,137,25,59,-34
55,25,55,139,452,310,142
55,25,55,141,181,159,22
55,27,4,13,35,36,-1
55,27,17,31,43,39,4
55,27,27,53,0,37,-37
55,27,32,3,0,24,-24
55,27,55,9,29,80,-51
55,27,55,15,0,26,-26
55,27,55,21,359,312,47
55,27,55,25,478,432,46
55,27,55,39,565,708,-143
55,27,55,47,95,49,46
55,27,55,55,1010,953,57
55,27,55,59,23,0,23
55,27,55,63,0,40,-40
55,27,55,73,0,50,-50
55,27,55,77,0,38,-38
55,27,55,79,435,321,114
55,27,55,87,50,65,-15
55,27,55,89,34,39,-5
55,27,55,97,0,38,-38
55,27,55,101,49,27,22
55,27,55,105,59,52,7
55,27,55,111,0,31,-31
55,27,55,117,35,49,-14
55,27,55,125,0,29,-29
55,27,55,127,34,33,1
55,27,55,131,735,677,58
55,27,55,133,488,416,72
55,27,55,135,35,0,35
55,27,55,139,62,135,-73
55,27,55,141,0,32,-32
55,29,12,71,0,27,-27
55,29,17,31,73,21,52
55,29,17,43,26,0,26
55,29,55,9,243,235,8
55,29,55,25,74,52,22
55,29,55,61,105,131,-26
55,29,55,79,79,98,-19
55,29,55,87,56,38,18
55,29,55,101,33,0,33
55,29,55,133,36,24,12
55,29,55,139,45,31,14
55,31,27,3,0,44,-44
55,31,27,17,82,99,-17
55,31,27,37,0,46,-46
55,31,27,53,49,139,-90
55,31,27,123,48,43,5
55,31,27,137,831,727,104
55,31,55,3,40,28,12
55,31,55,5,39,0,39
55,31,55,7,104,114,-10
55,31,55,13,0,29,-29
55,31,55,25,26,38,-12
55,31,55,35,25,25,0
55,31,55,109,40,33,7
55,31,55,113,27,33,-6
55,31,55,129,69,91,-22
55,33,27,3,27,0,27
55,33,27,37,48,44,4
55,33,27,53,83,123,-40
55,33,27,123,72,71,1
55,33,27,163,43,40,3
55,33,55,5,85,131,-46
55,33,55,9,34,0,34
55,33,55,17,290,220,70
55,33,55,25,42,64,-22
55,33,55,35,505,643,-138
55,33,55,63,58,26,32
55,33,55,73,28,0,28
55,33,55,79,30,21,9
55,33,55,87,26,26,0
55,33,55,91,77,69,8
55,33,55,93,100,90,10
55,33,55,95,63,47,16
55,33,55,109,312,285,27
55,33,55,121,55,32,23
55,35,4,13,38,62,-24
55,35,6,37,24,23,1
55,35,6,73,0,28,-28
55,35,17,31,45,50,-5
55,35,27,3,37,30,7
55,35,27,37,87,121,-34
55,35,27,53,113,319,-206
55,35,27,109,49,71,-22
55,35,27,123,104,167,-63
55,35,27,137,49,40,9
55,35,27,139,27,0,27
55,35,27,163,38,80,-42
55,35,32,3,0,39,-39
55,35,55,3,36,0,36
55,35,55,5,257,157,100
55,35,55,7,36,0,36
55,35,55,9,50,94,-44
55,35,55,11,135,97,38
55,35,55,13,34,0,34
55,35,55,17,1348,1536,-188
55,35,55,19,139,114,25
55,35,55,25,204,238,-34
55,35,55,31,25,25,0
55,35,55,33,643,505,138
55,35,55,39,29,0,29
55,35,55,53,104,68,36
55,35,55,63,104,143,-39
55,35,55,71,28,0,28
55,35,55,73,153,115,38
55,35,55,79,95,104,-9
55,35,55,81,33,40,-7
55,35,55,85,37,27,10
55,35,55,87,45,55,-10
55,35,55,91,71,59,12
55,35,55,93,60,52,8
55,35,55,95,44,47,-3
55,35,55,97,57,61,-4
55,35,55,99,45,21,24
55,35,55,101,31,0,31
55,35,55,105,45,27,18
55,35,55,107,93,71,22
55,35,55,109,148,155,-7
55,35,55,111,33,0,33
55,35,55,113,50,49,1
55,35,55,117,33,0,33
55,35,55,119,51,51,0
55,35,55,121,310,276,34
55,35,55,129,58,47,11
55,35,55,133,55,101,-46
55,35,55,139,59,32,27
55,35,55,141,121,67,54
55,37,26,43,84,123,-39
55,37,26,71,32,0,32
55,37,55,9,0,51,-51
55,37,55,75,0,35,-35
55,39,4,13,29,40,-11
55,39,17,31,101,68,33
55,39,27,53,0,47,-47
55,39,55,9,65,100,-35
55,39,55,15,163,70,93
55,39,55,21,48,51,-3
55,39,55,25,126,273,-147
55,39,55,27,708,565,143
55,39,55,35,0,29,-29
55,39,55,47,251,256,-5
55,39,55,55,0,34,-34
55,39,55,63,38,38,0
55,39,55,71,59,50,9
55,39,55,73,54,51,3
55,39,55,75,25,0,25
55,39,55,77,36,32,4
55,39,55,79,361,347,14
55,39,55,85,0,28,-28
55,39,55,87,132,148,-16
55,39,55,89,72,71,1
55,39,55,97,0,57,-57
55,39,55,101,45,0,45
55,39,55,105,40,0,40
55,39,55,111,42,0,42
55,39,55,117,220,194,26
55,39,55,131,588,420,168
55,39,55,133,124,126,-2
55,39,55,135,0,39,-39
55,39,55,137,53,83,-30
55,39,55,139,492,691,-199
55,39,55,141,28,0,28
55,41,55,9,46,39,7
55,41,55,67,39,0,39
55,41,55,73,40,0,40
55,41,55,79,47,28,19
55,41,55,83,0,35,-35
55,41,55,85,0,63,-63
55,41,55,87,0,32,-32
55,43,17,31,23,29,-6
55,43,17,85,79,72,7
55,43,19,43,0,26,-26
55,43,19,61,237,233,4
55,43,55,21,0,32,-32
55,43,55,23,209,227,-18
55,43,55,25,268,401,-133
55,43,55,45,44,36,8
55,43,55,49,235,290,-55
55,43,55,55,0,32,-32
55,43,55,59,0,29,-29
55,43,55,63,45,56,-11
55,43,55,65,185,171,14
55,43,55,79,57,58,-1
55,43,55,103,166,105,61
55,43,55,105,29,62,-33
55,43,55,111,54,41,13
55,43,55,123,30,0,30
55,43,55,127,0,25,-25
55,43,55,133,23,35,-12
55,45,17,31,55,21,34
55,45,17,177,148,83,65
55,45,17,201,44,0,44
55,45,55,21,35,0,35
55,45,55,25,740,643,97
55,45,55,43,36,44,-8
55,45,55,49,33,21,12
55,45,55,55,0,36,-36
55,45,55,65,157,147,10
55,45,55,79,0,28,-28
55,45,55,105,304,309,-5
55,45,55,111,29,26,3
55,45,55,127,0,22,-22
55,45,55,133,0,32,-32
55,47,55,9,21,22,-1
55,47,55,21,50,57,-7
55,47,55,25,33,56,-23
55,47,55,27,49,95,-46
55,47,55,39,256,251,5
55,47,55,77,60,82,-22
55,47,55,79,65,37,28
55,47,55,87,39,0,39
55,47,55,137,188,106,82
55,47,55,139,178,285,-107
55,49,55,25,599,558,41
55,49,55,43,290,235,55
55,49,55,45,21,33,-12
55,49,55,65,120,89,31
55,49,55,79,32,28,4
55,49,55,103,94,66,28
55,49,55,105,31,37,-6
55,49,55,111,107,129,-22
55,51,26,53,116,112,4
55,53,55,17,33,0,33
55,53,55,19,79,70,9
55,53,55,25,39,40,-1
55,53,55,35,68,104,-36
55,53,55,63,165,152,13
55,53,55,79,39,37,2
55,53,55,81,114,123,-9
55,53,55,105,35,0,35
55,53,55,121,200,138,62
55,53,55,123,33,0,33
55,53,55,141,25,34,-9
55,55,4,13,0,42,-42
55,55,17,31,59,63,-4
55,55,17,201,0,32,-32
55,55,27,53,0,27,-27
55,55,55,9,31,41,-10
55,55,55,21,79,79,0
55,55,55,25,1041,933,108
55,55,55,27,953,1010,-57
55,55,55,39,34,0,34
55,55,55,43,32,0,32
55,55,55,45,36,0,36
55,55,55,59,27,0,27
55,55,55,71,36,0,36
55,55,55,73,0,42,-42
55,55,55,79,486,371,115
55,55,55,89,48,0,48
55,55,55,97,0,33,-33
55,55,55,101,82,62,20
55,55,55,105,287,420,-133
55,55,55,111,45,55,-10
55,55,55,117,23,0,23
55,55,55,127,358,310,48
55,55,55,131,83,63,20
55,55,55,133,1172,780,392
55,55,55,139,0,40,-40
55,57,17,31,47,0,47
55,57,55,1,73,60,13
55,57,55,21,64,66,-2
55,57,55,25,113,117,-4
55,57,55,63,64,88,-24
55,57,55,79,61,47,14
55,57,55,81,287,298,-11
55,57,55,101,30,0,30
55,57,55,105,71,34,37
55,57,55,111,343,368,-25
55,57,55,123,69,71,-2
55,57,55,133,34,39,-5
55,57,55,139,0,26,-26
55,57,55,141,57,40,17
55,59,4,13,80,135,-55
55,59,6,37,0,47,-47
55,59,6,73,73,63,10
55,59,12,71,0,41,-41
55,59,12,103,0,28,-28
55,59,15,3,57,0,57
55,59,17,31,998,551,447
55,59,17,43,141,95,46
55,59,17,89,37,83,-46
55,59,17,97,3312,1765,1547
55,59,17,111,327,211,116
55,59,17,197,58,37,21
55,59,17,201,0,27,-27
55,59,27,53,39,50,-11
55,59,27,123,0,37,-37
55,59,32,3,44,64,-20
55,59,39,49,0,38,-38
55,59,48,29,0,45,-45
55,59,51,810,74,60,14
55,59,55,1,0,28,-28
55,59,55,9,43,95,-52
55,59,55,25,141,180,-39
55,59,55,27,0,23,-23
55,59,55,43,29,0,29
55,59,55,55,0,27,-27
55,59,55,63,0,25,-25
55,59,55,73,0,44,-44
55,59,55,79,581,742,-161
55,59,55,81,0,34,-34
55,59,55,85,0,36,-36
55,59,55,87,37,45,-8
55,59,55,101,1616,2075,-459
55,59,55,105,65,89,-24
55,59,55,117,35,44,-9
55,59,55,127,306,455,-149
55,59,55,131,28,26,2
55,59,55,133,142,167,-25
55,59,55,139,59,46,13
55,59,55,141,0,34,-34
55,61,55,9,468,548,-80
55,61,55,29,131,105,26
55,61,55,71,62,65,-3
55,61,55,79,0,41,-41
55,63,4,13,53,49,4
55,63,6,37,0,30,-30
55,63,6,73,26,26,0
55,63,17,31,89,80,9
55,63,19,5,0,22,-22
55,63,19,103,0,24,-24
55,63,19,113,0,27,-27
55,63,27,3,33,0,33
55,63,27,37,43,27,16
55,63,27,45,24,0,24
55,63,27,53,125,271,-146
55,63,27,55,414,312,102
55,63,27,109,104,149,-45
55,63,27,123,93,141,-48
55,63,27,137,29,0,29
55,63,27,163,0,33,-33
55,63,27,169,280,152,128
55,63,32,3,35,0,35
55,63,55,5,30,0,30
55,63,55,9,55,77,-22
55,63,55,11,27,0,27
55,63,55,17,54,39,15
55,63,55,19,44,0,44
55,63,55,21,65,49,16
55,63,55,23,105,50,55
55,63,55,25,339,434,-95
55,63,55,27,40,0,40
55,63,55,33,26,58,-32
55,63,55,35,143,104,39
55,63,55,39,38,38,0
55,63,55,43,56,45,11
55,63,55,53,152,165,-13
55,63,55,57,88,64,24
55,63,55,59,25,0,25
55,63,55,73,49,90,-41
55,63,55,79,158,199,-41
55,63,55,81,574,469,105
55,63,55,85,20,0,20
55,63,55,87,70,73,-3
55,63,55,93,32,0,32
55,63,55,97,34,20,14
55,63,55,101,48,24,24
55,63,55,103,56,33,23
55,63,55,105,59,55,4
55,63,55,109,40,28,12
55,63,55,111,49,54,-5
55,63,55,117,43,31,12
55,63,55,121,380,407,-27
55,63,55,123,531,426,105
55,63,55,131,0,27,-27
55,63,55,133,53,100,-47
55,63,55,139,56,44,12
55,63,55,141,115,49,66
55,65,17,85,37,35,2
55,65,19,61,31,49,-18
55,65,55,25,187,150,37
55,65,55,43,171,185,-14
55,65,55,45,147,157,-10
55,65,55,49,89,120,-31
55,67,55,9,40,44,-4
55,67,55,25,0,38,-38
55,67,55,41,0,39,-39
55,67,55,69,29,51,-22
55,67,55,73,170,194,-24
55,67,55,79,42,33,9
55,67,55,83,33,0,33
55,67,55,85,51,59,-8
55,67,55,87,28,55,-27
55,67,55,97,0,33,-33
55,67,55,115,112,102,10
55,67,55,133,29,0,29
55,67,55,139,38,29,9
55,69,55,9,25,38,-13
55,69,55,25,45,50,-5
55,69,55,67,51,29,22
55,69,55,73,482,581,-99
55,69,55,79,22,57,-35
55,69,55,85,129,115,14
55,69,55,97,35,44,-9
55,69,55,119,0,32,-32
55,69,55,133,53,0,53
55,69,55,139,0,34,-34
55,71,4,13,20,30,-10
55,71,17,31,29,71,-42
55,71,27,53,0,35,-35
55,71,55,9,474,471,3
55,71,55,15,204,319,-115
55,71,55,25,73,141,-68
55,71,55,35,0,28,-28
55,71,55,39,50,59,-9
55,71,55,55,0,36,-36
55,71,55,61,65,62,3
55,71,55,73,0,30,-30
55,71,55,75,0,52,-52
55,71,55,79,155,266,-111
55,71,55,83,22,0,22
55,71,55,87,127,114,13
55,71,55,89,35,36,-1
55,71,55,97,0,55,-55
55,71,55,117,681,500,181
55,71,55,131,29,52,-23
55,71,55,133,71,55,16
55,71,55,139,96,125,-29
55,73,4,13,55,45,10
55,73,6,73,0,24,-24
55,73,17,31,91,78,13
55,73,17,43,43,0,43
55,73,27,37,44,36,8
55,73,27,53,85,147,-62
55,73,27,123,46,75,-29
55,73,32,3,30,33,-3
55,73,40,143,0,34,-34
55,73,53,33,0,20,-20
55,73,55,9,155,192,-37
55,73,55,17,45,76,-31
55,73,55,19,275,324,-49
55,73,55,25,237,318,-81
55,73,55,27,50,0,50
55,73,55,33,0,28,-28
55,73,55,35,115,153,-38
55,73,55,39,51,54,-3
55,73,55,41,0,40,-40
55,73,55,55,42,0,42
55,73,55,59,44,0,44
55,73,55,63,90,49,41
55,73,55,67,194,170,24
55,73,55,69,581,482,99
55,73,55,71,30,0,30
55,73,55,79,201,225,-24
55,73,55,83,34,0,34
55,73,55,85,163,157,6
55,73,55,87,139,136,3
55,73,55,93,0,34,-34
55,73,55,97,408,347,61
55,73,55,99,57,33,24
55,73,55,101,59,32,27
55,73,55,105,36,0,36
55,73,55,109,0,32,-32
55,73,55,111,0,36,-36
55,73,55,115,284,244,40
55,73,55,117,37,22,15
55,73,55,119,114,145,-31
55,73,55,125,61,36,25
55,73,55,127,0,25,-25
55,73,55,131,54,47,7
55,73,55,133,91,88,3
55,73,55,135,44,44,0
55,73,55,139,121,166,-45
55,73,55,141,612,487,125
55,75,17,97,29,0,29
55,75,26,41,39,0,39
55,75,26,43,134,115,19
55,75,26,109,393,453,-60
55,75,27,53,0,25,-25
55,75,55,9,342,443,-101
55,75,55,25,0,47,-47
55,75,55,37,35,0,35
55,75,55,39,0,25,-25
55,75,55,71,52,0,52
55,75,55,79,118,90,28
55,75,55,83,209,243,-34
55,75,55,87,79,99,-20
55,75,55,97,0,32,-32
55,75,55,115,33,0,33
55,75,55,117,53,31,22
55,75,55,133,50,43,7
55,75,55,139,42,42,0
55,77,55,1,95,69,26
55,77,55,21,274,256,18
55,77,55,25,138,119,19
55,77,55,27,38,0,38
55,77,55,39,32,36,-4
55,77,55,47,82,60,22
55,77,55,79,66,39,27
55,77,55,105,27,0,27
55,77,55,111,70,66,4
55,77,55,133,35,0,35
55,77,55,137,77,62,15
55,77,55,139,38,24,14
55,78,55,9,0,42,-42
55,78,55,115,110,165,-55
55,79,1,73,0,41,-41
55,79,1,89,0,27,-27
55,79,1,97,0,34,-34
55,79,2,20,24,0,24
55,79,4,13,406,753,-347
55,79,4,19,51,141,-90
55,79,4,21,0,48,-48
55,79,4,25,23,24,-1
55,79,5,119,0,80,-80
55,79,6,1,88,77,11
55,79,6,13,0,71,-71
55,79,6,19,0,38,-38
55,79,6,29,0,28,-28
55,79,6,37,315,354,-39
55,79,6,59,79,122,-43
55,79,6,65,49,72,-23
55,79,6,67,37,60,-23
55,79,6,71,45,77,-32
55,79,6,73,228,247,-19
55,79,6,75,70,105,-35
55,79,6,77,33,0,33
55,79,6,81,0,33,-33
55,79,6,85,35,75,-40
55,79,6,111,36,0,36
55,79,8,1,0,38,-38
55,79,8,5,0,37,-37
55,79,8,13,0,39,-39
55,79,8,31,60,135,-75
55,79,8,41,65,81,-16
55,79,8,59,0,40,-40
55,79,8,69,0,50,-50
55,79,9,1,34,27,7
55,79,9,3,45,28,17
55,79,9,9,37,33,4
55,79,11,1,56,84,-28
55,79,12,1,0,36,-36
55,79,12,9,0,26,-26
55,79,12,11,76,133,-57
55,79,12,21,31,38,-7
55,79,12,31,57,113,-56
55,79,12,57,84,169,-85
55,79,12,69,0,30,-30
55,79,12,71,55,60,-5
55,79,12,83,0,22,-22
55,79,12,86,75,81,-6
55,79,12,95,93,137,-44
55,79,12,99,57,79,-22
55,79,12,101,22,0,22
55,79,12,103,95,78,17
55,79,12,105,42,66,-24
55,79,12,115,0,26,-26
55,79,12,117,29,34,-5
55,79,12,119,0,32,-32
55,79,12,127,0,29,-29
55,79,13,51,0,28,-28
55,79,13,63,35,46,-11
55,79,13,67,35,170,-135
55,79,13,89,96,111,-15
55,79,13,121,71,195,-124
55,79,13,135,68,98,-30
55,79,13,223,0,33,-33
55,79,15,3,55,78,-23
55,79,16,1,0,31,-31
55,79,17,19,40,54,-14
55,79,17,31,2112,2093,19
55,79,17,37,31,0,31
55,79,17,43,271,222,49
55,79,17,89,155,84,71
55,79,17,91,30,0,30
55,79,17,97,374,327,47
55,79,17,111,94,49,45
55,79,17,113,48,0,48
55,79,17,115,25,0,25
55,79,17,119,31,0,31
55,79,17,143,56,45,11
55,79,17,161,38,43,-5
55,79,17,167,46,48,-2
55,79,17,197,127,131,-4
55,79,17,201,195,148,47
55,79,18,3,41,24,17
55,79,18,57,24,43,-19
55,79,18,67,0,46,-46
55,79,18,89,152,74,78
55,79,18,91,28,24,4
55,79,18,97,120,211,-91
55,79,18,105,23,23,0
55,79,18,127,30,0,30
55,79,18,141,70,41,29
55,79,18,157,46,31,15
55,79,19,13,41,39,2
55,79,19,61,31,0,31
55,79,19,103,49,31,18
55,79,19,113,36,47,-11
55,79,19,153,69,46,23
55,79,19,163,40,124,-84
55,79,20,91,33,60,-27
55,79,20,173,0,33,-33
55,79,21,67,25,0,25
55,79,21,111,51,87,-36
55,79,22,33,0,25,-25
55,79,22,71,0,48,-48
55,79,24,5,49,0,49
55,79,24,21,33,0,33
55,79,24,31,61,70,-9
55,79,24,33,0,40,-40
55,79,24,510,24,31,-7
55,79,25,17,86,109,-23
55,79,25,21,32,0,32
55,79,25,25,76,64,12
55,79,25,27,40,0,40
55,79,26,21,35,0,35
55,79,26,41,40,0,40
55,79,26,49,32,0,32
55,79,26,65,53,0,53
55,79,26,77,49,0,49
55,79,26,81,97,40,57
55,79,26,99,66,0,66
55,79,26,103,0,44,-44
55,79,26,109,0,32,-32
55,79,26,121,37,0,37
55,79,26,125,148,67,81
55,79,26,139,53,0,53
55,79,26,161,53,34,19
55,79,26,163,169,89,80
55,79,27,3,49,55,-6
55,79,27,37,76,89,-13
55,79,27,53,429,553,-124
55,79,27,109,61,43,18
55,79,27,123,226,255,-29
55,79,27,137,25,30,-5
55,79,27,145,27,0,27
55,79,27,163,41,66,-25
55,79,28,33,0,37,-37
55,79,28,47,0,28,-28
55,79,28,49,0,47,-47
55,79,29,47,0,42,-42
55,79,29,77,0,27,-27
55,79,29,95,88,79,9
55,79,29,183,0,35,-35
55,79,29,189,94,116,-22
55,79,29,510,50,44,6
55,79,31,55,55,62,-7
55,79,31,109,37,0,37
55,79,32,3,246,377,-131
55,79,32,31,38,31,7
55,79,34,3,29,0,29
55,79,34,17,0,31,-31
55,79,34,23,0,34,-34
55,79,35,1,41,52,-11
55,79,36,5,52,24,28
55,79,36,47,83,122,-39
55,79,36,55,0,23,-23
55,79,36,61,80,131,-51
55,79,36,81,54,64,-10
55,79,36,119,35,30,5
55,79,37,51,39,52,-13
55,79,37,63,0,29,-29
55,79,37,81,0,37,-37
55,79,37,85,0,36,-36
55,79,37,119,70,121,-51
55,79,37,133,39,41,-2
55,79,37,183,30,69,-39
55,79,39,35,131,86,45
55,79,39,49,80,109,-29
55,79,39,61,70,53,17
55,79,39,95,34,0,34
55,79,39,113,49,0,49
55,79,39,153,48,0,48
55,79,40,109,0,48,-48
55,79,40,143,60,0,60
55,79,41,51,51,107,-56
55,79,41,67,0,31,-31
55,79,42,3,49,67,-18
55,79,42,91,32,36,-4
55,79,42,101,60,62,-2
55,79,45,19,0,47,-47
55,79,45,45,26,0,26
55,79,45,79,0,32,-32
55,79,47,37,94,185,-91
55,79,47,93,0,31,-31
55,79,47,113,0,34,-34
55,79,47,149,0,45,-45
55,79,47,157,140,233,-93
55,79,48,27,34,66,-32
55,79,48,29,98,129,-31
55,79,48,85,33,110,-77
55,79,48,113,101,245,-144
55,79,48,121,0,75,-75
55,79,48,141,38,49,-11
55,79,48,157,0,56,-56
55,79,48,201,152,315,-163
55,79,48,339,0,32,-32
55,79,48,439,115,201,-86
55,79,48,453,51,113,-62
55,79,48,491,0,39,-39
55,79,49,35,40,60,-20
55,79,49,49,44,0,44
55,79,51,13,0,47,-47
55,79,51,59,48,93,-45
55,79,51,510,0,28,-28
55,79,51,710,34,0,34
55,79,53,33,88,182,-94
55,79,53,53,0,33,-33
55,79,53,61,0,51,-51
55,79,55,1,47,90,-43
55,79,55,5,0,41,-41
55,79,55,9,673,587,86
55,79,55,15,104,72,32
55,79,55,17,38,42,-4
55,79,55,19,32,0,32
55,79,55,21,68,73,-5
55,79,55,25,1600,1541,59
55,79,55,27,321,435,-114
55,79,55,29,98,79,19
55,79,55,33,21,30,-9
55,79,55,35,104,95,9
55,79,55,39,347,361,-14
55,79,55,41,28,47,-19
55,79,55,43,58,57,1
55,79,55,45,28,0,28
55,79,55,47,37,65,-28
55,79,55,49,28,32,-4
55,79,55,53,37,39,-2
55,79,55,55,371,486,-115
55,79,55,57,47,61,-14
55,79,55,59,742,581,161
55,79,55,61,41,0,41
55,79,55,63,199,158,41
55,79,55,67,33,42,-9
55,79,55,69,57,22,35
55,79,55,71,266,155,111
55,79,55,73,225,201,24
55,79,55,75,90,118,-28
55,79,55,77,39,66,-27
55,79,55,81,34,59,-25
55,79,55,83,55,67,-12
55,79,55,85,81,101,-20
55,79,55,87,403,410,-7
55,79,55,89,1448,2482,-1034
55,79,55,97,154,124,30
55,79,55,99,33,0,33
55,79,55,101,2154,2529,-375
55,79,55,105,268,188,80
55,79,55,109,38,44,-6
55,79,55,111,88,110,-22
55,79,55,115,77,90,-13
55,79,55,117,586,525,61
55,79,55,119,28,27,1
55,79,55,121,33,0,33
55,79,55,123,0,32,-32
55,79,55,125,58,73,-15
55,79,55,127,601,570,31
55,79,55,131,1394,2663,-1269
55,79,55,133,8803,12089,-3286
55,79,55,135,70,80,-10
55,79,55,137,35,135,-100
55,79,55,139,513,409,104
55,79,55,141,89,81,8
55,81,17,31,24,0,24
55,81,27,53,0,29,-29
55,81,55,21,39,0,39
55,81,55,25,198,187,11
55,81,55,35,40,33,7
55,81,55,53,123,114,9
55,81,55,57,298,287,11
55,81,55,59,34,0,34
55,81,55,63,469,574,-105
55,81,55,79,59,34,25
55,81,55,87,34,0,34
55,81,55,97,0,25,-25
55,81,55,105,0,50,-50
55,81,55,111,62,55,7
55,81,55,121,40,25,15
55,81,55,123,182,161,21
55,81,55,133,0,25,-25
55,81,55,141,47,42,5
55,83,26,109,30,0,30
55,83,55,9,1049,999,50
55,83,55,25,0,21,-21
55,83,55,41,35,0,35
55,83,55,67,0,33,-33
55,83,55,71,0,22,-22
55,83,55,73,0,34,-34
55,83,55,75,243,209,34
55,83,55,79,67,55,12
55,83,55,87,98,114,-16
55,83,55,115,160,160,0
55,83,55,117,31,0,31
55,83,55,139,32,38,-6
55,85,4,13,0,38,-38
55,85,17,31,56,29,27
55,85,27,53,0,26,-26
55,85,55,9,66,83,-17
55,85,55,25,55,133,-78
55,85,55,35,27,37,-10
55,85,55,39,28,0,28
55,85,55,41,63,0,63
55,85,55,59,36,0,36
55,85,55,63,0,20,-20
55,85,55,67,59,51,8
55,85,55,69,115,129,-14
55,85,55,73,157,163,-6
55,85,55,79,101,81,20
55,85,55,87,31,75,-44
55,85,55,97,46,49,-3
55,85,55,101,29,0,29
55,85,55,125,331,333,-2
55,85,55,131,38,36,2
55,85,55,133,97,49,48
55,85,55,139,64,44,20
55,85,55,141,30,27,3
55,87,4,13,58,71,-13
55,87,4,19,0,37,-37
55,87,6,37,31,30,1
55,87,6,73,0,44,-44
55,87,8,31,0,23,-23
55,87,8,41,0,32,-32
55,87,17,31,157,140,17
55,87,17,97,33,38,-5
55,87,17,201,27,0,27
55,87,26,41,32,0,32
55,87,26,43,30,0,30
55,87,26,103,68,0,68
55,87,26,109,54,0,54
55,87,27,37,36,32,4
55,87,27,53,100,141,-41
55,87,27,123,42,51,-9
55,87,27,163,0,26,-26
55,87,32,3,39,36,3
55,87,36,61,0,20,-20
55,87,53,33,24,0,24
55,87,55,9,1560,1470,90
55,87,55,15,1162,1372,-210
55,87,55,25,276,399,-123
55,87,55,27,65,50,15
55,87,55,29,38,56,-18
55,87,55,33,26,26,0
55,87,55,35,55,45,10
55,87,55,39,148,132,16
55,87,55,41,32,0,32
55,87,55,47,0,39,-39
55,87,55,59,45,37,8
55,87,55,63,73,70,3
55,87,55,67,55,28,27
55,87,55,71,114,127,-13
55,87,55,73,136,139,-3
55,87,55,75,99,79,20
55,87,55,79,410,403,7
55,87,55,81,0,34,-34
55,87,55,83,114,98,16
55,87,55,85,75,31,44
55,87,55,89,41,0,41
55,87,55,97,140,108,32
55,87,55,101,62,32,30
55,87,55,105,60,25,35
55,87,55,111,0,35,-35
55,87,55,115,229,269,-40
55,87,55,117,104,108,-4
55,87,55,125,43,60,-17
55,87,55,127,28,0,28
55,87,55,131,88,82,6
55,87,55,133,145,141,4
55,87,55,135,721,600,121
55,87,55,137,88,102,-14
55,87,55,139,3707,3616,91
55,87,55,141,112,58,54
55,89,4,13,31,67,-36
55,89,6,37,0,27,-27
55,89,6,73,0,25,-25
55,89,12,21,0,35,-35
55,89,12,71,0,46,-46
55,89,17,31,88,149,-61
55,89,17,43,37,0,37
55,89,17,97,41,35,6
55,89,27,53,34,55,-21
55,89,55,9,62,76,-14
55,89,55,15,26,0,26
55,89,55,25,135,160,-25
55,89,55,27,39,34,5
55,89,55,39,71,72,-1
55,89,55,55,0,48,-48
55,89,55,71,36,35,1
55,89,55,79,2482,1448,1034
55,89,55,87,0,41,-41
55,89,55,101,57,61,-4
55,89,55,117,421,536,-115
55,89,55,127,0,30,-30
55,89,55,131,655,856,-201
55,89,55,133,408,350,58
55,89,55,139,34,66,-32
55,91,27,157,0,36,-36
55,91,55,11,56,45,11
55,91,55,33,69,77,-8
55,91,55,35,59,71,-12
55,91,55,93,93,80,13
55,93,4,13,0,29,-29
55,93,17,31,0,20,-20
55,93,27,3,38,32,6
55,93,27,37,290,182,108
55,93,27,49,198,167,31
55,93,27,53,171,109,62
55,93,27,123,204,177,27
55,93,27,157,0,40,-40
55,93,27,163,235,146,89
55,93,55,5,0,42,-42
55,93,55,17,0,24,-24
55,93,55,25,32,42,-10
55,93,55,33,90,100,-10
55,93,55,35,52,60,-8
55,93,55,63,0,32,-32
55,93,55,73,34,0,34
55,93,55,91,80,93,-13
55,93,55,95,64,68,-4
55,93,55,109,535,603,-68
55,95,27,3,96,36,60
55,95,27,25,179,153,26
55,95,27,37,86,66,20
55,95,27,53,110,157,-47
55,95,27,115,33,0,33
55,95,27,123,190,120,70
55,95,27,137,32,31,1
55,95,27,163,190,141,49
55,95,55,5,230,272,-42
55,95,55,9,0,24,-24
55,95,55,13,128,136,-8
55,95,55,25,24,0,24
55,95,55,33,47,63,-16
55,95,55,35,47,44,3
55,95,55,93,68,64,4
55,95,55,109,550,517,33
55,97,4,13,30,34,-4
55,97,17,31,48,33,15
55,97,27,53,31,111,-80
55,97,27,123,33,29,4
55,97,32,3,0,35,-35
55,97,55,1,39,51,-12
55,97,55,9,132,92,40
55,97,55,19,37,0,37
55,97,55,21,33,0,33
55,97,55,25,152,261,-109
55,97,55,27,38,0,38
55,97,55,35,61,57,4
55,97,55,39,57,0,57
55,97,55,55,33,0,33
55,97,55,63,20,34,-14
55,97,55,67,33,0,33
55,97,55,69,44,35,9
55,97,55,71,55,0,55
55,97,55,73,347,408,-61
55,97,55,75,32,0,32
55,97,55,79,124,154,-30
55,97,55,81,25,0,25
55,97,55,85,49,46,3
55,97,55,87,108,140,-32
55,97,55,101,44,34,10
55,97,55,105,23,48,-25
55,97,55,111,29,33,-4
55,97,55,115,56,28,28
55,97,55,117,22,28,-6
55,97,55,131,40,27,13
55,97,55,133,48,84,-36
55,97,55,135,257,245,12
55,97,55,137,162,106,56
55,97,55,139,75,106,-31
55,97,55,141,604,635,-31
55,99,55,3,71,39,32
55,99,55,25,42,21,21
55,99,55,35,21,45,-24
55,99,55,73,33,57,-24
55,99,55,79,0,33,-33
55,99,55,107,33,26,7
55,99,55,119,41,52,-11
55,99,55,139,0,27,-27
55,99,55,141,32,0,32
55,101,4,13,65,149,-84
55,101,4,19,0,27,-27
55,101,6,37,49,48,1
55,101,6,73,45,43,2
55,101,8,31,0,23,-23
55,101,12,57,27,0,27
55,101,12,101,0,35,-35
55,101,12,115,0,30,-30
55,101,17,31,309,340,-31
55,101,17,43,64,58,6
55,101,17,97,340,205,135
55,101,17,111,57,43,14
55,101,17,201,34,32,2
55,101,26,163,32,75,-43
55,101,27,53,0,83,-83
55,101,27,123,0,35,-35
55,101,32,3,62,44,18
55,101,55,1,0,27,-27
55,101,55,9,79,36,43
55,101,55,21,34,0,34
55,101,55,25,127,253,-126
55,101,55,27,27,49,-22
55,101,55,29,0,33,-33
55,101,55,35,0,31,-31
55,101,55,39,0,45,-45
55,101,55,55,62,82,-20
55,101,55,57,0,30,-30
55,101,55,59,2075,1616,459
55,101,55,63,24,48,-24
55,101,55,73,32,59,-27
55,101,55,79,2529,2154,375
55,101,55,85,0,29,-29
55,101,55,87,32,62,-30
55,101,55,89,61,57,4
55,101,55,97,34,44,-10
55,101,55,105,61,100,-39
55,101,55,117,0,57,-57
55,101,55,127,516,599,-83
55,101,55,131,56,94,-38
55,101,55,133,731,726,5
55,101,55,137,0,36,-36
55,101,55,139,53,73,-20
55,101,55,141,0,39,-39
55,103,55,23,31,36,-5
55,103,55,25,134,155,-21
55,103,55,43,105,166,-61
55,103,55,49,66,94,-28
55,103,55,63,33,56,-23
55,103,55,111,167,177,-10
55,103,55,123,119,107,12
55,105,4,13,40,80,-40
55,105,6,73,32,22,10
55,105,17,7,76,60,16
55,105,17,31,269,279,-10
55,105,17,37,30,0,30
55,105,17,43,39,30,9
55,105,17,89,55,60,-5
55,105,17,97,55,25,30
55,105,17,111,72,47,25
55,105,17,177,38,31,7
55,105,17,201,839,881,-42
55,105,27,53,32,68,-36
55,105,32,3,57,41,16
55,105,53,33,0,26,-26
55,105,55,1,43,35,8
55,105,55,9,32,31,1
55,105,55,21,74,69,5
55,105,55,25,1582,1474,108
55,105,55,27,52,59,-7
55,105,55,35,27,45,-18
55,105,55,39,0,40,-40
55,105,55,43,62,29,33
55,105,55,45,309,304,5
55,105,55,49,37,31,6
55,105,55,53,0,35,-35
55,105,55,55,420,287,133
55,105,55,57,34,71,-37
55,105,55,59,89,65,24
55,105,55,63,55,59,-4
55,105,55,73,0,36,-36
55,105,55,77,0,27,-27
55,105,55,79,188,268,-80
55,105,55,81,50,0,50
55,105,55,87,25,60,-35
55,105,55,97,48,23,25
55,105,55,101,100,61,39
55,105,55,111,83,91,-8
55,105,55,117,35,0,35
55,105,55,123,0,45,-45
55,105,55,127,703,466,237
55,105,55,131,0,41,-41
55,105,55,133,146,142,4
55,105,55,139,32,61,-29
55,105,55,141,35,21,14
55,107,55,5,90,125,-35
55,107,55,17,129,125,4
55,107,55,35,71,93,-22
55,107,55,99,26,33,-7
55,107,55,109,33,0,33
55,107,55,113,46,27,19
55,107,55,119,43,0,43
55,109,4,13,57,35,22
55,109,27,3,174,107,67
55,109,27,25,58,29,29
55,109,27,37,334,223,111
55,109,27,49,39,0,39
55,109,27,53,367,264,103
55,109,27,123,586,487,99
55,109,27,137,24,52,-28
55,109,27,139,47,40,7
55,109,27,163,1011,641,370
55,109,32,3,0,30,-30
55,109,55,5,107,106,1
55,109,55,9,29,0,29
55,109,55,13,59,0,59
55,109,55,17,95,72,23
55,109,55,25,52,66,-14
55,109,55,31,33,40,-7
55,109,55,33,285,312,-27
55,109,55,35,155,148,7
55,109,55,63,28,40,-12
55,109,55,73,32,0,32
55,109,55,79,44,38,6
55,109,55,93,603,535,68
55,109,55,95,517,550,-33
55,109,55,107,0,33,-33
55,109,55,129,48,44,4
55,111,4,13,26,21,5
55,111,17,31,73,60,13
55,111,17,43,33,0,33
55,111,27,53,0,31,-31
55,111,55,1,186,110,76
55,111,55,21,533,479,54
55,111,55,25,954,900,54
55,111,55,27,31,0,31
55,111,55,35,0,33,-33
55,111,55,39,0,42,-42
55,111,55,43,41,54,-13
55,111,55,45,26,29,-3
55,111,55,49,129,107,22
55,111,55,55,55,45,10
55,111,55,57,368,343,25
55,111,55,63,54,49,5
55,111,55,73,36,0,36
55,111,55,77,66,70,-4
55,111,55,79,110,88,22
55,111,55,81,55,62,-7
55,111,55,87,35,0,35
55,111,55,97,33,29,4
55,111,55,103,177,167,10
55,111,55,105,91,83,8
55,111,55,123,48,40,8
55,111,55,133,59,60,-1
55,111,55,139,35,0,35
55,111,55,141,43,44,-1
55,113,17,31,27,0,27
55,113,27,53,45,36,9
55,113,55,3,32,0,32
55,113,55,5,62,79,-17
55,113,55,7,26,34,-8
55,113,55,31,33,27,6
55,113,55,35,49,50,-1
55,113,55,107,27,46,-19
55,113,55,129,70,92,-22
55,115,55,9,434,411,23
55,115,55,25,44,54,-10
55,115,55,67,102,112,-10
55,115,55,73,244,284,-40
55,115,55,75,0,33,-33
55,115,55,78,165,110,55
55,115,55,79,90,77,13
55,115,55,83,160,160,0
55,115,55,87,269,229,40
55,115,55,97,28,56,-28
55,115,55,135,153,247,-94
55,115,55,139,64,49,15
55,117,4,13,26,58,-32
55,117,6,73,0,33,-33
55,117,17,31,99,128,-29
55,117,17,97,35,0,35
55,117,26,125,45,0,45
55,117,27,53,42,48,-6
55,117,55,9,151,214,-63
55,117,55,15,56,145,-89
55,117,55,25,133,196,-63
55,117,55,27,49,35,14
55,117,55,35,0,33,-33
55,117,55,39,194,220,-26
55,117,55,55,0,23,-23
55,117,55,59,44,35,9
55,117,55,63,31,43,-12
55,117,55,71,500,681,-181
55,117,55,73,22,37,-15
55,117,55,75,31,53,-22
55,117,55,79,525,586,-61
55,117,55,83,0,31,-31
55,117,55,87,108,104,4
55,117,55,89,536,421,115
55,117,55,97,28,22,6
55,117,55,101,57,0,57
55,117,55,105,0,35,-35
55,117,55,127,0,31,-31
55,117,55,131,243,168,75
55,117,55,133,131,139,-8
55,117,55,139,132,109,23
55,119,27,53,0,23,-23
55,119,55,17,57,84,-27
55,119,55,19,189,187,2
55,119,55,25,0,29,-29
55,119,55,35,51,51,0
55,119,55,69,32,0,32
55,119,55,73,145,114,31
55,119,55,79,27,28,-1
55,119,55,99,52,41,11
55,119,55,107,0,43,-43
55,119,55,141,0,49,-49
55,121,27,53,0,32,-32
55,121,27,109,0,24,-24
55,121,27,169,115,95,20
55,121,55,11,159,109,50
55,121,55,17,58,43,15
55,121,55,19,41,0,41
55,121,55,25,186,63,123
55,121,55,33,32,55,-23
55,121,55,35,276,310,-34
55,121,55,53,138,200,-62
55,121,55,63,407,380,27
55,121,55,79,0,33,-33
55,121,55,81,25,40,-15
55,123,27,53,33,0,33
55,123,55,23,91,93,-2
55,123,55,25,85,59,26
55,123,55,43,0,30,-30
55,123,55,53,0,33,-33
55,123,55,57,71,69,2
55,123,55,63,426,531,-105
55,123,55,79,32,0,32
55,123,55,81,161,182,-21
55,123,55,103,107,119,-12
55,123,55,105,45,0,45
55,123,55,111,40,48,-8
55,125,17,31,45,0,45
55,125,26,53,0,34,-34
55,125,55,9,0,41,-41
55,125,55,25,63,60,3
55,125,55,27,29,0,29
55,125,55,73,36,61,-25
55,125,55,79,73,58,15
55,125,55,85,333,331,2
55,125,55,87,60,43,17
55,125,55,133,73,30,43
55,127,4,13,65,72,-7
55,127,6,73,30,28,2
55,127,12,71,0,29,-29
55,127,12,115,0,29,-29
55,127,17,7,0,61,-61
55,127,17,31,353,248,105
55,127,17,43,108,74,34
55,127,17,89,42,52,-10
55,127,17,97,280,187,93
55,127,17,111,473,506,-33
55,127,17,201,92,56,36
55,127,27,53,0,35,-35
55,127,55,9,0,27,-27
55,127,55,21,25,0,25
55,127,55,25,191,348,-157
55,127,55,27,33,34,-1
55,127,55,43,25,0,25
55,127,55,45,22,0,22
55,127,55,55,310,358,-48
55,127,55,59,455,306,149
55,127,55,73,25,0,25
55,127,55,79,570,601,-31
55,127,55,87,0,28,-28
55,127,55,89,30,0,30
55,127,55,101,599,516,83
55,127,55,105,466,703,-237
55,127,55,117,31,0,31
55,127,55,131,44,32,12
55,127,55,133,697,635,62
55,127,55,139,0,29,-29
55,129,27,37,35,26,9
55,129,27,53,31,23,8
55,129,27,123,37,0,37
55,129,27,137,0,28,-28
55,129,55,5,200,218,-18
55,129,55,13,50,54,-4
55,129,55,25,0,34,-34
55,129,55,31,91,69,22
55,129,55,35,47,58,-11
55,129,55,109,44,48,-4
55,129,55,113,92,70,22
55,131,4,13,47,99,-52
55,131,4,19,0,32,-32
55,131,6,37,0,27,-27
55,131,6,73,0,41,-41
55,131,17,31,84,90,-6
55,131,17,201,36,0,36
55,131,27,53,37,85,-48
55,131,55,9,91,68,23
55,131,55,25,125,287,-162
55,131,55,27,677,735,-58
55,131,55,39,420,588,-168
55,131,55,55,63,83,-20
55,131,55,59,26,28,-2
55,131,55,63,27,0,27
55,131,55,71,52,29,23
55,131,55,73,47,54,-7
55,131,55,79,2663,1394,1269
55,131,55,85,36,38,-2
55,131,55,87,82,88,-6
55,131,55,89,856,655,201
55,131,55,97,27,40,-13
55,131,55,101,94,56,38
55,131,55,105,41,0,41
55,131,55,117,168,243,-75
55,131,55,127,32,44,-12
55,131,55,133,1954,1368,586
55,131,55,139,88,132,-44
55,133,4,13,192,357,-165
55,133,4,19,38,48,-10
55,133,4,21,0,31,-31
55,133,6,1,0,28,-28
55,133,6,37,73,147,-74
55,133,6,59,45,58,-13
55,133,6,65,25,0,25
55,133,6,73,137,92,45
55,133,6,75,0,27,-27
55,133,6,85,0,55,-55
55,133,8,1,0,26,-26
55,133,8,5,0,37,-37
55,133,8,13,0,30,-30
55,133,8,31,0,39,-39
55,133,8,35,0,41,-41
55,133,8,41,37,53,-16
55,133,9,1,30,0,30
55,133,9,3,37,0,37
55,133,11,1,0,21,-21
55,133,12,11,37,54,-17
55,133,12,21,30,55,-25
55,133,12,31,0,38,-38
55,133,12,57,33,60,-27
55,133,12,71,36,68,-32
55,133,12,95,41,39,2
55,133,12,99,43,34,9
55,133,12,103,51,93,-42
55,133,12,105,0,29,-29
55,133,12,115,0,39,-39
55,133,12,117,55,0,55
55,133,13,67,40,0,40
55,133,13,121,0,44,-44
55,133,13,135,0,28,-28
55,133,15,3,0,40,-40
55,133,17,31,473,426,47
55,133,17,43,146,178,-32
55,133,17,89,73,57,16
55,133,17,93,35,0,35
55,133,17,97,144,161,-17
55,133,17,111,97,51,46
55,133,17,197,82,0,82
55,133,17,201,94,66,28
55,133,18,57,0,47,-47
55,133,18,89,28,0,28
55,133,18,97,0,26,-26
55,133,19,153,39,24,15
55,133,19,163,0,102,-102
55,133,21,111,44,0,44
55,133,25,17,40,39,1
55,133,25,25,0,20,-20
55,133,26,81,39,0,39
55,133,26,125,61,59,2
55,133,26,161,33,0,33
55,133,26,163,54,0,54
55,133,27,3,26,0,26
55,133,27,37,24,69,-45
55,133,27,53,167,208,-41
55,133,27,109,0,25,-25
55,133,27,123,39,76,-37
55,133,27,163,0,74,-74
55,133,29,189,42,30,12
55,133,32,3,88,81,7
55,133,34,23,0,37,-37
55,133,36,61,0,57,-57
55,133,37,119,0,41,-41
55,133,37,183,43,43,0
55,133,39,17,36,0,36
55,133,39,35,0,42,-42
55,133,39,49,59,43,16
55,133,40,109,0,34,-34
55,133,41,51,0,32,-32
55,133,48,29,0,71,-71
55,133,48,85,0,81,-81
55,133,48,113,29,27,2
55,133,48,121,0,44,-44
55,133,48,201,38,87,-49
55,133,48,439,38,52,-14
55,133,48,453,0,67,-67
55,133,49,35,0,33,-33
55,133,53,33,64,82,-18
55,133,55,1,26,77,-51
55,133,55,9,209,172,37
55,133,55,15,33,45,-12
55,133,55,21,50,41,9
55,133,55,25,753,855,-102
55,133,55,27,416,488,-72
55,133,55,29,24,36,-12
55,133,55,35,101,55,46
55,133,55,39,126,124,2
55,133,55,43,35,23,12
55,133,55,45,32,0,32
55,133,55,55,780,1172,-392
55,133,55,57,39,34,5
55,133,55,59,167,142,25
55,133,55,63,100,53,47
55,133,55,67,0,29,-29
55,133,55,69,0,53,-53
55,133,55,71,55,71,-16
55,133,55,73,88,91,-3
55,133,55,75,43,50,-7
55,133,55,77,0,35,-35
55,133,55,79,12089,8803,3286
55,133,55,81,25,0,25
55,133,55,85,49,97,-48
55,133,55,87,141,145,-4
55,133,55,89,350,408,-58
55,133,55,97,84,48,36
55,133,55,101,726,731,-5
55,133,55,105,142,146,-4
55,133,55,111,60,59,1
55,133,55,117,139,131,8
55,133,55,125,30,73,-43
55,133,55,127,635,697,-62
55,133,55,131,1368,1954,-586
55,133,55,135,47,45,2
55,133,55,137,0,45,-45
55,133,55,139,206,168,38
55,133,55,141,70,46,24
55,135,55,9,102,111,-9
55,135,55,15,63,69,-6
55,135,55,25,61,84,-23
55,135,55,27,0,35,-35
55,135,55,39,39,0,39
55,135,55,73,44,44,0
55,135,55,79,80,70,10
55,135,55,87,600,721,-121
55,135,55,97,245,257,-12
55,135,55,115,247,153,94
55,135,55,133,45,47,-2
55,135,55,137,93,122,-29
55,135,55,139,354,345,9
55,135,55,141,47,35,12
55,137,55,1,33,0,33
55,137,55,21,28,0,28
55,137,55,25,59,25,34
55,137,55,39,83,53,30
55,137,55,47,106,188,-82
55,137,55,77,62,77,-15
55,137,55,79,135,35,100
55,137,55,87,102,88,14
55,137,55,97,106,162,-56
55,137,55,101,36,0,36
55,137,55,133,45,0,45
55,137,55,135,122,93,29
55,137,55,139,264,264,0
55,137,55,141,33,31,2
55,139,4,13,42,81,-39
55,139,4,19,33,28,5
55,139,6,37,0,50,-50
55,139,6,59,31,0,31
55,139,6,73,26,36,-10
55,139,12,57,0,28,-28
55,139,13,121,0,25,-25
55,139,17,31,106,141,-35
55,139,17,43,29,36,-7
55,139,17,97,38,0,38
55,139,26,41,30,0,30
55,139,26,103,29,0,29
55,139,26,163,29,0,29
55,139,27,53,80,92,-12
55,139,27,109,0,29,-29
55,139,27,123,27,68,-41
55,139,32,3,32,24,8
55,139,48,201,0,36,-36
55,139,53,33,28,25,3
55,139,55,9,467,390,77
55,139,55,15,694,591,103
55,139,55,17,29,29,0
55,139,55,21,54,41,13
55,139,55,25,310,452,-142
55,139,55,27,135,62,73
55,139,55,29,31,45,-14
55,139,55,35,32,59,-27
55,139,55,39,691,492,199
55,139,55,47,285,178,107
55,139,55,55,40,0,40
55,139,55,57,26,0,26
55,139,55,59,46,59,-13
55,139,55,63,44,56,-12
55,139,55,67,29,38,-9
55,139,55,69,34,0,34
55,139,55,71,125,96,29
55,139,55,73,166,121,45
55,139,55,75,42,42,0
55,139,55,77,24,38,-14
55,139,55,79,409,513,-104
55,139,55,83,38,32,6
55,139,55,85,44,64,-20
55,139,55,87,3616,3707,-91
55,139,55,89,66,34,32
55,139,55,97,106,75,31
55,139,55,99,27,0,27
55,139,55,101,73,53,20
55,139,55,105,61,32,29
55,139,55,111,0,35,-35
55,139,55,115,49,64,-15
55,139,55,117,109,132,-23
55,139,55,127,29,0,29
55,139,55,131,132,88,44
55,139,55,133,168,206,-38
55,139,55,135,345,354,-9
55,139,55,137,264,264,0
55,139,55,141,72,63,9
55,141,4,13,0,41,-41
55,141,17,31,45,45,0
55,141,27,53,0,68,-68
55,141,27,109,0,23,-23
55,141,27,123,0,29,-29
55,141,55,1,207,89,118
55,141,55,9,34,81,-47
55,141,55,17,25,49,-24
55,141,55,19,300,217,83
55,141,55,21,28,0,28
55,141,55,25,159,181,-22
55,141,55,27,32,0,32
55,141,55,35,67,121,-54
55,141,55,39,0,28,-28
55,141,55,53,34,25,9
55,141,55,57,40,57,-17
55,141,55,59,34,0,34
55,141,55,63,49,115,-66
55,141,55,73,487,612,-125
55,141,55,79,81,89,-8
55,141,55,81,42,47,-5
55,141,55,85,27,30,-3
55,141,55,87,58,112,-54
55,141,55,97,635,604,31
55,141,55,99,0,32,-32
55,141,55,101,39,0,39
55,141,55,105,21,35,-14
55,141,55,111,44,43,1
55,141,55,119,49,0,49
55,141,55,133,46,70,-24
55,141,55,135,35,47,-12
55,141,55,137,31,33,-2
55,141,55,139,63,72,-9
56,1,4,13,0,67,-67
56,1,6,37,29,28,1
56,1,8,1,0,36,-36
56,1,8,5,49,48,1
56,1,8,13,46,37,9
56,1,8,31,33,73,-40
56,1,8,35,0,21,-21
56,1,8,41,33,30,3
56,1,8,59,28,33,-5
56,1,8,69,118,161,-43
56,1,8,77,24,0,24
56,1,8,123,34,41,-7
56,1,31,157,0,29,-29
56,1,32,3,29,26,3
56,1,46,103,0,30,-30
56,1,48,201,0,23,-23
56,1,48,453,0,32,-32
56,1,49,35,35,37,-2
56,1,53,33,0,37,-37
56,1,56,3,40,41,-1
56,1,56,5,80,104,-24
56,1,56,7,107,60,47
56,1,56,9,0,43,-43
56,1,56,13,90,88,2
56,1,56,15,25,0,25
56,1,56,19,26,0,26
56,1,56,21,282,472,-190
56,1,56,23,47,32,15
56,1,56,25,181,150,31
56,1,56,29,61,44,17
56,1,56,31,43,43,0
56,1,56,33,87,100,-13
56,1,56,37,93,110,-17
56,1,56,39,42,21,21
56,1,56,41,34,41,-7
56,1,56,43,29,0,29
56,3,30,111,40,56,-16
56,3,56,1,41,40,1
56,3,56,5,30,0,30
56,3,56,25,0,31,-31
56,3,56,29,171,195,-24
56,3,56,33,48,0,48
56,3,56,43,36,27,9
56,5,4,13,60,42,18
56,5,8,41,31,32,-1
56,5,8,69,36,34,2
56,5,8,123,37,49,-12
56,5,26,49,66,0,66
56,5,30,31,0,33,-33
56,5,30,63,31,0,31
56,5,30,111,74,82,-8
56,5,31,157,27,0,27
56,5,32,3,0,36,-36
56,5,38,15,25,0,25
56,5,46,19,54,33,21
56,5,46,81,111,88,23
56,5,46,93,76,36,40
56,5,46,103,176,140,36
56,5,49,35,47,32,15
56,5,56,1,104,80,24
56,5,56,3,0,30,-30
56,5,56,7,35,30,5
56,5,56,9,35,72,-37
56,5,56,11,141,172,-31
56,5,56,13,35,51,-16
56,5,56,19,53,82,-29
56,5,56,21,63,81,-18
56,5,56,25,152,192,-40
56,5,56,29,53,37,16
56,5,56,31,50,36,14
56,5,56,33,144,204,-60
56,5,56,37,55,28,27
56,5,56,45,71,97,-26
56,7,8,69,45,40,5
56,7,49,35,0,32,-32
56,7,56,1,60,107,-47
56,7,56,5,30,35,-5
56,7,56,13,0,89,-89
56,7,56,21,71,104,-33
56,7,56,25,70,112,-42
56,7,56,37,98,83,15
56,9,8,69,27,0,27
56,9,56,1,43,0,43
56,9,56,5,72,35,37
56,9,56,13,43,0,43
56,9,56,21,47,59,-12
56,9,56,25,347,334,13
56,9,56,31,40,0,40
56,9,56,33,0,29,-29
56,11,46,81,35,49,-14
56,11,46,103,41,0,41
56,11,56,5,172,141,31
56,11,56,25,0,29,-29
56,11,56,45,0,29,-29
56,13,8,59,28,0,28
56,13,8,69,0,30,-30
56,13,8,77,0,50,-50
56,13,49,35,40,29,11
56,13,56,1,88,90,-2
56,13,56,5,51,35,16
56,13,56,7,89,0,89
56,13,56,9,0,43,-43
56,13,56,17,33,58,-25
56,13,56,21,66,77,-11
56,13,56,25,203,187,16
56,13,56,29,32,38,-6
56,13,56,33,34,40,-6
56,13,56,35,24,0,24
56,13,56,37,105,52,53
56,13,56,39,35,32,3
56,13,56,41,43,39,4
56,15,8,69,27,0,27
56,15,31,157,107,77,30
56,15,56,1,0,25,-25
56,15,56,21,77,78,-1
56,15,56,25,0,32,-32
56,15,56,31,66,42,24
56,17,56,13,58,33,25
56,17,56,25,29,32,-3
56,19,56,1,0,26,-26
56,19,56,5,82,53,29
56,19,56,25,52,52,0
56,19,56,33,129,113,16
56,21,2,20,67,46,21
56,21,2,90,52,0,52
56,21,4,13,121,148,-27
56,21,4,19,0,63,-63
56,21,6,37,63,0,63
56,21,6,59,34,0,34
56,21,6,71,40,40,0
56,21,6,73,38,28,10
56,21,6,83,106,68,38
56,21,8,1,120,78,42
56,21,8,5,67,121,-54
56,21,8,13,39,59,-20
56,21,8,31,105,113,-8
56,21,8,35,52,68,-16
56,21,8,41,126,189,-63
56,21,8,59,56,75,-19
56,21,8,69,353,462,-109
56,21,8,77,39,0,39
56,21,8,101,26,0,26
56,21,8,123,207,274,-67
56,21,13,153,43,0,43
56,21,15,3,49,0,49
56,21,16,1,0,36,-36
56,21,30,13,42,0,42
56,21,30,111,0,42,-42
56,21,31,55,35,23,12
56,21,31,105,43,24,19
56,21,31,111,30,0,30
56,21,31,153,0,43,-43
56,21,31,157,84,27,57
56,21,32,3,80,104,-24
56,21,35,1,45,40,5
56,21,38,101,40,0,40
56,21,46,103,72,33,39
56,21,48,29,80,112,-32
56,21,48,201,35,40,-5
56,21,48,439,0,32,-32
56,21,48,453,28,0,28
56,21,49,11,45,46,-1
56,21,49,35,45,56,-11
56,21,51,59,0,32,-32
56,21,53,33,0,34,-34
56,21,53,63,0,45,-45
56,21,56,1,472,282,190
56,21,56,5,81,63,18
56,21,56,7,104,71,33
56,21,56,9,59,47,12
56,21,56,13,77,66,11
56,21,56,15,78,77,1
56,21,56,25,191,181,10
56,21,56,29,24,0,24
56,21,56,31,129,89,40
56,21,56,33,70,81,-11
56,21,56,37,108,83,25
56,21,56,41,40,0,40
56,23,4,13,34,0,34
56,23,16,5,40,36,4
56,23,16,19,0,39,-39
56,23,16,65,44,49,-5
56,23,49,5,54,53,1
56,23,49,11,0,37,-37
56,23,49,35,97,41,56
56,23,49,49,66,25,41
56,23,49,57,0,23,-23
56,23,56,1,32,47,-15
56,23,56,25,0,28,-28
56,23,56,35,66,45,21
56,23,56,37,89,57,32
56,23,56,39,200,89,111
56,23,56,41,46,125,-79
56,25,4,13,106,86,20
56,25,6,29,0,28,-28
56,25,6,37,59,23,36
56,25,6,71,31,0,31
56,25,6,73,49,0,49
56,25,8,1,81,81,0
56,25,8,5,45,69,-24
56,25,8,13,0,49,-49
56,25,8,31,41,56,-15
56,25,8,35,0,36,-36
56,25,8,41,0,50,-50
56,25,8,59,28,36,-8
56,25,8,69,95,113,-18
56,25,8,77,31,101,-70
56,25,8,123,53,75,-22
56,25,26,49,51,0,51
56,25,26,163,27,0,27
56,25,30,31,0,24,-24
56,25,30,63,31,0,31
56,25,30,111,60,94,-34
56,25,31,157,0,38,-38
56,25,32,3,76,47,29
56,25,41,51,0,30,-30
56,25,46,99,0,26,-26
56,25,46,103,97,75,22
56,25,48,201,33,69,-36
56,25,49,35,44,46,-2
56,25,49,49,0,33,-33
56,25,53,33,30,0,30
56,25,53,63,27,0,27
56,25,56,1,150,181,-31
56,25,56,3,31,0,31
56,25,56,5,192,152,40
56,25,56,7,112,70,42
56,25,56,9,334,347,-13
56,25,56,11,29,0,29
56,25,56,13,187,203,-16
56,25,56,15,32,0,32
56,25,56,17,32,29,3
56,25,56,19,52,52,0
56,25,56,21,181,191,-10
56,25,56,23,28,0,28
56,25,56,29,79,70,9
56,25,56,31,50,58,-8
56,25,56,33,97,109,-12
56,25,56,35,31,45,-14
56,25,56,37,154,95,59
56,25,56,39,0,24,-24
56,25,56,41,31,24,7
56,25,56,43,38,0,38
56,25,56,45,24,0,24
56,29,4,13,39,0,39
56,29,6,37,27,0,27
56,29,6,73,25,0,25
56,29,30,9,32,0,32
56,29,30,31,30,28,2
56,29,30,67,0,37,-37
56,29,30,111,116,183,-67
56,29,32,3,28,0,28
56,29,56,1,44,61,-17
56,29,56,3,195,171,24
56,29,56,5,37,53,-16
56,29,56,13,38,32,6
56,29,56,21,0,24,-24
56,29,56,25,70,79,-9
56,29,56,33,0,46,-46
56,29,56,35,0,32,-32
56,29,56,43,43,73,-30
56,31,31,157,0,30,-30
56,31,56,1,43,43,0
56,31,56,5,36,50,-14
56,31,56,9,0,40,-40
56,31,56,15,42,66,-24
56,31,56,21,89,129,-40
56,31,56,25,58,50,8
56,33,4,13,0,29,-29
56,33,8,41,32,0,32
56,33,8,69,33,29,4
56,33,30,3,37,49,-12
56,33,30,31,0,32,-32
56,33,30,111,97,151,-54
56,33,46,81,28,0,28
56,33,46,103,31,32,-1
56,33,56,1,100,87,13
56,33,56,3,0,48,-48
56,33,56,5,204,144,60
56,33,56,9,29,0,29
56,33,56,13,40,34,6
56,33,56,19,113,129,-16
56,33,56,21,81,70,11
56,33,56,25,109,97,12
56,33,56,29,46,0,46
56,33,56,37,35,0,35
56,35,8,77,0,50,-50
56,35,49,35,44,32,12
56,35,56,13,0,24,-24
56,35,56,23,45,66,-21
56,35,56,25,45,31,14
56,35,56,29,32,0,32
56,35,56,37,141,95,46
56,35,56,39,30,0,30
56,35,56,41,34,0,34
56,37,4,13,75,39,36
56,37,6,29,34,0,34
56,37,6,37,45,0,45
56,37,6,59,47,0,47
56,37,6,65,26,0,26
56,37,8,1,39,41,-2
56,37,8,31,0,28,-28
56,37,8,41,55,28,27
56,37,8,69,43,49,-6
56,37,8,77,47,183,-136
56,37,8,123,39,31,8
56,37,16,5,0,47,-47
56,37,16,19,0,34,-34
56,37,30,111,27,0,27
56,37,32,3,88,0,88
56,37,35,45,0,46,-46
56,37,46,103,0,33,-33
56,37,48,201,46,28,18
56,37,49,5,0,38,-38
56,37,49,7,118,42,76
56,37,49,11,67,0,67
56,37,49,15,101,0,101
56,37,49,35,131,158,-27
56,37,49,47,43,76,-33
56,37,49,49,84,57,27
56,37,49,57,35,48,-13
56,37,56,1,110,93,17
56,37,56,5,28,55,-27
56,37,56,7,83,98,-15
56,37,56,13,52,105,-53
56,37,56,21,83,108,-25
56,37,56,23,57,89,-32
56,37,56,25,95,154,-59
56,37,56,33,0,35,-35
56,37,56,35,95,141,-46
56,37,56,41,131,177,-46
56,39,4,13,52,40,12
56,39,6,37,32,22,10
56,39,6,73,30,23,7
56,39,8,13,26,42,-16
56,39,8,31,24,31,-7
56,39,8,69,37,0,37
56,39,9,1,32,0,32
56,39,16,1,31,0,31
56,39,16,19,32,0,32
56,39,16,81,115,263,-148
56,39,17,31,27,0,27
56,39,25,17,23,0,23
56,39,30,31,26,54,-28
56,39,41,51,0,28,-28
56,39,49,35,47,69,-22
56,39,49,57,0,37,-37
56,39,50,7,21,0,21
56,39,53,33,36,49,-13
56,39,56,1,21,42,-21
56,39,56,13,32,35,-3
56,39,56,23,89,200,-111
56,39,56,25,24,0,24
56,39,56,35,0,30,-30
56,41,6,37,80,0,80
56,41,8,77,0,61,-61
56,41,32,3,61,0,61
56,41,49,5,0,29,-29
56,41,49,11,74,42,32
56,41,49,35,174,154,20
56,41,49,49,61,61,0
56,41,49,53,0,32,-32
56,41,49,57,56,56,0
56,41,56,1,41,34,7
56,41,56,13,39,43,-4
56,41,56,21,0,40,-40
56,41,56,23,125,46,79
56,41,56,25,24,31,-7
56,41,56,35,0,34,-34
56,41,56,37,177,131,46
56,43,30,111,0,39,-39
56,43,56,1,0,29,-29
56,43,56,3,27,36,-9
56,43,56,25,0,38,-38
56,43,56,29,73,43,30
56,45,46,81,0,34,-34
56,45,46,103,32,0,32
56,45,56,5,97,71,26
56,45,56,11,29,0,29
56,45,56,25,0,24,-24
